locus,erv.assigned,erv.assigned.freq,n.erv.called,actual.stop,actual.start,all.hits.ervs,all.hits.counts,locus.width,mapped.width
chr1-100096040_100096227,cPa581,0.6,3,100096210,100096090,cPa356-cPa527-hybrid_cPa395-unknown_cPa581,1_1_3,187,120
chr1-10089520_10089765,cPa75,0.580645161290323,7,10089743,10089528,cPa260_cPa260-cPa75-hybrid_cPa62-HERV-W_repbase_HERV17_LTR17-hybrid_cPa62-unknown_cPa75_cPa75-HERV-W_repbase_HERV17_LTR17-hybrid_HERV-W_repbase_HERV17_LTR17,2_1_5_2_18_1_2,245,215
chr1-101297468_101297631,cPa62,0.96551724137931,2,101297589,101297508,cPa254_cPa62,1_28,163,81
chr1-101430640_101430764,HERV-W_repbase_HERV17_LTR17,0.769230769230769,6,101430722,101430648,cPa62-cPa293-hybrid_cPa62-HERV-W_repbase_HERV17_LTR17-hybrid_HERV-F_repbase_HERVFH19I_LTR19A_HERV-W_repbase_HERV17_LTR17_KoRV_AF151794_PERV_AJ293656,1_1_1_30_4_2,124,74
chr1-101465489_101465591,cPa62,0.944444444444444,2,101465541,101465523,cPa254_cPa62,1_17,102,18
chr1-101488728_101488830,cPa426,0.421052631578947,7,101488785,101488765,cPa287_cPa293_cPa391_cPa391-cPa287-hybrid_cPa391-cPa293-hybrid_cPa391-unknown_cPa426,2_2_2_2_1_2_8,102,20
chr1-101723981_101724096,PtERV1_AC142352,1,1,101724094,101724030,PtERV1_AC142352,9,115,64
chr1-10196137_10196247,cPa15,0.653846153846154,5,10196201,10196180,cPa118_cPa15_cPa15-cPa268-hybrid_cPa268_cPa268-cPa118-hybrid,1_17_1_5_2,110,21
chr1-1021278_1021380,cPa163,1,1,1021328,1021328,cPa163,1,102,0
chr1-102610526_102610645,cPa62,0.928571428571429,4,102610600,102610574,cPa293-unknown_cPa333-unknown_cPa62_cPa62-unknown,1_1_52_2,119,26
chr1-102633705_102633807,cPa75,1,1,102633755,102633755,cPa75,2,102,0
chr1-102633885_102634033,cPa75,1,1,102633981,102633931,cPa75,7,148,50
chr1-102668715_102668817,cPa75,1,1,102668765,102668765,cPa75,1,102,0
chr1-10325516_10325628,cPa363,0.333333333333333,5,10325576,10325564,cPa117-cPa174-hybrid_cPa363_cPa452_cPa452-cPa174-hybrid_cPa456,2_3_1_1_2,112,12
chr1-103849251_103849420,cPa62,0.761904761904762,5,103849413,103849250,cPa113-unknown_cPa62_cPa62-cPa75-hybrid_cPa75_cPa75-cPa62-hybrid,1_16_1_2_1,169,163
chr1-103849428_103850054,cPa62,0.641975308641975,11,103850025,103849478,cPa113_cPa113-cPa62-hybrid_cPa113-cPa75-hybrid_cPa113-unknown_cPa285_cPa285-cPa75-hybrid_cPa293_cPa293-cPa285-hybrid_cPa62_cPa75_cPa75-cPa62-hybrid,1_3_1_1_3_3_1_1_52_14_1,626,547
chr1-103850126_103850228,cPa75,0.375,4,103850190,103850161,cPa113-cPa62-hybrid_cPa285_cPa62_cPa75,2_1_2_3,102,29
chr1-103850283_103850391,cPa62,0.75,3,103850346,103850311,cPa285_cPa62_cPa75,2_9_1,108,35
chr1-103912267_103912460,cPa62,1,1,103912408,103912315,cPa62,39,193,93
chr1-104114775_104114877,cPa456,0.5,3,104114831,104114825,cPa117-cPa587-hybrid_cPa363_cPa456,1_1_2,102,6
chr1-104228838_104228940,cPa75-unknown,1,1,104228937,104228853,cPa75-unknown,8,102,84
chr1-10436800_10437031,cPa62,0.851063829787234,5,10436979,10436835,cPa285-unknown_cPa293-cPa62-hybrid_cPa293-unknown_cPa62_cPa62-unknown,1_1_1_40_4,231,144
chr1-10449460_10449562,cPa62,1,1,10449510,10449463,cPa62,2,102,47
chr1-104534370_104534562,cPa62,0.882352941176471,2,104534511,104534371,cPa62_cPa62-unknown,15_2,192,140
chr1-104757364_104757466,cPa492,1,1,104757414,104757408,cPa492,2,102,6
chr1-104805322_104805424,cPa529,1,1,104805373,104805372,cPa529,2,102,1
chr1-104900979_104901117,cPa75,0.466666666666667,8,104901111,104900979,cPa260_cPa413_cPa62_cPa62-cPa293-hybrid_cPa62-cPa75-hybrid_cPa62-unknown_cPa75_cPa75-cPa260-hybrid,1_1_3_1_1_16_21_1,138,132
chr1-105289530_105289640,cPa62,1,1,105289614,105289576,cPa62,16,110,38
chr1-105295199_105295301,cPa62,0.96551724137931,2,105295301,105295249,cPa285_cPa62,1_28,102,52
chr1-105380458_105380567,cPa539,0.611111111111111,6,105380543,105380504,cPa119-unknown_cPa199-cPa539-hybrid_cPa199-unknown_cPa419_cPa539_cPa539-unknown,2_1_1_2_11_1,109,39
chr1-10544212_10544314,cPa47,0.376470588235294,8,10544314,10544226,cPa174_cPa254_cPa254-cPa174-hybrid_cPa404-cPa174-hybrid_cPa404-cPa425-hybrid_cPa425_cPa47_cPa47-cPa174-hybrid,2_20_3_2_1_22_32_3,102,88
chr1-105515681_105515783,cPa62,0.6,4,105515755,105515691,cPa285-cPa62-hybrid_cPa62_cPa75-cPa62-hybrid_HML2_Pheonix-cPa62-hybrid,2_9_3_1,102,64
chr1-105913236_105913338,cPa62,1,1,105913286,105913286,cPa62,1,102,0
chr1-106065243_106065345,cPa113,0.75,2,106065304,106065253,cPa113_cPa75-cPa67-hybrid,3_1,102,51
chr1-106083139_106083241,cPa62,0.938775510204082,2,106083198,106083149,cPa62_cPa62-unknown,46_3,102,49
chr1-106179791_106179893,cPa118_cPa15,0.5,2,106179841,106179841,cPa118_cPa15,1_1,102,0
chr1-106647162_106647264,cPa293,1,1,106647218,106647167,cPa293,7,102,51
chr1-106647293_106647395,cPa293-unknown,1,1,106647343,106647343,cPa293-unknown,1,102,0
chr1-106756194_106756296,HERV-W_repbase_HERV17_LTR17-cPa62-hybrid,1,1,106756244,106756244,HERV-W_repbase_HERV17_LTR17-cPa62-hybrid,1,102,0
chr1-106756353_106756458,cPa75,0.75,2,106756406,106756403,cPa75_HERV-W_repbase_HERV17_LTR17-cPa62-hybrid,3_1,105,3
chr1-106756742_106756844,cPa75,1,1,106756792,106756792,cPa75,1,102,0
chr1-106757404_106757506,cPa75,1,1,106757454,106757454,cPa75,1,102,0
chr1-107012529_107012631,cPa419,1,1,107012579,107012579,cPa419,1,102,0
chr1-107193069_107193193,HERV-Fb_repbase_HERVH48I_MER48,0.375,4,107193191,107193072,cPa260_HERV-Fb_repbase_HERVH48I_MER48_PERV_AJ293656_PERV_AJ293656-unknown,5_6_4_1,124,119
chr1-107303689_107303791,cPa62,1,1,107303739,107303739,cPa62,1,102,0
chr1-10737565_10737667,cPa255,0.4375,3,10737615,10737590,cPa131_cPa255_cPa478,4_7_5,102,25
chr1-107617381_107617522,cPa285,0.444444444444444,4,107617470,107617421,cPa285_cPa293_cPa62_cPa62-unknown,4_1_3_1,141,49
chr1-107807389_107807587,cPa62,0.5,6,107807535,107807403,cPa285_cPa285-cPa62-hybrid_cPa293_cPa293-cPa62-hybrid_cPa293-unknown_cPa62,10_2_12_2_2_28,198,132
chr1-107838874_107838976,HERV-W_repbase_HERV17_LTR17,1,1,107838928,107838883,HERV-W_repbase_HERV17_LTR17,15,102,45
chr1-107839091_107839252,HERV-W_repbase_HERV17_LTR17,0.96551724137931,3,107839251,107839121,cPa75-HERV-W_repbase_HERV17_LTR17-hybrid_HERV-W_repbase_HERV17_LTR17_HERV-W_repbase_HERV17_LTR17-cPa75-hybrid,1_56_1,161,130
chr1-107966538_107966677,cPa539,0.891891891891892,4,107966659,107966557,cPa492_cPa539_cPa539-cPa492-hybrid_WDSV_NC001867,2_33_1_1,139,102
chr1-108229480_108229603,cPa62,0.684210526315789,4,108229557,108229501,cPa285_cPa293_cPa62_cPa62-cPa285-hybrid,4_1_13_1,123,56
chr1-108323182_108323284,cPa285_cPa62,0.5,2,108323232,108323232,cPa285_cPa62,1_1,102,0
chr1-108439029_108439131,cPa572-cPa62-hybrid_cPa75,0.5,2,108439079,108439039,cPa572-cPa62-hybrid_cPa75,1_1,102,40
chr1-108439304_108439406,cPa75_HML5_repbase_HERVK22I_LTR22-cPa62-hybrid,0.5,2,108439354,108439340,cPa75_HML5_repbase_HERVK22I_LTR22-cPa62-hybrid,1_1,102,14
chr1-108611049_108611750,cPa62,0.345794392523364,11,108611698,108611099,cPa62_cPa62-cPa285-hybrid_cPa62-cPa402-hybrid_cPa62-cPa71-hybrid_cPa62-cPa75-hybrid_cPa62-unknown_cPa71_cPa71-cPa75-hybrid_cPa75_cPa75-cPa402-hybrid_cPa75-cPa71-hybrid,74_2_1_34_10_6_31_2_52_1_1,701,599
chr1-108869200_108869302,cPa62,1,1,108869255,108869233,cPa62,21,102,22
chr1-108952258_108952363,cPa62,1,1,108952317,108952290,cPa62,14,105,27
chr1-10908949_10909051,cPa363,0.391304347826087,7,10909043,10908962,cPa363_cPa456_cPa456-cPa117-hybrid_cPa456-cPa452-hybrid_cPa456-unknown_cPa587-cPa117-hybrid_cPa587-cPa452-hybrid,9_7_1_2_1_2_1,102,81
chr1-109252617_109252874,cPa583,0.283333333333333,23,109252872,109252629,cPa118_cPa118-cPa358-hybrid_cPa118-cPa410-hybrid_cPa15_cPa223-cPa118-hybrid_cPa223-cPa15-hybrid_cPa223-cPa268-hybrid_cPa223-cPa410-hybrid_cPa223-unknown_cPa251_cPa251-cPa298-hybrid_cPa251-cPa410-hybrid_cPa268-cPa15-hybrid_cPa358_cPa358-cPa118-hybrid_cPa358-cPa410-hybrid_cPa410_cPa583_cPa583-cPa15-hybrid_cPa583-cPa268-hybrid_cPa583-cPa358-hybrid_cPa583-cPa410-hybrid_cPa75-cPa410-hybrid,3_1_1_4_2_1_1_1_1_1_1_1_1_12_1_1_1_17_4_1_2_1_1,257,243
chr1-109252912_109253014,cPa15,0.416666666666667,7,109253014,109252911,cPa118_cPa15_cPa358_cPa583_cPa583-cPa118-hybrid_cPa583-cPa15-hybrid_HERV-Fb_repbase_HERVH48I_MER48,2_5_1_1_1_1_1,102,103
chr1-109538011_109538113,cPa75,0.413793103448276,5,109538109,109538010,cPa62_cPa62-cPa75-hybrid_cPa62-HERV-W_repbase_HERV17_LTR17-hybrid_cPa62-unknown_cPa75,2_7_2_6_12,102,99
chr1-109580923_109581025,cPa75,1,1,109580973,109580973,cPa75,1,102,0
chr1-109596224_109596326,cPa363_cPa363-cPa446-hybrid,0.5,2,109596279,109596274,cPa363_cPa363-cPa446-hybrid,1_1,102,5
chr1-109612671_109612775,cPa450,0.497109826589595,18,109612774,109612675,cPa199_cPa199-cPa227-hybrid_cPa199-cPa273-hybrid_cPa199-cPa450-hybrid_cPa199-cPa542-hybrid_cPa223-cPa199-hybrid_cPa223-cPa273-hybrid_cPa223-cPa542-hybrid_cPa223-cPa553-hybrid_cPa227_cPa227-cPa273-hybrid_cPa227-cPa542-hybrid_cPa345-cPa450-hybrid_cPa450_cPa450-cPa542-hybrid_cPa482-cPa273-hybrid_cPa482-cPa542-hybrid_cPa553,21_1_4_1_2_3_7_16_2_3_1_1_1_86_1_2_2_19,104,99
chr1-10963977_10964079,cPa62,1,1,10964073,10963994,cPa62,22,102,79
chr1-109787271_109787424,cPa492,1,1,109787422,109787321,cPa492,21,153,101
chr1-109798987_109799089,cPa251,1,1,109799037,109799037,cPa251,1,102,0
chr1-109985418_109985520,cPa62-unknown,0.555555555555556,3,109985476,109985444,cPa62-cPa75-hybrid_cPa62-unknown_cPa75,1_5_3,102,32
chr1-110025348_110025450,PERVA_AY099323,0.555555555555556,4,110025447,110025369,cPa228-unknown_HERV30_repbase_HERV30I_LTR30_PERVA_AY099323_PERVA_AY099323-unknown,2_1_5_1,102,78
chr1-1102575_1102862,cPa194,0.516129032258065,5,1102810,1102625,cPa194_cPa194-cPa345-hybrid_cPa194-cPa67-hybrid_cPa67_cPa67-cPa345-hybrid,16_2_2_10_1,287,185
chr1-110291100_110291202,cPa62,1,1,110291190,110291135,cPa62,32,102,55
chr1-1102913_1103015,cPa194,0.7,2,1102996,1102916,cPa194_cPa67,7_3,102,80
chr1-1103077_1103261,cPa67,0.428571428571429,3,1103257,1103093,cPa194_cPa194-cPa67-hybrid_cPa67,2_2_3,184,164
chr1-110384282_110384384,cPa75,0.375,5,110384351,110384282,cPa62_cPa75_cPa75-cPa62-hybrid_cPa75-unknown_KWERV_GQ222416-cPa62-hybrid,2_3_1_1_1,102,69
chr1-110426435_110426537,cPa62,1,1,110426496,110426485,cPa62,2,102,11
chr1-110483506_110483613,cPa363_cPa452-unknown_cPa456,0.333333333333333,3,110483561,110483556,cPa363_cPa452-unknown_cPa456,1_1_1,107,5
chr1-110509083_110509185,cPa109,1,1,110509133,110509133,cPa109,1,102,0
chr1-110582987_110583089,cPa450,0.375,4,110583037,110583024,cPa227_cPa273-cPa199-hybrid_cPa450_cPa553,2_1_3_2,102,13
chr1-110596183_110596326,cPa75,1,1,110596274,110596233,cPa75,3,143,41
chr1-110596418_110596520,cPa75,1,1,110596468,110596468,cPa75,1,102,0
chr1-110622220_110622326,cPa62,1,1,110622300,110622266,cPa62,10,106,34
chr1-11064638_11064740,cPa333,0.631578947368421,3,11064730,11064682,cPa323_cPa333_cPa371,2_36_19,102,48
chr1-110656885_110657076,cPa62,0.4375,5,110657036,110656923,cPa62_cPa62-cPa200-hybrid_cPa62-cPa482-hybrid_cPa62-unknown_cPa75-unknown,7_1_2_5_1,191,113
chr1-110657192_110657294,cPa62-unknown,0.4,4,110657291,110657241,cPa482_cPa62-cPa482-hybrid_cPa62-unknown_cPa75-unknown,1_1_2_1,102,50
chr1-110742724_110742826,cPa62,1,1,110742774,110742730,cPa62,3,102,44
chr1-110936970_110937096,cPa75,0.551724137931034,5,110937087,110937008,cPa75_HERV-F_repbase_HERVFH19I_LTR19A-cPa75-hybrid_HERV-W_repbase_HERV17_LTR17_HERV-W_repbase_HERV17_LTR17-cPa194-hybrid_HERV-W_repbase_HERV17_LTR17-cPa75-hybrid,16_1_10_1_1,126,79
chr1-110977417_110977547,cPa223,0.363636363636364,10,110977543,110977421,cPa176_cPa176-cPa446-hybrid_cPa223_cPa223-cPa363-hybrid_cPa363_cPa379_cPa446_cPa452_cPa452-cPa183-hybrid_cPa452-cPa363-hybrid,6_1_20_2_8_5_5_6_1_1,130,122
chr1-111018688_111018790,cPa62,0.875,2,111018777,111018734,cPa254_cPa62,5_35,102,43
chr1-111019515_111019617,cPa62,0.92,3,111019584,111019515,cPa254_cPa419_cPa62,1_1_23,102,69
chr1-111258285_111258438,cPa118-cPa15-hybrid_cPa125-cPa15-hybrid_cPa443-cPa15-hybrid,0.333333333333333,3,111258386,111258335,cPa118-cPa15-hybrid_cPa125-cPa15-hybrid_cPa443-cPa15-hybrid,1_1_1,153,51
chr1-111302322_111302424,cPa363_cPa456,0.4,3,111302372,111302370,cPa117-unknown_cPa363_cPa456,1_2_2,102,2
chr1-111402082_111402184,cPa223,1,1,111402143,111402122,cPa223,8,102,21
chr1-111525510_111525612,cPa62,0.923076923076923,2,111525562,111525559,cPa62_WDSV_NC001867-cPa62-hybrid,12_1,102,3
chr1-111560273_111560375,cPa345,1,1,111560343,111560311,cPa345,4,102,32
chr1-111624858_111624960,cPa254-unknown_cPa62,0.5,2,111624928,111624908,cPa254-unknown_cPa62,2_2,102,20
chr1-111720240_111720596,HERV-W_repbase_HERV17_LTR17,0.722222222222222,6,111720585,111720287,cPa62-HERV-W_repbase_HERV17_LTR17-hybrid_cPa62-unknown_cPa75_cPa75-HERV-W_repbase_HERV17_LTR17-hybrid_HERV-W_repbase_HERV17_LTR17_KoRV_AF151794,4_3_1_1_26_1,356,298
chr1-111725361_111725463,cPa529,0.571428571428571,2,111725411,111725369,cPa247_cPa529,3_4,102,42
chr1-111765102_111765204,cPa456,0.584,9,111765158,111765113,cPa363_cPa363-cPa117-hybrid_cPa363-cPa452-hybrid_cPa456_cPa456-cPa117-hybrid_cPa456-cPa363-hybrid_cPa587-cPa117-hybrid_cPa587-cPa363-hybrid_cPa587-cPa452-hybrid,28_2_4_73_2_1_6_2_7,102,45
chr1-112039914_112040016,cPa15,0.875,2,112039973,112039951,cPa118-cPa268-hybrid_cPa15,1_7,102,22
chr1-112144959_112145061,cPa15,0.461538461538462,5,112145009,112144964,cPa118_cPa15_cPa248-cPa118-hybrid_cPa248-unknown_cPa443,9_12_2_1_2,102,45
chr1-112189675_112189820,cPa205_cPa61,0.5,2,112189768,112189725,cPa205_cPa61,1_1,145,43
chr1-112249494_112249620,cPa62,0.933333333333333,3,112249618,112249495,cPa254-cPa62-hybrid_cPa62_cPa62-unknown,1_28_1,126,123
chr1-112444733_112444835,cPa75,1,1,112444784,112444776,cPa75,7,102,8
chr1-112555647_112555749,cPa392_cPa61-unknown,0.5,2,112555697,112555687,cPa392_cPa61-unknown,1_1,102,10
chr1-112652887_112652989,cPa482,1,1,112652957,112652937,cPa482,2,102,20
chr1-1127018_1127120,cPa199-cPa75-hybrid,1,1,1127068,1127068,cPa199-cPa75-hybrid,1,102,0
chr1-112785579_112785791,cPa465-cPa308-hybrid,0.444444444444444,6,112785752,112785605,cPa205-cPa308-hybrid_cPa333-unknown_cPa465-cPa308-hybrid_cPa465-unknown_cPa61-cPa308-hybrid_FeFV_NC001871-cPa308-hybrid,1_1_4_1_1_1,212,147
chr1-112786887_112786990,cPa371-cPa308-hybrid_cPa465-cPa308-hybrid,0.5,2,112786938,112786937,cPa371-cPa308-hybrid_cPa465-cPa308-hybrid,1_1,103,1
chr1-112978772_112978874,cPa47,0.3,7,112978847,112978790,cPa254_cPa404_cPa425_cPa425-cPa174-hybrid_cPa425-cPa254-hybrid_cPa47_cPa47-cPa174-hybrid,2_1_1_1_1_3_1,102,57
chr1-113058908_113059010,cPa293-cPa339-hybrid_cPa339_cPa62,0.333333333333333,3,113058962,113058934,cPa293-cPa339-hybrid_cPa339_cPa62,1_1_1,102,28
chr1-113059066_113059179,cPa62,0.846153846153846,4,113059128,113059108,cPa285-cPa62-hybrid_cPa293_cPa62_cPa62-unknown,1_1_22_2,113,20
chr1-113070162_113070264,cPa419,1,1,113070212,113070212,cPa419,1,102,0
chr1-113097780_113097882,cPa16,0.407407407407407,8,113097859,113097791,cPa16_cPa308-cPa379-hybrid_cPa363_cPa363-cPa71-hybrid_cPa363-unknown_cPa379_cPa71_cPa71-unknown,11_1_1_1_1_6_5_1,102,68
chr1-113158008_113158246,cPa75-unknown,0.736842105263158,3,113158194,113158046,cPa75_cPa75-cPa285-hybrid_cPa75-unknown,3_2_14,238,148
chr1-113203057_113203165,cPa492,0.857142857142857,2,113203160,113203107,cPa472_cPa492,1_6,108,53
chr1-113203181_113203283,cPa492,0.967741935483871,2,113203275,113203188,cPa492_cPa492-unknown,30_1,102,87
chr1-11330265_11330367,GaLV_M26927-cPa62-hybrid,1,1,11330315,11330315,GaLV_M26927-cPa62-hybrid,1,102,0
chr1-113409331_113409433,cPa505-cPa75-hybrid,0.333333333333333,6,113409399,113409330,cPa425_cPa425-cPa75-hybrid_cPa425-unknown_cPa505-cPa75-hybrid_cPa566_cPa566-unknown,2_1_1_3_1_1,102,69
chr1-113411865_113411967,cPa482,1,1,113411944,113411915,cPa482,8,102,29
chr1-113428735_113428837,cPa62-unknown,0.363636363636364,4,113428796,113428736,cPa62_cPa62-cPa75-hybrid_cPa62-unknown_cPa75,3_4_8_7,102,60
chr1-113483546_113483648,cPa15,0.666666666666667,2,113483596,113483589,cPa15_cPa268,2_1,102,7
chr1-113532750_113533024,cPa75,1,1,113532972,113532795,cPa75,16,274,177
chr1-113613370_113613512,cPa75,1,1,113613460,113613420,cPa75,10,142,40
chr1-113613611_113613713,cPa75,1,1,113613661,113613661,cPa75,1,102,0
chr1-113684951_113685053,cPa75,0.5,4,113685043,113684956,cPa62_cPa75_cPa75-cPa62-hybrid_cPa75-unknown,3_6_2_1,102,87
chr1-113685240_113685342,cPa62,0.5,4,113685326,113685246,cPa62_cPa75_cPa75-cPa62-hybrid_PERVC_HM159246-unknown,3_1_1_1,102,80
chr1-113871304_113871406,HERV-W_repbase_HERV17_LTR17,0.666666666666667,2,113871387,113871307,cPa62-unknown_HERV-W_repbase_HERV17_LTR17,1_2,102,80
chr1-113934215_113934317,cPa419-GaLV_M26927-hybrid,1,1,113934265,113934265,cPa419-GaLV_M26927-hybrid,1,102,0
chr1-113957484_113957586,cPa323-cPa512-hybrid,1,1,113957534,113957534,cPa323-cPa512-hybrid,1,102,0
chr1-1143737_1143839,cPa75,1,1,1143787,1143775,cPa75,2,102,12
chr1-1143968_1144077,cPa75,0.875,2,1144026,1143993,cPa75_cPa75-unknown,14_2,109,33
chr1-1144630_1144847,cPa75,0.823529411764706,2,1144842,1144680,cPa75_cPa75-HERV-W_repbase_HERV17_LTR17-hybrid,14_3,217,162
chr1-1144856_1144958,cPa62-HERV-W_repbase_HERV17_LTR17-hybrid_cPa75_cPa75-HERV-W_repbase_HERV17_LTR17-hybrid,0.333333333333333,3,1144909,1144877,cPa62-HERV-W_repbase_HERV17_LTR17-hybrid_cPa75_cPa75-HERV-W_repbase_HERV17_LTR17-hybrid,1_1_1,102,32
chr1-1145229_1145374,cPa75,0.571428571428571,5,1145322,1145259,cPa62_cPa62-cPa75-hybrid_cPa62-HERV-W_repbase_HERV17_LTR17-hybrid_cPa75_HERV-W_repbase_HERV17_LTR17,1_1_6_12_1,145,63
chr1-1145507_1145609,cPa75,0.4,4,1145557,1145536,cPa62-cPa71-hybrid_cPa62-HERV-W_repbase_HERV17_LTR17-hybrid_cPa75_HERV-W_repbase_HERV17_LTR17,1_1_2_1,102,21
chr1-11493755_11493876,cPa15,0.390243902439024,28,11493876,11493758,cPa118_cPa118-unknown_cPa119_cPa125_cPa125-cPa248-hybrid_cPa140_cPa140-cPa118-hybrid_cPa140-unknown_cPa15_cPa248_cPa248-cPa118-hybrid_cPa248-unknown_cPa264_cPa264-cPa118-hybrid_cPa264-cPa119-hybrid_cPa264-cPa15-hybrid_cPa264-cPa268-hybrid_cPa264-cPa443-hybrid_cPa264-unknown_cPa268_cPa268-cPa118-hybrid_cPa268-cPa15-hybrid_cPa268-unknown_cPa443_cPa443-cPa118-hybrid_cPa443-cPa119-hybrid_cPa443-cPa15-hybrid_cPa443-cPa268-hybrid,12_2_3_1_1_7_2_3_48_1_2_1_1_1_1_1_1_1_5_9_3_1_7_5_1_1_1_1,121,118
chr1-11494163_11494265,cPa15,0.428571428571429,5,11494242,11494213,cPa118-unknown_cPa140_cPa140-unknown_cPa15_cPa268,1_1_1_6_5,102,29
chr1-1151384_1151486,cPa443,1,1,1151434,1151434,cPa443,1,102,0
chr1-11523481_11523583,HERV-W_repbase_HERV17_LTR17,0.642857142857143,4,11523579,11523500,HERV-W_repbase_HERV17_LTR17_HERV-XA34_repbase_HERVFH21I_LTR21A_HERV-XA34_repbase_HERVFH21I_LTR21A-HERV-W_repbase_HERV17_LTR17-hybrid_HERV-XA34_repbase_HERVFH21I_LTR21A-unknown,9_2_2_1,102,79
chr1-1164623_1164725,cPa400_FrMuLV_NC001362,0.5,2,1164673,1164625,cPa400_FrMuLV_NC001362,1_1,102,48
chr1-11696427_11696529,cPa392,1,1,11696490,11696477,cPa392,2,102,13
chr1-11700247_11700471,cPa392,0.977777777777778,2,11700430,11700289,cPa152-cPa392-hybrid_cPa392,1_44,224,141
chr1-11701016_11701118,cPa392,1,1,11701066,11701066,cPa392,1,102,0
chr1-11701135_11701237,cPa392,1,1,11701230,11701185,cPa392,3,102,45
chr1-11701293_11701399,cPa392,1,1,11701347,11701343,cPa392,2,106,4
chr1-11702054_11702158,cPa392,1,1,11702106,11702083,cPa392,8,104,23
chr1-11702983_11703130,cPa392,0.666666666666667,2,11703078,11702993,cPa392_cPa392-cPa552-hybrid,2_1,147,85
chr1-11703484_11703586,cPa392,1,1,11703574,11703534,cPa392,27,102,40
chr1-11703635_11703737,cPa392,1,1,11703685,11703685,cPa392,1,102,0
chr1-11703979_11704081,cPa392,1,1,11704029,11704029,cPa392,4,102,0
chr1-11899101_11899203,cPa539,1,1,11899151,11899146,cPa539,3,102,5
chr1-11903116_11903218,cPa62,1,1,11903166,11903166,cPa62,1,102,0
chr1-11992788_11992890,cPa16,0.333333333333333,6,11992889,11992797,cPa16_cPa379_cPa419_cPa505_cPa62-cPa16-hybrid_cPa71,3_2_1_1_1_1,102,92
chr1-1201022_1201153,cPa260,0.847457627118644,4,1201144,1201033,cPa106_cPa260_cPa452-cPa106-hybrid_cPa539-cPa106-hybrid,7_50_1_1,131,111
chr1-12032987_12033292,cPa363,0.857142857142857,2,12033240,12033037,cPa363_cPa75-cPa363-hybrid,6_1,305,203
chr1-12141221_12141335,cPa47,0.266666666666667,7,12141283,12141241,cPa174_cPa174-cPa404-hybrid_cPa254_cPa254-cPa404-hybrid_cPa425_cPa425-cPa404-hybrid_cPa47,1_3_2_2_1_2_4,114,42
chr1-12152918_12153113,cPa345,1,1,12153067,12152920,cPa345,6,195,147
chr1-12321754_12321893,cPa75,0.591836734693878,13,12321889,12321778,cPa260_cPa260-cPa293-hybrid_cPa260-cPa62-hybrid_cPa293_cPa62_cPa71-cPa62-hybrid_cPa71-cPa75-hybrid_cPa71-unknown_cPa75_cPa75-unknown_HERV-W_repbase_HERV17_LTR17_HML1b_repbase_HERV-K14I_LTR14A-cPa62-hybrid_KoRV_AF151794,1_1_1_1_4_3_1_1_29_3_2_1_1,139,111
chr1-12325749_12325863,cPa62,0.96969696969697,2,12325856,12325777,cPa62_cPa62-unknown,32_1,114,79
chr1-12435224_12435329,cPa254_cPa47,0.266666666666667,8,12435311,12435231,cPa254_cPa254-cPa174-hybrid_cPa404-cPa392-hybrid_cPa425_cPa47_cPa47-cPa174-hybrid_cPa47-cPa254-hybrid_cPa62-cPa392-hybrid,8_1_1_7_8_3_1_1,105,80
chr1-12520921_12521023,cPa323-unknown,1,1,12520990,12520971,cPa323-unknown,2,102,19
chr1-126055_126157,cPa75,1,1,126119,126063,cPa75,4,102,56
chr1-126237_126435,cPa75,1,1,126383,126287,cPa75,4,198,96
chr1-126781_126886,cPa75,1,1,126834,126831,cPa75,2,105,3
chr1-126888_126990,cPa75,1,1,126938,126938,cPa75,1,102,0
chr1-127091_127193,cPa75,1,1,127141,127141,cPa75,1,102,0
chr1-127302_127588,cPa75,1,1,127536,127350,cPa75,17,286,186
chr1-12736415_12736517,cPa150-cPa216-hybrid_cPa302-cPa255-hybrid,0.5,2,12736465,12736465,cPa150-cPa216-hybrid_cPa302-cPa255-hybrid,1_1,102,0
chr1-12757893_12758083,cPa75,0.806451612903226,3,12758046,12757943,cPa293-cPa75-hybrid_cPa75_cPa75-cPa62-hybrid,1_25_5,190,103
chr1-12772859_12772975,cPa113,0.5,3,12772923,12772867,cPa113_cPa113-cPa67-hybrid_HTLV1_NC001436,2_1_1,116,56
chr1-12790998_12791100,cPa47,0.35,8,12791060,12791012,cPa174_cPa254_cPa254-cPa174-hybrid_cPa392-cPa254-hybrid_cPa392-cPa425-hybrid_cPa404-cPa174-hybrid_cPa425_cPa47,3_4_1_1_1_1_2_7,102,48
chr1-1279545_1279647,cPa67,1,1,1279595,1279595,cPa67,1,102,0
chr1-1279839_1279941,cPa194,0.666666666666667,2,1279904,1279877,cPa194_cPa67,2_1,102,27
chr1-1279951_1280053,cPa194,1,1,1280001,1280001,cPa194,1,102,0
chr1-12842567_12842669,cPa104-cPa18-hybrid_cPa4_cPa541,0.333333333333333,3,12842617,12842617,cPa104-cPa18-hybrid_cPa4_cPa541,1_1_1,102,0
chr1-12900466_12900570,cPa452,0.452380952380952,15,12900531,12900465,cPa16-cPa223-hybrid_cPa16-cPa363-hybrid_cPa16-cPa446-hybrid_cPa16-cPa541-hybrid_cPa16-cPa71-hybrid_cPa16-unknown_cPa176-cPa14-hybrid_cPa176-cPa363-hybrid_cPa176-cPa541-hybrid_cPa363_cPa452_cPa452-unknown_cPa71_cPa71-cPa363-hybrid_cPa71-unknown,1_1_1_1_3_2_1_1_1_51_76_3_23_1_2,104,66
chr1-1310230_1310332,cPa75,0.555555555555556,4,1310287,1310247,cPa75_cPa75-cPa228-hybrid_cPa75-cPa260-hybrid_cPa75-cPa425-hybrid,5_1_2_1,102,40
chr1-1310539_1310641,cPa75,0.285714285714286,6,1310633,1310544,cPa106-cPa16-hybrid_cPa260_cPa260-cPa113-hybrid_cPa260-cPa71-hybrid_cPa62-cPa113-hybrid_cPa75,1_1_1_1_1_2,102,89
chr1-1311775_1311877,cPa75,0.294117647058824,10,1311859,1311804,cPa260_cPa260-cPa113-hybrid_cPa546-cPa293-hybrid_cPa62-cPa106-hybrid_cPa62-cPa113-hybrid_cPa62-cPa293-hybrid_cPa75_cPa75-cPa260-hybrid_HERVFc2_repbase-cPa113-hybrid_HERVHcons-cPa71-hybrid,4_1_1_1_1_1_5_1_1_1,102,55
chr1-1312158_1312260,cPa260,0.4,7,1312252,1312172,cPa106-cPa293-hybrid_cPa199-cPa260-hybrid_cPa260_cPa293_cPa75_cPa75-cPa293-hybrid_HERVHcons-PERVC_HM159246-hybrid,1_1_6_1_3_2_1,102,80
chr1-13134748_13134850,cPa419,1,1,13134798,13134798,cPa419,1,102,0
chr1-1318808_1318910,cPa75,1,1,1318858,1318858,cPa75,1,102,0
chr1-1318964_1319234,cPa75,0.875,2,1319182,1319014,cPa260-unknown_cPa75,1_7,270,168
chr1-1336792_1336894,cPa260,0.695652173913043,2,1336869,1336791,cPa228_cPa260,7_16,102,78
chr1-1345551_1345653,cPa260,0.916666666666667,2,1345644,1345573,cPa106_cPa260,1_11,102,71
chr1-13456924_13457026,cPa117,1,1,13456974,13456974,cPa117,1,102,0
chr1-13457188_13457306,cPa117,1,1,13457254,13457238,cPa117,2,118,16
chr1-13472155_13472273,cPa62,1,1,13472228,13472205,cPa62,11,118,23
chr1-13472708_13472852,cPa62,0.916666666666667,2,13472800,13472758,cPa62_cPa75,22_2,144,42
chr1-13768919_13769021,cPa363,0.4,4,13768980,13768969,cPa363_cPa452-cPa456-hybrid_cPa452-cPa587-hybrid_cPa456,2_1_1_1,102,11
chr1-14020174_14020276,cPa363,0.666666666666667,2,14020224,14020214,cPa363_cPa75-cPa363-hybrid,2_1,102,10
chr1-14020738_14020840,cPa363_cPa363-cPa452-hybrid,0.5,2,14020802,14020788,cPa363_cPa363-cPa452-hybrid,1_1,102,14
chr1-14066199_14066301,cPa363,1,1,14066249,14066249,cPa363,1,102,0
chr1-14067024_14067126,cPa363,0.666666666666667,2,14067104,14067074,cPa363_cPa75-cPa285-hybrid,2_1,102,30
chr1-1407051_1407153,cPa356_STLV2_NC001815-cPa260-hybrid,0.5,2,1407130,1407101,cPa356_STLV2_NC001815-cPa260-hybrid,1_1,102,29
chr1-1411325_1411594,cPa16,0.722222222222222,4,1411542,1411335,cPa16_cPa16-cPa379-hybrid_cPa16-unknown_cPa379,13_1_1_3,269,207
chr1-1411762_1411864,cPa16,1,1,1411831,1411812,cPa16,2,102,19
chr1-1411917_1412030,cPa16_cPa16-cPa75-hybrid_cPa327-cPa75-hybrid,0.333333333333333,3,1411994,1411967,cPa16_cPa16-cPa75-hybrid_cPa327-cPa75-hybrid,1_1_1,113,27
chr1-1412192_1412294,cPa16,1,1,1412242,1412242,cPa16,1,102,0
chr1-14184614_14184729,cPa433,0.177570093457944,27,14184729,14184621,cPa196-cPa260-hybrid_cPa196-cPa308-hybrid_cPa196-cPa424-hybrid_cPa196-cPa459-hybrid_cPa196-unknown_cPa305_cPa305-cPa308-hybrid_cPa305-cPa424-hybrid_cPa305-cPa433-hybrid_cPa305-cPa459-hybrid_cPa308_cPa308-cPa424-hybrid_cPa308-cPa459-hybrid_cPa327_cPa327-cPa308-hybrid_cPa327-cPa424-hybrid_cPa327-cPa433-hybrid_cPa327-cPa459-hybrid_cPa327-cPa62-hybrid_cPa327-unknown_cPa424_cPa433_cPa433-cPa424-hybrid_cPa433-cPa459-hybrid_cPa433-unknown_cPa459_cPa62-cPa459-hybrid,1_2_6_2_5_1_5_5_2_5_3_1_1_5_11_2_3_2_2_2_3_19_2_2_1_13_1,115,108
chr1-14223837_14223939,cPa452,0.523809523809524,6,14223889,14223868,cPa16-cPa223-hybrid_cPa363_cPa363-unknown_cPa452_cPa71_cPa71-unknown,1_10_2_22_6_1,102,21
chr1-14456615_14456719,cPa62,0.48780487804878,7,14456708,14456642,cPa546-cPa75-hybrid_cPa62_cPa71-cPa62-hybrid_cPa75_cPa75-cPa260-hybrid_cPa75-cPa546-hybrid_cPa75-cPa62-hybrid,1_20_1_14_1_1_3,104,66
chr1-1457806_1457908,cPa223,0.666666666666667,3,1457857,1457840,cPa199_cPa223_cPa553,1_4_1,102,17
chr1-14580390_14580492,cPa75-cPa117-hybrid,1,1,14580440,14580440,cPa75-cPa117-hybrid,1,102,0
chr1-14819730_14819835,cPa117-cPa587-hybrid_cPa363_cPa452-cPa587-hybrid_cPa456,0.25,4,14819783,14819780,cPa117-cPa587-hybrid_cPa363_cPa452-cPa587-hybrid_cPa456,1_1_1_1,105,3
chr1-14850916_14851181,HERV-W_repbase_HERV17_LTR17,0.833333333333333,4,14851175,14850966,HERV-W_repbase_HERV17_LTR17_HERV-W_repbase_HERV17_LTR17-unknown_PERV_AJ293656_PERV_AJ293656-cPa75-hybrid,15_1_1_1,265,209
chr1-14851216_14851361,HERV-W_repbase_HERV17_LTR17,0.961165048543689,5,14851334,14851218,cPa62-KoRV_AF151794-hybrid_cPa75_HERV-W_repbase_HERV17_LTR17_HERV-W_repbase_HERV17_LTR17-KoRV_AF151794-hybrid_HERV-W_repbase_HERV17_LTR17-unknown,1_1_99_1_1,145,116
chr1-14851440_14851592,HERV-W_repbase_HERV17_LTR17,1,1,14851540,14851440,HERV-W_repbase_HERV17_LTR17,6,152,100
chr1-149525_149627,cPa75,1,1,149575,149575,cPa75,1,102,0
chr1-15109165_15109330,cPa75,0.730769230769231,5,15109286,15109187,cPa293-unknown_cPa546_cPa62_cPa75_cPa75-unknown,1_1_3_19_2,165,99
chr1-15131821_15131923,cPa75,0.666666666666667,2,15131871,15131832,cPa75_HERV-W_repbase_HERV17_LTR17,2_1,102,39
chr1-1523100_1523267,cPa71-unknown,0.571428571428571,4,1523240,1523100,cPa71_cPa71-cPa62-hybrid_cPa71-unknown_cPa75,1_4_8_1,167,140
chr1-1523408_1523510,cPa71-cPa75-hybrid,0.363636363636364,6,1523458,1523411,cPa62_cPa62-cPa75-hybrid_cPa71-cPa62-hybrid_cPa71-cPa75-hybrid_cPa71-unknown_cPa75,1_1_1_4_2_2,102,47
chr1-15271677_15271779,cPa106-cPa56-hybrid,1,1,15271727,15271727,cPa106-cPa56-hybrid,1,102,0
chr1-1597722_1597824,cPa75,1,1,1597772,1597772,cPa75,1,102,0
chr1-16072240_16072342,cPa118-unknown_cPa15,0.5,2,16072335,16072290,cPa118-unknown_cPa15,1_1,102,45
chr1-1639908_1640010,cPa199,1,1,1639979,1639949,cPa199,3,102,30
chr1-16450322_16450424,cPa62,1,1,16450381,16450356,cPa62,22,102,25
chr1-16460045_16460147,cPa75,1,1,16460095,16460094,cPa75,2,102,1
chr1-16895951_16896053,cPa419,1,1,16896001,16896001,cPa419,1,102,0
chr1-1713119_1713242,cPa260,0.918918918918919,2,1713226,1713126,cPa228_cPa260,3_34,123,100
chr1-17175202_17175347,cPa553,0.372549019607843,24,17175342,17175223,cPa199_cPa199-cPa227-hybrid_cPa199-cPa273-hybrid_cPa223_cPa223-cPa227-hybrid_cPa223-cPa273-hybrid_cPa227_cPa227-cPa273-hybrid_cPa227-unknown_cPa273_cPa345_cPa345-cPa199-hybrid_cPa345-cPa227-hybrid_cPa345-cPa273-hybrid_cPa419_cPa450_cPa450-cPa273-hybrid_cPa482-cPa227-hybrid_cPa482-cPa273-hybrid_cPa553_cPa553-cPa199-hybrid_cPa553-cPa273-hybrid_cPa62-cPa273-hybrid_cPa62-cPa450-hybrid,4_1_11_2_6_19_25_7_1_1_1_2_2_13_1_13_1_2_6_76_1_2_4_3,145,119
chr1-17277271_17277373,cPa452,0.47887323943662,8,17277335,17277292,cPa176_cPa363_cPa363-cPa16-hybrid_cPa363-cPa71-hybrid_cPa452_cPa452-unknown_cPa71_cPa71-cPa16-hybrid,1_25_2_1_34_1_6_1,102,43
chr1-17309788_17309890,cPa101,0.428571428571429,5,17309838,17309826,cPa101_cPa142_cPa256_cPa582-cPa256-hybrid_cPa582-cPa51-hybrid,3_1_1_1_1,102,12
chr1-17740373_17740475,cPa62,1,1,17740423,17740422,cPa62,5,102,1
chr1-17816399_17816534,cPa456,0.363636363636364,6,17816482,17816418,cPa363_cPa363-cPa117-hybrid_cPa456_cPa456-cPa117-hybrid_cPa587-cPa452-hybrid_cPa75,6_3_8_3_1_1,135,64
chr1-1790151_1790253,cPa152,1,1,1790201,1790187,cPa152,2,102,14
chr1-17902673_17902775,cPa62,1,1,17902751,17902703,cPa62,36,102,48
chr1-18102350_18102461,cPa254,0.354838709677419,10,18102456,18102375,cPa174_cPa174-cPa404-hybrid_cPa174-cPa425-hybrid_cPa174-cPa47-hybrid_cPa254_cPa254-cPa47-hybrid_cPa404_cPa425_cPa425-cPa47-hybrid_cPa47,5_1_1_2_11_3_3_2_1_2,111,81
chr1-1824871_1824973,cPa260,0.8,2,1824921,1824887,cPa260_cPa553-WDSV_NC001867-hybrid,4_1,102,34
chr1-18277688_18277805,cPa456,0.363636363636364,13,18277758,18277705,BLV_NC001414-cPa363-hybrid_BLV_NC001414-cPa456-hybrid_BLV_NC001414-cPa587-hybrid_BLV_NC001414-cPa75-hybrid_BLV_NC001414-EIAV_NC001450-hybrid_cPa117-cPa363-hybrid_cPa117-cPa456-hybrid_cPa117-cPa587-hybrid_cPa117-unknown_cPa363_cPa452_cPa452-cPa587-hybrid_cPa456,1_3_1_1_1_3_4_1_1_10_1_1_16,117,53
chr1-1852212_1852314,cPa363-cPa106-hybrid_cPa363-cPa260-hybrid,0.5,2,1852262,1852255,cPa363-cPa106-hybrid_cPa363-cPa260-hybrid,1_1,102,7
chr1-18612478_18612580,cPa260-cPa75-hybrid,1,1,18612528,18612525,cPa260-cPa75-hybrid,2,102,3
chr1-18908862_18909064,cPa260-cPa75-hybrid_HERV-W_repbase_HERV17_LTR17-cPa75-hybrid,0.5,2,18909012,18908912,cPa260-cPa75-hybrid_HERV-W_repbase_HERV17_LTR17-cPa75-hybrid,1_1,202,100
chr1-18909072_18909174,HERV-W_repbase_HERV17_LTR17-unknown,1,1,18909122,18909122,HERV-W_repbase_HERV17_LTR17-unknown,1,102,0
chr1-190235_190337,cPa75-unknown,1,1,190285,190285,cPa75-unknown,1,102,0
chr1-1945877_1945979,cPa62-cPa75-hybrid,1,1,1945927,1945927,cPa62-cPa75-hybrid,1,102,0
chr1-19556498_19556600,cPa142,1,1,19556549,19556505,cPa142,3,102,44
chr1-19700013_19700115,cPa62,1,1,19700063,19700018,cPa62,2,102,45
chr1-19700157_19700267,cPa62,0.611111111111111,4,19700267,19700188,cPa285_cPa492_cPa62_cPa62-unknown,4_2_11_1,110,79
chr1-19768373_19768475,cPa285,0.5,3,19768460,19768412,cPa16_cPa285_cPa62,1_2_1,102,48
chr1-19869106_19869230,cPa62,0.681818181818182,3,19869230,19869117,cPa62_cPa75-cPa62-hybrid_cPa75-unknown,15_4_3,124,113
chr1-19869359_19869523,cPa62,0.627906976744186,5,19869522,19869379,cPa293-unknown_cPa62_cPa75_cPa75-cPa62-hybrid_cPa75-unknown,1_27_1_2_12,164,143
chr1-19869530_19869632,cPa62,0.619047619047619,5,19869628,19869548,cPa293-cPa62-hybrid_cPa293-unknown_cPa62_cPa75-cPa62-hybrid_cPa75-unknown,1_1_13_3_3,102,80
chr1-2013731_2013833,cPa260_cPa75,0.5,2,2013830,2013781,cPa260_cPa75,1_1,102,49
chr1-2027262_2027364,cPa75-cPa583-hybrid,1,1,2027312,2027312,cPa75-cPa583-hybrid,1,102,0
chr1-2028215_2028317,cPa75-cPa583-hybrid,1,1,2028265,2028265,cPa75-cPa583-hybrid,1,102,0
chr1-2033158_2033260,cPa62-WDSV_NC001867-hybrid,1,1,2033231,2033208,cPa62-WDSV_NC001867-hybrid,4,102,23
chr1-2033279_2033388,cPa62-WDSV_NC001867-hybrid,0.75,2,2033344,2033299,cPa62-unknown_cPa62-WDSV_NC001867-hybrid,1_3,109,45
chr1-2033446_2033632,WDSV_NC001867,0.666666666666667,3,2033580,2033480,cPa62-unknown_cPa62-WDSV_NC001867-hybrid_WDSV_NC001867,1_1_4,186,100
chr1-2072701_2072848,cPa223-cPa273-hybrid_cPa450,0.5,2,2072796,2072751,cPa223-cPa273-hybrid_cPa450,1_1,147,45
chr1-2082638_2082780,cPa260,1,1,2082745,2082648,cPa260,27,142,97
chr1-2082828_2083007,cPa260,1,1,2083004,2082866,cPa260,11,179,138
chr1-2083112_2083267,cPa260,1,1,2083242,2083111,cPa260,9,155,131
chr1-20885181_20885300,cPa540,0.388888888888889,12,20885248,20885231,cPa127_cPa241_cPa241-cPa11-hybrid_cPa241-cPa531-hybrid_cPa290_cPa515_cPa530_cPa530-cPa11-hybrid_cPa530-cPa290-hybrid_cPa540_cPa540-cPa11-hybrid_cPa540-cPa127-hybrid,6_1_3_1_2_2_3_1_1_14_1_1,119,17
chr1-20938256_20938358,cPa62,0.978260869565217,2,20938345,20938256,cPa419_cPa62,1_45,102,89
chr1-21093116_21093218,cPa62,1,1,21093191,21093166,cPa62,3,102,25
chr1-21226689_21226964,cPa450,0.450704225352113,12,21226962,21226735,cPa199_cPa199-cPa542-hybrid_cPa227_cPa227-cPa199-hybrid_cPa227-cPa542-hybrid_cPa227-cPa553-hybrid_cPa273_cPa345_cPa345-cPa553-hybrid_cPa450_cPa553_cPa553-unknown,6_1_5_1_1_4_4_1_1_32_14_1,275,227
chr1-2130200_2130302,cPa260,1,1,2130250,2130250,cPa260,1,102,0
chr1-21359837_21359939,cPa529,0.833333333333333,3,21359888,21359842,cPa14-cPa247-hybrid_cPa14-cPa529-hybrid_cPa529,1_1_10,102,46
chr1-213611_213713,cPa539,1,1,213705,213661,cPa539,4,102,44
chr1-21583350_21583452,cPa395,1,1,21583400,21583400,cPa395,1,102,0
chr1-21714538_21714640,cPa419,1,1,21714588,21714588,cPa419,1,102,0
chr1-2175518_2175811,cPa260,0.5,5,2175759,2175529,cPa260_cPa260-cPa75-hybrid_cPa260-unknown_HERV-W_repbase_HERV17_LTR17_HERV-XA34_repbase_HERVFH21I_LTR21A,4_1_1_1_1,293,230
chr1-2175814_2175983,cPa62-unknown,0.5,3,2175931,2175857,cPa62-cPa75-hybrid_cPa62-unknown_cPa75,2_3_1,169,74
chr1-21891474_21891576,cPa456,0.642857142857143,5,21891540,21891479,cPa363_cPa452-cPa363-hybrid_cPa456_cPa587-cPa117-hybrid_cPa587-cPa119-hybrid,22_1_45_1_1,102,61
chr1-22149238_22149347,cPa293_cPa391_cPa426,0.333333333333333,3,22149295,22149288,cPa293_cPa391_cPa426,1_1_1,109,7
chr1-22218290_22218392,cPa62,1,1,22218340,22218340,cPa62,1,102,0
chr1-22218492_22218596,cPa62,0.904761904761905,3,22218545,22218515,cPa254-cPa62-hybrid_cPa264-cPa62-hybrid_cPa62,1_1_19,104,30
chr1-22218683_22218785,cPa285-unknown_cPa62,0.5,2,22218733,22218733,cPa285-unknown_cPa62,1_1,102,0
chr1-2249835_2250000,cPa199,0.25,7,2249964,2249856,cPa199_cPa273_cPa450_cPa450-cPa542-hybrid_cPa482_cPa482-cPa542-hybrid_cPa542,2_1_1_1_1_1_1,165,108
chr1-2250326_2250428,cPa199,0.363636363636364,6,2250383,2250325,cPa199_cPa199-cPa542-hybrid_cPa273_cPa273-cPa199-hybrid_cPa450_cPa542,4_1_1_1_3_1,102,58
chr1-22565829_22566030,HERV-W_repbase_HERV17_LTR17,0.684210526315789,7,22566024,22565838,cPa419-HERV-F_repbase_HERVFH19I_LTR19A-hybrid_cPa62-cPa75-hybrid_cPa62-unknown_cPa75_HERV-W_repbase_HERV17_LTR17_HERV-W_repbase_HERV17_LTR17-cPa75-hybrid_PERV_AJ293656-cPa75-hybrid,1_1_1_6_26_2_1,201,186
chr1-22566115_22566260,HERV-W_repbase_HERV17_LTR17,0.628571428571429,7,22566254,22566125,cPa62-cPa75-hybrid_cPa62-unknown_cPa75_cPa75-unknown_HERV-W_repbase_HERV17_LTR17_HERV-W_repbase_HERV17_LTR17-cPa75-hybrid_KoRV_AF151794,2_2_6_1_22_1_1,145,129
chr1-22566336_22566681,HERV-W_repbase_HERV17_LTR17,0.574074074074074,9,22566663,22566335,cPa62_cPa62-cPa75-hybrid_cPa62-unknown_cPa75_cPa75-unknown_HERV-W_repbase_HERV17_LTR17_HERV-W_repbase_HERV17_LTR17-cPa75-hybrid_HERV-W_repbase_HERV17_LTR17-unknown_KWERV_GQ222416,1_3_5_10_1_31_1_1_1,345,328
chr1-22566695_22566797,HERV-W_repbase_HERV17_LTR17,0.625,4,22566777,22566709,cPa62_cPa62-unknown_cPa75_HERV-W_repbase_HERV17_LTR17,1_1_1_5,102,68
chr1-22566846_22566948,cPa75,1,1,22566896,22566896,cPa75,1,102,0
chr1-2260204_2260507,cPa260,0.516129032258065,9,2260463,2260207,cPa260_cPa260-cPa62-hybrid_cPa260-HERV-W_repbase_HERV17_LTR17-hybrid_cPa293_cPa486-HERV-W_repbase_HERV17_LTR17-hybrid_cPa62_cPa62-cPa260-hybrid_cPa75-cPa62-hybrid_HERV-W_repbase_HERV17_LTR17,16_1_4_1_2_3_1_1_2,303,256
chr1-22639467_22639584,cPa15,0.5,5,22639532,22639470,cPa118_cPa15_cPa248_cPa443_cPa443-cPa118-hybrid,5_8_1_1_1,117,62
chr1-22660998_22661111,cPa62,0.555555555555556,5,22661065,22661024,cPa15_cPa62_cPa62-cPa15-hybrid_cPa62-unknown_cPa75,5_10_1_1_1,113,41
chr1-22714581_22714683,cPa456,0.727272727272727,3,22714652,22714585,cPa363_cPa456_cPa542-cPa363-hybrid,5_16_1,102,67
chr1-2274078_2274252,cPa62_cPa62-cPa486-hybrid,0.272727272727273,5,2274200,2274093,cPa62_cPa62-cPa486-hybrid_cPa62-cPa492-hybrid_cPa62-unknown_cPa62-WDSV_NC001867-hybrid,3_3_1_2_2,174,107
chr1-22800930_22801032,cPa62,1,1,22800986,22800955,cPa62,5,102,31
chr1-22805917_22806019,cPa285-unknown,1,1,22805967,22805967,cPa285-unknown,1,102,0
chr1-2281612_2281714,cPa75,1,1,2281688,2281623,cPa75,7,102,65
chr1-2282051_2282481,cPa75,0.684210526315789,6,2282477,2282101,cPa285_cPa293_cPa293-cPa400-hybrid_cPa293-cPa75-hybrid_cPa293-unknown_cPa75,1_4_1_3_3_26,430,376
chr1-22861508_22861610,cPa529-cPa62-hybrid,0.285714285714286,8,22861600,22861542,cPa18-cPa62-hybrid_cPa247-cPa62-hybrid_cPa4-cPa62-hybrid_cPa529_cPa529-cPa62-hybrid_cPa541-cPa62-hybrid_cPa583-cPa62-hybrid_cPa62,3_2_1_1_4_1_1_1,102,58
chr1-22861619_22861752,cPa529-cPa62-hybrid,0.586206896551724,8,22861700,22861622,cPa18-cPa62-hybrid_cPa18-unknown_cPa247-cPa587-hybrid_cPa247-cPa62-hybrid_cPa4-cPa62-hybrid_cPa475-cPa62-hybrid_cPa529-cPa62-hybrid_cPa545-cPa62-hybrid,5_1_1_1_1_2_17_1,133,78
chr1-22896038_22896142,cPa157-cPa456-hybrid,0.666666666666667,4,22896098,22896082,cPa157-cPa332-hybrid_cPa157-cPa456-hybrid_cPa157-unknown_cPa492-cPa332-hybrid,1_10_3_1,104,16
chr1-22996786_22996948,cPa4,0.540540540540541,6,22996930,22996832,cPa4_cPa4-cPa14-hybrid_cPa4-cPa18-hybrid_cPa4-cPa541-hybrid_cPa541_cPa541-cPa14-hybrid,40_12_1_3_17_1,162,98
chr1-23019514_23019616,cPa419,1,1,23019564,23019564,cPa419,1,102,0
chr1-23064527_23064629,cPa62,1,1,23064619,23064577,cPa62,4,102,42
chr1-2307662_2307764,cPa75,1,1,2307712,2307712,cPa75,1,102,0
chr1-2307789_2307948,cPa75-unknown,0.666666666666667,3,2307896,2307804,cPa75_cPa75-unknown_HERV-W_repbase_HERV17_LTR17-cPa113-hybrid,1_4_1,159,92
chr1-23078494_23078596,cPa62,1,1,23078544,23078531,cPa62,2,102,13
chr1-23078613_23078763,cPa62,0.972972972972973,2,23078754,23078612,cPa293-unknown_cPa62,1_36,150,142
chr1-23106897_23106999,cPa142,0.8,2,23106956,23106944,cPa142_cPa142-unknown,4_1,102,12
chr1-23122960_23123062,cPa174-cPa47-hybrid_cPa425-cPa47-hybrid_cPa425-cPa511-hybrid,0.333333333333333,3,23123011,23123003,cPa174-cPa47-hybrid_cPa425-cPa47-hybrid_cPa425-cPa511-hybrid,1_1_1,102,8
chr1-23125276_23125383,cPa450,0.3203125,20,23125347,23125279,cPa199_cPa199-cPa227-hybrid_cPa199-cPa273-hybrid_cPa199-cPa450-hybrid_cPa199-cPa511-hybrid_cPa199-cPa553-hybrid_cPa199-unknown_cPa223-cPa273-hybrid_cPa223-cPa450-hybrid_cPa227_cPa227-cPa542-hybrid_cPa273_cPa450_cPa450-cPa273-hybrid_cPa450-unknown_cPa542_cPa553_cPa553-cPa273-hybrid_FrMuLV_NC001362-cPa273-hybrid_FrMuLV_NC001362-cPa553-hybrid,9_4_29_4_1_9_5_1_1_6_1_6_41_1_1_3_2_1_2_1,107,68
chr1-23190642_23190744,cPa75,0.666666666666667,2,23190715,23190692,cPa62-cPa285-hybrid_cPa75,1_2,102,23
chr1-23190844_23191015,cPa260_cPa75,0.5,2,23190963,23190894,cPa260_cPa75,1_1,171,69
chr1-23203568_23203670,cPa62,0.411764705882353,6,23203667,23203584,cPa419_cPa62_cPa62-cPa75-hybrid_cPa62-unknown_cPa71_cPa75,1_7_3_2_3_1,102,83
chr1-23213804_23213906,cPa62,1,1,23213900,23213854,cPa62,34,102,46
chr1-23233363_23233513,cPa34-unknown,0.857142857142857,2,23233479,23233413,cPa34-unknown_cPa456-unknown,6_1,150,66
chr1-23936241_23936343,cPa456,0.697674418604651,7,23936316,23936255,cPa117-cPa363-hybrid_cPa363_cPa419_cPa452-cPa363-hybrid_cPa452-unknown_cPa456_cPa456-cPa363-hybrid,4_4_1_2_1_30_1,102,61
chr1-23985394_23985496,cPa456,0.528571428571429,10,23985482,23985395,cPa363_cPa363-cPa117-hybrid_cPa363-cPa452-hybrid_cPa452_cPa456_cPa456-cPa117-hybrid_cPa456-cPa363-hybrid_cPa456-cPa452-hybrid_cPa456-unknown_cPa587-cPa117-hybrid,13_6_2_1_37_5_3_1_1_1,102,87
chr1-2406235_2406337,cPa260,0.588235294117647,6,2406323,2406236,cPa118-cPa260-hybrid_cPa118-unknown_cPa15-cPa260-hybrid_cPa15-cPa465-hybrid_cPa15-unknown_cPa260,1_1_2_1_2_10,102,87
chr1-24384767_24384869,cPa62,1,1,24384829,24384804,cPa62,17,102,25
chr1-24405666_24405805,cPa62,0.978723404255319,2,24405793,24405676,cPa119-unknown_cPa62,1_46,139,117
chr1-24487641_24487743,cPa62,1,1,24487697,24487669,cPa62,6,102,28
chr1-24532070_24532184,cPa339,0.333333333333333,5,24532132,24532070,cPa339_cPa390-cPa444-hybrid_cPa447_cPa447-cPa444-hybrid_cPa62-cPa444-hybrid,4_2_2_2_2,114,62
chr1-2475982_2476084,STLV2_NC001815-cPa228-hybrid,0.625,4,2476039,2475996,cPa228_STLV2_NC001815_STLV2_NC001815-cPa228-hybrid_STLV2_NC001815-unknown,1_1_5_1,102,43
chr1-2476085_2476187,cPa228_cPa260-cPa228-hybrid_STLV2_NC001815,0.333333333333333,3,2476148,2476094,cPa228_cPa260-cPa228-hybrid_STLV2_NC001815,1_1_1,102,54
chr1-25049362_25049465,cPa75,1,1,25049413,25049405,cPa75,3,103,8
chr1-25251073_25251354,cPa62,0.756410256410256,7,25251334,25251101,cPa285_cPa285-unknown_cPa293_cPa62_cPa62-unknown_cPa75_cPa75-unknown,8_2_3_59_1_4_1,281,233
chr1-2544662_2544907,cPa260,0.916666666666667,2,2544894,2544712,cPa260_cPa75,11_1,245,182
chr1-2545045_2545623,cPa260,0.88135593220339,6,2545588,2545079,cPa260_cPa285-cPa260-hybrid_cPa285-cPa75-hybrid_cPa400_cPa400-cPa260-hybrid_cPa75,52_2_1_1_1_2,578,509
chr1-25529070_25529533,HERV-W_repbase_HERV17_LTR17,0.647058823529412,13,25529481,25529093,cPa419_cPa75_cPa75-HERV-W_repbase_HERV17_LTR17-hybrid_cPa75-unknown_HERV-W_repbase_HERV17_LTR17_HERV-W_repbase_HERV17_LTR17-cPa419-hybrid_HERV-W_repbase_HERV17_LTR17-cPa62-hybrid_HERV-W_repbase_HERV17_LTR17-PERV_AJ293656-hybrid_HERV-W_repbase_HERV17_LTR17-unknown_KoRV_AF151794_KoRV_AF151794-unknown_KWERV_GQ222416-cPa200-hybrid_PERV_AJ293656,1_3_2_1_44_1_1_1_10_1_1_1_1,463,388
chr1-25670807_25670909,cPa75,1,1,25670858,25670857,cPa75,2,102,1
chr1-25677640_25677752,cPa62,0.818181818181818,4,25677703,25677685,cPa62_cPa62-cPa75-hybrid_cPa62-unknown_cPa75,36_4_1_3,112,18
chr1-25682004_25682106,cPa62,0.944444444444444,2,25682100,25682036,cPa62_cPa62-unknown,17_1,102,64
chr1-2575845_2575947,cPa456_cPa456-cPa587-hybrid,0.5,2,2575926,2575895,cPa456_cPa456-cPa587-hybrid,1_1,102,31
chr1-258213_258315,cPa260_cPa363,0.285714285714286,5,258314,258261,cPa260_cPa327-cPa363-hybrid_cPa363_cPa379_cPa452-cPa260-hybrid,2_1_2_1_1,102,53
chr1-258480_258582,cPa363,1,1,258530,258494,cPa363,2,102,36
chr1-2585096_2585198,cPa75,1,1,2585146,2585146,cPa75,1,102,0
chr1-260301_260403,cPa16_cPa379,0.5,2,260351,260300,cPa16_cPa379,2_2,102,51
chr1-26087963_26088065,cPa15,0.4,4,26088015,26088004,cPa118_cPa15_cPa248-cPa118-hybrid_cPa248-unknown,1_2_1_1,102,11
chr1-26177001_26177103,cPa505,1,1,26177051,26177051,cPa505,1,102,0
chr1-2628592_2628694,cPa260,1,1,2628642,2628632,cPa260,2,102,10
chr1-26591946_26592048,cPa62,0.888888888888889,2,26592000,26591985,cPa62_cPa62-unknown,8_1,102,15
chr1-2667934_2668036,cPa539,1,1,2667984,2667984,cPa539,1,102,0
chr1-26740008_26740110,cPa15,0.571428571428571,3,26740073,26740053,cPa118_cPa15_cPa248-cPa118-hybrid,2_4_1,102,20
chr1-2674776_2674878,cPa539-cPa75-hybrid_cPa62-cPa75-hybrid,0.5,2,2674826,2674809,cPa539-cPa75-hybrid_cPa62-cPa75-hybrid,1_1,102,17
chr1-27353438_27353540,cPa363,0.5,3,27353496,27353470,cPa16-cPa183-hybrid_cPa363_cPa452,1_3_2,102,26
chr1-27363404_27363506,cPa15,0.666666666666667,3,27363454,27363450,cPa118_cPa15_cPa248-unknown,1_4_1,102,4
chr1-2771179_2771282,cPa290,0.375,5,2771274,2771217,cPa254-cPa260-hybrid_cPa260_cPa260-cPa539-hybrid_cPa290_cPa512,1_1_1_3_2,103,57
chr1-27753358_27753460,cPa62,0.8,3,27753421,27753403,cPa285-cPa62-hybrid_cPa285-unknown_cPa62,2_1_12,102,18
chr1-27790701_27790812,cPa450,0.391304347826087,8,27790784,27790748,cPa199_cPa199-cPa273-hybrid_cPa199-cPa542-hybrid_cPa227_cPa273_cPa450_cPa450-cPa542-hybrid_cPa542,1_1_6_3_1_9_1_1,111,36
chr1-27812678_27812839,cPa75,0.428571428571429,5,27812787,27812678,cPa113_cPa113-cPa75-hybrid_cPa293_cPa62_cPa75,1_1_1_1_3,161,109
chr1-27813271_27813373,cPa113_cPa75_cPa75-cPa62-hybrid_PERVC_HM159246,0.25,4,27813332,27813306,cPa113_cPa75_cPa75-cPa62-hybrid_PERVC_HM159246,1_1_1_1,102,26
chr1-27813899_27814058,cPa75,0.9375,2,27814033,27813949,cPa75_cPa75-cPa62-hybrid,15_1,159,84
chr1-27825734_27825840,cPa545_cPa95,0.333333333333333,4,27825788,27825756,cPa14_cPa247_cPa545_cPa95,1_1_2_2,106,32
chr1-27850765_27850868,cPa127_cPa241_cPa540,0.333333333333333,3,27850816,27850815,cPa127_cPa241_cPa540,1_1_1,103,1
chr1-2797567_2797669,cPa118_cPa15,0.5,2,2797617,2797617,cPa118_cPa15,1_1,102,0
chr1-28006155_28006257,cPa62,0.925,3,28006211,28006191,cPa254_cPa254-unknown_cPa62,1_2_37,102,20
chr1-2805304_2805406,cPa260,1,1,2805354,2805340,cPa260,6,102,14
chr1-28192876_28192978,cPa425,0.5,3,28192967,28192926,cPa254_cPa404-cPa174-hybrid_cPa425,1_1_2,102,41
chr1-28233644_28233746,cPa392,0.916666666666667,2,28233746,28233694,cPa392_cPa419,11_1,102,52
chr1-28233757_28233862,cPa392,0.905660377358491,4,28233862,28233757,cPa285-unknown_cPa392_cPa62_cPa62-unknown,1_48_1_3,105,105
chr1-28233885_28234073,cPa392,0.918918918918919,4,28234039,28233888,cPa285-cPa447-hybrid_cPa285-unknown_cPa392_cPa413-EIAV_NC001450-hybrid,1_1_34_1,188,151
chr1-28234086_28234287,cPa392,0.805970149253731,4,28234286,28234093,cPa285-unknown_cPa392_cPa419_cPa62-unknown,4_54_1_8,201,193
chr1-28234580_28234690,cPa392,0.842105263157895,2,28234689,28234583,cPa392_cPa62-unknown,16_3,110,106
chr1-28234893_28234995,cPa392,1,1,28234962,28234911,cPa392,5,102,51
chr1-285243_285345,cPa194_cPa67,0.5,2,285309,285243,cPa194_cPa67,5_5,102,66
chr1-285439_285547,cPa194,0.636363636363636,3,285533,285479,cPa194_cPa194-cPa67-hybrid_cPa67,7_1_3,108,54
chr1-285554_285689,cPa194,0.533333333333333,2,285689,285601,cPa194_cPa67,8_7,135,88
chr1-2855756_2855858,cPa539,1,1,2855806,2855806,cPa539,1,102,0
chr1-28577609_28577726,cPa450,0.375,5,28577674,28577659,cPa199_cPa199-cPa273-hybrid_cPa227_cPa450_cPa553-cPa273-hybrid,2_1_1_3_1,117,15
chr1-28848337_28848464,cPa75,1,1,28848412,28848358,cPa75,17,127,54
chr1-28858317_28858419,cPa62,1,1,28858367,28858367,cPa62,1,102,0
chr1-28945378_28945480,cPa62,1,1,28945430,28945411,cPa62,20,102,19
chr1-2901395_2901497,cPa199,1,1,2901467,2901413,cPa199,3,102,54
chr1-29149449_29149551,cPa62,1,1,29149499,29149499,cPa62,1,102,0
chr1-29287928_29288033,cPa118_cPa15_cPa248-unknown,0.333333333333333,3,29287990,29287978,cPa118_cPa15_cPa248-unknown,1_1_1,105,12
chr1-29456844_29456946,cPa62,0.947368421052632,2,29456903,29456886,cPa254_cPa62,1_18,102,17
chr1-29583142_29583244,cPa419,1,1,29583192,29583192,cPa419,1,102,0
chr1-2979748_2979850,cPa379_cPa71,0.5,2,2979798,2979750,cPa379_cPa71,3_3,102,48
chr1-3003382_3003484,cPa62-HERV-W_repbase_HERV17_LTR17-hybrid,1,1,3003432,3003432,cPa62-HERV-W_repbase_HERV17_LTR17-hybrid,1,102,0
chr1-3003763_3003896,cPa62,0.5,3,3003844,3003799,cPa260_cPa62_cPa62-cPa75-hybrid,1_2_1,133,45
chr1-3004000_3004102,cPa62-cPa75-hybrid,1,1,3004050,3004050,cPa62-cPa75-hybrid,1,102,0
chr1-3004715_3004945,cPa75,0.375,5,3004893,3004763,cPa260_cPa260-cPa75-hybrid_cPa62-HERV-W_repbase_HERV17_LTR17-hybrid_cPa75_cPa75-HERV-W_repbase_HERV17_LTR17-hybrid,1_1_2_3_1,230,130
chr1-30480165_30480267,cPa75,1,1,30480215,30480215,cPa75,1,102,0
chr1-30637036_30637138,cPa419,1,1,30637086,30637086,cPa419,1,102,0
chr1-307244_307346,cPa75,1,1,307294,307294,cPa75,1,102,0
chr1-31079805_31080031,cPa75-unknown,0.333333333333333,5,31080025,31079855,cPa75-unknown_HERV-W_repbase_HERV17_LTR17_HERV-W_repbase_HERV17_LTR17-cPa75-hybrid_KoRV_AF151794-cPa75-hybrid_S71_repbase_HERVS71_LTR6A-cPa447-hybrid,2_1_1_1_1,226,170
chr1-31080119_31080221,cPa75-HERV-W_repbase_HERV17_LTR17-hybrid,1,1,31080169,31080169,cPa75-HERV-W_repbase_HERV17_LTR17-hybrid,1,102,0
chr1-31314833_31314935,HERV-W_repbase_HERV17_LTR17_HERV-W_repbase_HERV17_LTR17-unknown,0.5,2,31314883,31314834,HERV-W_repbase_HERV17_LTR17_HERV-W_repbase_HERV17_LTR17-unknown,1_1,102,49
chr1-31314949_31315060,HERV-W_repbase_HERV17_LTR17,0.333333333333333,7,31315031,31314963,cPa62_cPa62-cPa75-hybrid_cPa62-HERV-W_repbase_HERV17_LTR17-hybrid_cPa75_cPa75-HERV-W_repbase_HERV17_LTR17-hybrid_cPa75-unknown_HERV-W_repbase_HERV17_LTR17,1_1_4_2_3_1_6,111,68
chr1-31315289_31315768,HERV-W_repbase_HERV17_LTR17,0.357142857142857,9,31315723,31315313,cPa62_cPa62-HERV-W_repbase_HERV17_LTR17-hybrid_cPa75_cPa75-HERV-W_repbase_HERV17_LTR17-hybrid_HERV-W_repbase_HERV17_LTR17_HERV-W_repbase_HERV17_LTR17-cPa75-hybrid_PERV_AJ293656_PERVB_AY099324-MSEV_CT990572-hybrid_PERVC_HM159246-S71_repbase_HERVS71_LTR6A-hybrid,3_29_17_16_40_1_4_1_1,479,410
chr1-315202_315360,cPa260,1,1,315308,315252,cPa260,2,158,56
chr1-31691638_31691740,cPa199_cPa542,0.359116022099448,13,31691738,31691638,cPa199_cPa199-cPa273-hybrid_cPa199-cPa450-hybrid_cPa199-cPa542-hybrid_cPa199-cPa553-hybrid_cPa345_cPa345-cPa273-hybrid_cPa345-cPa450-hybrid_cPa345-cPa553-hybrid_cPa450_cPa542_cPa542-cPa450-hybrid_cPa553,65_2_6_2_3_7_3_6_2_10_65_2_8,102,100
chr1-31727911_31728017,cPa553,0.325,15,31727977,31727949,cPa199_cPa199-cPa273-hybrid_cPa199-cPa345-hybrid_cPa199-cPa450-hybrid_cPa223-cPa273-hybrid_cPa223-cPa450-hybrid_cPa227_cPa273_cPa345_cPa345-cPa273-hybrid_cPa345-cPa450-hybrid_cPa345-cPa542-hybrid_cPa482-cPa450-hybrid_cPa482-cPa542-hybrid_cPa553,3_1_1_2_1_7_1_3_1_1_2_1_2_1_13,106,28
chr1-31945014_31945125,cPa62-cPa75-hybrid_cPa75,0.5,2,31945073,31945064,cPa62-cPa75-hybrid_cPa75,1_1,111,9
chr1-32070850_32070952,cPa15,0.516129032258065,3,32070903,32070852,cPa118_cPa118-cPa140-hybrid_cPa15,14_1_16,102,51
chr1-321062_321164,cPa75,1,1,321112,321112,cPa75,1,102,0
chr1-32109421_32109523,HERV-W_repbase_HERV17_LTR17,1,1,32109471,32109471,HERV-W_repbase_HERV17_LTR17,1,102,0
chr1-32109779_32109881,HERV-W_repbase_HERV17_LTR17,1,1,32109865,32109829,HERV-W_repbase_HERV17_LTR17,2,102,36
chr1-32155812_32155914,cPa62,1,1,32155876,32155852,cPa62,9,102,24
chr1-32207794_32207896,cPa15,0.5,3,32207844,32207844,cPa140-cPa118-hybrid_cPa140-cPa248-hybrid_cPa15,1_1_2,102,0
chr1-3237813_3237920,cPa62,1,1,3237884,3237863,cPa62,4,107,21
chr1-32587448_32587550,cPa62,0.888888888888889,2,32587508,32587486,cPa62_cPa62-unknown,8_1,102,22
chr1-3285040_3285173,cPa260,0.285714285714286,6,3285121,3285068,cPa113_cPa260_cPa62-unknown_cPa75_cPa75-cPa260-hybrid_SMRV_NC001514,1_2_1_1_1_1,133,53
chr1-32856038_32856140,cPa62,0.75,3,32856115,32856060,cPa285_cPa62_cPa62-unknown,2_9_1,102,55
chr1-32883126_32883231,cPa345,0.727272727272727,4,32883183,32883163,cPa345_cPa475_cPa475-cPa345-hybrid_cPa482-cPa15-hybrid,8_1_1_1,105,20
chr1-32924972_32925074,cPa444_cPa447,0.5,2,32925022,32925022,cPa444_cPa447,1_1,102,0
chr1-33040510_33040612,HERV-W_repbase_HERV17_LTR17,1,1,33040560,33040560,HERV-W_repbase_HERV17_LTR17,1,102,0
chr1-33040972_33041074,HERV-W_repbase_HERV17_LTR17,1,1,33041035,33041022,HERV-W_repbase_HERV17_LTR17,2,102,13
chr1-33041550_33041696,HERV-W_repbase_HERV17_LTR17,0.571428571428571,2,33041644,33041600,HERV-W_repbase_HERV17_LTR17_HERV-W_repbase_HERV17_LTR17-cPa62-hybrid,4_3,146,44
chr1-33043447_33043549,HERV-W_repbase_HERV17_LTR17,0.8,2,33043497,33043447,cPa75_HERV-W_repbase_HERV17_LTR17,1_4,102,50
chr1-33044156_33044258,HERV-W_repbase_HERV17_LTR17,1,1,33044235,33044206,HERV-W_repbase_HERV17_LTR17,2,102,29
chr1-33049104_33049206,HERV-W_repbase_HERV17_LTR17,0.555555555555556,7,33049203,33049104,cPa285-cPa62-hybrid_cPa75_cPa75-cPa62-hybrid_cPa75-HERV-W_repbase_HERV17_LTR17-hybrid_HERV-W_repbase_HERV17_LTR17_HERV-W_repbase_HERV17_LTR17-cPa62-hybrid_HERV-W_repbase_HERV17_LTR17-unknown,1_4_3_1_15_2_1,102,99
chr1-3321664_3321766,cPa419,1,1,3321714,3321714,cPa419,1,102,0
chr1-33299768_33299892,cPa75,0.529411764705882,7,33299890,33299805,cPa293-cPa62-hybrid_cPa62_cPa75_cPa75-cPa62-hybrid_cPa75-unknown_HERV-W_repbase_HERV17_LTR17_HERV-W_repbase_HERV17_LTR17-cPa62-hybrid,1_1_9_1_1_2_2,124,85
chr1-33495528_33495642,cPa174_cPa254_cPa392-cPa254-hybrid_cPa425_cPa425-cPa174-hybrid_cPa47_cPa47-cPa254-hybrid,0.142857142857143,7,33495590,33495537,cPa174_cPa254_cPa392-cPa254-hybrid_cPa425_cPa425-cPa174-hybrid_cPa47_cPa47-cPa254-hybrid,1_1_1_1_1_1_1,114,53
chr1-3352119_3352221,cPa118_cPa140-cPa264-hybrid_cPa15_cPa248_cPa443,0.2,5,3352169,3352169,cPa118_cPa140-cPa264-hybrid_cPa15_cPa248_cPa443,1_1_1_1_1,102,0
chr1-33629459_33629561,cPa62-unknown,0.4,4,33629559,33629485,cPa62-unknown_cPa75_HERV-W_repbase_HERV17_LTR17_HERV-W_repbase_HERV17_LTR17-unknown,2_1_1_1,102,74
chr1-3388134_3388254,cPa75,0.923076923076923,2,3388235,3388168,cPa75_cPa75-cPa260-hybrid,12_1,120,67
chr1-33888784_33888892,cPa130-cPa555-hybrid_cPa555,0.225225225225225,15,33888874,33888824,cPa130-cPa257-hybrid_cPa130-cPa285-hybrid_cPa130-cPa546-hybrid_cPa130-cPa555-hybrid_cPa130-unknown_cPa285_cPa285-cPa257-hybrid_cPa285-cPa546-hybrid_cPa285-cPa555-hybrid_cPa285-unknown_cPa555_cPa60_cPa60-cPa257-hybrid_cPa60-cPa555-hybrid_cPa60-unknown,18_1_5_25_2_6_6_2_2_1_25_9_5_3_1,108,50
chr1-34244_34352,cPa117,1,1,34300,34276,cPa117,3,108,24
chr1-34320104_34320206,cPa199,0.205128205128205,19,34320185,34320130,cPa199_cPa199-cPa273-hybrid_cPa199-cPa345-hybrid_cPa199-cPa450-hybrid_cPa199-cPa482-hybrid_cPa223-cPa199-hybrid_cPa223-cPa345-hybrid_cPa223-cPa450-hybrid_cPa223-cPa482-hybrid_cPa227_cPa227-cPa345-hybrid_cPa273_cPa345_cPa450_cPa450-cPa199-hybrid_cPa542_cPa542-cPa273-hybrid_cPa542-cPa450-hybrid_cPa553,16_1_1_4_1_1_1_1_1_5_1_15_1_12_1_4_2_2_8,102,55
chr1-34320230_34320332,cPa542,0.333333333333333,5,34320290,34320236,cPa199-cPa450-hybrid_cPa199-unknown_cPa450_cPa542_cPa542-unknown,1_1_1_2_1,102,54
chr1-34390_35207,cPa117,0.985915492957746,2,35191,34412,cPa117_cPa452,70_1,817,779
chr1-35204189_35204297,cPa456,0.642857142857143,6,35204292,35204218,cPa363_cPa363-cPa452-hybrid_cPa456_cPa456-cPa452-hybrid_cPa587-cPa363-hybrid_cPa587-cPa452-hybrid,24_10_72_3_1_2,108,74
chr1-35222_35400,cPa117,0.933333333333333,2,35363,35221,cPa117_cPa419-cPa452-hybrid,14_1,178,142
chr1-35312621_35312723,cPa419,1,1,35312671,35312671,cPa419,1,102,0
chr1-35317357_35317459,cPa450,0.375,4,35317417,35317404,cPa223_cPa223-unknown_cPa450_cPa542,2_1_3_2,102,13
chr1-35318006_35318123,cPa223-cPa62-hybrid,0.666666666666667,3,35318071,35318053,cPa223-cPa62-hybrid_cPa542-cPa62-hybrid_cPa62,4_1_1,117,18
chr1-35373471_35373585,cPa75,0.418604651162791,8,35373579,35373490,cPa62_cPa62-cPa75-hybrid_cPa62-HERV-W_repbase_HERV17_LTR17-hybrid_cPa62-unknown_cPa75_HERV-W_repbase_HERV17_LTR17_HERV-W_repbase_HERV17_LTR17-unknown_KoRV_AF151794-HERV-W_repbase_HERV17_LTR17-hybrid,2_6_3_9_18_3_1_1,114,89
chr1-35679736_35679845,cPa363_cPa456,0.333333333333333,4,35679797,35679786,cPa363_cPa456_cPa587-cPa117-hybrid_cPa75-cPa117-hybrid,2_2_1_1,109,11
chr1-35711789_35711891,cPa452,0.428571428571429,3,35711839,35711827,cPa363_cPa452_cPa71,2_3_2,102,12
chr1-35881962_35882064,cPa15,0.741935483870968,6,35882037,35881965,cPa118_cPa15_cPa15-cPa118-hybrid_cPa268_cPa268-cPa118-hybrid_cPa268-unknown,6_46_1_2_6_1,102,72
chr1-3607773_3607875,cPa71,0.842105263157895,4,3607871,3607785,cPa419_cPa71_cPa71-cPa62-hybrid_cPa71-cPa75-hybrid,1_16_1_1,102,86
chr1-3616860_3616970,cPa62,0.28125,11,3616966,3616870,cPa113_cPa62_cPa62-cPa75-hybrid_cPa62-PERVC_HM159246-hybrid_cPa75_cPa75-cPa113-hybrid_cPa75-cPa285-hybrid_cPa75-PERVC_HM159246-hybrid_cPa75-unknown_PERVA_AY099323-cPa62-hybrid_PERVC_HM159246-PERVA_AY099323-hybrid,6_9_1_4_2_3_1_2_2_1_1,110,96
chr1-36348790_36348892,cPa220,0.714285714285714,5,36348847,36348790,cPa190_cPa219-cPa190-hybrid_cPa219-unknown_cPa220_cPa258,1_1_1_10_1,102,57
chr1-36441369_36441471,cPa14-unknown_cPa247_cPa529,0.333333333333333,3,36441419,36441419,cPa14-unknown_cPa247_cPa529,1_1_1,102,0
chr1-36459852_36459954,cPa456,0.545454545454545,7,36459928,36459902,cPa363_cPa363-cPa117-hybrid_cPa363-cPa452-hybrid_cPa456_cPa456-unknown_cPa587-cPa117-hybrid_cPa587-cPa452-hybrid,4_2_4_18_2_1_2,102,26
chr1-36507484_36507594,HERV-W_repbase_HERV17_LTR17,0.857142857142857,2,36507542,36507501,cPa75-HERV-W_repbase_HERV17_LTR17-hybrid_HERV-W_repbase_HERV17_LTR17,1_6,110,41
chr1-36507598_36508123,HERV-W_repbase_HERV17_LTR17,0.877358490566038,7,36508102,36507648,cPa62_cPa62-HERV-W_repbase_HERV17_LTR17-hybrid_cPa62-unknown_cPa75_cPa75-HERV-W_repbase_HERV17_LTR17-hybrid_HERV-W_repbase_HERV17_LTR17_KoRV_AF151794,1_1_2_7_1_93_1,525,454
chr1-36761087_36761189,cPa15,0.666666666666667,2,36761137,36761111,cPa118_cPa15,1_2,102,26
chr1-37075375_37075477,cPa193_cPa500,0.3125,5,37075439,37075421,cPa183_cPa193_cPa229_cPa500_cPa500-unknown,1_5_4_5_1,102,18
chr1-37075945_37076047,cPa62,0.962962962962963,2,37076005,37075986,cPa285_cPa62,1_26,102,19
chr1-3726190_3726479,cPa260,0.666666666666667,6,3726428,3726194,cPa260_cPa260-cPa75-hybrid_cPa546_cPa75_cPa75-cPa260-hybrid_cPa75-cPa546-hybrid,12_1_1_2_1_1,289,234
chr1-38376962_38377064,cPa75,1,1,38377012,38377012,cPa75,1,102,0
chr1-38379149_38379251,HERV-W_repbase_HERV17_LTR17,0.75,2,38379236,38379155,HERV-W_repbase_HERV17_LTR17_HERV-W_repbase_HERV17_LTR17-unknown,3_1,102,81
chr1-38379273_38379375,HERV-W_repbase_HERV17_LTR17,0.9,2,38379346,38379278,HERV-W_repbase_HERV17_LTR17_HERV-W_repbase_HERV17_LTR17-cPa62-hybrid,9_1,102,68
chr1-38379430_38380008,HERV-W_repbase_HERV17_LTR17,0.916666666666667,8,38379960,38379479,cPa67-cPa419-hybrid_cPa71-unknown_cPa75_HERV-W_repbase_HERV17_LTR17_HERV-W_repbase_HERV17_LTR17-cPa62-hybrid_HERV-W_repbase_HERV17_LTR17-cPa75-hybrid_HERV-W_repbase_HERV17_LTR17-unknown_KoRV_AF151794,1_1_2_110_2_1_1_2,578,481
chr1-38380036_38380138,HERV-W_repbase_HERV17_LTR17,0.909090909090909,2,38380086,38380036,cPa75_HERV-W_repbase_HERV17_LTR17,1_10,102,50
chr1-38419591_38419699,HERV-W_repbase_HERV17_LTR17,0.875,3,38419691,38419597,cPa75_HERV-W_repbase_HERV17_LTR17_HERV-W_repbase_HERV17_LTR17-unknown,1_14_1,108,94
chr1-38419872_38420055,HERV-W_repbase_HERV17_LTR17,0.864197530864197,10,38420036,38419875,cPa62-cPa75-hybrid_cPa62-HERV-W_repbase_HERV17_LTR17-hybrid_cPa75_cPa75-HERV-W_repbase_HERV17_LTR17-hybrid_HERV-W_repbase_HERV17_LTR17_HERV-W_repbase_HERV17_LTR17-cPa75-hybrid_HERV-W_repbase_HERV17_LTR17-unknown_KoRV_AF151794_PERV_AJ293656_PERV_AJ293656-unknown,1_2_1_1_70_1_2_1_1_1,183,161
chr1-38420873_38420975,cPa363_cPa452,0.333333333333333,6,38420966,38420911,cPa183-cPa16-hybrid_cPa363_cPa452_cPa71_cPa71-cPa363-hybrid_cPa71-unknown,1_12_12_9_1_1,102,55
chr1-38423591_38423697,cPa117,1,1,38423685,38423641,cPa117,7,106,44
chr1-3850629_3850734,cPa157-cPa456-hybrid,0.642857142857143,4,3850692,3850677,cPa157_cPa157-cPa130-hybrid_cPa157-cPa456-hybrid_cPa157-unknown,3_2_27_10,105,15
chr1-38561620_38561722,cPa62,1,1,38561691,38561670,cPa62,7,102,21
chr1-38563013_38563198,cPa62,1,1,38563154,38563012,cPa62,63,185,142
chr1-387826_387928,cPa75,1,1,387876,387876,cPa75,1,102,0
chr1-38890349_38890521,cPa433,0.153061224489796,26,38890518,38890390,cPa196_cPa196-cPa308-hybrid_cPa196-cPa424-hybrid_cPa196-cPa433-hybrid_cPa196-cPa459-hybrid_cPa196-unknown_cPa260_cPa305-cPa260-hybrid_cPa305-cPa308-hybrid_cPa305-cPa433-hybrid_cPa305-cPa459-hybrid_cPa308_cPa308-cPa459-hybrid_cPa308-unknown_cPa327_cPa327-cPa260-hybrid_cPa327-cPa308-hybrid_cPa327-cPa424-hybrid_cPa327-cPa433-hybrid_cPa327-cPa459-hybrid_cPa327-unknown_cPa424_cPa433_cPa433-cPa459-hybrid_cPa433-unknown_cPa459,1_2_1_1_10_4_1_1_1_1_7_4_1_2_9_1_1_1_1_11_1_3_15_3_1_14,172,128
chr1-390044_390146,cPa75,1,1,390094,390094,cPa75,1,102,0
chr1-390467_390569,cPa75,1,1,390517,390517,cPa75,1,102,0
chr1-390730_390832,cPa75,1,1,390780,390780,cPa75,1,102,0
chr1-3926053_3926155,cPa583-cPa400-hybrid,0.666666666666667,2,3926113,3926085,cPa583-cPa400-hybrid_cPa62-cPa400-hybrid,2_1,102,28
chr1-39302444_39302565,cPa75_cPa75-unknown,0.5,2,39302513,39302494,cPa75_cPa75-unknown,1_1,121,19
chr1-39377947_39378049,cPa452,1,1,39377997,39377997,cPa452,1,102,0
chr1-39541851_39541965,cPa15,0.6,5,39541918,39541901,cPa118_cPa118-cPa15-hybrid_cPa118-cPa268-hybrid_cPa118-unknown_cPa15,3_1_1_1_9,114,17
chr1-39771186_39771288,cPa260-HERV-W_repbase_HERV17_LTR17-hybrid_cPa62-HERV-W_repbase_HERV17_LTR17-hybrid_cPa75,0.333333333333333,3,39771271,39771236,cPa260-HERV-W_repbase_HERV17_LTR17-hybrid_cPa62-HERV-W_repbase_HERV17_LTR17-hybrid_cPa75,1_1_1,102,35
chr1-39771465_39771567,cPa75,1,1,39771515,39771515,cPa75,1,102,0
chr1-39771622_39771752,cPa75,0.666666666666667,3,39771724,39771672,cPa62-HERV-W_repbase_HERV17_LTR17-hybrid_cPa75_HERV-W_repbase_HERV17_LTR17,1_4_1,130,52
chr1-39771774_39772387,cPa75,0.56,6,39772335,39771824,cPa62-cPa260-hybrid_cPa62-HERV-W_repbase_HERV17_LTR17-hybrid_cPa62-unknown_cPa75_HERV-W_repbase_HERV17_LTR17_KWERV_GQ222416,1_1_4_14_4_1,613,511
chr1-39875680_39875782,cPa62,1,1,39875771,39875709,cPa62,19,102,62
chr1-3990297_3990432,cPa260,0.3,8,3990431,3990317,cPa260_cPa260-cPa308-hybrid_cPa285-cPa260-hybrid_cPa62-cPa260-hybrid_cPa62-unknown_cPa75_cPa75-cPa260-hybrid_cPa75-unknown,12_1_1_9_9_1_2_5,135,114
chr1-39907713_39907904,cPa47,0.280821917808219,15,39907852,39907751,cPa174_cPa174-cPa254-hybrid_cPa174-cPa404-hybrid_cPa174-cPa47-hybrid_cPa174-unknown_cPa254_cPa254-cPa404-hybrid_cPa254-unknown_cPa404_cPa419_cPa425_cPa425-cPa254-hybrid_cPa425-cPa404-hybrid_cPa425-unknown_cPa47,15_1_14_1_3_36_3_1_7_1_15_1_6_1_41,191,101
chr1-3994449_3994688,HERV-W_repbase_HERV17_LTR17,0.384615384615385,7,3994644,3994489,cPa413-unknown_cPa62_cPa75_cPa75-cPa62-hybrid_HERV-W_repbase_HERV17_LTR17_HERV-W_repbase_HERV17_LTR17-cPa62-hybrid_PERV_AJ293656-cPa62-hybrid,1_1_2_1_5_2_1,239,155
chr1-3994826_3994928,HERV-W_repbase_HERV17_LTR17,0.5,4,3994926,3994845,cPa75_cPa75-cPa62-hybrid_HERV-W_repbase_HERV17_LTR17_HERV-W_repbase_HERV17_LTR17-cPa62-hybrid,1_1_3_1,102,81
chr1-39988229_39988347,cPa118_cPa15,0.5,2,39988295,39988279,cPa118_cPa15,1_1,118,16
chr1-40038215_40038317,cPa452,0.419047619047619,7,40038316,40038218,cPa16-cPa446-hybrid_cPa363_cPa363-cPa71-hybrid_cPa363-unknown_cPa452_cPa71_cPa71-cPa363-hybrid,1_32_1_3_44_23_1,102,98
chr1-40205938_40206136,cPa174,0.416666666666667,7,40206084,40205971,cPa118_cPa125_cPa174_cPa174-unknown_cPa254_cPa264_cPa425-cPa15-hybrid,1_1_5_1_2_1_1,198,113
chr1-40545445_40545547,cPa62,1,1,40545525,40545495,cPa62,2,102,30
chr1-40629554_40629672,cPa553,0.427835051546392,26,40629663,40629553,cPa199_cPa227_cPa273_cPa273-cPa199-hybrid_cPa273-cPa223-hybrid_cPa273-cPa227-hybrid_cPa273-cPa34-hybrid_cPa273-cPa450-hybrid_cPa273-cPa482-hybrid_cPa273-cPa553-hybrid_cPa273-unknown_cPa34_cPa450_cPa450-cPa227-hybrid_cPa450-cPa34-hybrid_cPa482_cPa542_cPa542-cPa199-hybrid_cPa542-cPa227-hybrid_cPa542-cPa34-hybrid_cPa542-cPa450-hybrid_cPa542-cPa482-hybrid_cPa542-cPa553-hybrid_cPa542-unknown_cPa553_cPa553-cPa34-hybrid,1_12_2_1_1_8_3_4_13_1_1_1_25_5_1_1_3_5_9_2_1_6_1_3_83_1,118,110
chr1-40629681_40629783,cPa553,0.333333333333333,6,40629770,40629682,cPa199-cPa482-hybrid_cPa254-cPa227-hybrid_cPa425-cPa227-hybrid_cPa425-cPa482-hybrid_cPa450_cPa553,1_1_2_1_1_3,102,88
chr1-4124692_4124794,cPa583-unknown,0.689655172413793,5,4124788,4124727,cPa583_cPa583-HERV-E_repbase_HERVE_LTR2-hybrid_cPa583-HERV-Fb_repbase_HERVH48I_MER48-hybrid_cPa583-unknown_FrMuLV_NC001362,4_2_1_20_2,102,61
chr1-41349352_41349454,cPa224,1,1,41349405,41349402,cPa224,8,102,3
chr1-41362345_41362500,cPa363,0.466666666666667,5,41362448,41362361,cPa363_cPa363-cPa452-hybrid_cPa452_cPa456-cPa452-hybrid_cPa587,7_4_1_2_1,155,87
chr1-41362770_41362872,cPa363-cPa452-hybrid,0.666666666666667,3,41362858,41362801,cPa363_cPa363-cPa452-hybrid_cPa587-cPa452-hybrid,1_4_1,102,57
chr1-41362929_41363121,cPa363,1,1,41363093,41362962,cPa363,5,192,131
chr1-4148165_4148267,cPa75,0.666666666666667,2,4148215,4148194,cPa75_cPa75-cPa285-hybrid,2_1,102,21
chr1-41793917_41794019,cPa379,1,1,41793967,41793967,cPa379,1,102,0
chr1-41970158_41970272,cPa529,0.272727272727273,6,41970267,41970204,cPa247_cPa529_cPa541_cPa545_cPa545-unknown_cPa95,2_3_1_1_2_2,114,63
chr1-42000540_42000642,cPa15_cPa248-cPa118-hybrid,0.333333333333333,5,42000602,42000543,cPa118_cPa15_cPa248-cPa118-hybrid_cPa248-unknown_cPa61-cPa118-hybrid,1_3_3_1_1,102,59
chr1-42311542_42311644,HERV-W_repbase_HERV17_LTR17-unknown,0.5,6,42311634,42311548,cPa75_cPa75-unknown_HERV-F_repbase_HERVFH19I_LTR19A-cPa539-hybrid_HERV-W_repbase_HERV17_LTR17-cPa539-hybrid_HERV-W_repbase_HERV17_LTR17-cPa62-hybrid_HERV-W_repbase_HERV17_LTR17-unknown,1_1_1_1_1_5,102,86
chr1-42311690_42311924,cPa75-unknown,0.25,8,42311917,42311699,cPa75_cPa75-cPa539-hybrid_cPa75-cPa62-hybrid_cPa75-unknown_HERV-W_repbase_HERV17_LTR17_HERV-W_repbase_HERV17_LTR17-cPa539-hybrid_HERV-W_repbase_HERV17_LTR17-cPa62-hybrid_HERV-W_repbase_HERV17_LTR17-unknown,5_1_4_8_1_2_5_6,234,218
chr1-42326140_42326248,cPa75,0.333333333333333,6,42326247,42326150,cPa293-cPa62-hybrid_cPa293-cPa75-hybrid_cPa293-unknown_cPa62_cPa75_cPa75-cPa62-hybrid,2_1_1_1_3_1,108,97
chr1-42326276_42326860,cPa75,0.444444444444444,15,42326823,42326326,cPa113_cPa260-cPa109-hybrid_cPa293_cPa293-cPa113-hybrid_cPa293-cPa62-hybrid_cPa62_cPa75_cPa75-cPa113-hybrid_cPa75-cPa260-hybrid_cPa75-cPa62-hybrid_cPa75-PERVC_HM159246-hybrid_cPa75-unknown_PERVA_AY099323_PERVC_HM159246_PERVC_HM159246-cPa62-hybrid,9_1_1_7_2_2_32_7_1_2_1_2_2_2_1,584,497
chr1-4236190_4236425,cPa62,0.813559322033898,5,4236373,4236194,cPa285_cPa285-cPa62-hybrid_cPa285-unknown_cPa492-cPa62-hybrid_cPa62,4_5_1_1_48,235,179
chr1-42458060_42458165,cPa47,0.235294117647059,9,42458113,42458076,cPa174_cPa254_cPa392_cPa392-cPa174-hybrid_cPa404-cPa174-hybrid_cPa404-cPa254-hybrid_cPa404-unknown_cPa425_cPa47,2_3_1_1_1_1_1_3_4,105,37
chr1-42549046_42549161,cPa515,0.272727272727273,7,42549115,42549063,cPa127_cPa241_cPa290-cPa241-hybrid_cPa290-unknown_cPa515_cPa530_cPa540,2_1_1_1_3_1_2,115,52
chr1-42558462_42558577,cPa4,0.3,5,42558525,42558479,cPa14_cPa18_cPa4_cPa541_cPa541-cPa14-hybrid,2_2_3_2_1,115,46
chr1-42575314_42575429,cPa563,0.333333333333333,5,42575380,42575364,cPa216-cPa131-hybrid_cPa246-cPa131-hybrid_cPa438-cPa131-hybrid_cPa463-cPa131-hybrid_cPa563,1_1_1_1_2,115,16
chr1-42729459_42729578,cPa529,0.833333333333333,4,42729526,42729486,cPa247-cPa529-hybrid_cPa247-cPa545-hybrid_cPa247-unknown_cPa529,1_1_1_15,119,40
chr1-42754779_42754881,cPa62_cPa75,0.5,2,42754876,42754785,cPa62_cPa75,2_2,102,91
chr1-42827807_42827996,cPa75,1,1,42827944,42827857,cPa75,3,189,87
chr1-42828160_42828270,cPa75,0.5,3,42828252,42828210,cPa285_cPa293_cPa75,1_1_2,110,42
chr1-42828379_42828481,cPa285_cPa75,0.5,2,42828429,42828398,cPa285_cPa75,1_1,102,31
chr1-42828504_42828676,cPa75_cPa75-HML5_repbase_HERVK22I_LTR22-hybrid,0.5,2,42828624,42828554,cPa75_cPa75-HML5_repbase_HERVK22I_LTR22-hybrid,1_1,172,70
chr1-42860617_42860719,cPa363_cPa452,0.375,4,42860717,42860643,cPa363_cPa452_cPa456-cPa587-hybrid_cPa587,3_3_1_1,102,74
chr1-42875611_42875713,cPa75,1,1,42875671,42875661,cPa75,3,102,10
chr1-42875802_42875904,cPa482-cPa75-hybrid_cPa75,0.5,2,42875867,42875852,cPa482-cPa75-hybrid_cPa75,1_1,102,15
chr1-42884126_42884228,cPa18-cPa34-hybrid,1,1,42884176,42884176,cPa18-cPa34-hybrid,1,102,0
chr1-42884742_42884844,cPa190-cPa34-hybrid,1,1,42884792,42884792,cPa190-cPa34-hybrid,1,102,0
chr1-42957242_42957364,cPa47,0.444444444444444,4,42957314,42957253,cPa404_cPa425_cPa425-cPa254-hybrid_cPa47,4_2_4_8,122,61
chr1-42984904_42985015,cPa118_cPa15,0.428571428571429,3,42984964,42984954,cPa118_cPa15_cPa248-unknown,3_3_1,111,10
chr1-43037836_43037938,cPa260_cPa260-cPa75-hybrid,0.5,2,43037936,43037886,cPa260_cPa260-cPa75-hybrid,2_2,102,50
chr1-43039898_43040054,cPa443,0.241379310344828,11,43040035,43039908,cPa118_cPa118-cPa119-hybrid_cPa118-cPa174-hybrid_cPa118-cPa254-hybrid_cPa15-cPa119-hybrid_cPa15-cPa174-hybrid_cPa15-cPa443-hybrid_cPa15-unknown_cPa248_cPa248-cPa174-hybrid_cPa443,2_3_2_1_2_6_2_1_1_2_7,156,127
chr1-43054529_43054631,cPa75,0.583333333333333,6,43054591,43054532,cPa293_cPa413_cPa71-cPa62-hybrid_cPa75_cPa75-cPa62-hybrid_HERV-W_repbase_HERV17_LTR17,1_1_1_7_1_1,102,59
chr1-43055071_43055173,cPa75,0.408450704225352,10,43055173,43055071,cPa293_cPa293-cPa62-hybrid_cPa62_cPa71_cPa71-cPa62-hybrid_cPa75_cPa75-cPa62-hybrid_FeFV_NC001871-cPa62-hybrid_HERV-W_repbase_HERV17_LTR17-cPa75-hybrid_HERV-W_repbase_HERV17_LTR17-PERVC_HM159246-hybrid,5_4_7_3_9_29_11_1_1_1,102,102
chr1-43057114_43057216,cPa255-cPa150-hybrid,1,1,43057164,43057164,cPa255-cPa150-hybrid,1,102,0
chr1-43057601_43057703,cPa302,0.4,4,43057673,43057651,cPa246_cPa255-cPa150-hybrid_cPa302_cPa478,1_1_2_1,102,22
chr1-43068799_43069162,cPa62-unknown,0.625,3,43069110,43068849,cPa62_cPa62-cPa287-hybrid_cPa62-unknown,2_1_5,363,261
chr1-43088979_43089081,cPa14,0.617647058823529,5,43089031,43089001,cPa14_cPa18_cPa18-cPa4-hybrid_cPa18-cPa541-hybrid_cPa541,21_3_1_2_7,102,30
chr1-43165444_43165546,cPa254,0.380952380952381,14,43165534,43165484,cPa174_cPa174-cPa392-hybrid_cPa254_cPa254-cPa392-hybrid_cPa254-cPa425-hybrid_cPa392_cPa404-cPa425-hybrid_cPa425_cPa47_cPa47-cPa174-hybrid_cPa47-cPa254-hybrid_cPa47-cPa392-hybrid_cPa47-cPa425-hybrid_cPa47-unknown,2_1_24_1_1_9_2_1_3_2_2_10_4_1,102,50
chr1-43233847_43233949,cPa62,1,1,43233908,43233891,cPa62,22,102,17
chr1-43304084_43304281,cPa62,1,1,43304229,43304131,cPa62,8,197,98
chr1-43340421_43340523,cPa419,1,1,43340471,43340471,cPa419,1,102,0
chr1-43395151_43395253,cPa219-cPa190-hybrid,1,1,43395201,43395201,cPa219-cPa190-hybrid,1,102,0
chr1-43532983_43533101,cPa220-cPa150-hybrid,0.387096774193548,14,43533077,43533033,cPa104_cPa104-cPa131-hybrid_cPa104-cPa150-hybrid_cPa104-cPa255-hybrid_cPa190_cPa190-cPa131-hybrid_cPa190-cPa150-hybrid_cPa190-cPa479-hybrid_cPa220-cPa104-hybrid_cPa220-cPa131-hybrid_cPa220-cPa150-hybrid_cPa220-cPa302-hybrid_cPa220-cPa479-hybrid_cPa220-unknown,2_1_2_1_2_1_1_1_2_2_12_1_2_1,118,44
chr1-43537430_43537545,cPa150_cPa246_cPa302,0.333333333333333,3,43537493,43537480,cPa150_cPa246_cPa302,1_1_1,115,13
chr1-43541222_43541324,cPa104_cPa18-cPa104-hybrid,0.333333333333333,4,43541293,43541239,cPa104_cPa18-cPa104-hybrid_cPa219_cPa219-cPa104-hybrid,3_3_1_2,102,54
chr1-43547630_43547745,cPa18-cPa104-hybrid_cPa190_cPa219-cPa104-hybrid_cPa220,0.25,4,43547693,43547680,cPa18-cPa104-hybrid_cPa190_cPa219-cPa104-hybrid_cPa220,1_1_1_1,115,13
chr1-43565269_43565371,cPa16-cPa227-hybrid,1,1,43565319,43565319,cPa16-cPa227-hybrid,1,102,0
chr1-43845234_43845336,cPa62,0.604651162790698,9,43845335,43845235,cPa201_cPa201-cPa62-hybrid_cPa201-cPa75-hybrid_cPa285-cPa293-hybrid_cPa293_cPa62_cPa71_cPa75_cPa75-unknown,2_2_1_1_1_26_1_8_1,102,100
chr1-43845677_43845879,cPa62,0.732394366197183,5,43845865,43845709,cPa201_cPa201-cPa293-hybrid_cPa62_cPa71-cPa75-hybrid_cPa75,3_1_52_1_14,202,156
chr1-43875564_43875666,cPa62,0.75,2,43875626,43875584,cPa285_cPa62,1_3,102,42
chr1-43909214_43909337,cPa75,0.470588235294118,5,43909333,43909264,cPa62_cPa75_cPa75-cPa62-hybrid_FeFV_NC001871-cPa62-hybrid_FeFV_NC001871-cPa75-hybrid,4_8_1_3_1,123,69
chr1-43909948_43910052,cPa62_cPa75-cPa62-hybrid_FeFV_NC001871-cPa62-hybrid,0.285714285714286,4,43910000,43909997,cPa62_cPa75-cPa62-hybrid_FeFV_NC001871-cPa62-hybrid_HERV-W_repbase_HERV17_LTR17-cPa62-hybrid,2_2_2_1,104,3
chr1-43910067_43910169,cPa75-cPa62-hybrid,1,1,43910117,43910105,cPa75-cPa62-hybrid,2,102,12
chr1-43921489_43921591,cPa62,1,1,43921578,43921508,cPa62,33,102,70
chr1-44041962_44042064,cPa199-cPa273-hybrid,0.376404494382022,14,44042062,44042005,cPa199_cPa199-cPa273-hybrid_cPa199-cPa450-hybrid_cPa199-cPa542-hybrid_cPa199-cPa553-hybrid_cPa199-unknown_cPa223-cPa273-hybrid_cPa273_cPa345_cPa345-cPa273-hybrid_cPa450_cPa542_cPa542-cPa273-hybrid_cPa553,7_67_3_4_4_2_2_1_13_1_7_59_3_5,102,57
chr1-44062807_44062922,cPa4,0.418181818181818,7,44062893,44062849,cPa4_cPa4-cPa104-hybrid_cPa4-unknown_cPa529-cPa104-hybrid_cPa541_cPa541-cPa104-hybrid_cPa541-unknown,23_3_1_2_11_13_2,115,44
chr1-4407822_4407950,cPa62,0.916666666666667,2,4407936,4407829,cPa293-cPa62-hybrid_cPa62,1_11,128,107
chr1-44121818_44121920,cPa75,0.666666666666667,2,44121892,44121842,cPa62_cPa75,3_6,102,50
chr1-44121929_44122150,cPa62,0.382352941176471,9,44122129,44121979,cPa109-cPa113-hybrid_cPa201-cPa293-hybrid_cPa201-cPa62-hybrid_cPa201-cPa75-hybrid_cPa62_cPa75_cPa75-cPa62-hybrid_cPa75-unknown_HERV-W_repbase_HERV17_LTR17-cPa62-hybrid,1_1_1_1_13_12_1_2_2,221,150
chr1-44122180_44122348,cPa62,0.3,8,44122321,44122217,cPa113-cPa75-hybrid_cPa173-cPa75-hybrid_cPa201-cPa113-hybrid_cPa201-cPa293-hybrid_cPa285-cPa62-hybrid_cPa62_cPa75_cPa75-cPa62-hybrid,1_1_1_1_1_3_1_1,168,104
chr1-44146179_44146288,cPa15,0.5,3,44146236,44146196,cPa118_cPa15_cPa268,1_2_1,109,40
chr1-44174967_44175082,cPa293_cPa391_cPa426,0.333333333333333,3,44175030,44175017,cPa293_cPa391_cPa426,1_1_1,115,13
chr1-44336767_44336871,cPa394-cPa62-hybrid,0.625,2,44336819,44336817,cPa394-cPa62-hybrid_cPa394-unknown,5_3,104,2
chr1-44357390_44357502,cPa450,0.5,12,44357454,44357435,cPa199-cPa542-hybrid_cPa223-cPa227-hybrid_cPa223-cPa450-hybrid_cPa223-cPa542-hybrid_cPa223-cPa553-hybrid_cPa345-cPa542-hybrid_cPa450_cPa450-cPa542-hybrid_cPa450-cPa553-hybrid_cPa482-cPa542-hybrid_cPa482-cPa553-hybrid_cPa553,2_1_2_15_9_1_48_1_1_1_1_14,112,19
chr1-444323_444425,cPa15,0.5,3,444376,444370,cPa118_cPa15_cPa248-unknown,1_2_1,102,6
chr1-44562649_44562751,cPa500,0.333333333333333,5,44562699,44562684,cPa121_cPa157-cPa229-hybrid_cPa183_cPa193_cPa500,1_1_2_2_3,102,15
chr1-4462706_4462983,HERV-W_repbase_HERV17_LTR17,0.8,4,4462966,4462728,HERV-W_repbase_HERV17_LTR17_HERV-W_repbase_HERV17_LTR17-unknown_KWERV_GQ222416_PERV_AJ293656,16_2_1_1,277,238
chr1-44716566_44716668,cPa419,1,1,44716616,44716616,cPa419,1,102,0
chr1-44721197_44721299,cPa16_cPa16-unknown,0.5,2,44721247,44721218,cPa16_cPa16-unknown,1_1,102,29
chr1-44730927_44731036,cPa118_cPa15,0.5,2,44730984,44730931,cPa118_cPa15,3_3,109,53
chr1-4481105_4481207,HERV-W_repbase_HERV17_LTR17,0.3,9,4481207,4481121,cPa75_HERV-W_repbase_HERV17_LTR17_HERV-W_repbase_HERV17_LTR17-cPa285-hybrid_HERV-W_repbase_HERV17_LTR17-cPa293-hybrid_HERV-W_repbase_HERV17_LTR17-cPa75-hybrid_HERV-W_repbase_HERV17_LTR17-KoRV_AF151794-hybrid_KoRV_AF151794_KoRV_AF151794-cPa75-hybrid_PERV_AJ293656-cPa75-hybrid,4_6_1_1_3_1_2_1_1,102,86
chr1-4481589_4481704,HERV-W_repbase_HERV17_LTR17,0.533333333333333,8,4481702,4481617,cPa62-cPa75-hybrid_cPa62-HERV-W_repbase_HERV17_LTR17-hybrid_cPa71-cPa67-hybrid_cPa75_HERV-W_repbase_HERV17_LTR17_HERV-W_repbase_HERV17_LTR17-cPa293-hybrid_HERV-W_repbase_HERV17_LTR17-cPa75-hybrid_PERV_AJ293656-cPa75-hybrid,1_1_1_20_32_1_3_1,115,85
chr1-4481921_4482023,HERV-W_repbase_HERV17_LTR17,1,1,4481976,4481971,HERV-W_repbase_HERV17_LTR17,2,102,5
chr1-44978886_44978988,cPa391,0.558823529411765,5,44978939,44978914,cPa293_cPa391_cPa426-cPa293-hybrid_cPa426-cPa391-hybrid_cPa426-unknown,7_19_5_1_2,102,25
chr1-4503308_4503423,cPa75-unknown,0.631578947368421,3,4503416,4503307,cPa75-cPa482-hybrid_cPa75-HERV30_repbase_HERV30I_LTR30-hybrid_cPa75-unknown,6_1_12,115,109
chr1-45136523_45136628,cPa174_cPa254_cPa425_cPa47,0.25,4,45136576,45136573,cPa174_cPa254_cPa425_cPa47,1_1_1_1,105,3
chr1-45224276_45224378,cPa62,0.857142857142857,2,45224326,45224278,cPa62_cPa62-unknown,6_1,102,48
chr1-45225251_45225363,cPa529,0.333333333333333,7,45225349,45225268,cPa14_cPa247_cPa529_cPa529-cPa246-hybrid_cPa529-cPa247-hybrid_cPa95-cPa14-hybrid_cPa95-unknown,3_2_5_2_1_1_1,112,81
chr1-45233121_45233223,cPa425_cPa47,0.3,5,45233180,45233171,cPa174_cPa254_cPa404-unknown_cPa425_cPa47,1_2_1_3_3,102,9
chr1-4527343_4527445,cPa101,0.5,3,4527393,4527393,cPa101_cPa101-unknown_cPa551,2_1_1,102,0
chr1-45420112_45420214,cPa15,1,1,45420162,45420157,cPa15,2,102,5
chr1-45420292_45420405,cPa15,0.516304347826087,11,45420401,45420295,cPa118_cPa118-cPa15-hybrid_cPa118-cPa248-hybrid_cPa118-cPa443-hybrid_cPa118-unknown_cPa15_cPa15-cPa443-hybrid_cPa264_cPa443_cPa443-unknown_cPa75-cPa248-hybrid,23_2_9_9_7_95_1_1_35_1_1,113,106
chr1-45699550_45699652,cPa62,1,1,45699600,45699600,cPa62,1,102,0
chr1-45798288_45798402,cPa363_cPa452_cPa71,0.333333333333333,3,45798350,45798338,cPa363_cPa452_cPa71,1_1_1,114,12
chr1-45939691_45939793,cPa62,1,1,45939741,45939741,cPa62,1,102,0
chr1-45950959_45951082,cPa62,1,1,45951041,45950981,cPa62,11,123,60
chr1-4601982_4602084,cPa254_cPa392-cPa425-hybrid,0.285714285714286,5,4602032,4601983,cPa254_cPa392-cPa254-hybrid_cPa392-cPa425-hybrid_cPa404-cPa254-hybrid_cPa404-cPa425-hybrid,2_1_2_1_1,102,49
chr1-46023472_46023574,cPa541,0.461538461538462,7,46023533,46023483,cPa14_cPa14-cPa4-hybrid_cPa14-cPa541-hybrid_cPa14-unknown_cPa18_cPa4_cPa541,1_2_1_1_1_1_6,102,50
chr1-46072125_46072227,cPa425,0.357142857142857,10,46072227,46072146,cPa254_cPa254-cPa174-hybrid_cPa254-cPa404-hybrid_cPa392-cPa174-hybrid_cPa404_cPa425_cPa47_cPa47-cPa174-hybrid_cPa47-cPa404-hybrid_cPa47-unknown,23_2_1_2_2_30_13_3_1_7,102,81
chr1-46075526_46075628,cPa104-cPa220-hybrid_cPa190,0.5,2,46075576,46075576,cPa104-cPa220-hybrid_cPa190,1_1,102,0
chr1-46091177_46091279,cPa220,0.75,2,46091238,46091227,cPa190-cPa18-hybrid_cPa220,1_3,102,11
chr1-46192969_46193085,cPa163_cPa360,0.5,2,46193033,46193019,cPa163_cPa360,1_1,116,14
chr1-46273852_46273954,cPa75,1,1,46273902,46273872,cPa75,4,102,30
chr1-46274138_46274270,cPa75,1,1,46274268,46274187,cPa75,11,132,81
chr1-46328906_46329008,cPa117-unknown,1,1,46328957,46328947,cPa117-unknown,3,102,10
chr1-46362629_46362731,HTLV1_NC001436,1,1,46362679,46362679,HTLV1_NC001436,1,102,0
chr1-46392062_46392164,cPa190,0.233333333333333,18,46392120,46392069,cPa104_cPa104-cPa150-hybrid_cPa104-cPa302-hybrid_cPa14-cPa104-hybrid_cPa14-unknown_cPa190_cPa190-cPa104-hybrid_cPa190-cPa150-hybrid_cPa190-cPa302-hybrid_cPa220_cPa220-cPa104-hybrid_cPa220-cPa150-hybrid_cPa220-cPa190-hybrid_cPa220-cPa302-hybrid_cPa4-cPa104-hybrid_cPa4-cPa150-hybrid_cPa4-cPa190-hybrid_cPa4-cPa302-hybrid,5_1_1_1_1_14_1_3_2_11_4_4_1_5_1_2_1_2,102,51
chr1-4642034_4642483,cPa62,0.975609756097561,2,4642431,4642084,cPa62_cPa62-unknown,40_1,449,347
chr1-46433001_46433105,cPa104_cPa190,0.333333333333333,4,46433053,46433051,cPa104_cPa190_cPa220_cPa258,2_2_1_1,104,2
chr1-46667498_46667600,cPa75,1,1,46667551,46667548,cPa75,2,102,3
chr1-46667740_46667948,cPa75,1,1,46667938,46667790,cPa75,14,208,148
chr1-46668008_46668110,cPa75,1,1,46668085,46668013,cPa75,4,102,72
chr1-4702135_4702237,cPa542,0.290322580645161,10,4702193,4702175,cPa199_cPa199-cPa273-hybrid_cPa199-cPa419-hybrid_cPa199-cPa553-hybrid_cPa223_cPa223-cPa273-hybrid_cPa345_cPa345-cPa450-hybrid_cPa450_cPa542,8_3_1_1_2_1_2_1_3_9,102,18
chr1-47375189_47375291,cPa75,0.730769230769231,6,47375289,47375189,cPa62_cPa75_cPa75-cPa62-hybrid_cPa75-unknown_HERV-W_repbase_HERV17_LTR17_HERV-W_repbase_HERV17_LTR17-cPa62-hybrid,2_38_4_2_2_4,102,100
chr1-47461084_47461258,cPa75,1,1,47461206,47461134,cPa75,7,174,72
chr1-47461343_47461445,cPa75,1,1,47461393,47461393,cPa75,1,102,0
chr1-47462228_47462349,cPa75,0.75,2,47462297,47462278,cPa425-cPa75-hybrid_cPa75,1_3,121,19
chr1-47462431_47462596,cPa75,1,1,47462551,47462481,cPa75,10,165,70
chr1-4751059_4751205,cPa62,1,1,4751193,4751069,cPa62,25,146,124
chr1-4786439_4786541,cPa75,1,1,4786493,4786461,cPa75,11,102,32
chr1-47877366_47877480,cPa62,0.931034482758621,3,47877431,47877365,cPa293_cPa62_cPa62-unknown,1_27_1,114,66
chr1-48069433_48069536,cPa216-cPa131-hybrid,0.5,3,48069485,48069482,cPa216_cPa216-cPa131-hybrid_cPa523-cPa131-hybrid,1_2_1,103,3
chr1-48078876_48079162,cPa62,0.621212121212121,5,48079110,48078892,cPa260-cPa62-hybrid_cPa62_cPa75_cPa75-cPa62-hybrid_cPa75-unknown,1_41_14_5_5,286,218
chr1-48429390_48429493,cPa285-unknown,0.714285714285714,3,48429441,48429399,cPa199-unknown_cPa285-unknown_cPa75-unknown,1_5_1,103,42
chr1-4846400_4846514,cPa127_cPa290-unknown_cPa515_cPa530_cPa540,0.2,5,4846462,4846450,cPa127_cPa290-unknown_cPa515_cPa530_cPa540,1_1_1_1_1,114,12
chr1-4917390_4917492,cPa62-unknown,1,1,4917440,4917440,cPa62-unknown,1,102,0
chr1-49201591_49201693,cPa62,1,1,49201691,49201600,cPa62,8,102,91
chr1-492775_493119,cPa260,0.824561403508772,3,493110,492780,cPa106_cPa106-unknown_cPa260,9_1_47,344,330
chr1-4934312_4934417,cPa75,1,1,4934365,4934362,cPa75,3,105,3
chr1-493668_493770,cPa260,0.75,2,493756,493718,cPa106_cPa260,1_3,102,38
chr1-494466_494619,cPa260,0.766666666666667,3,494568,494514,cPa106_cPa106-HERVHcons-hybrid_cPa260,6_1_23,153,54
chr1-5033429_5033531,cPa260-unknown,0.5,3,5033528,5033479,BaEV_D10032-cPa260-hybrid_cPa260_cPa260-unknown,1_4_5,102,49
chr1-50448298_50448400,cPa62,0.964285714285714,2,50448355,50448324,cPa254_cPa62,1_27,102,31
chr1-5057019_5057121,cPa62,1,1,5057070,5057020,cPa62,24,102,50
chr1-50705522_50705624,cPa75,1,1,50705572,50705572,cPa75,1,102,0
chr1-50779464_50779566,HERV-W_repbase_HERV17_LTR17-cPa75-hybrid,0.666666666666667,2,50779543,50779483,cPa71-cPa75-hybrid_HERV-W_repbase_HERV17_LTR17-cPa75-hybrid,1_2,102,60
chr1-50790101_50790203,cPa62,1,1,50790197,50790142,cPa62,18,102,55
chr1-50808518_50808638,cPa104_cPa220,0.297872340425532,10,50808604,50808559,cPa104_cPa104-cPa18-hybrid_cPa104-cPa219-hybrid_cPa190_cPa190-cPa18-hybrid_cPa190-cPa219-hybrid_cPa220_cPa220-cPa18-hybrid_cPa220-cPa219-hybrid_cPa220-unknown,14_2_4_4_2_1_14_1_4_1,120,45
chr1-50833157_50833259,cPa545_cPa95,0.45,10,50833221,50833182,cPa14_cPa254-cPa14-hybrid_cPa545_cPa545-cPa541-hybrid_cPa545-cPa62-hybrid_cPa545-unknown_cPa62-cPa14-hybrid_cPa62-cPa541-hybrid_cPa95_cPa95-cPa541-hybrid,1_1_36_1_1_1_1_1_36_1,102,39
chr1-50888418_50888520,cPa104-cPa18-hybrid_cPa104-unknown_cPa4,0.333333333333333,3,50888468,50888447,cPa104-cPa18-hybrid_cPa104-unknown_cPa4,1_1_1,102,21
chr1-50966202_50966339,cPa75,0.5,3,50966287,50966234,cPa419_cPa75_HERV-W_repbase_HERV17_LTR17,1_2_1,137,53
chr1-50978704_50978806,cPa456,0.481481481481481,5,50978759,50978726,cPa363_cPa363-cPa452-hybrid_cPa456_cPa587-cPa117-hybrid_cPa587-cPa452-hybrid,8_4_13_1_1,102,33
chr1-509796_509898,cPa260-unknown,1,1,509846,509846,cPa260-unknown,1,102,0
chr1-5098121_5098253,SIV_NC001549,0.75,2,5098214,5098149,cPa200-cPa75-hybrid_SIV_NC001549,1_3,132,65
chr1-5098311_5098413,cPa200-cPa75-hybrid_SIV_NC001549,0.5,2,5098361,5098351,cPa200-cPa75-hybrid_SIV_NC001549,1_1,102,10
chr1-51070892_51070994,cPa75-cPa62-hybrid_HERV-W_repbase_HERV17_LTR17-cPa75-hybrid,0.5,2,51070962,51070942,cPa75-cPa62-hybrid_HERV-W_repbase_HERV17_LTR17-cPa75-hybrid,1_1,102,20
chr1-51071335_51071505,HERV-W_repbase_HERV17_LTR17-cPa75-hybrid,0.666666666666667,2,51071492,51071385,cPa260-cPa75-hybrid_HERV-W_repbase_HERV17_LTR17-cPa75-hybrid,1_2,170,107
chr1-51078518_51078620,cPa541,1,1,51078568,51078568,cPa541,1,102,0
chr1-51078702_51078804,cPa14,0.666666666666667,2,51078752,51078743,cPa14_cPa541-cPa254-hybrid,2_1,102,9
chr1-5110299_5110401,cPa308-unknown,1,1,5110349,5110349,cPa308-unknown,1,102,0
chr1-511407_511528,cPa446,1,1,511514,511409,cPa446,23,121,105
chr1-51295618_51295720,cPa339,0.396825396825397,7,51295696,51295633,cPa339_cPa444-cPa339-hybrid_cPa444-cPa390-hybrid_cPa444-cPa447-hybrid_cPa444-cPa62-hybrid_cPa444-unknown_cPa447,25_3_5_18_4_1_7,102,63
chr1-51314416_51314518,cPa62,0.433333333333333,11,51314498,51314433,cPa131_cPa150-cPa529-hybrid_cPa254-cPa529-hybrid_cPa254-unknown_cPa255_cPa302-cPa255-hybrid_cPa419-cPa62-hybrid_cPa479_cPa479-cPa255-hybrid_cPa62_cPa62-cPa255-hybrid,2_1_1_1_2_1_1_5_2_13_1,102,65
chr1-51416758_51417019,cPa62,0.792207792207792,5,51416990,51416788,cPa285_cPa62_cPa62-cPa75-hybrid_cPa62-unknown_cPa75,2_61_3_3_8,261,202
chr1-51617206_51617308,cPa75-cPa62-hybrid,1,1,51617256,51617256,cPa75-cPa62-hybrid,1,102,0
chr1-51618297_51618408,cPa75-cPa62-hybrid,0.666666666666667,2,51618396,51618347,cPa62_cPa75-cPa62-hybrid,1_2,111,49
chr1-51627733_51627835,cPa452,0.533333333333333,3,51627806,51627777,cPa363_cPa452_cPa71,11_16_3,102,29
chr1-51649022_51649124,cPa434,1,1,51649072,51649072,cPa434,1,102,0
chr1-51652073_51652175,cPa434,1,1,51652170,51652076,cPa434,3,102,94
chr1-51652770_51652872,cPa434,1,1,51652820,51652820,cPa434,1,102,0
chr1-51655763_51655865,cPa434,1,1,51655813,51655813,cPa434,1,102,0
chr1-51657455_51657557,cPa434,1,1,51657506,51657455,cPa434,23,102,51
chr1-51658058_51658160,cPa434,1,1,51658108,51658108,cPa434,1,102,0
chr1-51658447_51658549,cPa434,1,1,51658513,51658474,cPa434,6,102,39
chr1-51663186_51663306,cPa434,1,1,51663261,51663185,cPa434,16,120,76
chr1-51663455_51663629,cPa434,1,1,51663577,51663505,cPa434,8,174,72
chr1-51666737_51666878,cPa392,0.932432432432432,3,51666838,51666738,cPa392_cPa392-cPa434-hybrid_cPa392-unknown,69_1_4,141,100
chr1-51772736_51772838,cPa450,0.454545454545455,6,51772786,51772770,cPa223-cPa273-hybrid_cPa223-cPa553-hybrid_cPa227_cPa345-cPa273-hybrid_cPa450_cPa553,1_1_1_1_5_2,102,16
chr1-51896959_51897079,cPa118-cPa443-hybrid_cPa15,0.5,2,51897027,51897009,cPa118-cPa443-hybrid_cPa15,1_1,120,18
chr1-52006491_52006593,cPa254_cPa419_cPa47,0.333333333333333,3,52006574,52006541,cPa254_cPa419_cPa47,1_1_1,102,33
chr1-52125619_52125721,cPa75-unknown,1,1,52125669,52125669,cPa75-unknown,1,102,0
chr1-52148963_52149065,cPa15_cPa248-cPa118-hybrid,0.5,2,52149013,52149013,cPa15_cPa248-cPa118-hybrid,1_1,102,0
chr1-52177545_52177704,cPa101,0.535714285714286,10,52177659,52177581,cPa101_cPa101-cPa142-hybrid_cPa101-cPa582-hybrid_cPa101-unknown_cPa142-cPa582-hybrid_cPa256_cPa256-cPa582-hybrid_cPa256-unknown_cPa51_cPa582,30_1_1_1_4_6_3_6_2_2,159,78
chr1-52177728_52177845,cPa101_cPa256-unknown,0.333333333333333,5,52177830,52177778,cPa101_cPa142_cPa142-unknown_cPa256-unknown_cPa582,3_1_1_3_1,117,52
chr1-52285581_52285685,cPa15_cPa268,0.321428571428571,8,52285634,52285616,cPa118_cPa15_cPa15-cPa118-hybrid_cPa15-cPa268-hybrid_cPa15-unknown_cPa264-cPa118-hybrid_cPa268_cPa75-cPa118-hybrid,1_9_4_1_2_1_9_1,104,18
chr1-52287425_52287537,cPa75,0.714285714285714,5,52287513,52287475,cPa482-cPa62-hybrid_cPa482-unknown_cPa62_cPa75_cPa75-unknown,3_2_1_20_2,112,38
chr1-5230701_5230803,cPa183_cPa223,0.285714285714286,5,5230784,5230734,cPa183_cPa223_cPa223-cPa446-hybrid_cPa363-cPa446-hybrid_cPa446,2_2_1_1_1,102,50
chr1-52552792_52552894,cPa75,0.8,2,52552886,52552809,cPa62-cPa75-hybrid_cPa75,1_4,102,77
chr1-52553204_52553556,cPa75,0.6125,6,52553547,52553210,cPa293_cPa62_cPa62-cPa75-hybrid_cPa62-unknown_cPa75_KWERV_GQ222416,1_5_15_9_49_1,352,337
chr1-52915537_52915639,cPa62,1,1,52915587,52915587,cPa62,1,102,0
chr1-53036834_53036936,cPa254_cPa392_cPa425,0.285714285714286,4,53036884,53036884,cPa254_cPa392_cPa404_cPa425,2_2_1_2,102,0
chr1-531610_531736,cPa75-unknown,1,1,531684,531632,cPa75-unknown,4,126,52
chr1-53193001_53193103,cPa14-cPa247-hybrid_cPa14-cPa529-hybrid_cPa529_cPa541-cPa95-hybrid_cPa545-cPa529-hybrid,0.2,5,53193071,53193051,cPa14-cPa247-hybrid_cPa14-cPa529-hybrid_cPa529_cPa541-cPa95-hybrid_cPa545-cPa529-hybrid,1_1_1_1_1,102,20
chr1-53227622_53227724,cPa62,0.96551724137931,2,53227674,53227625,cPa260_cPa62,1_28,102,49
chr1-53286966_53287068,cPa117,1,1,53287016,53287016,cPa117,1,102,0
chr1-53416095_53416197,cPa131-cPa216-hybrid_cPa255-cPa216-hybrid,0.5,2,53416145,53416099,cPa131-cPa216-hybrid_cPa255-cPa216-hybrid,1_1,102,46
chr1-53424471_53424573,cPa541,0.352941176470588,8,53424521,53424498,cPa18-cPa104-hybrid_cPa18-cPa190-hybrid_cPa4_cPa4-cPa104-hybrid_cPa4-cPa190-hybrid_cPa529-cPa104-hybrid_cPa529-cPa190-hybrid_cPa541,1_1_3_1_2_2_1_6,102,23
chr1-53483825_53483927,cPa104-cPa220-hybrid_cPa190_cPa220,0.266666666666667,6,53483884,53483831,cPa104-cPa18-hybrid_cPa104-cPa219-hybrid_cPa104-cPa220-hybrid_cPa104-unknown_cPa190_cPa220,1_1_4_1_4_4,102,53
chr1-53547917_53548019,cPa62,1,1,53547978,53547960,cPa62,5,102,18
chr1-53583903_53584005,cPa150,0.6,3,53583953,53583934,cPa150_cPa150-cPa268-hybrid_cPa478,3_1_1,102,19
chr1-53584987_53585098,cPa15,0.5,4,53585056,53585027,cPa118_cPa118-cPa419-hybrid_cPa15_cPa150-cPa248-hybrid,2_1_4_1,111,29
chr1-53678986_53679148,cPa392,0.9,3,53679097,53679035,cPa200_cPa223-unknown_cPa392,1_1_18,162,62
chr1-53679168_53679533,cPa392,0.948979591836735,5,53679518,53679187,cPa223-cPa392-hybrid_cPa223-cPa419-hybrid_cPa392_cPa392-unknown_cPa62,1_1_93_2_1,365,331
chr1-53680299_53680401,cPa392,1,1,53680356,53680349,cPa392,4,102,7
chr1-53829645_53829747,cPa62,0.95,2,53829699,53829689,cPa62_cPa62-cPa285-hybrid,19_1,102,10
chr1-53860149_53860272,cPa75,0.461538461538462,5,53860267,53860150,cPa62_cPa75_cPa75-cPa62-hybrid_HERV-W_repbase_HERV17_LTR17-cPa62-hybrid_HERV-W_repbase_HERV17_LTR17-unknown,9_12_3_1_1,123,117
chr1-53860294_53860423,cPa75,0.32,7,53860420,53860344,cPa62_cPa75_cPa75-cPa62-hybrid_cPa75-unknown_HERV-W_repbase_HERV17_LTR17_HERV-W_repbase_HERV17_LTR17-cPa62-hybrid_HERV-W_repbase_HERV17_LTR17-unknown,7_8_4_2_2_1_1,129,76
chr1-53864752_53864854,cPa450,0.320754716981132,7,53864837,53864795,cPa199-cPa227-hybrid_cPa199-cPa273-hybrid_cPa199-cPa542-hybrid_cPa227-cPa273-hybrid_cPa450_cPa450-cPa273-hybrid_cPa553,1_16_1_2_17_1_15,102,42
chr1-53875829_53875931,cPa118,0.395348837209302,10,53875915,53875845,cPa118_cPa118-cPa125-hybrid_cPa118-cPa248-hybrid_cPa118-cPa61-hybrid_cPa118-unknown_cPa15_cPa15-cPa125-hybrid_cPa15-cPa248-hybrid_cPa15-unknown_cPa293-cPa248-hybrid,17_2_1_1_1_12_3_2_3_1,102,70
chr1-53906659_53906761,cPa75,1,1,53906709,53906709,cPa75,1,102,0
chr1-53954859_53955165,cPa131-cPa255-hybrid,0.310344827586207,10,53955113,53954876,cPa131_cPa131-cPa216-hybrid_cPa131-cPa255-hybrid_cPa131-unknown_cPa150-cPa246-hybrid_cPa150-cPa255-hybrid_cPa150-unknown_cPa255_cPa479_cPa479-cPa255-hybrid,2_1_9_1_1_1_1_4_5_4,306,237
chr1-54185352_54185454,cPa62,0.925,4,54185421,54185378,cPa285_cPa293_cPa62_cPa62-unknown,1_1_37_1,102,43
chr1-5428180_5428300,cPa199_cPa553,0.333333333333333,4,5428248,5428218,cPa199_cPa450_cPa542-cPa227-hybrid_cPa553,2_1_1_2,120,30
chr1-54285152_54285325,cPa62,0.525,8,54285311,54285161,cPa293_cPa293-cPa413-hybrid_cPa293-cPa62-hybrid_cPa293-cPa75-hybrid_cPa293-unknown_cPa62_cPa75_cPa75-unknown,2_1_3_2_1_21_8_2,173,150
chr1-54371315_54371429,cPa456,0.496,9,54371418,54371315,cPa363_cPa363-cPa117-hybrid_cPa363-cPa452-hybrid_cPa452_cPa456_cPa456-cPa117-hybrid_cPa456-cPa452-hybrid_cPa587-cPa117-hybrid_cPa587-cPa452-hybrid,25_9_5_5_62_4_7_7_1,114,103
chr1-54438230_54438332,cPa75-cPa62-hybrid,1,1,54438280,54438280,cPa75-cPa62-hybrid,1,102,0
chr1-5450002_5450104,cPa75,1,1,5450052,5450052,cPa75,1,102,0
chr1-5454146_5454263,cPa182,0.769230769230769,6,5454262,5454145,cPa16-cPa391-hybrid_cPa182_cPa21-cPa391-hybrid_cPa21-cPa425-hybrid_cPa391_cPa391-cPa425-hybrid,1_50_3_1_9_1,117,117
chr1-5454346_5454468,cPa182,0.727272727272727,5,5454456,5454364,cPa182_cPa391_cPa391-cPa182-hybrid_cPa391-cPa568-hybrid_cPa391-unknown,32_9_1_1_1,122,92
chr1-5454512_5454614,cPa182,0.791666666666667,2,5454585,5454519,cPa182_cPa391,19_5,102,66
chr1-5454835_5454937,cPa182,1,1,5454935,5454841,cPa182,9,102,94
chr1-54576022_54576475,cPa75,0.625,7,54576427,54576070,cPa113_cPa62_cPa62-cPa75-hybrid_cPa75_cPa75-unknown_PERV_AJ293656-cPa75-hybrid_PERVC_HM159246,1_4_2_20_2_2_1,453,357
chr1-54781960_54782062,cPa15,0.542857142857143,7,54782016,54781980,cPa118_cPa118-cPa125-hybrid_cPa15_cPa15-cPa118-hybrid_cPa268_cPa268-cPa118-hybrid_cPa268-unknown,11_1_19_1_1_1_1,102,36
chr1-54862834_54862936,cPa62,1,1,54862926,54862850,cPa62,53,102,76
chr1-5518627_5518733,cPa363_cPa456,0.333333333333333,4,5518681,5518635,cPa117-cPa587-hybrid_cPa363_cPa452-cPa587-hybrid_cPa456,1_2_1_2,106,46
chr1-55202587_55202689,cPa391,0.4,4,55202640,55202637,cPa293_cPa391_cPa426_cPa426-cPa287-hybrid,1_2_1_1,102,3
chr1-5529766_5529868,cPa118_cPa118-cPa248-hybrid_cPa264,0.181818181818182,8,5529866,5529772,cPa118_cPa118-cPa248-hybrid_cPa118-cPa443-hybrid_cPa15-cPa248-hybrid_cPa15-unknown_cPa264_cPa400-cPa443-hybrid_cPa443,2_2_1_1_1_2_1_1,102,94
chr1-55526225_55526327,cPa363_cPa456,0.428571428571429,3,55526278,55526244,cPa363_cPa456_cPa456-cPa117-hybrid,3_3_1,102,34
chr1-55671057_55671159,cPa456,0.315789473684211,13,55671142,55671075,cPa117-cPa456-hybrid_cPa117-cPa587-hybrid_cPa117-unknown_cPa363_cPa363-cPa456-hybrid_cPa363-cPa587-hybrid_cPa363-unknown_cPa452_cPa452-cPa363-hybrid_cPa452-cPa456-hybrid_cPa452-cPa587-hybrid_cPa452-unknown_cPa456,3_9_1_12_2_2_1_1_1_1_4_2_18,102,67
chr1-55792201_55792322,cPa199,0.928571428571429,2,55792274,55792230,cPa199_cPa419,13_1,121,44
chr1-5587654_5587756,cPa67,0.5,3,5587753,5587656,cPa345_cPa419_cPa67,4_1_5,102,97
chr1-55925390_55925498,cPa219-cPa104-hybrid,0.222222222222222,13,55925477,55925421,cPa104_cPa18-cPa104-hybrid_cPa18-cPa190-hybrid_cPa18-unknown_cPa190_cPa190-cPa104-hybrid_cPa219-cPa104-hybrid_cPa219-cPa190-hybrid_cPa219-cPa220-hybrid_cPa220_cPa220-cPa104-hybrid_cPa258-cPa220-hybrid_cPa258-unknown,4_2_2_1_3_1_6_1_1_3_1_1_1,108,56
chr1-55977706_55977808,cPa540,1,1,55977756,55977756,cPa540,1,102,0
chr1-560693_560795,cPa308-cPa75-hybrid,1,1,560743,560743,cPa308-cPa75-hybrid,1,102,0
chr1-56214982_56215084,cPa142,0.777777777777778,3,56215032,56214995,cPa101_cPa142_cPa142-unknown,1_7_1,102,37
chr1-56308912_56309014,cPa75_HERV-W_repbase_HERV17_LTR17,0.333333333333333,4,56308973,56308962,cPa75_HERV-W_repbase_HERV17_LTR17_KoRV_AF151794_PERV_AJ293656,2_2_1_1,102,11
chr1-56412938_56413053,cPa75-cPa62-hybrid,0.470588235294118,6,56413053,56412985,cPa109_cPa16-cPa201-hybrid_cPa62_cPa75_cPa75-cPa62-hybrid_cPa75-unknown,1_1_2_3_8_2,115,68
chr1-56496977_56497079,cPa62,0.92,2,56497037,56497006,cPa62_cPa62-unknown,23_2,102,31
chr1-56571980_56572082,cPa118,0.666666666666667,2,56572042,56572024,cPa118_cPa15,2_1,102,18
chr1-56585104_56585206,cPa121-cPa456-hybrid,1,1,56585154,56585154,cPa121-cPa456-hybrid,1,102,0
chr1-56721841_56721951,cPa220-cPa18-hybrid,0.461538461538462,3,56721915,56721877,cPa104-cPa18-hybrid_cPa190-cPa18-hybrid_cPa220-cPa18-hybrid,4_3_6,110,38
chr1-56731513_56731615,cPa583,0.533333333333333,8,56731607,56731520,cPa251_cPa251-cPa358-hybrid_cPa332-cPa251-hybrid_cPa332-cPa358-hybrid_cPa332-unknown_cPa358_cPa419_cPa583,3_4_1_3_1_8_1_24,102,87
chr1-56810562_56810664,cPa492,1,1,56810612,56810612,cPa492,1,102,0
chr1-5684387_5684489,cPa450-unknown,0.444444444444444,5,5684464,5684435,cPa450-cPa174-hybrid_cPa450-cPa332-hybrid_cPa450-unknown_cPa459-cPa449-hybrid_cPa459-unknown,1_1_4_2_1,102,29
chr1-56933059_56933174,cPa62,0.954545454545455,2,56933149,56933086,cPa62_cPa62-unknown,21_1,115,63
chr1-56935853_56935966,cPa62,0.979166666666667,2,56935916,56935867,cPa419_cPa62,1_47,113,49
chr1-56965161_56965263,cPa62,0.529411764705882,3,56965245,56965162,cPa62_cPa62-cPa75-hybrid_cPa62-unknown,18_1_15,102,83
chr1-56991745_56991847,cPa363_cPa456,0.285714285714286,5,56991801,56991795,cPa117-cPa587-hybrid_cPa363_cPa452-cPa587-hybrid_cPa452-unknown_cPa456,1_2_1_1_2,102,6
chr1-57072672_57072774,cPa142,0.666666666666667,2,57072722,57072690,cPa101-unknown_cPa142,1_2,102,32
chr1-57090375_57090477,cPa223,1,1,57090475,57090400,cPa223,19,102,75
chr1-57251982_57252144,cPa75,0.35,10,57252128,57251987,cPa260_cPa260-cPa62-hybrid_cPa293_cPa62_cPa71-cPa62-hybrid_cPa75_cPa75-cPa62-hybrid_cPa75-unknown_PERV_AJ293656_PERV_AJ293656-cPa62-hybrid,1_1_1_2_2_7_3_1_1_1,162,141
chr1-57279173_57279275,cPa47,0.283333333333333,11,57279272,57279174,cPa174_cPa254_cPa254-cPa174-hybrid_cPa425_cPa425-cPa174-hybrid_cPa47_cPa47-cPa174-hybrid_cPa47-unknown_cPa75-cPa174-hybrid_cPa75-cPa254-hybrid_cPa75-cPa425-hybrid,2_14_2_9_2_17_8_1_3_1_1,102,98
chr1-57371632_57371747,cPa223-cPa16-hybrid_cPa363_cPa452_cPa71,0.25,4,57371695,57371682,cPa223-cPa16-hybrid_cPa363_cPa452_cPa71,1_1_1_1,115,13
chr1-57632102_57632235,cPa75,0.4,4,57632228,57632152,cPa62-cPa75-hybrid_cPa75_HERV-W_repbase_HERV17_LTR17_KoRV_AF151794-cPa75-hybrid,1_2_1_1,133,76
chr1-57632427_57632540,cPa75,0.363636363636364,4,57632525,57632471,cPa62-cPa75-hybrid_cPa75_HERV-W_repbase_HERV17_LTR17_HERV-W_repbase_HERV17_LTR17-cPa75-hybrid,3_4_2_2,113,54
chr1-57632689_57632796,cPa75,0.8,2,57632744,57632716,cPa62-unknown_cPa75,1_4,107,28
chr1-57640608_57640729,cPa67,0.52112676056338,3,57640699,57640623,cPa113_cPa67_cPa75-cPa113-hybrid,27_37_7,121,76
chr1-57762590_57762692,cPa220,0.75,3,57762646,57762628,cPa190_cPa220_cPa258,2_9_1,102,18
chr1-57843660_57843762,HERV-W_repbase_HERV17_LTR17,0.86046511627907,7,57843750,57843663,cPa75_HERV-W_repbase_HERV17_LTR17_HERV-W_repbase_HERV17_LTR17-unknown_HERV-XA34_repbase_HERVFH21I_LTR21A_KoRV_AF151794-unknown_S71_repbase_HERVS71_LTR6A-cPa62-hybrid_S71_repbase_HERVS71_LTR6A-HERV-W_repbase_HERV17_LTR17-hybrid,1_37_1_1_1_1_1,102,87
chr1-57843781_57843883,HERV-W_repbase_HERV17_LTR17,0.75,3,57843875,57843814,cPa75_cPa75-cPa62-hybrid_HERV-W_repbase_HERV17_LTR17,1_1_6,102,61
chr1-57937342_57937444,cPa541,0.4,4,57937437,57937392,cPa4_cPa4-cPa14-hybrid_cPa492-cPa14-hybrid_cPa541,1_1_1_2,102,45
chr1-5840873_5840996,cPa425,0.375,7,5840971,5840923,cPa315_cPa404_cPa425_cPa425-cPa404-hybrid_cPa47_cPa47-cPa404-hybrid_cPa47-unknown,2_2_6_1_3_1_1,123,48
chr1-58441056_58441158,cPa390_cPa447_cPa62-cPa447-hybrid,0.333333333333333,3,58441106,58441106,cPa390_cPa447_cPa62-cPa447-hybrid,1_1_1,102,0
chr1-5854271_5854373,cPa62,0.666666666666667,3,5854369,5854321,cPa285_cPa293_cPa62,1_1_4,102,48
chr1-5870151_5870258,cPa254_cPa404,0.285714285714286,5,5870213,5870192,cPa174_cPa254_cPa404_cPa425_cPa47,1_2_2_1_1,107,21
chr1-58703189_58703304,cPa450,0.428571428571429,4,58703263,58703238,cPa223-cPa199-hybrid_cPa223-cPa273-hybrid_cPa450_cPa553,1_2_3_1,115,25
chr1-58807722_58807824,cPa339,1,1,58807811,58807765,cPa339,29,102,46
chr1-59170621_59170925,cPa75,0.445652173913043,10,59170925,59170671,cPa293_cPa413_cPa419_cPa62_cPa62-cPa293-hybrid_cPa62-cPa75-hybrid_cPa62-unknown_cPa75_cPa75-unknown_PERVC_HM159246,4_1_1_35_1_2_3_41_3_1,304,254
chr1-59204457_59204562,cPa117_cPa452,0.476190476190476,3,59204523,59204476,cPa117_cPa419_cPa452,10_1_10,105,47
chr1-59221268_59221375,cPa363_cPa452,0.4,3,59221329,59221318,cPa363_cPa452_cPa71,2_2_1,107,11
chr1-59234337_59234452,cPa15,0.6875,6,59234440,59234387,cPa118_cPa118-cPa268-hybrid_cPa118-unknown_cPa15_cPa443_cPa443-unknown,1_1_1_11_1_1,115,53
chr1-59416168_59416270,cPa62-cPa260-hybrid,1,1,59416218,59416218,cPa62-cPa260-hybrid,1,102,0
chr1-59416883_59417039,cPa75,0.5,3,59417009,59416933,cPa62-cPa260-hybrid_cPa62-cPa75-hybrid_cPa75,1_1_2,156,76
chr1-59498201_59498303,cPa285_cPa62,0.5,2,59498251,59498243,cPa285_cPa62,1_1,102,8
chr1-598510_598636,cPa75-unknown,0.75,2,598593,598513,cPa75_cPa75-unknown,1_3,126,80
chr1-59906109_59906211,cPa223,0.6,3,59906181,59906152,cPa223_cPa424-cPa363-hybrid_cPa446-cPa363-hybrid,3_1_1,102,29
chr1-5998979_5999081,cPa75_HERV-W_repbase_HERV17_LTR17-cPa62-hybrid,0.333333333333333,4,5999068,5999022,cPa75_HERV-W_repbase_HERV17_LTR17-cPa62-hybrid_HERV-W_repbase_HERV17_LTR17-cPa75-hybrid_HERV-W_repbase_HERV17_LTR17-unknown,2_2_1_1,102,46
chr1-5999347_5999511,cPa75-cPa62-hybrid,0.235294117647059,8,5999484,5999396,cPa543-cPa62-hybrid_cPa75_cPa75-cPa62-hybrid_cPa75-MoMLV_J02255-hybrid_cPa75-MSEV_CT990572-hybrid_HERV-W_repbase_HERV17_LTR17_HERV-W_repbase_HERV17_LTR17-cPa62-hybrid_HERV-W_repbase_HERV17_LTR17-cPa75-hybrid,1_3_4_1_1_2_2_3,164,88
chr1-60768393_60768495,cPa62,0.933333333333333,2,60768451,60768442,cPa285-cPa62-hybrid_cPa62,1_14,102,9
chr1-61229545_61229647,cPa315,1,1,61229595,61229595,cPa315,1,102,0
chr1-61468359_61468461,cPa62,1,1,61468412,61468393,cPa62,20,102,19
chr1-61468832_61468940,cPa450,0.5,9,61468903,61468831,cPa199_cPa199-cPa223-hybrid_cPa227_cPa227-cPa199-hybrid_cPa227-cPa223-hybrid_cPa450_cPa450-cPa223-hybrid_cPa542-cPa223-hybrid_cPa553-cPa223-hybrid,3_1_2_1_2_19_3_1_6,108,72
chr1-61684100_61684228,cPa75-cPa492-hybrid_HERV-W_repbase_HERV17_LTR17-cPa492-hybrid,0.5,2,61684176,61684150,cPa75-cPa492-hybrid_HERV-W_repbase_HERV17_LTR17-cPa492-hybrid,1_1,128,26
chr1-61684655_61684790,HERV-W_repbase_HERV17_LTR17-cPa62-hybrid,0.625,4,61684738,61684660,cPa75_HERV-W_repbase_HERV17_LTR17_HERV-W_repbase_HERV17_LTR17-cPa492-hybrid_HERV-W_repbase_HERV17_LTR17-cPa62-hybrid,1_1_1_5,135,78
chr1-61684901_61685074,cPa75_HERV-W_repbase_HERV17_LTR17-cPa62-hybrid_HERV-W_repbase_HERV17_LTR17-cPa75-hybrid,0.333333333333333,3,61685022,61684951,cPa75_HERV-W_repbase_HERV17_LTR17-cPa62-hybrid_HERV-W_repbase_HERV17_LTR17-cPa75-hybrid,1_1_1,173,71
chr1-61960285_61960387,cPa62,1,1,61960335,61960335,cPa62,1,102,0
chr1-62017353_62017534,cPa75_cPa75-cPa62-hybrid,0.5,2,62017482,62017403,cPa75_cPa75-cPa62-hybrid,1_1,181,79
chr1-62017639_62017741,cPa75,1,1,62017689,62017689,cPa75,1,102,0
chr1-62018028_62018130,cPa75-cPa62-hybrid,1,1,62018078,62018078,cPa75-cPa62-hybrid,1,102,0
chr1-62099341_62099443,cPa15,0.75,2,62099391,62099380,cPa118_cPa15,1_3,102,11
chr1-62207140_62207242,cPa450,0.407407407407407,12,62207211,62207180,cPa199_cPa227_cPa273-cPa199-hybrid_cPa450_cPa450-cPa199-hybrid_cPa450-unknown_cPa542_cPa542-cPa199-hybrid_cPa553_cPa553-cPa199-hybrid_cPa553-unknown_cPa62-cPa199-hybrid,5_2_2_22_7_2_1_1_2_5_2_3,102,31
chr1-62302292_62302394,cPa456,0.608695652173913,6,62302391,62302342,cPa363_cPa363-cPa117-hybrid_cPa363-cPa452-hybrid_cPa456_cPa456-cPa363-hybrid_cPa587-cPa452-hybrid,1_4_2_14_1_1,102,49
chr1-62437109_62437222,cPa371,1,1,62437170,62437159,cPa371,5,113,11
chr1-62651289_62651391,cPa15_cPa15-cPa118-hybrid_cPa268,0.333333333333333,3,62651339,62651339,cPa15_cPa15-cPa118-hybrid_cPa268,1_1_1,102,0
chr1-62780046_62780148,cPa15,0.5,4,62780115,62780059,cPa118_cPa118-cPa248-hybrid_cPa118-cPa443-hybrid_cPa15,10_3_2_15,102,56
chr1-62798363_62798465,cPa345,1,1,62798453,62798413,cPa345,3,102,40
chr1-63198358_63198460,cPa456,0.375,6,63198415,63198408,cPa117-cPa308-hybrid_cPa117-cPa363-hybrid_cPa363_cPa452_cPa452-cPa308-hybrid_cPa456,1_1_1_1_1_3,102,7
chr1-63349452_63349557,cPa62,1,1,63349513,63349495,cPa62,44,105,18
chr1-63588533_63588644,cPa174,0.375,6,63588592,63588549,cPa174_cPa404_cPa425-cPa404-hybrid_cPa425-unknown_cPa47-cPa404-hybrid_cPa47-unknown,3_1_1_1_1_1,111,43
chr1-63666530_63666632,cPa456,0.3125,6,63666581,63666530,cPa121-cPa587-hybrid_cPa363_cPa452-cPa363-hybrid_cPa452-cPa456-hybrid_cPa452-cPa587-hybrid_cPa456,2_4_1_2_2_5,102,51
chr1-63667477_63667761,cPa75-unknown,0.6,7,63667709,63667522,cPa402-unknown_cPa482-cPa62-hybrid_cPa482-unknown_cPa543_cPa75_cPa75-cPa62-hybrid_cPa75-unknown,3_1_1_1_16_2_36,284,187
chr1-64125767_64125869,cPa450,0.383333333333333,22,64125849,64125767,cPa199_cPa227-cPa199-hybrid_cPa273_cPa273-cPa199-hybrid_cPa273-cPa227-hybrid_cPa273-cPa450-hybrid_cPa273-cPa542-hybrid_cPa273-unknown_cPa419-cPa199-hybrid_cPa450_cPa450-cPa199-hybrid_cPa450-cPa223-hybrid_cPa450-unknown_cPa542-cPa199-hybrid_cPa553_cPa553-cPa199-hybrid_cPa553-cPa227-hybrid_cPa553-cPa450-hybrid_cPa553-unknown_VISNA_S55323-cPa199-hybrid_VISNA_S55323-cPa450-hybrid_VISNA_S55323-unknown,69_1_16_14_1_1_3_4_1_92_4_1_3_1_4_7_1_1_1_7_2_6,102,82
chr1-6413637_6413746,cPa363_cPa452-cPa587-hybrid_cPa456,0.222222222222222,6,6413694,6413638,cPa117-cPa456-hybrid_cPa121-cPa587-hybrid_cPa363_cPa452_cPa452-cPa587-hybrid_cPa456,1_1_2_1_2_2,109,56
chr1-64195188_64195290,cPa75,1,1,64195238,64195238,cPa75,1,102,0
chr1-64360164_64360266,cPa62,0.941176470588235,4,64360255,64360214,cPa285-cPa62-hybrid_cPa285-unknown_cPa50-cPa62-hybrid_cPa62,1_1_2_64,102,41
chr1-64609822_64610027,cPa456,0.32,15,64609975,64609871,cPa117-cPa363-hybrid_cPa117-cPa452-hybrid_cPa117-cPa456-hybrid_cPa117-cPa587-hybrid_cPa117-unknown_cPa119-cPa456-hybrid_cPa363_cPa363-cPa456-hybrid_cPa363-cPa587-hybrid_cPa419-cPa587-hybrid_cPa452_cPa452-cPa456-hybrid_cPa456_cPa456-cPa452-hybrid_cPa539-cPa587-hybrid,1_5_2_3_3_1_6_2_1_1_5_2_16_1_1,205,104
chr1-65185726_65185839,cPa174_cPa254_cPa404_cPa425_cPa47,0.2,5,65185787,65185776,cPa174_cPa254_cPa404_cPa425_cPa47,1_1_1_1_1,113,11
chr1-65412363_65412465,cPa254_cPa47-cPa174-hybrid,0.307692307692308,6,65412460,65412411,cPa174_cPa254_cPa254-cPa174-hybrid_cPa425_cPa47-cPa174-hybrid_cPa47-unknown,2_4_1_1_4_1,102,49
chr1-6564234_6564336,cPa505_cPa505-unknown,0.4,3,6564333,6564284,cPa482-unknown_cPa505_cPa505-unknown,1_2_2,102,49
chr1-6570584_6570686,cPa62,0.833333333333333,2,6570652,6570607,cPa118-cPa62-hybrid_cPa62,1_5,102,45
chr1-6583669_6583771,cPa62-cPa75-hybrid,0.571428571428571,2,6583744,6583676,cPa62-cPa75-hybrid_HERV-W_repbase_HERV17_LTR17,4_3,102,68
chr1-6583945_6584052,cPa62-cPa75-hybrid,0.317073170731707,7,6584045,6583955,cPa62-cPa75-hybrid_cPa62-HERV-W_repbase_HERV17_LTR17-hybrid_cPa62-KoRV_AF151794-hybrid_cPa62-unknown_cPa75_HERV-W_repbase_HERV17_LTR17_KoRV_AF151794,13_4_3_7_10_3_1,107,90
chr1-66130870_66130972,cPa4,0.5,3,66130931,66130919,cPa4_cPa4-unknown_cPa419,2_1_1,102,12
chr1-66473966_66474131,cPa62-HERV-W_repbase_HERV17_LTR17-hybrid,0.769230769230769,3,66474079,66474013,cPa62_cPa62-HERV-W_repbase_HERV17_LTR17-hybrid_cPa75,1_10_2,165,66
chr1-66474368_66475342,cPa62-HERV-W_repbase_HERV17_LTR17-hybrid,0.311475409836066,8,66475290,66474370,cPa62_cPa62-cPa75-hybrid_cPa62-HERV-W_repbase_HERV17_LTR17-hybrid_cPa62-unknown_cPa75_cPa75-GaLV_M26927-hybrid_cPa75-HERV-W_repbase_HERV17_LTR17-hybrid_HERV-W_repbase_HERV17_LTR17,9_2_19_3_15_1_2_10,974,920
chr1-66475454_66475556,cPa62-HERV-W_repbase_HERV17_LTR17-hybrid,1,1,66475504,66475504,cPa62-HERV-W_repbase_HERV17_LTR17-hybrid,1,102,0
chr1-66565611_66565853,cPa75,0.470588235294118,4,66565842,66565661,cPa293-cPa62-hybrid_cPa62_cPa75_cPa75-cPa62-hybrid,1_3_8_5,242,181
chr1-66566222_66566324,cPa75,0.666666666666667,2,66566272,66566224,cPa293-cPa62-hybrid_cPa75,1_2,102,48
chr1-66566676_66566778,cPa75,1,1,66566726,66566726,cPa75,1,102,0
chr1-66566850_66566952,cPa75-cPa62-hybrid,1,1,66566900,66566900,cPa75-cPa62-hybrid,1,102,0
chr1-66567261_66567372,cPa75_cPa75-cPa62-hybrid,0.5,2,66567320,66567311,cPa75_cPa75-cPa62-hybrid,1_1,111,9
chr1-66567373_66567475,cPa75-cPa62-hybrid,1,1,66567423,66567423,cPa75-cPa62-hybrid,1,102,0
chr1-671757_671866,cPa254,0.352941176470588,10,671827,671758,cPa174_cPa174-cPa425-hybrid_cPa254_cPa404_cPa404-cPa174-hybrid_cPa404-cPa425-hybrid_cPa425_cPa47_cPa47-cPa174-hybrid_cPa47-cPa425-hybrid,9_1_18_1_2_1_4_5_8_2,109,69
chr1-67598243_67598345,cPa434,1,1,67598305,67598254,cPa434,3,102,51
chr1-67598442_67598544,cPa434,0.8,2,67598534,67598442,cPa419_cPa434,1_4,102,92
chr1-67599103_67599205,cPa434,1,1,67599153,67599136,cPa434,8,102,17
chr1-67599352_67599491,cPa434,1,1,67599487,67599368,cPa434,21,139,119
chr1-67599786_67599888,cPa434,1,1,67599836,67599836,cPa434,1,102,0
chr1-67599979_67600081,cPa434,1,1,67600029,67599982,cPa434,9,102,47
chr1-67601822_67601924,cPa434,1,1,67601881,67601848,cPa434,5,102,33
chr1-67601999_67602141,cPa434,1,1,67602126,67602043,cPa434,6,142,83
chr1-67602212_67602314,cPa434,1,1,67602286,67602262,cPa434,6,102,24
chr1-67602811_67602913,cPa434,1,1,67602884,67602861,cPa434,2,102,23
chr1-67603246_67603348,cPa434,1,1,67603347,67603296,cPa434,5,102,51
chr1-67603570_67603672,cPa434,1,1,67603665,67603620,cPa434,2,102,45
chr1-67606730_67606883,cPa434,0.985294117647059,2,67606831,67606739,cPa434_cPa459,67_1,153,92
chr1-67606910_67607064,cPa434,1,1,67607056,67606911,cPa434,10,154,145
chr1-67607794_67607896,cPa434,0.984,2,67607883,67607834,cPa434_cPa459,123_2,102,49
chr1-67610091_67610295,cPa34,0.736842105263158,4,67610269,67610141,cPa183_cPa183-cPa34-hybrid_cPa34_cPa500,3_1_14_1,204,128
chr1-67611458_67611572,cPa34,0.928571428571429,2,67611523,67611495,cPa34_cPa553-cPa34-hybrid,13_1,114,28
chr1-67611728_67611830,cPa34,1,1,67611778,67611751,cPa34,2,102,27
chr1-67613328_67613585,cPa434,1,1,67613533,67613330,cPa434,54,257,203
chr1-6768154_6768343,cPa75,1,1,6768291,6768188,cPa75,5,189,103
chr1-6768854_6768967,cPa75,0.857142857142857,2,6768916,6768904,cPa75_cPa75-cPa308-hybrid,6_1,113,12
chr1-6796024_6796138,cPa142,0.6,2,6796086,6796073,cPa101_cPa142,2_3,114,13
chr1-68471912_68472014,cPa62,1,1,68471971,68471954,cPa62,36,102,17
chr1-68839954_68840070,cPa290_cPa515_cPa530-cPa127-hybrid_cPa540,0.25,4,68840018,68840004,cPa290_cPa515_cPa530-cPa127-hybrid_cPa540,1_1_1_1,116,14
chr1-69812009_69812111,cPa62,1,1,69812059,69812039,cPa62,11,102,20
chr1-7016977_7017079,cPa62,1,1,7017034,7017019,cPa62,6,102,15
chr1-70255579_70255681,cPa254-cPa248-hybrid,1,1,70255629,70255629,cPa254-cPa248-hybrid,1,102,0
chr1-70256688_70256790,cPa15,0.636363636363636,4,70256770,70256734,cPa15_cPa248_cPa264-cPa248-hybrid_cPa443-cPa248-hybrid,7_2_1_1,102,36
chr1-70256854_70257043,cPa248,0.333333333333333,6,70256997,70256879,cPa118-cPa248-hybrid_cPa15_cPa248_cPa443-cPa248-hybrid_cPa566_cPa75-cPa248-hybrid,1_3_4_1_1_2,189,118
chr1-7052479_7052632,cPa71-cPa62-hybrid,0.6,3,7052580,7052529,cPa285-cPa62-hybrid_cPa71_cPa71-cPa62-hybrid,1_1_3,153,51
chr1-7052991_7053222,cPa285-cPa62-hybrid,0.380952380952381,5,7053174,7053041,cPa285_cPa285-cPa62-hybrid_cPa71_cPa71-cPa62-hybrid_cPa75,2_8_6_4_1,231,133
chr1-7053377_7053479,cPa285,1,1,7053427,7053427,cPa285,1,102,0
chr1-7113333_7113459,cPa472-unknown_cPa62,0.5,2,7113407,7113383,cPa472-unknown_cPa62,1_1,126,24
chr1-71253011_71253125,cPa15,0.5,3,71253074,71253061,cPa118_cPa15_cPa248-unknown,1_2_1,114,13
chr1-71477646_71477748,cPa543,1,1,71477700,71477696,cPa543,2,102,4
chr1-71860131_71860233,cPa62,1,1,71860191,71860164,cPa62,25,102,27
chr1-71911182_71911284,cPa15,0.625,3,71911243,71911230,cPa118-cPa268-hybrid_cPa118-unknown_cPa15,1_2_5,102,13
chr1-72074150_72074252,cPa62,1,1,72074200,72074193,cPa62,2,102,7
chr1-72134715_72134817,cPa323,0.428571428571429,6,72134813,72134722,cPa323_cPa323-cPa568-hybrid_cPa333_cPa333-cPa568-hybrid_cPa371-cPa50-hybrid_cPa371-cPa568-hybrid,6_1_1_2_1_3,102,91
chr1-7242611_7242713,cPa392,1,1,7242661,7242657,cPa392,3,102,4
chr1-7242846_7242948,cPa392,1,1,7242896,7242896,cPa392,1,102,0
chr1-72439059_72439161,cPa62,1,1,72439116,72439083,cPa62,12,102,33
chr1-72454587_72454702,cPa339_cPa447,0.25,6,72454650,72454637,cPa339_cPa390_cPa447_cPa447-cPa390-hybrid_cPa62-cPa339-hybrid_cPa62-cPa444-hybrid,2_1_2_1_1_1,115,13
chr1-7247885_7248020,cPa392,0.714285714285714,3,7247997,7247935,cPa152_cPa392_cPa392-cPa152-hybrid,1_5_1,135,62
chr1-7265785_7265887,cPa392,1,1,7265880,7265835,cPa392,3,102,45
chr1-7266011_7266125,cPa392,1,1,7266073,7266059,cPa392,3,114,14
chr1-72943011_72943121,cPa363_cPa456,0.3,5,72943113,72943059,cPa363_cPa456_cPa587-cPa117-hybrid_cPa587-cPa452-hybrid_cPa75-cPa117-hybrid,3_3_2_1_1,110,54
chr1-73031990_73032092,cPa201-cPa62-hybrid,0.5,3,73032056,73032009,cPa201-cPa62-hybrid_cPa293-cPa62-hybrid_cPa419,3_2_1,102,47
chr1-73061621_73061727,cPa273-cPa199-hybrid_cPa542,0.25,6,73061716,73061669,cPa273-cPa199-hybrid_cPa345_cPa450_cPa450-cPa199-hybrid_cPa542_cPa553,3_1_2_2_3_1,106,47
chr1-73086359_73086461,cPa199,1,1,73086409,73086409,cPa199,1,102,0
chr1-73192948_73193050,cPa62,1,1,73193006,73192982,cPa62,20,102,24
chr1-73319268_73319370,cPa75-cPa117-hybrid,1,1,73319318,73319318,cPa75-cPa117-hybrid,1,102,0
chr1-73319841_73319943,cPa117,0.6,2,73319891,73319872,cPa117_cPa75-cPa117-hybrid,3_2,102,19
chr1-73342591_73342693,cPa456,0.5625,9,73342666,73342607,cPa363_cPa363-cPa452-hybrid_cPa434-cPa452-hybrid_cPa452_cPa456_cPa456-cPa117-hybrid_cPa456-cPa452-hybrid_cPa587-cPa117-hybrid_cPa587-cPa452-hybrid,18_4_1_1_45_4_2_3_2,102,59
chr1-73788388_73788558,cPa75,0.888888888888889,2,73788506,73788438,cPa413-cPa62-hybrid_cPa75,1_8,170,68
chr1-73788576_73788678,cPa75,1,1,73788626,73788626,cPa75,1,102,0
chr1-73788749_73789115,cPa75,0.833333333333333,5,73789115,73788770,cPa260_cPa62_cPa75_cPa75-cPa62-hybrid_cPa75-unknown,1_1_25_1_2,366,345
chr1-73893013_73893115,cPa127_cPa127-cPa11-hybrid_cPa290,0.333333333333333,3,73893063,73893035,cPa127_cPa127-cPa11-hybrid_cPa290,1_1_1,102,28
chr1-73935901_73936054,cPa61,0.666666666666667,2,73936048,73935951,cPa61_JSRV_DQ838494-cPa205-hybrid,2_1,153,97
chr1-73985548_73985650,cPa75,0.608695652173913,6,73985637,73985588,cPa113_cPa119-cPa62-hybrid_cPa62_cPa75_cPa75-unknown_PERVC_HM159246-PERVA_AY099323-hybrid,2_2_2_14_2_1,102,49
chr1-74079078_74079180,cPa62,1,1,74079130,74079128,cPa62,2,102,2
chr1-74348901_74349003,cPa456,0.666666666666667,8,74348987,74348902,cPa363_cPa363-cPa117-hybrid_cPa363-cPa452-hybrid_cPa452_cPa456_cPa456-unknown_cPa62_cPa62-cPa452-hybrid,10_1_7_1_48_1_1_3,102,85
chr1-74728479_74728581,cPa15,0.666666666666667,2,74728529,74728518,cPa118_cPa15,1_2,102,11
chr1-75146550_75146659,cPa142,0.75,2,75146623,75146600,cPa101_cPa142,1_3,109,23
chr1-75241525_75241627,cPa323-cPa50-hybrid_cPa333_cPa371-cPa50-hybrid_cPa568,0.25,4,75241575,75241574,cPa323-cPa50-hybrid_cPa333_cPa371-cPa50-hybrid_cPa568,1_1_1_1,102,1
chr1-75597236_75597338,cPa75,0.5,3,75597311,75597284,cPa75_cPa75-unknown_HERV-W_repbase_HERV17_LTR17-cPa75-hybrid,2_1_1,102,27
chr1-75623744_75623846,PRIMA41_repbase_PRIMA41_MER41A,1,1,75623794,75623747,PRIMA41_repbase_PRIMA41_MER41A,2,102,47
chr1-76047649_76047751,HERV-W_repbase_HERV17_LTR17,1,1,76047740,76047697,HERV-W_repbase_HERV17_LTR17,3,102,43
chr1-76121590_76121698,cPa4_cPa541,0.375,3,76121646,76121595,cPa18_cPa4_cPa541,2_3_3,108,51
chr1-76207329_76207431,cPa101_cPa142,0.5,2,76207382,76207379,cPa101_cPa142,1_1,102,3
chr1-76255829_76255931,cPa62,0.968253968253968,2,76255906,76255846,cPa62_cPa62-unknown,61_2,102,60
chr1-76415648_76415750,cPa456,0.625,5,76415699,76415649,cPa117-cPa363-hybrid_cPa117-cPa456-hybrid_cPa117-cPa587-hybrid_cPa363_cPa456,1_1_1_3_10,102,50
chr1-76493768_76493870,cPa419_cPa75_cPa75-cPa62-hybrid,0.333333333333333,3,76493823,76493807,cPa419_cPa75_cPa75-cPa62-hybrid,1_1_1,102,16
chr1-76494120_76494222,cPa50-cPa62-hybrid,1,1,76494170,76494170,cPa50-cPa62-hybrid,1,102,0
chr1-76540153_76540255,cPa118,0.333333333333333,6,76540204,76540194,cPa118_cPa125-cPa15-hybrid_cPa15_cPa15-cPa118-hybrid_cPa248-cPa118-hybrid_cPa268-cPa118-hybrid,3_1_2_1_1_1,102,10
chr1-76663400_76663502,cPa190,0.381818181818182,12,76663453,76663433,cPa104_cPa104-cPa220-hybrid_cPa18-cPa190-hybrid_cPa18-cPa220-hybrid_cPa18-unknown_cPa190_cPa190-cPa220-hybrid_cPa219-cPa190-hybrid_cPa219-cPa220-hybrid_cPa219-unknown_cPa220_cPa258-cPa190-hybrid,1_1_2_11_2_21_1_1_5_1_8_1,102,20
chr1-76839612_76839728,cPa62,0.777777777777778,3,76839676,76839658,cPa419_cPa62_cPa75-cPa62-hybrid,1_14_3,116,18
chr1-76910861_76910963,cPa15,0.8,2,76910956,76910906,cPa118_cPa15,1_4,102,50
chr1-77054571_77054673,cPa62,0.326086956521739,9,77054669,77054570,cPa201-cPa62-hybrid_cPa62_cPa75_cPa75-cPa62-hybrid_cPa75-unknown_HERV-W_repbase_HERV17_LTR17_HERV-W_repbase_HERV17_LTR17-cPa62-hybrid_KoRV_AF151794-cPa62-hybrid_S71_repbase_HERVS71_LTR6A,3_15_11_4_1_1_8_2_1,102,99
chr1-77136679_77136781,cPa62-cPa75-hybrid_cPa62-unknown,0.35,5,77136781,77136680,cPa62-cPa71-hybrid_cPa62-cPa75-hybrid_cPa62-unknown_cPa75_HERV-W_repbase_HERV17_LTR17,1_7_7_4_1,102,101
chr1-7770230_7770417,cPa75-unknown,0.769230769230769,3,7770417,7770240,cPa71_cPa75_cPa75-unknown,2_7_30,187,177
chr1-77761999_77762114,cPa15,0.325,16,77762108,77762037,cPa118_cPa15_cPa223-cPa15-hybrid_cPa223-cPa199-hybrid_cPa223-cPa227-hybrid_cPa223-cPa542-hybrid_cPa227_cPa227-cPa273-hybrid_cPa227-cPa542-hybrid_cPa443_cPa443-cPa118-hybrid_cPa443-cPa15-hybrid_cPa443-cPa268-hybrid_cPa450_cPa553_cPa553-unknown,2_13_1_1_1_1_2_1_1_1_1_1_1_10_2_1,115,71
chr1-7776730_7776832,cPa425,1,1,7776790,7776780,cPa425,3,102,10
chr1-78076011_78076113,cPa452,0.714285714285714,3,78076073,78076033,cPa363_cPa452_cPa71,1_5_1,102,40
chr1-78370873_78370975,HERV-W_repbase_HERV17_LTR17_HERV-W_repbase_HERV17_LTR17-cPa75-hybrid,0.5,2,78370923,78370888,HERV-W_repbase_HERV17_LTR17_HERV-W_repbase_HERV17_LTR17-cPa75-hybrid,1_1,102,35
chr1-78371134_78371236,cPa75,0.444444444444444,6,78371217,78371159,cPa293-HERV-W_repbase_HERV17_LTR17-hybrid_cPa71-cPa75-hybrid_cPa75_HERV-W_repbase_HERV17_LTR17-cPa75-hybrid_HERV-W_repbase_HERV17_LTR17-S71_repbase_HERVS71_LTR6A-hybrid_HERV-W_repbase_HERV17_LTR17-unknown,1_1_4_1_1_1,102,58
chr1-78452561_78452791,cPa75-cPa113-hybrid,0.378378378378378,6,78452739,78452611,cPa62-cPa113-hybrid_cPa62-cPa67-hybrid_cPa62-unknown_cPa75-cPa113-hybrid_cPa75-cPa67-hybrid_cPa75-unknown,3_2_1_14_9_8,230,128
chr1-78700388_78700500,cPa199,0.6,2,78700450,78700438,cPa199_cPa542-unknown,3_2,112,12
chr1-78903156_78903267,cPa101,0.375,4,78903215,78903199,cPa101_cPa256_cPa256-unknown_cPa582,3_2_1_2,111,16
chr1-79047144_79047246,cPa75,1,1,79047195,79047194,cPa75,3,102,1
chr1-79086839_79086979,cPa500,0.298245614035088,16,79086954,79086859,cPa157_cPa157-cPa183-hybrid_cPa157-cPa229-hybrid_cPa157-cPa34-hybrid_cPa157-unknown_cPa183_cPa193_cPa193-cPa183-hybrid_cPa193-cPa229-hybrid_cPa193-cPa500-hybrid_cPa229_cPa293_cPa426_cPa500_cPa500-cPa183-hybrid_cPa500-cPa229-hybrid,1_2_4_1_1_3_16_1_2_1_4_1_1_17_1_1,140,95
chr1-79122939_79123043,cPa75-cPa223-hybrid,0.75,2,79122991,79122978,cPa75_cPa75-cPa223-hybrid,1_3,104,13
chr1-79264587_79264702,cPa118_cPa15_cPa248-unknown,0.333333333333333,3,79264650,79264637,cPa118_cPa15_cPa248-unknown,1_1_1,115,13
chr1-79403585_79403700,cPa15,0.4,4,79403648,79403635,cPa118_cPa15_cPa248-unknown_cPa268-cPa118-hybrid,1_2_1_1,115,13
chr1-79558091_79558220,cPa190,0.25,6,79558168,79558139,cPa104_cPa190_cPa219_cPa220-cPa104-hybrid_cPa220-unknown_cPa258-unknown,2_3_2_1_2_2,129,29
chr1-79857388_79857490,cPa75,1,1,79857446,79857436,cPa75,3,102,10
chr1-79993941_79994089,cPa469_cPa75,0.4,3,79994037,79993991,cPa469_cPa75_cPa75-unknown,2_2_1,148,46
chr1-79994287_79994389,cPa62_cPa75-cPa62-hybrid,0.5,2,79994343,79994337,cPa62_cPa75-cPa62-hybrid,1_1,102,6
chr1-80243538_80243647,cPa62,0.8,2,80243595,80243588,cPa62_cPa62-unknown,4_1,109,7
chr1-80243666_80243768,cPa62,1,1,80243716,80243716,cPa62,1,102,0
chr1-80486906_80487008,cPa563,0.40625,13,80486977,80486932,cPa131_cPa131-cPa478-hybrid_cPa131-cPa526-hybrid_cPa131-cPa545-hybrid_cPa131-cPa95-hybrid_cPa216-cPa95-hybrid_cPa247-cPa95-hybrid_cPa255_cPa479-cPa95-hybrid_cPa526_cPa526-cPa545-hybrid_cPa529_cPa563,4_1_1_1_3_2_1_1_1_2_1_1_13,102,45
chr1-80632839_80632941,cPa117,1,1,80632889,80632889,cPa117,1,102,0
chr1-80633560_80633662,cPa117,1,1,80633610,80633610,cPa117,1,102,0
chr1-80634065_80634167,cPa117,1,1,80634115,80634115,cPa117,1,102,0
chr1-80634338_80634491,cPa117,0.833333333333333,2,80634476,80634350,cPa117_cPa452,20_4,153,126
chr1-80634577_80634839,cPa117,0.888888888888889,3,80634810,80634599,cPa117_cPa452_PERV_AJ293656-cPa452-hybrid,32_3_1,262,211
chr1-80634910_80635054,cPa117,0.888888888888889,3,80635045,80634916,cPa117_cPa452_cPa452-cPa75-hybrid,16_1_1,144,129
chr1-808896_808998,cPa260,0.75,2,808947,808895,cPa260_cPa260-unknown,3_1,102,52
chr1-809110_809212,cPa228-STLV2_NC001815-hybrid_cPa260_cPa260-unknown,0.333333333333333,3,809181,809160,cPa228-STLV2_NC001815-hybrid_cPa260_cPa260-unknown,1_1_1,102,21
chr1-81072815_81072917,cPa190,1,1,81072876,81072865,cPa190,2,102,11
chr1-8138518_8138635,cPa323,0.478260869565217,5,8138583,8138560,cPa323_cPa323-cPa568-hybrid_cPa333_cPa333-cPa568-hybrid_cPa371-cPa568-hybrid,11_6_1_1_4,117,23
chr1-81478111_81478234,cPa62,0.533333333333333,6,81478182,81478150,cPa254-cPa62-hybrid_cPa285_cPa285-cPa62-hybrid_cPa285-unknown_cPa62_cPa75-cPa62-hybrid,1_2_7_3_16_1,123,32
chr1-81504877_81504979,cPa15,0.428571428571429,3,81504947,81504927,cPa118_cPa118-cPa248-hybrid_cPa15,2_2_3,102,20
chr1-8231902_8232004,cPa75,1,1,8231953,8231938,cPa75,8,102,15
chr1-82498956_82499058,cPa419,1,1,82499006,82499006,cPa419,1,102,0
chr1-82516284_82516386,cPa62,0.974358974358974,2,82516384,82516333,cPa109-cPa62-hybrid_cPa62,1_38,102,51
chr1-82593976_82594078,cPa62,0.96551724137931,2,82594029,82594012,cPa273-cPa62-hybrid_cPa62,1_28,102,17
chr1-82605333_82605463,cPa260_cPa75,0.5,2,82605411,82605383,cPa260_cPa75,1_1,130,28
chr1-82693266_82693368,cPa183_cPa223-cPa424-hybrid,0.238095238095238,9,82693346,82693275,cPa183_cPa223-cPa183-hybrid_cPa223-cPa327-hybrid_cPa223-cPa424-hybrid_cPa223-cPa446-hybrid_cPa357-cPa327-hybrid_cPa379-cPa327-hybrid_cPa75-cPa327-hybrid_cPa75-cPa424-hybrid,5_2_3_5_1_2_1_1_1,102,71
chr1-82826267_82826369,cPa62,0.888888888888889,2,82826329,82826314,cPa254_cPa62,3_24,102,15
chr1-8285073_8285175,cPa452,0.4,5,8285170,8285092,cPa183_cPa363_cPa379_cPa446_cPa452,2_5_1_1_6,102,78
chr1-82876419_82876595,cPa62,0.85,3,82876571,82876469,cPa285_cPa62_cPa62-unknown,1_17_2,176,102
chr1-82895610_82895712,cPa62,0.945945945945946,3,82895678,82895660,cPa285_cPa62_cPa62-unknown,1_35_1,102,18
chr1-82980906_82981008,cPa62-HERV-W_repbase_HERV17_LTR17-hybrid,0.378378378378378,7,82981005,82980910,cPa62_cPa62-cPa75-hybrid_cPa62-HERV-W_repbase_HERV17_LTR17-hybrid_cPa62-unknown_cPa75_cPa75-HERV-W_repbase_HERV17_LTR17-hybrid_HERV-W_repbase_HERV17_LTR17,1_7_14_1_11_1_2,102,95
chr1-83120902_83121004,cPa75,0.333333333333333,5,83120952,83120906,cPa293-cPa62-hybrid_cPa62_cPa75_cPa75-cPa62-hybrid_cPa75-unknown,1_2_4_3_2,102,46
chr1-83192923_83193025,cPa62,0.923076923076923,2,83192995,83192943,cPa62_cPa62-unknown,12_1,102,52
chr1-83260506_83260619,cPa456,0.333333333333333,6,83260601,83260556,cPa117-cPa11-hybrid_cPa363_cPa363-cPa515-hybrid_cPa452-cPa11-hybrid_cPa452-cPa515-hybrid_cPa456,1_2_1_1_1_3,113,45
chr1-83370914_83371016,cPa254-unknown_cPa62_cPa62-unknown,0.333333333333333,3,83370964,83370946,cPa254-unknown_cPa62_cPa62-unknown,1_1_1,102,18
chr1-83656951_83657091,cPa75,0.625,4,83657085,83656955,cPa62_cPa75_cPa75-cPa62-hybrid_cPa75-unknown,3_15_5_1,140,130
chr1-84006631_84006762,HERV-W_repbase_HERV17_LTR17,0.666666666666667,4,84006760,84006633,cPa75_HERV-W_repbase_HERV17_LTR17_HERV-W_repbase_HERV17_LTR17-unknown_KoRV_AF151794,2_16_4_2,131,127
chr1-84344235_84344337,cPa62,0.923076923076923,2,84344296,84344275,cPa62_cPa62-unknown,12_1,102,21
chr1-85055762_85055864,cPa426,1,1,85055812,85055812,cPa426,1,102,0
chr1-85176860_85177003,cPa75,1,1,85176951,85176910,cPa75,16,143,41
chr1-85177017_85177307,cPa75,0.972972972972973,2,85177299,85177067,cPa113-cPa75-hybrid_cPa75,1_36,290,232
chr1-85319128_85319334,cPa62,1,1,85319304,85319127,cPa62,54,206,177
chr1-85405219_85405321,cPa419,1,1,85405269,85405269,cPa419,1,102,0
chr1-85496501_85496603,cPa452,0.388888888888889,4,85496570,85496533,cPa363_cPa452_cPa452-cPa363-hybrid_cPa71,6_7_1_4,102,37
chr1-85568380_85568482,cPa273-cPa553-hybrid_cPa419_cPa71-cPa553-hybrid,0.333333333333333,3,85568430,85568413,cPa273-cPa553-hybrid_cPa419_cPa71-cPa553-hybrid,1_1_1,102,17
chr1-85569113_85569215,cPa345,1,1,85569163,85569163,cPa345,1,102,0
chr1-85569342_85569444,cPa345,0.551724137931034,9,85569412,85569341,cPa199-cPa450-hybrid_cPa199-cPa553-hybrid_cPa223_cPa223-cPa227-hybrid_cPa223-cPa450-hybrid_cPa345_cPa482-cPa227-hybrid_cPa553_PtERV1_AC142352-cPa450-hybrid,1_1_2_3_1_16_1_3_1,102,71
chr1-85815722_85815824,cPa163,1,1,85815772,85815771,cPa163,3,102,1
chr1-86237718_86237820,cPa15,0.666666666666667,2,86237768,86237745,cPa118_cPa15,1_2,102,23
chr1-86238129_86238231,cPa15,0.8,2,86238189,86238140,cPa118_cPa15,1_4,102,49
chr1-86350193_86350295,cPa75-cPa360-hybrid,1,1,86350243,86350243,cPa75-cPa360-hybrid,1,102,0
chr1-86413397_86413511,cPa339_cPa390_cPa447,0.25,6,86413459,86413413,cPa339_cPa339-cPa205-hybrid_cPa390_cPa447_cPa447-cPa444-hybrid_cPa62-cPa444-hybrid,3_1_3_3_1_1,114,46
chr1-86511484_86511661,cPa75,1,1,86511620,86511534,cPa75,6,177,86
chr1-86552401_86552505,cPa75-unknown,0.857142857142857,2,86552455,86552431,cPa75-cPa482-hybrid_cPa75-unknown,1_6,104,24
chr1-86552608_86552924,cPa75-unknown,0.647058823529412,4,86552872,86552658,cPa75-cPa482-hybrid_cPa75-cPa542-hybrid_cPa75-HERV-F_repbase_HERVFH19I_LTR19A-hybrid_cPa75-unknown,4_1_1_11,316,214
chr1-86734579_86734681,cPa113,0.655172413793103,6,86734637,86734578,cPa113_cPa113-cPa67-hybrid_cPa113-cPa75-hybrid_cPa113-unknown_cPa67_HERV-W_repbase_HERV17_LTR17,19_1_4_3_1_1,102,59
chr1-8735790_8735892,cPa450,0.944444444444444,2,8735856,8735816,cPa450_cPa450-unknown,17_1,102,40
chr1-87421512_87421618,cPa425_cPa47,0.428571428571429,3,87421595,87421522,cPa174-cPa404-hybrid_cPa425_cPa47,1_3_3,106,73
chr1-8759125_8759227,cPa62,0.941176470588235,2,8759186,8759129,cPa62_cPa62-unknown,16_1,102,57
chr1-87665082_87665184,cPa75,1,1,87665132,87665132,cPa75,1,102,0
chr1-8777309_8777411,cPa62,0.666666666666667,2,8777407,8777357,cPa62_cPa62-unknown,4_2,102,50
chr1-88261823_88261925,cPa356_cPa428,0.5,2,88261907,88261873,cPa356_cPa428,1_1,102,34
chr1-88458959_88459061,cPa62,1,1,88459009,88458961,cPa62,26,102,48
chr1-88735751_88735853,HML1a_repbase_HERV-K14CI_LTR14C,0.666666666666667,2,88735801,88735757,HML1a_repbase_HERV-K14CI_LTR14C_HML1a_repbase_HERV-K14CI_LTR14C-unknown,2_1,102,44
chr1-89363101_89363215,BaEV_D10032,0.740740740740741,2,89363163,89363135,BaEV_D10032_BaEV_D10032-unknown,20_7,114,28
chr1-894647_894872,cPa323,0.509803921568627,4,894853,894676,cPa323_cPa323-cPa371-hybrid_cPa371_cPa371-cPa323-hybrid,26_3_21_1,225,177
chr1-8965984_8966107,cPa452,0.4,4,8966084,8966034,cPa379_cPa446_cPa452_cPa452-unknown,1_1_2_1,123,50
chr1-8966172_8966274,cPa446,0.666666666666667,2,8966265,8966220,cPa446_cPa452,6_3,102,45
chr1-89809858_89809960,cPa15,0.727272727272727,3,89809917,89809857,cPa118_cPa15_cPa268-cPa118-hybrid,2_8_1,102,60
chr1-89871936_89872181,HERV-W_repbase_HERV17_LTR17,0.702702702702703,11,89872176,89871968,cPa15-HERV-W_repbase_HERV17_LTR17-hybrid_cPa15-PERV_AJ293656-hybrid_cPa62-cPa15-hybrid_cPa67_cPa75_HERV-W_repbase_HERV17_LTR17_HERV-W_repbase_HERV17_LTR17-cPa75-hybrid_KoRV_AF151794_KoRV_AF151794-PERV_AJ293656-hybrid_KWERV_GQ222416_PERV_AJ293656,1_1_1_1_7_52_1_2_3_1_4,245,208
chr1-90005836_90005939,cPa75,0.666666666666667,2,90005888,90005886,cPa75_cPa75-unknown,2_1,103,2
chr1-90154912_90155065,cPa75,1,1,90155013,90154962,cPa75,2,153,51
chr1-90373440_90373554,cPa293_cPa391,0.333333333333333,4,90373514,90373490,cPa293_cPa391_cPa426_cPa426-cPa287-hybrid,2_2_1_1,114,24
chr1-90691776_90691903,cPa469,0.944444444444444,2,90691851,90691810,cPa469_cPa469-unknown,17_1,127,41
chr1-90731460_90731562,cPa15,0.4375,5,90731515,90731466,cPa118_cPa125-cPa118-hybrid_cPa15_cPa248-unknown_cPa443-unknown,6_1_7_1_1,102,49
chr1-91432425_91432527,cPa62,0.5,3,91432482,91432454,cPa62_cPa75_cPa75-cPa62-hybrid,2_1_1,102,28
chr1-91591088_91591190,cPa62,1,1,91591155,91591138,cPa62,14,102,17
chr1-91804611_91804713,cPa62,1,1,91804661,91804661,cPa62,1,102,0
chr1-91875499_91875601,cPa293_cPa391,0.5,2,91875549,91875549,cPa293_cPa391,1_1,102,0
chr1-9203890_9203992,cPa47,0.43859649122807,6,9203967,9203901,cPa174_cPa254_cPa254-cPa174-hybrid_cPa404-cPa174-hybrid_cPa425_cPa47,1_14_2_2_13_25,102,66
chr1-92122254_92122401,cPa482-cPa75-hybrid_cPa75,0.461538461538462,3,92122349,92122299,cPa482-cPa75-hybrid_cPa75_HERV-F_repbase_HERVFH19I_LTR19A-cPa75-hybrid,6_6_1,147,50
chr1-9272161_9272263,cPa363_cPa456-cPa117-hybrid,0.5,2,9272211,9272211,cPa363_cPa456-cPa117-hybrid,1_1,102,0
chr1-9286029_9286131,cPa308,1,1,9286079,9286079,cPa308,1,102,0
chr1-92881634_92881736,cPa452,0.625,2,92881701,92881681,cPa363_cPa452,3_5,102,20
chr1-93595595_93595697,cPa391,0.5,3,93595645,93595629,cPa293_cPa293-cPa426-hybrid_cPa391,1_1_2,102,16
chr1-93734190_93734302,cPa456,0.714285714285714,2,93734290,93734205,cPa363_cPa456,2_5,112,85
chr1-93737504_93737606,cPa456,1,1,93737554,93737554,cPa456,1,102,0
chr1-93737662_93737841,cPa456_cPa75,0.375,4,93737802,93737699,cPa452-cPa363-hybrid_cPa456_cPa587-cPa363-hybrid_cPa75,1_3_1_3,179,103
chr1-93756607_93756709,cPa15,0.555555555555556,2,93756662,93756648,cPa118_cPa15,4_5,102,14
chr1-93793913_93794015,cPa363,0.290322580645161,7,93794005,93793963,cPa117-cPa587-hybrid_cPa363_cPa363-cPa456-hybrid_cPa452-cPa456-hybrid_cPa452-unknown_cPa456_cPa75-cPa456-hybrid,1_9_3_5_2_8_3,102,42
chr1-93826269_93826371,cPa447,0.39344262295082,17,93826360,93826281,cPa205_cPa339_cPa339-cPa205-hybrid_cPa339-cPa332-hybrid_cPa353_cPa390_cPa390-cPa205-hybrid_cPa390-cPa332-hybrid_cPa390-cPa339-hybrid_cPa390-cPa353-hybrid_cPa447_cPa447-unknown_cPa62-cPa205-hybrid_cPa62-cPa332-hybrid_cPa62-cPa353-hybrid_cPa62-cPa390-hybrid_cPa62-unknown,2_19_3_1_4_19_1_1_1_1_48_5_6_2_2_1_6,102,79
chr1-94281439_94281541,cPa205-cPa583-hybrid_cPa357,0.5,2,94281516,94281489,cPa205-cPa583-hybrid_cPa357,1_1,102,27
chr1-94282245_94282347,cPa168,0.263157894736842,9,94282340,94282246,cPa164_cPa168_cPa168-cPa273-hybrid_cPa168-unknown_cPa227_cPa273_cPa357_cPa450-cPa227-hybrid_cPa583,9_10_1_2_6_4_3_1_2,102,94
chr1-94283187_94283301,cPa168,0.363636363636364,5,94283290,94283194,cPa168_cPa227_cPa273_cPa357_cPa583,4_1_2_3_1,114,96
chr1-94430462_94430564,cPa452,0.5,6,94430519,94430476,cPa363_cPa363-cPa452-hybrid_cPa363-cPa71-hybrid_cPa363-unknown_cPa452_cPa71,2_2_2_1_13_6,102,43
chr1-94480123_94480411,cPa62-unknown_cPa75,0.333333333333333,5,94480364,94480173,cPa62_cPa62-cPa75-hybrid_cPa62-unknown_cPa75_cPa75-unknown,1_1_3_3_1,288,191
chr1-94480515_94480617,cPa75,1,1,94480572,94480565,cPa75,2,102,7
chr1-94552409_94552531,cPa15,0.375,4,94552496,94552417,cPa118_cPa15_cPa268_cPa268-cPa140-hybrid,2_3_2_1,122,79
chr1-94554124_94554226,cPa125_cPa15,0.5,2,94554174,94554173,cPa125_cPa15,1_1,102,1
chr1-94581548_94581650,cPa62,1,1,94581619,94581561,cPa62,17,102,58
chr1-94799595_94799697,cPa315-cPa75-hybrid,1,1,94799645,94799645,cPa315-cPa75-hybrid,1,102,0
chr1-94816369_94816496,cPa450,0.4125,14,94816495,94816379,cPa168-cPa199-hybrid_cPa199_cPa227_cPa227-cPa199-hybrid_cPa273-cPa199-hybrid_cPa357-cPa199-hybrid_cPa450_cPa450-cPa199-hybrid_cPa450-unknown_cPa539-cPa553-hybrid_cPa542_cPa542-cPa199-hybrid_cPa553_cPa553-cPa199-hybrid,1_2_5_2_6_1_33_10_1_1_1_3_11_3,127,116
chr1-94823757_94823872,cPa15,0.435294117647059,9,94823868,94823804,cPa118_cPa118-HERV-W_repbase_HERV17_LTR17-hybrid_cPa15_cPa15-HERV-W_repbase_HERV17_LTR17-hybrid_cPa223-cPa248-hybrid_cPa443_cPa443-cPa223-hybrid_cPa443-cPa248-hybrid_cPa443-HERV-W_repbase_HERV17_LTR17-hybrid,24_3_37_2_1_12_1_1_4,115,64
chr1-94825145_94825247,cPa75,0.4,4,94825195,94825159,cPa118-HERV-W_repbase_HERV17_LTR17-hybrid_cPa71_cPa75_cPa75-HERV-W_repbase_HERV17_LTR17-hybrid,1_1_2_1,102,36
chr1-94839228_94839369,cPa183-cPa392-hybrid_cPa193_cPa229-cPa392-hybrid_cPa500,0.25,4,94839317,94839278,cPa183-cPa392-hybrid_cPa193_cPa229-cPa392-hybrid_cPa500,1_1_1_1,141,39
chr1-95033881_95033988,cPa118,0.571428571428571,2,95033936,95033931,cPa118_cPa15,4_3,107,5
chr1-95125595_95125697,cPa15,0.857142857142857,2,95125645,95125632,cPa15_cPa268-cPa118-hybrid,6_1,102,13
chr1-95199775_95200053,cPa345,0.875,3,95200041,95199783,cPa339-cPa223-hybrid_cPa345_cPa345-unknown,1_21_2,278,258
chr1-95200084_95200186,cPa345,0.962962962962963,2,95200159,95200105,cPa345_cPa345-unknown,26_1,102,54
chr1-9544014_9544116,cPa456,1,1,9544064,9544064,cPa456,1,102,0
chr1-95549280_95549382,cPa15_cPa248-cPa118-hybrid,0.5,2,95549330,95549330,cPa15_cPa248-cPa118-hybrid,1_1,102,0
chr1-95559733_95559835,cPa419,1,1,95559783,95559783,cPa419,1,102,0
chr1-95638243_95638345,cPa315,1,1,95638318,95638293,cPa315,2,102,25
chr1-95647434_95647604,cPa75,0.285714285714286,7,95647578,95647452,cPa62-unknown_cPa75_cPa75-unknown_HERV-W_repbase_HERV17_LTR17_HERV-W_repbase_HERV17_LTR17-cPa193-hybrid_HERV-W_repbase_HERV17_LTR17-cPa419-hybrid_HERV-W_repbase_HERV17_LTR17-unknown,7_8_2_2_1_1_7,170,126
chr1-95657929_95658033,cPa75-HERV-W_repbase_HERV17_LTR17-hybrid,0.435483870967742,5,95658022,95657978,cPa392-HERV-W_repbase_HERV17_LTR17-hybrid_cPa404-HERV-W_repbase_HERV17_LTR17-hybrid_cPa419-HERV-W_repbase_HERV17_LTR17-hybrid_cPa75_cPa75-HERV-W_repbase_HERV17_LTR17-hybrid,5_1_3_26_27,104,44
chr1-95670143_95670245,cPa419,1,1,95670244,95670149,cPa419,10,102,95
chr1-95765095_95765197,cPa419,1,1,95765145,95765145,cPa419,1,102,0
chr1-95847661_95847763,cPa419,1,1,95847711,95847711,cPa419,1,102,0
chr1-95893080_95893182,cPa118_cPa15,0.5,2,95893130,95893130,cPa118_cPa15,1_1,102,0
chr1-96082424_96082537,cPa118_cPa15,0.4,3,96082534,96082474,cPa118_cPa15_cPa248-unknown,2_2_1,113,60
chr1-96210849_96210951,cPa75,0.666666666666667,2,96210899,96210892,cPa75_cPa75-unknown,2_1,102,7
chr1-96840633_96840735,cPa75,1,1,96840683,96840683,cPa75,1,102,0
chr1-9701743_9701966,cPa71,0.473118279569892,13,9701957,9701752,cPa16-cPa363-hybrid_cPa16-cPa62-hybrid_cPa16-unknown_cPa363_cPa363-cPa62-hybrid_cPa379-cPa363-hybrid_cPa71_cPa71-cPa62-hybrid_cPa71-cPa75-hybrid_cPa71-unknown_cPa75_HERV-W_repbase_HERV17_LTR17_HERV-W_repbase_HERV17_LTR17-cPa62-hybrid,1_1_1_1_1_1_44_20_1_10_5_5_2,223,205
chr1-97193946_97194048,cPa62,1,1,97194023,97193961,cPa62,42,102,62
chr1-97752780_97752882,cPa425,0.4,4,97752841,97752830,cPa174_cPa254_cPa425_cPa47,1_1_2_1,102,11
chr1-9854396_9854542,cPa452,0.45,15,9854514,9854430,cPa176_cPa176-cPa62-hybrid_cPa183-cPa16-hybrid_cPa223-cPa16-hybrid_cPa327-cPa363-hybrid_cPa327-cPa62-hybrid_cPa363_cPa363-cPa16-hybrid_cPa363-cPa62-hybrid_cPa452_cPa71_cPa71-cPa16-hybrid_cPa71-cPa363-hybrid_cPa71-cPa62-hybrid_cPa71-unknown,1_1_1_1_1_1_34_1_2_54_14_3_2_2_2,146,84
chr1-98675189_98675291,cPa419,1,1,98675268,98675239,cPa419,1,102,29
chr1-9876308_9876410,cPa392,1,1,9876396,9876307,cPa392,8,102,89
chr1-98832458_98832656,cPa223,0.477272727272727,15,98832604,98832508,cPa199_cPa199-cPa223-hybrid_cPa199-cPa227-hybrid_cPa223_cPa223-cPa199-hybrid_cPa223-cPa450-hybrid_cPa227_cPa227-cPa223-hybrid_cPa273_cPa345_cPa450_cPa450-cPa345-hybrid_cPa450-HIV1_NC001802-hybrid_cPa553_cPa553-cPa345-hybrid,17_1_1_42_1_1_1_1_6_2_9_2_1_2_1,198,96
chr1-98845621_98845723,cPa62,0.833333333333333,2,98845717,98845671,cPa539-unknown_cPa62,1_5,102,46
chr1-9902744_9902846,cPa363,1,1,9902794,9902793,cPa363,2,102,1
chr1-99053399_99053501,WDSV_NC001867-cPa75-hybrid,1,1,99053449,99053449,WDSV_NC001867-cPa75-hybrid,1,102,0
chr1-99054667_99054769,cPa260_cPa539,0.5,2,99054717,99054700,cPa260_cPa539,1_1,102,17
chr1-99087598_99087700,cPa15,1,1,99087648,99087648,cPa15,1,102,0
chr1-99087790_99087920,cPa62,0.918367346938776,4,99087899,99087792,cPa118_cPa15_cPa248-cPa118-hybrid_cPa62,1_2_1_45,130,107
chr1-9911452_9911554,cPa62,1,1,9911502,9911456,cPa62,3,102,46
chr1-99238343_99238575,cPa260,1,1,99238556,99238342,cPa260,26,232,214
chr1-9950259_9950361,cPa345,1,1,9950309,9950261,cPa345,2,102,48
chr1-9950483_9950616,cPa345,1,1,9950564,9950533,cPa345,9,133,31
chr1-99675991_99676096,HERV-W_repbase_HERV17_LTR17,0.615384615384615,4,99676093,99676017,HERV-W_repbase_HERV17_LTR17_HERV-W_repbase_HERV17_LTR17-cPa75-hybrid_HERV-W_repbase_HERV17_LTR17-unknown_PERV_AJ293656,8_1_3_1,105,76
chr1-99840370_99840472,cPa62,0.96551724137931,2,99840448,99840377,cPa285_cPa62,1_28,102,71
chr1-99845213_99845315,cPa113_cPa113-cPa75-hybrid_MLV_Xmv43_MoMLV_J02255,0.25,4,99845263,99845222,cPa113_cPa113-cPa75-hybrid_MLV_Xmv43_MoMLV_J02255,1_1_1_1,102,41
chr10-10078376_10078490,cPa390-cPa444-hybrid_cPa447_cPa62-cPa444-hybrid,0.210526315789474,8,10078444,10078395,cPa339_cPa339-cPa444-hybrid_cPa390-cPa339-hybrid_cPa390-cPa444-hybrid_cPa447_cPa447-cPa339-hybrid_cPa447-cPa444-hybrid_cPa62-cPa444-hybrid,1_1_1_4_4_3_1_4,114,49
chr10-1044951_1045053,cPa121-cPa232-hybrid,1,1,1045001,1045001,cPa121-cPa232-hybrid,1,102,0
chr10-1045200_1045302,cPa121-unknown_cPa260-cPa232-hybrid,0.5,2,1045251,1045250,cPa121-unknown_cPa260-cPa232-hybrid,1_1,102,1
chr10-1059230_1059332,cPa539,1,1,1059293,1059257,cPa539,27,102,36
chr10-11187935_11188037,cPa14,0.4,5,11188002,11187985,cPa14_cPa18_cPa4_cPa4-cPa541-hybrid_cPa541,4_1_2_1_2,102,17
chr10-1153149_1153251,cPa434,0.666666666666667,2,1153221,1153177,cPa260-cPa113-hybrid_cPa434,1_2,102,44
chr10-12061772_12061874,cPa62,1,1,12061839,12061822,cPa62,2,102,17
chr10-12222943_12223045,cPa75,1,1,12222993,12222975,cPa75,4,102,18
chr10-1225195_1225327,cPa75,0.346153846153846,8,1225282,1225231,cPa285_cPa293_cPa293-cPa285-hybrid_cPa293-cPa75-hybrid_cPa293-unknown_cPa62-cPa75-hybrid_cPa62-unknown_cPa75,1_2_1_1_1_3_8_9,132,51
chr10-12760371_12760473,cPa62,1,1,12760458,12760413,cPa62,19,102,45
chr10-13920095_13920205,cPa62,0.96969696969697,2,13920156,13920132,cPa16-cPa71-hybrid_cPa62,1_32,110,24
chr10-14124951_14125053,cPa62,1,1,14125001,14124955,cPa62,3,102,46
chr10-15068608_15068710,cPa182,1,1,15068658,15068658,cPa182,1,102,0
chr10-15218706_15218808,VISNA_S55323,1,1,15218774,15218756,VISNA_S55323,6,102,18
chr10-15384456_15384558,cPa118,0.423076923076923,6,15384548,15384486,cPa118_cPa140-cPa15-hybrid_cPa15_cPa248-unknown_cPa443-cPa118-hybrid_cPa443-unknown,11_2_9_2_1_1,102,62
chr10-1538569_1538671,cPa363,0.333333333333333,5,1538668,1538572,cPa363_cPa363-cPa452-hybrid_cPa452_cPa587_cPa587-cPa452-hybrid,3_2_2_1_1,102,96
chr10-1539209_1539311,cPa363,1,1,1539305,1539259,cPa363,2,102,46
chr10-1539411_1539513,cPa363,1,1,1539461,1539410,cPa363,2,102,51
chr10-1583806_1584001,cPa75,1,1,1583949,1583856,cPa75,3,195,93
chr10-1584119_1584221,cPa75,1,1,1584169,1584169,cPa75,1,102,0
chr10-15988169_15988271,cPa285,1,1,15988219,15988219,cPa285,1,102,0
chr10-16085613_16085725,cPa425,0.285714285714286,10,16085675,16085655,cPa174_cPa254_cPa404-cPa174-hybrid_cPa425_cPa425-cPa174-hybrid_cPa47_cPa47-cPa174-hybrid_cPa47-cPa254-hybrid_cPa47-cPa425-hybrid_cPa47-unknown,1_5_1_6_1_2_1_1_1_2,112,20
chr10-16937749_16938052,cPa428,0.598290598290598,3,16938000,16937748,cPa356_cPa428_cPa428-cPa356-hybrid,45_70_2,303,252
chr10-16938173_16938275,cPa356_cPa428,0.5,2,16938223,16938199,cPa356_cPa428,2_2,102,24
chr10-16938311_16938472,cPa428,0.557894736842105,3,16938433,16938310,cPa356_cPa428_cPa428-cPa356-hybrid,39_53_3,161,123
chr10-16938499_16938616,cPa428,0.6,2,16938574,16938546,cPa356_cPa428,2_3,117,28
chr10-16962351_16962545,cPa308,0.454545454545455,7,16962493,16962401,cPa177_cPa308_cPa308-cPa177-hybrid_cPa339-cPa486-hybrid_cPa381-cPa486-hybrid_cPa486_cPa486-cPa177-hybrid,1_5_1_1_1_1_1,194,92
chr10-16993732_16993861,cPa363_cPa446,0.5,2,16993809,16993750,cPa363_cPa446,2_2,129,59
chr10-16993909_16994021,cPa363_cPa446,0.4,3,16994009,16993939,cPa327_cPa363_cPa446,2_4_4,112,70
chr10-17171983_17172120,cPa199,0.4375,4,17172100,17172010,cPa199_cPa273_cPa482_HTLV1_NC001436-cPa199-hybrid,7_2_5_2,137,90
chr10-17172154_17172306,cPa482,0.444444444444444,6,17172261,17172159,cPa199_cPa308-cPa199-hybrid_cPa482_cPa482-cPa199-hybrid_cPa482-unknown_HTLV1_NC001436-cPa199-hybrid,3_1_8_3_1_2,152,102
chr10-17198794_17198896,cPa402-unknown,1,1,17198844,17198844,cPa402-unknown,1,102,0
chr10-17198981_17199083,cPa75,1,1,17199031,17199031,cPa75,1,102,0
chr10-17209322_17209424,cPa75-unknown,1,1,17209372,17209372,cPa75-unknown,1,102,0
chr10-17209753_17209855,cPa75-unknown,1,1,17209803,17209803,cPa75-unknown,1,102,0
chr10-17225286_17225388,cPa62,1,1,17225336,17225336,cPa62,1,102,0
chr10-17225470_17225572,cPa62,1,1,17225525,17225510,cPa62,5,102,15
chr10-17316727_17316898,cPa75,0.75,3,17316846,17316777,cPa293_cPa293-cPa62-hybrid_cPa75,1_1_6,171,69
chr10-17392955_17393117,cPa450_cPa482-cPa450-hybrid,0.285714285714286,5,17393077,17393005,cPa199-BFV_NC001831-hybrid_cPa273-cPa553-hybrid_cPa450_cPa482-cPa450-hybrid_cPa482-unknown,1_1_2_2_1,162,72
chr10-17436938_17437271,cPa428,0.617283950617284,2,17437261,17436937,cPa356_cPa428,31_50,333,324
chr10-17437290_17437559,cPa428,0.603448275862069,2,17437533,17437289,cPa356_cPa428,23_35,269,244
chr10-17437611_17437783,cPa428,0.6,2,17437762,17437629,cPa356_cPa428,8_12,172,133
chr10-17437915_17438017,cPa428,0.583333333333333,2,17438011,17437915,cPa356_cPa428,10_14,102,96
chr10-17439235_17439363,cPa428,0.545454545454545,2,17439338,17439236,cPa356_cPa428,25_30,128,102
chr10-17439654_17439756,cPa428,0.583333333333333,2,17439756,17439653,cPa356_cPa428,15_21,102,103
chr10-17439809_17439984,cPa428,0.538461538461538,3,17439976,17439819,cPa356_cPa356-unknown_cPa428,34_2_42,175,157
chr10-17440529_17440790,cPa428,0.539568345323741,2,17440790,17440528,cPa356_cPa428,64_75,261,262
chr10-17441353_17441455,cPa428,0.558139534883721,2,17441451,17441382,cPa356_cPa428,19_24,102,69
chr10-17442630_17442812,cPa428,0.625,2,17442800,17442633,cPa356_cPa428,12_20,182,167
chr10-17443234_17443336,cPa428,0.565217391304348,2,17443336,17443236,cPa356_cPa428,30_39,102,100
chr10-17445048_17445150,cPa356_cPa428,0.5,2,17445098,17445098,cPa356_cPa428,1_1,102,0
chr10-17445665_17445767,cPa428,1,1,17445715,17445715,cPa428,1,102,0
chr10-17447366_17447492,cPa428,1,1,17447440,17447416,cPa428,2,126,24
chr10-17447912_17448014,cPa428,1,1,17447962,17447962,cPa428,1,102,0
chr10-17449213_17449335,cPa428,1,1,17449283,17449263,cPa428,3,122,20
chr10-17452439_17452541,cPa428,1,1,17452489,17452489,cPa428,1,102,0
chr10-17456454_17456556,cPa428,0.512820512820513,2,17456542,17456454,cPa356_cPa428,19_20,102,88
chr10-17456566_17456668,cPa428,0.666666666666667,2,17456633,17456584,cPa356_cPa428,1_2,102,49
chr10-17456769_17456871,cPa356,0.666666666666667,2,17456857,17456790,cPa356_cPa428,4_2,102,67
chr10-17457825_17457927,cPa428,0.666666666666667,2,17457926,17457875,cPa356_cPa428,2_4,102,51
chr10-17458248_17458350,cPa428,0.655172413793103,2,17458311,17458249,cPa356_cPa428,10_19,102,62
chr10-17458601_17458703,cPa428,0.583333333333333,2,17458696,17458650,cPa356_cPa428,5_7,102,46
chr10-17458964_17459066,cPa428,0.571428571428571,2,17459020,17458963,cPa356_cPa428,3_4,102,57
chr10-17459184_17459286,cPa428,0.62962962962963,2,17459270,17459191,cPa356_cPa428,20_34,102,79
chr10-17459299_17459401,cPa428,0.666666666666667,2,17459351,17459313,cPa356_cPa428,3_6,102,38
chr10-17459469_17459571,cPa428,0.714285714285714,2,17459565,17459468,cPa356_cPa428,2_5,102,97
chr10-17459738_17459840,cPa428,0.666666666666667,2,17459818,17459788,cPa356_cPa428,1_2,102,30
chr10-17459957_17460059,cPa428,0.6,2,17460055,17459978,cPa356_cPa428,4_6,102,77
chr10-17460533_17460635,cPa428,0.75,2,17460616,17460537,cPa356_cPa428,3_9,102,79
chr10-17460723_17460825,cPa356_cPa428,0.5,2,17460773,17460771,cPa356_cPa428,1_1,102,2
chr10-17461385_17461487,cPa428,0.75,2,17461435,17461397,cPa356_cPa428,1_3,102,38
chr10-17462009_17462111,cPa428,0.647058823529412,2,17462076,17462009,cPa356_cPa428,12_22,102,67
chr10-17462945_17463047,cPa428,0.5,3,17463034,17462995,cPa356_cPa419_cPa428,1_1_2,102,39
chr10-17463319_17463426,cPa428,0.761904761904762,2,17463375,17463320,cPa356_cPa428,5_16,107,55
chr10-17463481_17463583,cPa428,0.75,2,17463581,17463481,cPa356_cPa428,2_6,102,100
chr10-17463690_17463839,cPa356_cPa428,0.5,2,17463839,17463690,cPa356_cPa428,6_6,149,149
chr10-17463893_17464021,cPa428,0.75,2,17464006,17463905,cPa356_cPa428,4_12,128,101
chr10-17465143_17465367,cPa356,0.608695652173913,2,17465348,17465144,cPa356_cPa428,14_9,224,204
chr10-17467942_17468064,cPa356_cPa428,0.5,2,17468012,17467943,cPa356_cPa428,4_4,122,69
chr10-17468111_17468213,cPa428,0.689655172413793,2,17468161,17468128,cPa356_cPa428,9_20,102,33
chr10-17468500_17468602,cPa356,0.6,2,17468550,17468514,cPa356_cPa428,3_2,102,36
chr10-17468965_17469067,cPa428,0.549019607843137,2,17469063,17468981,cPa356_cPa428,23_28,102,82
chr10-17470161_17470279,cPa428,0.6,2,17470227,17470196,cPa356_cPa428,4_6,118,31
chr10-17470357_17470459,cPa428,1,1,17470407,17470366,cPa428,1,102,41
chr10-17470550_17470652,cPa428,0.75,2,17470600,17470553,cPa356_cPa428,1_3,102,47
chr10-17471456_17471620,cPa428,0.666666666666667,2,17471603,17471506,cPa356_cPa428,1_2,164,97
chr10-17473972_17474074,cPa356,0.555555555555556,2,17474041,17473980,cPa356_cPa428,5_4,102,61
chr10-17756836_17756938,cPa456,0.823529411764706,4,17756887,17756874,cPa117-cPa587-hybrid_cPa363_cPa452-cPa456-hybrid_cPa456,1_1_1_14,102,13
chr10-17757661_17757763,cPa356_cPa428,0.5,2,17757711,17757711,cPa356_cPa428,1_1,102,0
chr10-18523836_18523938,cPa62,1,1,18523886,18523886,cPa62,1,102,0
chr10-18614032_18614134,cPa456,1,1,18614082,18614082,cPa456,1,102,0
chr10-18823268_18823394,cPa71-cPa308-hybrid_cPa75-unknown,0.2,8,18823347,18823318,cPa176-cPa260-hybrid_cPa223-cPa308-hybrid_cPa308_cPa308-cPa260-hybrid_cPa452-cPa308-hybrid_cPa71-cPa308-hybrid_cPa71-unknown_cPa75-unknown,1_1_1_1_1_2_1_2,126,29
chr10-18887155_18887257,cPa199_cPa223_cPa345_cPa450_cPa542,0.2,5,18887205,18887205,cPa199_cPa223_cPa345_cPa450_cPa542,1_1_1_1_1,102,0
chr10-19512981_19513083,cPa363,0.75,2,19513065,19513013,cPa363_cPa363-cPa452-hybrid,3_1,102,52
chr10-19978053_19978155,cPa75,1,1,19978115,19978103,cPa75,4,102,12
chr10-20077603_20077727,cPa395,0.769230769230769,4,20077707,20077609,cPa130-cPa449-hybrid_cPa138_cPa395_cPa419,1_1_10_1,124,98
chr10-20173194_20173296,cPa363,0.5,3,20173250,20173229,cPa363_cPa456_cPa456-cPa363-hybrid,2_1_1,102,21
chr10-20233003_20233105,cPa15,0.5,3,20233061,20233008,cPa118_cPa15_cPa248-unknown,3_4_1,102,53
chr10-3519645_3519823,cPa75,0.777777777777778,2,3519789,3519695,cPa75_cPa75-unknown,7_2,178,94
chr10-3520236_3520338,cPa75,1,1,3520286,3520286,cPa75,1,102,0
chr10-3520344_3520459,cPa75_cPa75-cPa62-hybrid,0.5,2,3520407,3520394,cPa75_cPa75-cPa62-hybrid,1_1,115,13
chr10-3520567_3520717,cPa62_cPa75,0.4,3,3520678,3520617,cPa62_cPa75_cPa75-cPa62-hybrid,2_2_1,150,61
chr10-3520773_3520875,cPa75-cPa62-hybrid,1,1,3520823,3520823,cPa75-cPa62-hybrid,1,102,0
chr10-4527328_4527430,cPa62,1,1,4527378,4527378,cPa62,1,102,0
chr10-4528672_4528803,cPa62,1,1,4528767,4528722,cPa62,22,131,45
chr10-4529064_4529181,cPa62,0.666666666666667,2,4529129,4529114,cPa285_cPa62,1_2,117,15
chr10-4529537_4529639,cPa62,1,1,4529587,4529587,cPa62,1,102,0
chr10-4533102_4533281,cPa75,1,1,4533257,4533110,cPa75,17,179,147
chr10-4533729_4533881,cPa75,1,1,4533872,4533777,cPa75,9,152,95
chr10-4534448_4534554,cPa75,1,1,4534521,4534485,cPa75,6,106,36
chr10-4541844_4541962,cPa62,1,1,4541917,4541894,cPa62,6,118,23
chr10-4548345_4548447,cPa75,1,1,4548395,4548395,cPa75,1,102,0
chr10-4990337_4990439,cPa62,1,1,4990425,4990387,cPa62,10,102,38
chr10-5070976_5071078,cPa227-cPa539-hybrid_cPa62-cPa75-hybrid,0.5,2,5071026,5071020,cPa227-cPa539-hybrid_cPa62-cPa75-hybrid,1_1,102,6
chr10-520371_520479,cPa113,0.8,2,520427,520398,cPa113_cPa75,4_1,108,29
chr10-520524_520626,cPa113,1,1,520584,520574,cPa113,2,102,10
chr10-537667_537907,cPa199_cPa345_cPa450-cPa199-hybrid,0.181818181818182,11,537855,537667,cPa199_cPa223-cPa553-hybrid_cPa273-cPa199-hybrid_cPa345_cPa345-cPa199-hybrid_cPa450_cPa450-cPa199-hybrid_cPa450-cPa227-hybrid_cPa450-cPa345-hybrid_cPa482_cPa542,4_1_1_4_2_1_4_2_1_1_1,240,188
chr10-5487274_5487376,cPa71,0.223684210526316,19,5487373,5487277,cPa109_cPa16_cPa16-HERV-W_repbase_HERV17_LTR17-hybrid_cPa285_cPa379_cPa62_cPa62-cPa109-hybrid_cPa62-cPa16-hybrid_cPa62-cPa201-hybrid_cPa62-cPa71-hybrid_cPa62-cPa75-hybrid_cPa62-HERV-W_repbase_HERV17_LTR17-hybrid_cPa62-PERV_AJ293656-hybrid_cPa62-unknown_cPa71_cPa71-cPa109-hybrid_cPa71-cPa75-hybrid_cPa75_HERV-W_repbase_HERV17_LTR17,3_2_1_1_4_14_6_1_2_2_3_2_1_5_17_1_1_8_2,102,96
chr10-5654356_5654458,cPa62,0.5,4,5654452,5654358,cPa293_cPa62_cPa62-unknown_cPa75,1_4_2_1,102,94
chr10-5694307_5694581,cPa62,0.514285714285714,9,5694581,5694327,cPa293_cPa293-cPa62-hybrid_cPa62_cPa62-cPa293-hybrid_cPa62-cPa75-hybrid_cPa62-unknown_cPa75_cPa75-cPa419-hybrid_cPa75-unknown,2_1_36_3_3_14_9_1_1,274,254
chr10-6054232_6054334,cPa419,1,1,6054282,6054282,cPa419,1,102,0
chr10-696933_697035,cPa75,0.666666666666667,2,697002,696983,cPa75_cPa75-unknown,2_1,102,19
chr10-6999368_6999472,cPa285,0.857142857142857,2,6999449,6999418,cPa285_cPa293-cPa285-hybrid,6_1,104,31
chr10-7352002_7352115,cPa75,0.571428571428571,4,7352102,7352020,cPa75_cPa75-cPa62-hybrid_cPa75-unknown_HERV-W_repbase_HERV17_LTR17-unknown,4_1_1_1,113,82
chr10-7352163_7352400,cPa75,1,1,7352348,7352213,cPa75,5,237,135
chr10-7352405_7352507,cPa75,1,1,7352455,7352455,cPa75,1,102,0
chr10-7450158_7450260,cPa273_cPa345_cPa542_cPa553,0.25,4,7450208,7450208,cPa273_cPa345_cPa542_cPa553,1_1_1_1,102,0
chr10-7453517_7453619,cPa419,1,1,7453567,7453567,cPa419,1,102,0
chr10-7672836_7672954,cPa62,0.794117647058823,4,7672906,7672886,cPa285-cPa62-hybrid_cPa62_cPa62-cPa75-hybrid_cPa75,1_27_1_5,118,20
chr10-7678427_7678529,cPa75-cPa62-hybrid,1,1,7678477,7678477,cPa75-cPa62-hybrid,1,102,0
chr10-7678638_7678764,cPa75-cPa62-hybrid,0.666666666666667,2,7678712,7678688,cPa62_cPa75-cPa62-hybrid,1_2,126,24
chr10-7679423_7679525,cPa75,1,1,7679473,7679473,cPa75,1,102,0
chr10-7908294_7908396,cPa293_cPa391-cPa287-hybrid,0.5,2,7908344,7908344,cPa293_cPa391-cPa287-hybrid,1_1,102,0
chr10-824703_824805,cPa75,1,1,824753,824753,cPa75,1,102,0
chr10-825427_825529,cPa75,1,1,825477,825477,cPa75,1,102,0
chr10-8745510_8745612,cPa47,0.4,3,8745560,8745520,cPa254_cPa425_cPa47,3_3_4,102,40
chr10-8757076_8757187,cPa363,0.461538461538462,4,8757168,8757091,cPa363_cPa456_cPa456-cPa452-hybrid_cPa587-cPa452-hybrid,6_5_1_1,111,77
chr10-9078999_9079101,cPa62,1,1,9079049,9079047,cPa62,3,102,2
chr10-912366_912496,cPa285-cPa75-hybrid,0.5,6,912444,912398,cPa285_cPa285-cPa75-hybrid_cPa285-unknown_cPa62_cPa62-cPa75-hybrid_cPa75,1_10_1_6_1_1,130,46
chr10-912609_912822,cPa285-cPa75-hybrid_cPa62-cPa75-hybrid,0.333333333333333,5,912789,912652,cPa285_cPa285-cPa75-hybrid_cPa62_cPa62-cPa75-hybrid_cPa75,1_5_2_5_2,213,137
chr10-946442_946549,cPa62,0.5,4,946497,946479,cPa205-cPa285-hybrid_cPa260-cPa285-hybrid_cPa62_cPa62-unknown,1_1_3_1,107,18
chr10-946700_946802,cPa62,1,1,946750,946750,cPa62,1,102,0
chr11-10416739_10416841,cPa75,1,1,10416789,10416784,cPa75,2,102,5
chr11-10417612_10417714,cPa75,1,1,10417662,10417662,cPa75,1,102,0
chr11-10425906_10426021,cPa75,1,1,10425969,10425953,cPa75,9,115,16
chr11-10631828_10631930,cPa62,1,1,10631926,10631878,cPa62,3,102,48
chr11-10981592_10981694,cPa200_cPa463,0.5,2,10981690,10981642,cPa200_cPa463,1_1,102,48
chr11-10985443_10985545,cPa62,0.869565217391304,3,10985533,10985465,cPa254-unknown_cPa62_cPa62-unknown,2_20_1,102,68
chr11-11784091_11784193,cPa62,0.925925925925926,2,11784146,11784121,cPa62_S71_repbase_HERVS71_LTR6A-cPa62-hybrid,25_2,102,25
chr11-11948894_11948996,cPa419,1,1,11948944,11948944,cPa419,1,102,0
chr11-11992949_11993051,cPa583,0.60377358490566,6,11993034,11992990,cPa251_cPa358_cPa358-cPa251-hybrid_cPa358-unknown_cPa583_cPa75-cPa251-hybrid,1_30_6_4_64_1,102,44
chr11-12340528_12340630,cPa15,0.541666666666667,4,12340586,12340565,cPa118_cPa118-cPa248-hybrid_cPa118-cPa268-hybrid_cPa15,7_1_3_13,102,21
chr11-15009999_15010101,cPa459,0.416666666666667,6,15010065,15010048,cPa308_cPa327_cPa424_cPa424-cPa196-hybrid_cPa459_cPa459-cPa196-hybrid,1_1_1_2_5_2,102,17
chr11-15106118_15106220,cPa419,1,1,15106168,15106168,cPa419,1,102,0
chr11-1530980_1531140,cPa199,0.833333333333333,2,1531139,1530992,cPa199_cPa199-unknown,10_2,160,147
chr11-1531157_1531259,cPa199,0.9,2,1531256,1531160,cPa199_cPa199-unknown,9_1,102,96
chr11-15590699_15590801,cPa62,1,1,15590756,15590732,cPa62,5,102,24
chr11-15937186_15937288,cPa15,0.4,4,15937236,15937217,cPa118_cPa118-unknown_cPa15_cPa443,1_1_2_1,102,19
chr11-16030715_16030990,cPa425,0.333333333333333,6,16030938,16030716,cPa174_cPa254_cPa419_cPa425_cPa425-cPa174-hybrid_cPa47,7_4_1_12_1_11,275,222
chr11-16234474_16234585,cPa16-cPa363-hybrid_cPa400-cPa363-hybrid,0.32,7,16234538,16234481,cPa16_cPa16-cPa363-hybrid_cPa16-unknown_cPa182-cPa363-hybrid_cPa400-cPa363-hybrid_cPa419_cPa527-cPa363-hybrid,1_8_3_1_8_3_1,111,57
chr11-16401960_16402380,HERV-W_repbase_HERV17_LTR17,0.696969696969697,17,16402379,16401994,cPa327-HERV-W_repbase_HERV17_LTR17-hybrid_cPa62_cPa71-unknown_cPa75_cPa75-cPa223-hybrid_cPa75-cPa446-hybrid_cPa75-cPa452-hybrid_cPa75-cPa62-hybrid_cPa75-HERV-W_repbase_HERV17_LTR17-hybrid_cPa75-unknown_HERV-W_repbase_HERV17_LTR17_HERV-W_repbase_HERV17_LTR17-cPa223-hybrid_HERV-W_repbase_HERV17_LTR17-cPa363-hybrid_HERV-W_repbase_HERV17_LTR17-cPa379-hybrid_HERV-W_repbase_HERV17_LTR17-unknown_KoRV_AF151794_PERV_AJ293656-cPa379-hybrid,1_1_1_9_1_1_1_1_5_1_69_1_1_1_2_2_1,420,385
chr11-16467695_16467871,cPa345,0.25,18,16467864,16467732,cPa199_cPa199-cPa223-hybrid_cPa199-cPa273-hybrid_cPa199-cPa542-hybrid_cPa199-unknown_cPa223_cPa223-cPa345-hybrid_cPa227_cPa227-cPa199-hybrid_cPa227-unknown_cPa273_cPa345_cPa345-cPa62-hybrid_cPa450_cPa450-cPa223-hybrid_cPa553_cPa553-cPa62-hybrid_cPa553-unknown,9_1_1_1_1_7_1_10_1_1_10_20_1_3_1_10_1_1,176,132
chr11-16468418_16468615,cPa62,0.985714285714286,2,16468609,16468435,cPa62_cPa62-unknown,69_1,197,174
chr11-16514632_16514734,cPa62,1,1,16514682,16514682,cPa62,1,102,0
chr11-16514803_16514905,cPa62,1,1,16514853,16514843,cPa62,2,102,10
chr11-16609698_16609800,cPa62,0.933333333333333,2,16609764,16609710,cPa419_cPa62,1_14,102,54
chr11-16621857_16621959,cPa62,1,1,16621907,16621906,cPa62,2,102,1
chr11-16662435_16662537,HERV-W_repbase_HERV17_LTR17,0.909090909090909,2,16662507,16662440,HERV-F_repbase_HERVFH19I_LTR19A_HERV-W_repbase_HERV17_LTR17,1_10,102,67
chr11-16662709_16663351,HERV-W_repbase_HERV17_LTR17,0.948275862068966,4,16663347,16662730,cPa75_cPa75-HERV-W_repbase_HERV17_LTR17-hybrid_cPa75-KoRV_AF151794-hybrid_HERV-W_repbase_HERV17_LTR17,1_1_1_55,642,617
chr11-16674873_16674982,cPa450,0.358974358974359,11,16674948,16674893,cPa199-unknown_cPa227_cPa227-cPa223-hybrid_cPa227-unknown_cPa450_cPa450-unknown_cPa542-cPa223-hybrid_cPa542-unknown_cPa553_cPa553-cPa223-hybrid_cPa553-unknown,1_3_1_1_14_10_1_1_2_1_4,109,55
chr11-16682693_16682799,cPa585,0.5,4,16682754,16682736,cPa583-cPa190-hybrid_cPa583-unknown_cPa585_cPa585-cPa542-hybrid,1_1_3_1,106,18
chr11-16959619_16959721,cPa199,0.545454545454545,5,16959713,16959638,cPa109-unknown_cPa199_cPa199-cPa109-hybrid_cPa199-unknown_cPa482,1_6_1_2_1,102,75
chr11-17048557_17048704,cPa413,0.7,3,17048677,17048577,cPa413_cPa413-unknown_cPa526-unknown,28_4_8,147,100
chr11-17106899_17107001,cPa62,1,1,17106950,17106942,cPa62,8,102,8
chr11-17324027_17324223,cPa62,0.958333333333333,4,17324171,17324055,cPa285_cPa285-unknown_cPa62_cPa62-unknown,1_1_69_1,196,116
chr11-17481653_17481755,cPa2,1,1,17481703,17481703,cPa2,1,102,0
chr11-17551205_17551313,cPa456,0.454545454545455,6,17551267,17551254,cPa117-cPa452-hybrid_cPa363_cPa363-cPa456-hybrid_cPa452-cPa456-hybrid_cPa452-unknown_cPa456,1_2_1_1_1_5,108,13
chr11-17591363_17591465,cPa75,1,1,17591413,17591413,cPa75,1,102,0
chr11-17591488_17591724,HERV-W_repbase_HERV17_LTR17,0.682926829268293,3,17591722,17591530,cPa75_cPa75-cPa62-hybrid_HERV-W_repbase_HERV17_LTR17,36_3_84,236,192
chr11-17593755_17593857,cPa419,1,1,17593843,17593805,cPa419,2,102,38
chr11-17614171_17614273,HERV-W_repbase_HERV17_LTR17,1,1,17614221,17614221,HERV-W_repbase_HERV17_LTR17,1,102,0
chr11-17614324_17614426,cPa75-unknown_HERV-W_repbase_HERV17_LTR17-cPa75-hybrid,0.5,2,17614379,17614374,cPa75-unknown_HERV-W_repbase_HERV17_LTR17-cPa75-hybrid,1_1,102,5
chr11-17637222_17637364,cPa345_cPa553,0.5,2,17637312,17637272,cPa345_cPa553,1_1,142,40
chr11-17644889_17644991,cPa227-cPa308-hybrid,0.307692307692308,8,17644991,17644910,cPa15-FIV_NC001482-hybrid_cPa163_cPa199-cPa308-hybrid_cPa227-cPa308-hybrid_cPa363-cPa308-hybrid_cPa419_cPa61-cPa308-hybrid_HERV-W_repbase_HERV17_LTR17-cPa308-hybrid,1_1_2_4_1_2_1_1,102,81
chr11-17668766_17668868,cPa223,1,1,17668816,17668816,cPa223,1,102,0
chr11-17708592_17708694,cPa357-cPa553-hybrid,0.5,4,17708660,17708617,cPa353-cPa419-hybrid_cPa357-cPa199-hybrid_cPa357-cPa553-hybrid_cPa357-unknown,1_1_3_1,102,43
chr11-17720611_17720713,cPa308-cPa404-hybrid,1,1,17720661,17720661,cPa308-cPa404-hybrid,1,102,0
chr11-17721536_17721638,cPa308-cPa174-hybrid_cPa308-cPa254-hybrid_cPa450,0.333333333333333,3,17721586,17721535,cPa308-cPa174-hybrid_cPa308-cPa254-hybrid_cPa450,1_1_1,102,51
chr11-17722096_17722280,cPa254,0.266666666666667,10,17722239,17722134,cPa174_cPa254_cPa308-cPa174-hybrid_cPa308-cPa254-hybrid_cPa308-cPa425-hybrid_cPa308-cPa47-hybrid_cPa392-cPa425-hybrid_cPa404_cPa425_cPa47,1_8_1_2_2_5_1_6_2_2,184,105
chr11-17742128_17742230,cPa452,0.388888888888889,8,17742193,17742147,cPa260-cPa71-hybrid_cPa363_cPa363-cPa176-hybrid_cPa363-cPa452-hybrid_cPa452_cPa452-cPa363-hybrid_cPa452-cPa71-hybrid_cPa71,1_4_1_1_7_1_1_2,102,46
chr11-17770565_17770667,cPa56-unknown,0.357142857142857,8,17770615,17770567,cPa357-cPa106-hybrid_cPa357-cPa345-hybrid_cPa357-unknown_cPa56-cPa345-hybrid_cPa56-cPa482-hybrid_cPa56-cPa542-hybrid_cPa56-cPa553-hybrid_cPa56-unknown,1_1_2_2_1_1_1_5,102,48
chr11-17801826_17801997,cPa50-cPa333-hybrid,0.4,4,17801945,17801876,cPa118-cPa542-hybrid_cPa333_cPa50-cPa323-hybrid_cPa50-cPa333-hybrid,1_1_1_2,171,69
chr11-17809338_17809477,cPa223-cPa446-hybrid_cPa446,0.214285714285714,8,17809433,17809378,cPa183-cPa446-hybrid_cPa223-cPa379-hybrid_cPa223-cPa446-hybrid_cPa446_cPa452_cPa452-cPa183-hybrid_cPa452-cPa446-hybrid_cPa452-unknown,1_1_3_3_2_2_1_1,139,55
chr11-17836250_17836352,cPa379-cPa446-hybrid,0.3,7,17836349,17836300,cPa379_cPa379-cPa363-hybrid_cPa379-cPa446-hybrid_cPa379-cPa452-hybrid_cPa379-unknown_cPa446_cPa452,4_1_6_1_3_1_4,102,49
chr11-17839235_17839354,cPa15,0.727272727272727,4,17839326,17839279,cPa118_cPa15_cPa15-cPa118-hybrid_cPa268,2_16_1_3,119,47
chr11-17839397_17839499,cPa323,1,1,17839447,17839447,cPa323,1,102,0
chr11-17856493_17856595,cPa345,0.666666666666667,2,17856583,17856543,cPa345_cPa345-cPa62-hybrid,2_1,102,40
chr11-17857091_17857193,cPa345,1,1,17857166,17857099,cPa345,5,102,67
chr11-17858227_17858432,cPa345_cPa62,0.404255319148936,6,17858425,17858232,cPa199-cPa345-hybrid_cPa285_cPa345_cPa62_cPa62-cPa345-hybrid_cPa62-unknown,1_1_19_19_1_6,205,193
chr11-17858817_17858919,cPa199-unknown,0.75,3,17858889,17858816,cPa199-unknown_cPa345_cPa450-unknown,9_2_1,102,73
chr11-17939489_17939591,cPa482_cPa75,0.5,2,17939539,17939522,cPa482_cPa75,1_1,102,17
chr11-17939630_17939732,cPa482-cPa75-hybrid,1,1,17939680,17939676,cPa482-cPa75-hybrid,2,102,4
chr11-17981670_17981786,cPa540,0.4,6,17981741,17981716,cPa241_cPa515-cPa127-hybrid_cPa530_cPa530-cPa241-hybrid_cPa531-cPa127-hybrid_cPa540,2_1_1_1_1_4,116,25
chr11-18146491_18146593,cPa345,1,1,18146541,18146491,cPa345,2,102,50
chr11-18150535_18150637,cPa273_cPa360_cPa450,0.333333333333333,3,18150585,18150534,cPa273_cPa360_cPa450,1_1_1,102,51
chr11-18190425_18190569,cPa75,0.75,2,18190562,18190465,cPa75_cPa75-unknown,3_1,144,97
chr11-18190911_18191062,cPa75,0.666666666666667,2,18191010,18190946,cPa75_cPa75-cPa260-hybrid,2_1,151,64
chr11-18191244_18191451,cPa75,0.947368421052632,2,18191440,18191249,cPa543-unknown_cPa75,1_18,207,191
chr11-18254827_18254929,cPa260,1,1,18254925,18254844,cPa260,15,102,81
chr11-18359829_18359941,cPa118_cPa15,0.5,2,18359889,18359879,cPa118_cPa15,1_1,112,10
chr11-18539455_18539557,cPa75,1,1,18539505,18539505,cPa75,1,102,0
chr11-18652563_18652674,cPa67,1,1,18652622,18652613,cPa67,2,111,9
chr11-18652699_18652801,cPa67,1,1,18652797,18652701,cPa67,11,102,96
chr11-18700509_18700754,cPa117,0.769230769230769,2,18700744,18700559,cPa117_cPa452,10_3,245,185
chr11-18862031_18862133,cPa117,1,1,18862081,18862081,cPa117,1,102,0
chr11-18929385_18929487,cPa541,0.625,4,18929457,18929407,cPa14_cPa4-cPa14-hybrid_cPa4-cPa541-hybrid_cPa541,1_1_1_5,102,50
chr11-18942048_18942150,cPa117,0.9,2,18942148,18942094,cPa117_cPa452,27_3,102,54
chr11-18989633_18989735,cPa47,0.270833333333333,10,18989723,18989632,cPa174_cPa174-cPa404-hybrid_cPa174-cPa47-hybrid_cPa174-unknown_cPa254_cPa254-cPa404-hybrid_cPa254-cPa47-hybrid_cPa425_cPa425-cPa47-hybrid_cPa47,1_2_5_3_12_1_2_7_2_13,102,91
chr11-19042046_19042148,cPa402_cPa74-unknown,0.5,2,19042096,19042096,cPa402_cPa74-unknown,1_1,102,0
chr11-19202536_19202638,cPa62,1,1,19202586,19202580,cPa62,2,102,6
chr11-19205138_19205240,cPa363,1,1,19205188,19205188,cPa363,1,102,0
chr11-19418615_19418717,cPa419,1,1,19418671,19418665,cPa419,2,102,6
chr11-19420859_19420961,cPa419,1,1,19420909,19420909,cPa419,1,102,0
chr11-19425445_19425547,cPa419_cPa62,0.5,2,19425520,19425495,cPa419_cPa62,1_1,102,25
chr11-19559778_19559997,cPa62,1,1,19559965,19559800,cPa62,23,219,165
chr11-19637746_19637848,cPa572,1,1,19637796,19637796,cPa572,1,102,0
chr11-19940515_19940617,cPa75,1,1,19940565,19940565,cPa75,1,102,0
chr11-19941581_19941683,cPa62,0.478260869565217,4,19941631,19941603,cPa62_cPa62-cPa285-hybrid_cPa62-cPa75-hybrid_cPa75,11_1_6_5,102,28
chr11-20154200_20154312,cPa164,0.5,3,20154260,20154238,cPa164_cPa199-cPa164-hybrid_cPa199-cPa256-hybrid,2_1_1,112,22
chr11-20154498_20154600,cPa164,1,1,20154548,20154548,cPa164,1,102,0
chr11-20193550_20193652,cPa492,1,1,20193600,20193600,cPa492,1,102,0
chr11-20293770_20293872,cPa543,1,1,20293820,20293820,cPa543,1,102,0
chr11-20488172_20488274,HERV-W_repbase_HERV17_LTR17,0.75,2,20488230,20488219,HERV-F_repbase_HERVFH19I_LTR19A-cPa75-hybrid_HERV-W_repbase_HERV17_LTR17,1_3,102,11
chr11-20488523_20488637,HERV-W_repbase_HERV17_LTR17,1,1,20488621,20488573,HERV-W_repbase_HERV17_LTR17,3,114,48
chr11-20532510_20532612,HML4_repbase_HERVK13I_LTR13-unknown,1,1,20532560,20532560,HML4_repbase_HERVK13I_LTR13-unknown,1,102,0
chr11-20532787_20532953,HML4_repbase_HERVK13I_LTR13-unknown,1,1,20532905,20532837,HML4_repbase_HERVK13I_LTR13-unknown,4,166,68
chr11-20673776_20673878,cPa118,0.4375,5,20673868,20673799,cPa118_cPa118-cPa140-hybrid_cPa118-cPa268-hybrid_cPa15_cPa15-cPa443-hybrid,7_1_2_5_1,102,69
chr11-20813668_20813778,cPa287-cPa391-hybrid_cPa293,0.5,2,20813726,20813718,cPa287-cPa391-hybrid_cPa293,1_1,110,8
chr11-20853369_20853480,cPa228,0.75,3,20853428,20853370,cPa106_cPa228_cPa228-unknown,2_9_1,111,58
chr11-2307239_2307341,cPa62,1,1,2307289,2307289,cPa62,1,102,0
chr11-2307379_2307640,cPa62,1,1,2307588,2307429,cPa62,8,261,159
chr11-2308605_2308707,cPa62,1,1,2308655,2308655,cPa62,1,102,0
chr11-2338776_2338878,cPa452-cPa62-hybrid,1,1,2338826,2338826,cPa452-cPa62-hybrid,1,102,0
chr11-2374520_2374973,cPa345-cPa62-hybrid,0.631578947368421,4,2374921,2374570,cPa345-cPa62-hybrid_cPa62_cPa75_cPa75-cPa62-hybrid,12_5_1_1,453,351
chr11-2407414_2407516,cPa539,1,1,2407464,2407464,cPa539,1,102,0
chr11-2630750_2630852,cPa75,1,1,2630800,2630797,cPa75,2,102,3
chr11-2630859_2630961,cPa75,1,1,2630925,2630909,cPa75,4,102,16
chr11-2631133_2631235,cPa75,1,1,2631183,2631183,cPa75,1,102,0
chr11-2631597_2631699,cPa75,1,1,2631647,2631608,cPa75,2,102,39
chr11-2632078_2632238,cPa75,0.75,2,2632186,2632128,cPa260-cPa75-hybrid_cPa75,1_3,160,58
chr11-2632363_2632465,cPa260-cPa75-hybrid,0.75,2,2632413,2632401,cPa260-cPa75-hybrid_cPa260-unknown,3_1,102,12
chr11-2674530_2674690,cPa75,0.454545454545455,8,2674674,2674562,cPa113_cPa113-cPa75-hybrid_cPa260_cPa260-cPa113-hybrid_cPa260-cPa62-hybrid_cPa293-cPa62-hybrid_cPa75_cPa75-cPa62-hybrid,5_1_3_4_3_3_20_5,160,112
chr11-2674786_2674888,cPa75,0.666666666666667,5,2674856,2674819,cPa260-cPa113-hybrid_cPa260-cPa62-hybrid_cPa260-unknown_cPa75_cPa75-unknown,1_1_1_8_1,102,37
chr11-2800658_2800783,cPa62,1,1,2800769,2800684,cPa62,30,125,85
chr11-2800810_2800954,cPa62,0.777777777777778,4,2800949,2800818,cPa419_cPa62_cPa62-cPa285-hybrid_cPa62-unknown,1_14_1_2,144,131
chr11-2956588_2956849,cPa539,0.916666666666667,2,2956848,2956591,cPa539_cPa539-unknown,11_1,261,257
chr11-2962790_2962892,cPa260_WDSV_NC001867,0.333333333333333,5,2962853,2962832,cPa260_cPa260-unknown_EIAV_NC001450_EIAV_NC001450-WDSV_NC001867-hybrid_WDSV_NC001867,3_1_1_1_3,102,21
chr11-3381472_3381574,cPa539,1,1,3381522,3381522,cPa539,1,102,0
chr11-3460389_3460491,cPa62,0.666666666666667,2,3460477,3460439,cPa62_cPa62-unknown,2_1,102,38
chr11-3497324_3497462,cPa379,0.375,5,3497428,3497341,cPa16_cPa357-cPa183-hybrid_cPa379_cPa379-cPa71-hybrid_cPa379-unknown,2_1_3_1_1,138,87
chr11-3603757_3603923,cPa75_cPa75-unknown,0.5,2,3603871,3603807,cPa75_cPa75-unknown,2_2,166,64
chr11-3617110_3617212,cPa62,0.833333333333333,2,3617206,3617148,cPa62_cPa62-unknown,10_2,102,58
chr11-3624639_3624950,cPa285,0.222222222222222,11,3624928,3624689,cPa173_cPa285_cPa293_cPa293-cPa456-hybrid_cPa456_cPa62-cPa109-hybrid_cPa62-cPa173-hybrid_cPa62-cPa285-hybrid_cPa62-cPa456-hybrid_cPa62-unknown_WDSV_NC001867,4_6_1_1_2_3_1_1_3_4_1,311,239
chr11-3721864_3721966,cPa62,0.875,2,3721936,3721889,cPa539_cPa62,1_7,102,47
chr11-474560_474662,cPa75,0.388888888888889,8,474651,474563,cPa62_cPa62-unknown_cPa71-cPa62-hybrid_cPa75_cPa75-cPa62-hybrid_cPa75-unknown_HERV-W_repbase_HERV17_LTR17_HERV-W_repbase_HERV17_LTR17-cPa62-hybrid,1_1_2_7_2_1_3_1,102,88
chr11-5845531_5845644,cPa450,0.4,12,5845614,5845562,cPa227-cPa223-hybrid_cPa273-cPa199-hybrid_cPa273-cPa223-hybrid_cPa273-cPa482-hybrid_cPa450_cPa450-cPa345-hybrid_cPa542-cPa199-hybrid_cPa542-cPa345-hybrid_cPa542-cPa482-hybrid_cPa553_cPa553-cPa223-hybrid_cPa553-cPa345-hybrid,1_1_1_3_16_1_2_1_1_10_2_1,113,52
chr11-5986197_5986372,cPa553,0.388888888888889,15,5986346,5986214,cPa199_cPa223-cPa227-hybrid_cPa223-cPa273-hybrid_cPa223-cPa450-hybrid_cPa223-cPa542-hybrid_cPa223-cPa553-hybrid_cPa223-unknown_cPa227-cPa273-hybrid_cPa450_cPa482-unknown_cPa553_cPa553-cPa273-hybrid_cPa553-cPa450-hybrid_cPa553-cPa542-hybrid_cPa553-unknown,3_1_9_2_4_1_1_1_2_1_21_3_1_2_2,175,132
chr11-6126127_6126229,cPa62,1,1,6126177,6126177,cPa62,1,102,0
chr11-6215277_6215449,cPa62,1,1,6215397,6215327,cPa62,2,172,70
chr11-6357623_6357725,cPa75-unknown,1,1,6357698,6357639,cPa75-unknown,19,102,59
chr11-6576726_6576954,cPa75,0.388888888888889,5,6576902,6576776,cPa293_cPa293-unknown_cPa62_cPa75_cPa75-unknown,1_2_6_7_2,228,126
chr11-6576985_6577378,cPa62,0.542168674698795,9,6577376,6576988,cPa293_cPa293-cPa285-hybrid_cPa293-cPa62-hybrid_cPa293-cPa75-hybrid_cPa293-unknown_cPa62_cPa75_cPa75-cPa62-hybrid_cPa75-unknown,2_1_3_2_3_45_16_6_5,393,388
chr11-6831967_6832069,cPa469,1,1,6832017,6832017,cPa469,1,102,0
chr11-8434457_8434559,cPa62,0.941176470588235,2,8434545,8434476,cPa62_cPa62-cPa75-hybrid,16_1,102,69
chr11-8648098_8648212,cPa205-cPa542-hybrid_cPa363_cPa452-cPa542-hybrid_cPa456,0.25,4,8648160,8648148,cPa205-cPa542-hybrid_cPa363_cPa452-cPa542-hybrid_cPa456,1_1_1_1,114,12
chr11-8771036_8771138,cPa16_cPa363_cPa452_cPa71,0.25,4,8771086,8771071,cPa16_cPa363_cPa452_cPa71,1_1_1_1,102,15
chr11-8826247_8826349,cPa15,1,1,8826297,8826297,cPa15,1,102,0
chr11-9777701_9777803,cPa62,0.763157894736842,4,9777761,9777743,cPa285-cPa254-hybrid_cPa62_cPa62-cPa254-hybrid_cPa62-unknown,1_29_4_4,102,18
chr11-9921005_9921107,cPa113,0.538461538461538,7,9921101,9921044,cPa113_cPa113-cPa71-hybrid_cPa113-cPa75-hybrid_cPa71_cPa71-cPa75-hybrid_cPa75_PERVC_HM159246,14_1_6_1_1_2_1,102,57
chr12-10203433_10203535,cPa109_cPa199,0.5,2,10203483,10203481,cPa109_cPa199,2_2,102,2
chr12-10280108_10280210,WDSV_NC001867,0.857142857142857,2,10280168,10280112,WDSV_NC001867_WDSV_NC001867-cPa62-hybrid,6_1,102,56
chr12-10302384_10302522,cPa75,0.625,5,10302512,10302434,cPa113_cPa260-cPa62-hybrid_cPa293_cPa75_cPa75-cPa62-hybrid,1_2_3_15_3,138,78
chr12-10329823_10329925,cPa62-cPa75-hybrid,0.444444444444444,3,10329892,10329825,cPa62-cPa75-hybrid_cPa62-HERV-W_repbase_HERV17_LTR17-hybrid_cPa75,4_2_3,102,67
chr12-10330130_10330251,cPa62-cPa75-hybrid_cPa62-HERV-W_repbase_HERV17_LTR17-hybrid,0.363636363636364,4,10330227,10330171,cPa62-cPa75-hybrid_cPa62-HERV-W_repbase_HERV17_LTR17-hybrid_cPa75_HERV-W_repbase_HERV17_LTR17,8_8_2_4,121,56
chr12-10351095_10351200,cPa118_cPa15,0.333333333333333,4,10351181,10351145,cPa118_cPa15_cPa443-cPa125-hybrid_cPa443-cPa248-hybrid,2_2_1_1,105,36
chr12-10665500_10665602,cPa113-unknown_PERVC_HM159246-cPa62-hybrid,0.5,2,10665577,10665550,cPa113-unknown_PERVC_HM159246-cPa62-hybrid,1_1,102,27
chr12-10789575_10789677,cPa75-unknown,0.846153846153846,3,10789625,10789574,cPa75-cPa260-hybrid_cPa75-cPa308-hybrid_cPa75-unknown,1_1_11,102,51
chr12-1139281_1139390,cPa254,0.666666666666667,3,1139338,1139331,cPa254_cPa254-unknown_cPa395,8_2_2,109,7
chr12-1147900_1148020,cPa395,1,1,1147968,1147905,cPa395,5,120,63
chr12-11487264_11487372,cPa452,0.474074074074074,8,11487358,11487269,cPa16_cPa176_cPa363_cPa363-cPa16-hybrid_cPa363-cPa71-hybrid_cPa363-unknown_cPa452_cPa71,1_1_43_1_2_1_64_22,108,89
chr12-1154193_1154431,cPa107-unknown,1,1,1154420,1154242,cPa107-unknown,7,238,178
chr12-1157519_1157621,cPa413-cPa254-hybrid_cPa413-MSFV_NC010819-hybrid,0.5,2,1157569,1157569,cPa413-cPa254-hybrid_cPa413-MSFV_NC010819-hybrid,1_1,102,0
chr12-1157769_1157872,cPa413-MSFV_NC010819-hybrid,0.333333333333333,6,1157820,1157819,cPa413-cPa254-hybrid_cPa413-MSFV_NC010819-hybrid_cPa413-PRIMA41_repbase_PRIMA41_MER41A-hybrid_cPa419_cPa450-cPa254-hybrid_HML1a_repbase_HERV-K14CI_LTR14C-cPa254-hybrid,1_3_1_1_2_1,103,1
chr12-1160859_1160961,cPa587,0.538461538461538,6,1160952,1160861,cPa205-cPa75-hybrid_cPa357_cPa363_cPa452-unknown_cPa587_cPa587-unknown,1_2_1_1_7_1,102,91
chr12-1160980_1161480,cPa587,0.250720461095101,33,1161429,1161017,cPa308_cPa308-cPa413-hybrid_cPa308-cPa75-hybrid_cPa357_cPa357-cPa413-hybrid_cPa357-cPa587-hybrid_cPa357-cPa75-hybrid_cPa363_cPa363-cPa413-hybrid_cPa363-cPa456-hybrid_cPa363-cPa587-hybrid_cPa363-cPa75-hybrid_cPa363-unknown_cPa419_cPa425-cPa75-hybrid_cPa452_cPa452-cPa357-hybrid_cPa452-cPa363-hybrid_cPa452-cPa413-hybrid_cPa452-cPa587-hybrid_cPa452-cPa75-hybrid_cPa452-unknown_cPa456_cPa456-cPa413-hybrid_cPa456-cPa75-hybrid_cPa587_cPa587-cPa357-hybrid_cPa587-cPa413-hybrid_cPa587-cPa452-hybrid_cPa587-unknown_cPa75_HERV-W_repbase_HERV17_LTR17-cPa413-hybrid_HML7_repbase_HERVK11DI_MER11D-cPa587-hybrid,12_2_2_7_22_1_4_43_25_1_2_4_5_2_1_59_1_1_15_3_3_1_11_5_2_87_1_6_1_3_12_2_1,500,412
chr12-1162154_1162264,cPa357_cPa452-cPa413-hybrid,0.3125,7,1162253,1162180,cPa357_cPa363-cPa413-hybrid_cPa419_cPa425-cPa413-hybrid_cPa452_cPa452-cPa413-hybrid_cPa587-cPa413-hybrid,5_2_1_1_1_5_1,110,73
chr12-1162409_1162578,cPa413,0.781818181818182,6,1162531,1162411,cPa357_cPa363-cPa413-hybrid_cPa413_cPa452-cPa413-hybrid_cPa456-cPa413-hybrid_cPa587-cPa413-hybrid,2_4_43_3_1_2,169,120
chr12-1189775_1190235,cPa413,0.962655601659751,4,1190233,1189825,CAEV_NC001463-cPa75-hybrid_CAEV_NC001463-unknown_cPa413_cPa425-cPa75-hybrid,5_1_232_3,460,408
chr12-1190255_1190410,cPa413,1,1,1190406,1190271,cPa413,66,155,135
chr12-1216006_1216108,cPa61,0.5,3,1216096,1216044,cPa205-cPa357-hybrid_cPa339-cPa395-hybrid_cPa61,1_1_2,102,52
chr12-1218844_1218976,cPa395-cPa539-hybrid,1,1,1218924,1218894,cPa395-cPa539-hybrid,6,132,30
chr12-1219481_1219583,cPa395-cPa539-hybrid,1,1,1219531,1219531,cPa395-cPa539-hybrid,1,102,0
chr12-1220709_1220822,ALV_NC001408-cPa539-hybrid,1,1,1220770,1220759,ALV_NC001408-cPa539-hybrid,4,113,11
chr12-12318075_12318177,cPa62,1,1,12318143,12318125,cPa62,8,102,18
chr12-12407171_12407323,RELIK_ERVK,0.952380952380952,2,12407293,12407202,RELIK_ERVK_RELIK_ERVK-unknown,20_1,152,91
chr12-1278340_1278442,cPa539-unknown,1,1,1278390,1278390,cPa539-unknown,1,102,0
chr12-1283239_1283341,cPa413-MMTV_NC001503-hybrid_cPa545-cPa285-hybrid,0.5,2,1283289,1283262,cPa413-MMTV_NC001503-hybrid_cPa545-cPa285-hybrid,1_1,102,27
chr12-1283881_1283983,cPa545-cPa285-hybrid,1,1,1283931,1283931,cPa545-cPa285-hybrid,1,102,0
chr12-1284401_1284503,cPa413,0.625,5,1284463,1284421,cPa345_cPa345-cPa285-hybrid_cPa413_cPa413-cPa285-hybrid_cPa95-cPa345-hybrid,15_4_35_1_1,102,42
chr12-12914126_12914228,cPa62,0.964285714285714,2,12914177,12914162,cPa285-cPa419-hybrid_cPa62,1_27,102,15
chr12-13914754_13914856,cPa62,1,1,13914826,13914770,cPa62,18,102,56
chr12-14070087_14070189,HERV-XA34_repbase_HERVFH21I_LTR21A,1,1,14070188,14070137,HERV-XA34_repbase_HERVFH21I_LTR21A,2,102,51
chr12-14149694_14149804,cPa492,1,1,14149788,14149701,cPa492,12,110,87
chr12-1465349_1465489,cPa113,0.733333333333333,5,1465443,1465365,cPa113_cPa113-cPa75-hybrid_HERV-W_repbase_HERV17_LTR17_HERV-W_repbase_HERV17_LTR17-cPa75-hybrid_KWERV_GQ222416-unknown,11_1_1_1_1,140,78
chr12-14903793_14903972,cPa62,1,1,14903920,14903843,cPa62,5,179,77
chr12-14903998_14904193,cPa62,1,1,14904141,14904041,cPa62,5,195,100
chr12-14904205_14904656,cPa62,1,1,14904643,14904255,cPa62,24,451,388
chr12-1494239_1494354,cPa75-cPa260-hybrid,0.4,4,1494315,1494241,cPa308_cPa62-cPa260-hybrid_cPa75-cPa260-hybrid_HML5_repbase_HERVK22I_LTR22,1_1_2_1,115,74
chr12-1532343_1532445,S71_repbase_HERVS71_LTR6A,1,1,1532393,1532393,S71_repbase_HERVS71_LTR6A,1,102,0
chr12-15949724_15949826,cPa62,0.833333333333333,3,15949781,15949763,cPa62_cPa62-cPa254-hybrid_cPa62-unknown,20_3_1,102,18
chr12-1618256_1618369,cPa450,0.375,5,1618318,1618306,cPa199-cPa273-hybrid_cPa223-cPa273-hybrid_cPa450_cPa482-cPa273-hybrid_cPa553,1_1_3_1_2,113,12
chr12-1659319_1659573,cPa117,0.862068965517241,2,1659553,1659369,cPa117_cPa452,25_4,254,184
chr12-1659701_1659803,cPa117,0.818181818181818,2,1659780,1659725,cPa117_cPa452,9_2,102,55
chr12-1659814_1659916,cPa117,1,1,1659893,1659848,cPa117,3,102,45
chr12-16872060_16872162,cPa62,1,1,16872110,16872099,cPa62,3,102,11
chr12-17324_17426,cPa459,1,1,17374,17374,cPa459,1,102,0
chr12-1733029_1733403,cPa205,0.478260869565217,5,1733356,1733030,cPa205_cPa205-unknown_cPa61_cPa61-cPa205-hybrid_cPa61-unknown,22_2_15_1_6,374,326
chr12-17428_17609,cPa152-cPa413-hybrid_cPa327-cPa459-hybrid,0.5,2,17557,17478,cPa152-cPa413-hybrid_cPa327-cPa459-hybrid,1_1,181,79
chr12-17485313_17485415,cPa260_cPa75,0.4,3,17485394,17485362,cPa260_cPa260-cPa75-hybrid_cPa75,2_1_2,102,32
chr12-17638778_17638910,cPa71,0.91304347826087,3,17638859,17638818,cPa260-cPa75-hybrid_cPa71_SIV_NC001549-unknown,1_21_1,132,41
chr12-17638920_17639232,cPa71,0.82,5,17639215,17638948,cPa260_cPa71_cPa71-unknown_SIV_NC001549_SIV_NC001549-unknown,2_41_2_4_1,312,267
chr12-1767670_1767772,PtERV1_AC142352-unknown,1,1,1767720,1767719,PtERV1_AC142352-unknown,2,102,1
chr12-17691817_17691930,cPa15,0.4,4,17691878,17691831,cPa118_cPa15_cPa268-cPa419-hybrid_cPa268-unknown,1_2_1_1,113,47
chr12-17790632_17790734,cPa526-cPa216-hybrid,1,1,17790682,17790682,cPa526-cPa216-hybrid,1,102,0
chr12-17869048_17869150,cPa413_cPa56,0.4,3,17869127,17869098,cPa413_cPa482_cPa56,2_1_2,102,29
chr12-17942697_17942799,cPa199_cPa227_cPa273_cPa345_cPa419_cPa450_cPa482-unknown_cPa542,0.125,8,17942747,17942725,cPa199_cPa227_cPa273_cPa345_cPa419_cPa450_cPa482-unknown_cPa542,1_1_1_1_1_1_1_1,102,22
chr12-18072742_18072844,cPa539,1,1,18072806,18072792,cPa539,6,102,14
chr12-18260790_18260915,cPa62,0.941176470588235,3,18260876,18260806,cPa285_cPa62_cPa62-unknown,1_32_1,125,70
chr12-18424707_18424809,WDSV_NC001867,1,1,18424776,18424757,WDSV_NC001867,2,102,19
chr12-1849069_1849171,cPa75-cPa118-hybrid,1,1,1849119,1849119,cPa75-cPa118-hybrid,1,102,0
chr12-18697193_18697317,cPa75-unknown,0.538461538461538,3,18697291,18697229,cPa260_cPa62-unknown_cPa75-unknown,3_3_7,124,62
chr12-18763734_18763836,HFV_NC001736,0.666666666666667,2,18763831,18763784,cPa419_HFV_NC001736,1_2,102,47
chr12-187960_188062,cPa117-cPa363-hybrid,1,1,188010,188010,cPa117-cPa363-hybrid,1,102,0
chr12-188644_188854,cPa452,0.25,7,188802,188682,cPa363_cPa452_cPa452-cPa363-hybrid_cPa452-cPa456-hybrid_cPa452-cPa75-hybrid_cPa452-unknown_cPa587,2_3_1_1_1_2_2,210,120
chr12-18957723_18957825,cPa400,0.5,3,18957788,18957771,cPa254_cPa400_cPa75,1_2_1,102,17
chr12-18958325_18958427,cPa456,0.473684210526316,8,18958380,18958359,cPa117-cPa587-hybrid_cPa117-cPa75-hybrid_cPa117-unknown_cPa363_cPa452_cPa452-cPa363-hybrid_cPa452-cPa587-hybrid_cPa456,4_1_1_10_1_1_2_18,102,21
chr12-18960642_18960748,cPa199,0.625,4,18960707,18960657,CAEV_NC001463_cPa199_cPa450_cPa482,1_5_1_1,106,50
chr12-18964675_18964777,cPa75,1,1,18964736,18964725,cPa75,2,102,11
chr12-18964861_18965015,cPa75,0.714285714285714,2,18965013,18964883,cPa75_cPa75-cPa62-hybrid,5_2,154,130
chr12-18965480_18965593,cPa75_cPa75-cPa62-hybrid,0.5,2,18965541,18965530,cPa75_cPa75-cPa62-hybrid,1_1,113,11
chr12-18965713_18966030,cPa75,0.511111111111111,6,18966028,18965749,cPa260-cPa62-hybrid_cPa293-cPa62-hybrid_cPa313-cPa62-hybrid_cPa62_cPa75_cPa75-cPa62-hybrid,2_3_2_1_23_14,317,279
chr12-19223616_19223723,cPa62,1,1,19223681,19223664,cPa62,19,107,17
chr12-19290263_19290493,cPa199,0.826086956521739,4,19290441,19290282,cPa199_cPa199-cPa332-hybrid_cPa332_cPa332-unknown,19_1_2_1,230,159
chr12-19366799_19366901,cPa260,1,1,19366897,19366800,cPa260,18,102,97
chr12-19488546_19488722,cPa446,0.382352941176471,12,19488718,19488596,cPa174_cPa183_cPa223_cPa223-cPa174-hybrid_cPa223-cPa379-hybrid_cPa327_cPa327-cPa424-hybrid_cPa327-unknown_cPa424_cPa446_cPa582_cPa582-unknown,1_1_1_1_1_10_1_1_1_13_2_1,176,122
chr12-19648910_19649299,cPa62,0.746478873239437,6,19649257,19648920,cPa285_cPa285-cPa62-hybrid_cPa293-cPa62-hybrid_cPa62_cPa75_cPa75-cPa62-hybrid,1_3_8_53_5_1,389,337
chr12-19674460_19674562,cPa413,1,1,19674510,19674467,cPa413,2,102,43
chr12-19675885_19676143,cPa75,0.666666666666667,3,19676091,19675928,cPa75_cPa75-ALV_NC001408-hybrid_cPa75-unknown,4_1_1,258,163
chr12-19676159_19676261,cPa75-ALV_NC001408-hybrid,1,1,19676209,19676209,cPa75-ALV_NC001408-hybrid,1,102,0
chr12-19716947_19717049,cPa75,0.333333333333333,6,19717006,19716962,cPa293_cPa402_cPa413_cPa75_cPa75-unknown_KWERV_GQ222416,1_1_2_3_1_1,102,44
chr12-1984589_1984721,cPa199,0.318840579710145,16,1984700,1984598,cPa199_cPa199-cPa227-hybrid_cPa199-cPa345-hybrid_cPa199-cPa450-hybrid_cPa199-cPa553-hybrid_cPa199-unknown_cPa223_cPa223-cPa199-hybrid_cPa223-cPa227-hybrid_cPa223-cPa345-hybrid_cPa223-cPa450-hybrid_cPa223-cPa456-hybrid_cPa223-cPa553-hybrid_cPa227_cPa345_cPa450,22_2_2_4_1_1_1_1_1_3_3_1_4_1_6_16,132,102
chr12-19942305_19942445,cPa75,1,1,19942393,19942355,cPa75,2,140,38
chr12-19942855_19942998,cPa75,1,1,19942946,19942905,cPa75,6,143,41
chr12-19943252_19943453,cPa75,1,1,19943401,19943302,cPa75,8,201,99
chr12-19943626_19943736,cPa75,1,1,19943684,19943676,cPa75,2,110,8
chr12-19943737_19943862,cPa75,0.666666666666667,2,19943810,19943787,cPa308-cPa75-hybrid_cPa75,1_2,125,23
chr12-19943983_19944151,cPa75,1,1,19944099,19944033,cPa75,3,168,66
chr12-20055594_20055712,cPa413,1,1,20055660,20055644,cPa413,3,118,16
chr12-2015034_2015186,cPa62,0.5,3,2015134,2015084,cPa62_cPa62-unknown_cPa75,2_1_1,152,50
chr12-20169445_20169547,cPa75,1,1,20169495,20169495,cPa75,1,102,0
chr12-20178519_20178671,cPa75,0.459459459459459,6,20178629,20178518,cPa62_cPa75_cPa75-cPa62-hybrid_HERV-W_repbase_HERV17_LTR17_HERV-W_repbase_HERV17_LTR17-cPa62-hybrid_HERV-W_repbase_HERV17_LTR17-unknown,1_17_14_2_2_1,152,111
chr12-20187551_20187709,cPa75,1,1,20187657,20187601,cPa75,2,158,56
chr12-20230858_20230960,cPa62,1,1,20230908,20230908,cPa62,1,102,0
chr12-20649687_20649801,cPa193,0.333333333333333,5,20649777,20649737,cPa157_cPa157-cPa500-hybrid_cPa193_cPa229_cPa500,1_1_3_2_2,114,40
chr12-20702239_20702341,cPa62,0.92,2,20702299,20702264,cPa62_cPa62-unknown,46_4,102,35
chr12-20791733_20791835,cPa456,1,1,20791783,20791783,cPa456,1,102,0
chr12-2226578_2226778,MMTV_NC001503,1,1,2226726,2226628,MMTV_NC001503,3,200,98
chr12-2226792_2226894,MMTV_NC001503,0.75,2,2226853,2226842,cPa419_MMTV_NC001503,1_3,102,11
chr12-2259505_2259607,cPa75,0.666666666666667,4,2259592,2259514,cPa113-unknown_cPa62_cPa75_cPa75-unknown,1_1_6_1,102,78
chr12-2259891_2260064,cPa75,0.6875,5,2260021,2259940,cPa113_cPa293-cPa113-hybrid_cPa75_cPa75-cPa113-hybrid_PERVC_HM159246,1_1_11_2_1,173,81
chr12-2598261_2598363,cPa47-cPa174-hybrid,1,1,2598331,2598311,cPa47-cPa174-hybrid,2,102,20
chr12-2667635_2667737,cPa358-cPa539-hybrid,1,1,2667685,2667685,cPa358-cPa539-hybrid,1,102,0
chr12-2715606_2715708,cPa223-cPa339-hybrid_cPa227-cPa381-hybrid_cPa308_cPa345-cPa381-hybrid,0.25,4,2715657,2715655,cPa223-cPa339-hybrid_cPa227-cPa381-hybrid_cPa308_cPa345-cPa381-hybrid,1_1_1_1,102,2
chr12-2748350_2748452,cPa118,0.2,10,2748435,2748364,cPa118_cPa118-cPa248-hybrid_cPa118-cPa264-hybrid_cPa118-cPa443-hybrid_cPa118-unknown_cPa125_cPa125-cPa248-hybrid_cPa15-cPa248-hybrid_cPa264_cPa443,7_4_2_3_3_1_4_2_5_4,102,71
chr12-2754184_2754286,cPa450,1,1,2754271,2754234,cPa450,2,102,37
chr12-2799384_2799486,cPa75,0.8,3,2799446,2799394,cPa113_cPa113-cPa260-hybrid_cPa75,1_1_8,102,52
chr12-2799883_2800033,cPa75,0.785714285714286,3,2799991,2799933,cPa62_cPa62-cPa71-hybrid_cPa75,2_1_11,150,58
chr12-2800418_2800520,cPa75,0.727272727272727,3,2800476,2800421,cPa62_cPa62-cPa75-hybrid_cPa75,1_2_8,102,55
chr12-294016_294118,cPa62,1,1,294069,294053,cPa62,17,102,16
chr12-3022571_3022695,cPa56-cPa199-hybrid,0.681818181818182,2,3022690,3022621,cPa505-cPa199-hybrid_cPa56-cPa199-hybrid,7_15,124,69
chr12-3168068_3168170,cPa62-cPa446-hybrid,1,1,3168118,3168118,cPa62-cPa446-hybrid,1,102,0
chr12-3284543_3284665,cPa62,1,1,3284617,3284567,cPa62,4,122,50
chr12-3299816_3299918,cPa62-cPa75-hybrid,0.4,4,3299881,3299817,cPa62_cPa62-cPa75-hybrid_cPa62-unknown_cPa75,1_2_1_1,102,64
chr12-3342534_3342636,cPa456,0.5,4,3342635,3342536,cPa363_cPa456_cPa456-cPa452-hybrid_cPa587-cPa452-hybrid,4_6_1_1,102,99
chr12-3482822_3482924,cPa75,0.555555555555556,3,3482921,3482835,cPa75_cPa75-cPa138-hybrid_cPa75-unknown,5_1_3,102,86
chr12-3482927_3483029,cPa75,0.7,2,3482997,3482942,cPa138_cPa75,3_7,102,55
chr12-3603275_3603504,cPa308-unknown,0.636363636363636,7,3603463,3603308,cPa308_cPa308-cPa419-hybrid_cPa308-unknown_cPa419_cPa539_cPa539-cPa419-hybrid_cPa539-unknown,2_2_70_1_1_1_33,229,155
chr12-3605498_3605700,cPa14,0.471153846153846,8,3605650,3605503,cPa14_cPa14-cPa18-hybrid_cPa308-cPa18-hybrid_cPa4_cPa419_cPa541_cPa541-cPa18-hybrid_cPa545,49_2_1_28_1_21_1_1,202,147
chr12-3605775_3605901,cPa4,0.382978723404255,3,3605881,3605799,cPa14_cPa4_cPa541,13_18_16,126,82
chr12-3605952_3606054,cPa14,0.666666666666667,3,3606032,3605985,cPa14_cPa4_cPa541,4_1_1,102,47
chr12-3616293_3616395,cPa419,0.6,3,3616350,3616323,cPa419_cPa469-cPa61-hybrid_cPa469-unknown,3_1_1,102,27
chr12-4137343_4137525,cPa75-unknown,0.75,2,4137516,4137393,cPa75_cPa75-unknown,1_3,182,123
chr12-4137578_4137803,cPa75,1,1,4137784,4137628,cPa75,8,225,156
chr12-4225209_4225311,cPa75,1,1,4225259,4225259,cPa75,1,102,0
chr12-4225334_4225436,cPa75,1,1,4225384,4225384,cPa75,1,102,0
chr12-4645503_4645605,cPa293_cPa62-cPa75-hybrid_cPa62-unknown,0.25,5,4645569,4645553,cPa293_cPa62-cPa293-hybrid_cPa62-cPa75-hybrid_cPa62-unknown_cPa75,2_1_2_2_1,102,16
chr12-4699465_4699576,cPa363_cPa452_cPa456,0.333333333333333,3,4699524,4699485,cPa363_cPa452_cPa456,2_2_2,111,39
chr12-4786515_4786619,cPa456,0.625,4,4786575,4786524,cPa363_cPa363-cPa452-hybrid_cPa456_cPa587-cPa117-hybrid,2_3_10_1,104,51
chr12-4848340_4848442,cPa363,1,1,4848390,4848390,cPa363,1,102,0
chr12-5160991_5161093,cPa75,1,1,5161041,5161041,cPa75,1,102,0
chr12-5199168_5199270,cPa62,0.977272727272727,2,5199228,5199204,cPa293-cPa62-hybrid_cPa62,1_43,102,24
chr12-544793_544895,cPa527-cPa75-hybrid,1,1,544843,544843,cPa527-cPa75-hybrid,1,102,0
chr12-5583255_5583357,cPa75,1,1,5583305,5583305,cPa75,1,102,0
chr12-5656443_5656554,cPa456,0.4,4,5656502,5656487,cPa363_cPa363-cPa452-hybrid_cPa456_cPa587-cPa117-hybrid,1_1_2_1,111,15
chr12-5762_5864,cPa419,1,1,5812,5794,cPa419,2,102,18
chr12-6164981_6165090,cPa285-unknown,0.983050847457627,2,6165049,6165030,cPa285-unknown_cPa419,58_1,109,19
chr12-6506653_6506755,cPa62,1,1,6506703,6506688,cPa62,13,102,15
chr12-659697_659799,cPa434-cPa125-hybrid_cPa443,0.206896551724138,10,659793,659708,cPa228-cPa125-hybrid_cPa434_cPa434-cPa125-hybrid_cPa434-cPa264-hybrid_cPa434-cPa443-hybrid_cPa443_cPa500-cPa125-hybrid_cPa566_cPa566-cPa125-hybrid_cPa61-cPa410-hybrid,1_2_6_1_1_6_5_5_1_1,102,85
chr12-7317254_7317381,cPa541,0.424657534246575,14,7317334,7317266,cPa18_cPa18-cPa104-hybrid_cPa18-cPa14-hybrid_cPa18-cPa4-hybrid_cPa4_cPa529-cPa4-hybrid_cPa541_cPa541-cPa220-hybrid_cPa541-cPa4-hybrid_cPa545_cPa545-cPa104-hybrid_cPa545-cPa220-hybrid_cPa545-cPa4-hybrid_cPa545-unknown,1_3_2_2_22_1_31_1_3_1_1_1_3_1,127,68
chr12-744311_744413,cPa62,0.857142857142857,2,744387,744312,cPa62_cPa62-unknown,6_1,102,75
chr12-744572_744713,cPa62-unknown,1,1,744661,744588,cPa62-unknown,6,141,73
chr12-751473_751666,cPa434-unknown,0.436893203883495,17,751663,751474,cPa228_cPa228-HERV30_repbase_HERV30I_LTR30-hybrid_cPa419_cPa434-cPa125-hybrid_cPa434-cPa228-hybrid_cPa434-cPa419-hybrid_cPa434-cPa500-hybrid_cPa434-HERV30_repbase_HERV30I_LTR30-hybrid_cPa434-unknown_cPa443_cPa443-unknown_cPa500_cPa500-unknown_cPa566-cPa125-hybrid_cPa566-cPa228-hybrid_cPa566-HERV30_repbase_HERV30I_LTR30-hybrid_cPa566-unknown,1_1_5_1_1_2_1_1_45_1_3_8_2_1_1_2_27,193,189
chr12-751800_751902,cPa434-cPa419-hybrid,1,1,751850,751850,cPa434-cPa419-hybrid,1,102,0
chr12-752828_752930,cPa500,1,1,752878,752878,cPa500,1,102,0
chr12-7639901_7640003,cPa118_cPa15_cPa268,0.333333333333333,3,7639951,7639951,cPa118_cPa15_cPa268,1_1_1,102,0
chr12-831678_831817,cPa75,1,1,831765,831728,cPa75,2,139,37
chr12-8397404_8397506,cPa264-unknown_cPa521,0.5,2,8397454,8397454,cPa264-unknown_cPa521,1_1,102,0
chr13-11247305_11247407,cPa62,1,1,11247371,11247327,cPa62,3,102,44
chr13-11426338_11426440,cPa62,1,1,11426427,11426388,cPa62,11,102,39
chr13-11649643_11649750,HERV-W_repbase_HERV17_LTR17,0.9,2,11649703,11649691,cPa419_HERV-W_repbase_HERV17_LTR17,1_9,107,12
chr13-1180683_1180797,cPa118_cPa15,0.4,3,1180771,1180733,cPa118_cPa15_cPa419,2_2_1,114,38
chr13-12186899_12187001,cPa308,1,1,12186949,12186949,cPa308,1,102,0
chr13-12585669_12585780,cPa425_cPa47,0.285714285714286,5,12585728,12585702,cPa254_cPa404_cPa404-unknown_cPa425_cPa47,1_1_1_2_2,111,26
chr13-1259607_1259709,cPa75,1,1,1259657,1259657,cPa75,1,102,0
chr13-12597819_12597921,cPa363_cPa456,0.285714285714286,8,12597899,12597850,cPa117-cPa456-hybrid_cPa117-cPa587-hybrid_cPa205-cPa587-hybrid_cPa363_cPa363-unknown_cPa452-cPa456-hybrid_cPa452-cPa587-hybrid_cPa456,1_3_1_6_1_1_2_6,102,49
chr13-1260183_1260285,cPa75,1,1,1260233,1260233,cPa75,1,102,0
chr13-12892474_12892576,cPa456,0.375,4,12892529,12892514,cPa363_cPa452_cPa452-unknown_cPa456,2_2_1_3,102,15
chr13-13034560_13034668,cPa118,0.536585365853659,3,13034644,13034576,cPa118_cPa118-cPa15-hybrid_cPa15,22_2_17,108,68
chr13-13081292_13081394,cPa62,1,1,13081357,13081329,cPa62,57,102,28
chr13-13231306_13231408,cPa371,0.5,3,13231401,13231340,cPa323_cPa371_cPa371-cPa323-hybrid,3_4_1,102,61
chr13-13231560_13231662,cPa323,1,1,13231660,13231610,cPa323,4,102,50
chr13-13294159_13294261,cPa542,1,1,13294209,13294196,cPa542,3,102,13
chr13-1345297_1345399,cPa75_cPa75-unknown,0.5,2,1345362,1345303,cPa75_cPa75-unknown,3_3,102,59
chr13-14087577_14087679,cPa323_cPa371,0.5,2,14087630,14087627,cPa323_cPa371,1_1,102,3
chr13-14087698_14087800,cPa323,1,1,14087748,14087748,cPa323,1,102,0
chr13-14087987_14088211,cPa323,1,1,14088159,14088012,cPa323,5,224,147
chr13-14121369_14121473,cPa542,0.857142857142857,3,14121421,14121372,cPa227_cPa273_cPa542,1_1_12,104,49
chr13-1457801_1457903,cPa194,0.5,5,1457887,1457822,cPa194_cPa194-cPa360-hybrid_cPa360_cPa67_cPa67-unknown,5_1_2_1_1,102,65
chr13-1457959_1458163,cPa194,0.625,6,1458111,1457960,cPa194_cPa360_cPa360-cPa67-hybrid_cPa360-cPa75-hybrid_cPa67_cPa67-cPa194-hybrid,10_1_1_1_2_1,204,151
chr13-1458185_1458327,cPa194,0.666666666666667,4,1458275,1458232,cPa194_cPa360_cPa360-cPa67-hybrid_cPa67,6_1_1_1,142,43
chr13-1459094_1459196,cPa194-cPa75-hybrid_cPa360-cPa75-hybrid,0.4,3,1459189,1459144,cPa194-cPa75-hybrid_cPa360-cPa75-hybrid_cPa67-cPa75-hybrid,2_2_1,102,45
chr13-14736061_14736163,cPa199-unknown,1,1,14736111,14736111,cPa199-unknown,1,102,0
chr13-14736339_14736445,cPa199-cPa518-hybrid,0.419354838709677,7,14736393,14736366,cPa199-cPa518-hybrid_cPa199-WDSV_NC001867-hybrid_cPa273-cPa518-hybrid_cPa273-WDSV_NC001867-hybrid_cPa450-cPa518-hybrid_cPa482-cPa518-hybrid_cPa542-cPa518-hybrid,13_1_12_1_2_1_1,106,27
chr13-14736690_14736822,cPa199-cPa518-hybrid,0.6,2,14736770,14736740,cPa199-cPa518-hybrid_cPa273-cPa518-hybrid,6_4,132,30
chr13-14917046_14917148,cPa75,1,1,14917096,14917096,cPa75,1,102,0
chr13-14940761_14940863,cPa542,1,1,14940848,14940811,cPa542,3,102,37
chr13-14974208_14974564,cPa62-cPa75-hybrid,0.866666666666667,2,14974512,14974258,cPa62-cPa75-hybrid_HERVHcons-cPa75-hybrid,13_2,356,254
chr13-14974730_14974832,cPa62-cPa75-hybrid,1,1,14974780,14974780,cPa62-cPa75-hybrid,1,102,0
chr13-15033800_15033947,cPa62,0.6,3,15033895,15033812,cPa62_cPa75-cPa62-hybrid_cPa75-unknown,3_1_1,147,83
chr13-15120027_15120129,cPa117,0.666666666666667,2,15120083,15120077,cPa117_cPa452,2_1,102,6
chr13-15120246_15120348,cPa117,1,1,15120296,15120296,cPa117,1,102,0
chr13-15120426_15120622,cPa117_cPa452,0.5,2,15120570,15120476,cPa117_cPa452,1_1,196,94
chr13-15132350_15132582,cPa327,0.355140186915888,9,15132531,15132351,cPa183_cPa223_cPa223-cPa183-hybrid_cPa327_cPa424_cPa446_cPa446-cPa327-hybrid_cPa446-cPa424-hybrid_cPa446-unknown,1_1_1_38_24_36_2_3_1,232,180
chr13-15245006_15245138,cPa75-unknown,0.75,2,15245086,15245054,cPa75_cPa75-unknown,1_3,132,32
chr13-15255437_15255539,cPa260_SMRV_NC001514,0.5,2,15255516,15255487,cPa260_SMRV_NC001514,1_1,102,29
chr13-15444302_15444404,cPa62-unknown_cPa62-WDSV_NC001867-hybrid_WDSV_NC001867,0.333333333333333,3,15444352,15444320,cPa62-unknown_cPa62-WDSV_NC001867-hybrid_WDSV_NC001867,1_1_1,102,32
chr13-15727478_15727580,cPa356,0.5625,2,15727564,15727479,cPa356_cPa428,18_14,102,85
chr13-15727591_15727693,cPa428,0.526315789473684,2,15727693,15727601,cPa356_cPa428,9_10,102,92
chr13-15727711_15727911,cPa428,0.529411764705882,2,15727890,15727710,cPa356_cPa428,40_45,200,180
chr13-15729651_15729753,cPa428,0.578947368421053,2,15729751,15729660,cPa356_cPa428,8_11,102,91
chr13-15730570_15730672,cPa428,0.555555555555556,2,15730631,15730574,cPa356_cPa428,4_5,102,57
chr13-15730981_15731121,cPa428,0.642857142857143,2,15731120,15730999,cPa356_cPa428,5_9,140,121
chr13-15731263_15731365,cPa428,0.520833333333333,2,15731360,15731263,cPa356_cPa428,23_25,102,97
chr13-15732047_15732216,cPa356,0.574468085106383,2,15732214,15732046,cPa356_cPa428,27_20,169,168
chr13-15732400_15732769,cPa428,0.512820512820513,2,15732717,15732411,cPa356_cPa428,57_60,369,306
chr13-15732776_15733125,cPa356,0.52,2,15733093,15732805,cPa356_cPa428,52_48,349,288
chr13-15733886_15733988,cPa356_cPa428,0.5,2,15733936,15733936,cPa356_cPa428,1_1,102,0
chr13-15734224_15734326,cPa428,0.75,2,15734309,15734274,cPa356_cPa428,1_3,102,35
chr13-15734581_15734683,cPa356_cPa428,0.5,2,15734645,15734631,cPa356_cPa428,1_1,102,14
chr13-15735157_15735259,cPa356,1,1,15735207,15735207,cPa356,1,102,0
chr13-15736099_15736608,cPa356_cPa428,0.5,2,15736601,15736099,cPa356_cPa428,60_60,509,502
chr13-15736755_15736857,cPa356,0.6,3,15736849,15736760,cPa356_cPa356-unknown_cPa428,3_1_1,102,89
chr13-15736900_15737006,cPa356,0.512820512820513,2,15737006,15736904,cPa356_cPa428,20_19,106,102
chr13-15737451_15737553,cPa428,0.666666666666667,2,15737546,15737476,cPa356_cPa428,2_4,102,70
chr13-15737593_15737695,cPa356_cPa428,0.5,2,15737643,15737620,cPa356_cPa428,1_1,102,23
chr13-15738431_15738701,cPa356,0.58974358974359,2,15738698,15738433,cPa356_cPa428,23_16,270,265
chr13-15739142_15739244,cPa428,0.556818181818182,2,15739216,15739142,cPa356_cPa428,39_49,102,74
chr13-15739511_15739640,cPa356,0.525,2,15739616,15739517,cPa356_cPa428,21_19,129,99
chr13-15739673_15739837,cPa428,0.541666666666667,2,15739833,15739714,cPa356_cPa428,22_26,164,119
chr13-15739848_15739950,cPa428,0.625,2,15739929,15739851,cPa356_cPa428,3_5,102,78
chr13-15740131_15740312,cPa428,0.560606060606061,2,15740283,15740181,cPa356_cPa428,29_37,181,102
chr13-15741709_15741811,cPa356,0.551724137931034,2,15741808,15741713,cPa356_cPa428,16_13,102,95
chr13-15741869_15741971,cPa428,0.609756097560976,2,15741970,15741871,cPa356_cPa428,16_25,102,99
chr13-15743031_15743183,cPa428,0.496644295302013,3,15743183,15743037,cPa356_cPa356-unknown_cPa428,73_2_74,152,146
chr13-15743220_15743322,cPa428,0.636363636363636,2,15743281,15743233,cPa356_cPa428,4_7,102,48
chr13-15743404_15743593,cPa356,0.46031746031746,4,15743559,15743404,cPa356_cPa356-unknown_cPa428_cPa428-unknown,29_2_26_6,189,155
chr13-15743648_15743874,cPa356,0.580645161290323,2,15743835,15743682,cPa356_cPa428,18_13,226,153
chr13-15744105_15744207,cPa356_cPa428,0.5,2,15744162,15744135,cPa356_cPa428,11_11,102,27
chr13-15744267_15744420,cPa428,0.6,2,15744368,15744315,cPa356_cPa428,4_6,153,53
chr13-15764336_15764438,cPa308-cPa223-hybrid,0.814814814814815,5,15764411,15764350,cPa268-cPa223-hybrid_cPa308-cPa223-hybrid_cPa308-cPa62-hybrid_cPa381-cPa223-hybrid_cPa62,1_22_1_2_1,102,61
chr13-15769303_15769430,cPa42-cPa356-hybrid_cPa42-cPa428-hybrid,0.5,2,15769378,15769353,cPa42-cPa356-hybrid_cPa42-cPa428-hybrid,3_3,127,25
chr13-15771470_15771572,cPa356,0.666666666666667,2,15771524,15771520,cPa356_cPa428,2_1,102,4
chr13-15772102_15772204,cPa428,0.555555555555556,2,15772175,15772150,cPa356_cPa428,4_5,102,25
chr13-15772871_15772973,cPa428,1,1,15772921,15772921,cPa428,1,102,0
chr13-15777279_15777466,cPa356,0.538461538461538,2,15777421,15777329,cPa356_cPa428,7_6,187,92
chr13-15779126_15779431,cPa428,0.504385964912281,2,15779429,15779131,cPa356_cPa428,113_115,305,298
chr13-15779461_15779563,cPa428,0.51063829787234,2,15779562,15779460,cPa356_cPa428,23_24,102,102
chr13-15780014_15780121,cPa428,0.6,2,15780084,15780064,cPa356_cPa428,10_15,107,20
chr13-15780424_15780526,cPa428,0.55,2,15780520,15780428,cPa356_cPa428,9_11,102,92
chr13-15781203_15781305,cPa428,1,1,15781253,15781253,cPa428,1,102,0
chr13-15791937_15792039,cPa428,1,1,15791987,15791987,cPa428,1,102,0
chr13-15807798_15807900,cPa428,1,1,15807848,15807848,cPa428,1,102,0
chr13-15808364_15808466,cPa428,1,1,15808414,15808414,cPa428,1,102,0
chr13-15809007_15809109,cPa356_cPa428,0.5,2,15809057,15809057,cPa356_cPa428,1_1,102,0
chr13-15809647_15809757,cPa356_cPa428,0.5,2,15809730,15809697,cPa356_cPa428,3_3,110,33
chr13-15810000_15810102,cPa356,0.526315789473684,2,15810078,15809999,cPa356_cPa428,10_9,102,79
chr13-15810844_15810955,cPa356,0.521739130434783,2,15810953,15810846,cPa356_cPa428,12_11,111,107
chr13-15811779_15811939,cPa428,0.507936507936508,2,15811924,15811779,cPa356_cPa428,62_64,160,145
chr13-15812146_15812248,cPa428,0.636363636363636,2,15812224,15812148,cPa356_cPa428,4_7,102,76
chr13-15812371_15812473,cPa356,0.666666666666667,2,15812473,15812371,cPa356_cPa428,4_2,102,102
chr13-15813212_15813314,cPa428,0.571428571428571,2,15813265,15813223,cPa356_cPa428,3_4,102,42
chr13-15814082_15814184,cPa356,0.75,2,15814132,15814110,cPa356_cPa428,3_1,102,22
chr13-15814206_15814326,cPa356,0.538461538461538,2,15814274,15814210,cPa356_cPa428,28_24,120,64
chr13-15815860_15816020,cPa428,0.504424778761062,2,15815995,15815860,cPa356_cPa428,56_57,160,135
chr13-15816038_15816140,cPa356_cPa428,0.5,2,15816088,15816081,cPa356_cPa428,1_1,102,7
chr13-15816718_15816959,cPa356,0.528571428571429,2,15816945,15816740,cPa356_cPa428,37_33,241,205
chr13-15817381_15817610,cPa428,0.580645161290323,2,15817595,15817388,cPa356_cPa428,13_18,229,207
chr13-15817774_15817876,cPa356,0.536585365853659,2,15817872,15817782,cPa356_cPa428,22_19,102,90
chr13-15821877_15821979,cPa356,0.571428571428571,2,15821973,15821927,cPa356_cPa428,4_3,102,46
chr13-15822372_15822474,cPa356,1,1,15822474,15822374,cPa356,3,102,100
chr13-15822613_15822769,cPa428,0.625,2,15822762,15822613,cPa356_cPa428,9_15,156,149
chr13-15823109_15823211,cPa356,0.642857142857143,2,15823197,15823119,cPa356_cPa428,9_5,102,78
chr13-15823357_15823530,cPa428,0.574074074074074,2,15823490,15823356,cPa356_cPa428,23_31,173,134
chr13-15824045_15824177,cPa428,0.51063829787234,2,15824139,15824048,cPa356_cPa428,92_96,132,91
chr13-15826587_15826689,cPa356,0.666666666666667,2,15826637,15826617,cPa356_cPa428,2_1,102,20
chr13-15828726_15828857,cPa428,0.625,2,15828822,15828732,cPa356_cPa428,3_5,131,90
chr13-15828951_15829053,cPa428,0.75,2,15829031,15828954,cPa356_cPa428,2_6,102,77
chr13-15829216_15829318,cPa356,1,1,15829301,15829266,cPa356,2,102,35
chr13-15833908_15834086,cPa428,0.6875,2,15834043,15833929,cPa356_cPa428,5_11,178,114
chr13-15834118_15834220,cPa356,0.550724637681159,2,15834219,15834136,cPa356_cPa428,38_31,102,83
chr13-15834815_15834976,cPa356_cPa428,0.5,2,15834962,15834865,cPa356_cPa428,13_13,161,97
chr13-15835695_15836123,cPa428,0.509433962264151,2,15836096,15835694,cPa356_cPa428,52_54,428,402
chr13-15836561_15836680,cPa428,0.533333333333333,2,15836679,15836564,cPa356_cPa428,7_8,119,115
chr13-15838668_15838940,cPa428,0.527027027027027,2,15838938,15838670,cPa356_cPa428,35_39,272,268
chr13-15838941_15839058,cPa428,0.547619047619048,2,15839058,15838943,cPa356_cPa428,38_46,117,115
chr13-15839088_15839196,cPa356,0.521739130434783,2,15839190,15839092,cPa356_cPa428,12_11,108,98
chr13-15839611_15839715,cPa428,0.533333333333333,2,15839707,15839610,cPa356_cPa428,42_48,104,97
chr13-15840097_15840565,cPa428,0.55421686746988,2,15840534,15840147,cPa356_cPa428,37_46,468,387
chr13-15840812_15841080,cPa356_cPa428,0.5,2,15841076,15840837,cPa356_cPa428,7_7,268,239
chr13-15841467_15841654,cPa428,0.521739130434783,2,15841632,15841488,cPa356_cPa428,11_12,187,144
chr13-15842263_15842365,cPa428,0.576923076923077,2,15842364,15842313,cPa356_cPa428,11_15,102,51
chr13-15842472_15842677,cPa428,0.512820512820513,2,15842661,15842485,cPa356_cPa428,19_20,205,176
chr13-15842772_15842874,cPa428,0.6,2,15842845,15842797,cPa356_cPa428,2_3,102,48
chr13-15842881_15842983,cPa428,0.666666666666667,2,15842978,15842931,cPa356_cPa428,1_2,102,47
chr13-15843138_15843262,cPa428,0.578947368421053,2,15843262,15843154,cPa356_cPa428,24_33,124,108
chr13-15843386_15843488,cPa356,0.777777777777778,2,15843469,15843388,cPa356_cPa428,7_2,102,81
chr13-15843758_15844078,cPa428,0.529411764705882,2,15844075,15843786,cPa356_cPa428,24_27,320,289
chr13-15848661_15848763,cPa356,0.538461538461538,2,15848741,15848711,cPa356_cPa428,7_6,102,30
chr13-15848900_15849077,cPa428,0.5,3,15849026,15848919,cPa356_cPa356-cPa428-hybrid_cPa428,9_1_10,177,107
chr13-15849182_15849335,cPa356,0.518518518518518,2,15849283,15849182,cPa356_cPa428,14_13,153,101
chr13-15849678_15849780,cPa428,0.555555555555556,2,15849768,15849691,cPa356_cPa428,4_5,102,77
chr13-15849983_15850155,cPa356_cPa428,0.5,2,15850151,15849990,cPa356_cPa428,11_11,172,161
chr13-15850744_15850870,cPa356_cPa428,0.5,2,15850818,15850767,cPa356_cPa428,22_22,126,51
chr13-15850943_15851168,cPa356,0.537735849056604,3,15851155,15850966,cPa356_cPa356-unknown_cPa428,57_1_48,225,189
chr13-15854047_15854149,cPa356,0.52,2,15854141,15854054,cPa356_cPa428,13_12,102,87
chr13-15856651_15856753,cPa428,0.714285714285714,2,15856753,15856650,cPa356_cPa428,2_5,102,103
chr13-15857420_15857522,cPa356,1,1,15857470,15857470,cPa356,1,102,0
chr13-15857956_15858058,cPa356,1,1,15858006,15858006,cPa356,1,102,0
chr13-15858302_15858404,cPa356_cPa428,0.5,2,15858357,15858352,cPa356_cPa428,1_1,102,5
chr13-15858672_15858774,cPa356_cPa428,0.5,2,15858740,15858722,cPa356_cPa428,1_1,102,18
chr13-15859170_15859272,cPa428,0.666666666666667,2,15859220,15859209,cPa356_cPa428,1_2,102,11
chr13-15860310_15860412,cPa428,1,1,15860360,15860360,cPa428,1,102,0
chr13-15862050_15862152,cPa356,1,1,15862100,15862100,cPa356,1,102,0
chr13-15862519_15862687,cPa428,0.526315789473684,2,15862677,15862534,cPa356_cPa428,45_50,168,143
chr13-15863551_15863821,cPa428,0.51685393258427,2,15863820,15863597,cPa356_cPa428,43_46,270,223
chr13-15863888_15863990,cPa356,0.526315789473684,2,15863990,15863892,cPa356_cPa428,20_18,102,98
chr13-15864465_15864567,cPa356,0.6,2,15864564,15864464,cPa356_cPa428,6_4,102,100
chr13-15864704_15864806,cPa428,0.6,2,15864803,15864717,cPa356_cPa428,2_3,102,86
chr13-15865020_15865308,cPa356,0.503496503496504,2,15865300,15865023,cPa356_cPa428,72_71,288,277
chr13-15867755_15867857,cPa456-cPa428-hybrid,1,1,15867805,15867805,cPa456-cPa428-hybrid,1,102,0
chr13-15868110_15868223,cPa428,0.666666666666667,2,15868171,15868160,cPa356_cPa428,1_2,113,11
chr13-15934265_15934509,cPa71-unknown,0.6875,2,15934457,15934315,cPa71-cPa223-hybrid_cPa71-unknown,5_11,244,142
chr13-15942197_15942307,cPa308-unknown,0.615384615384615,4,15942270,15942217,cPa268-cPa223-hybrid_cPa308-cPa223-hybrid_cPa308-unknown_cPa381-unknown,1_3_8_1,110,53
chr13-16107502_16107684,HIV2_NC001722-unknown,0.875,2,16107663,16107551,cPa419_HIV2_NC001722-unknown,1_7,182,112
chr13-16110471_16110575,cPa419,0.666666666666667,2,16110527,16110480,cPa380-unknown_cPa419,2_4,104,47
chr13-16110586_16110746,cPa380-unknown,1,1,16110694,16110636,cPa380-unknown,3,160,58
chr13-16133804_16133906,cPa293-unknown,1,1,16133854,16133854,cPa293-unknown,1,102,0
chr13-16133924_16134119,cPa285-unknown,0.6,2,16134070,16133974,cPa285_cPa285-unknown,2_3,195,96
chr13-16228703_16228805,cPa75,0.75,3,16228803,16228703,cPa75_cPa75-cPa62-hybrid_HERV-W_repbase_HERV17_LTR17-unknown,6_1_1,102,100
chr13-16228955_16229136,cPa75,0.617647058823529,7,16229115,16229001,cPa293-cPa62-hybrid_cPa75_cPa75-cPa62-hybrid_cPa75-unknown_HERV-F_repbase_HERVFH19I_LTR19A-cPa62-hybrid_HERV-W_repbase_HERV17_LTR17_HERV-W_repbase_HERV17_LTR17-cPa62-hybrid,1_21_6_1_1_1_3,181,114
chr13-16232992_16233094,cPa199_cPa363-cPa199-hybrid_cPa482,0.333333333333333,3,16233042,16233028,cPa199_cPa363-cPa199-hybrid_cPa482,1_1_1,102,14
chr13-16238251_16238353,cPa62,1,1,16238303,16238270,cPa62,7,102,33
chr13-16312230_16312341,HFV_NC001736,0.571428571428571,3,16312297,16312271,cPa539_HFV_NC001736_HFV_NC001736-cPa75-hybrid,2_4_1,111,26
chr13-1633094_1633196,cPa75-unknown,1,1,1633144,1633144,cPa75-unknown,1,102,0
chr13-16344129_16344288,cPa75,1,1,16344247,16344179,cPa75,4,159,68
chr13-16344294_16344451,cPa75,0.666666666666667,3,16344399,16344344,cPa75_cPa75-HFV_NC001736-hybrid_cPa75-unknown,6_1_2,157,55
chr13-16353623_16353725,cPa67,0.416666666666667,5,16353722,16353648,cPa194_cPa194-cPa273-hybrid_cPa194-cPa345-hybrid_cPa345_cPa67,1_1_1_4_5,102,74
chr13-16357578_16357715,cPa199-cPa75-hybrid_cPa227-cPa75-hybrid_cPa75,0.333333333333333,3,16357663,16357601,cPa199-cPa75-hybrid_cPa227-cPa75-hybrid_cPa75,1_1_1,137,62
chr13-16537537_16537715,cPa260-cPa75-hybrid,1,1,16537663,16537587,cPa260-cPa75-hybrid,6,178,76
chr13-16540238_16540340,cPa75,1,1,16540294,16540288,cPa75,2,102,6
chr13-16640021_16640123,cPa75,1,1,16640071,16640071,cPa75,1,102,0
chr13-16652864_16652966,cPa339,1,1,16652931,16652893,cPa339,20,102,38
chr13-16712535_16712637,cPa260-cPa75-hybrid,1,1,16712585,16712585,cPa260-cPa75-hybrid,1,102,0
chr13-16781713_16781815,cPa583,1,1,16781763,16781763,cPa583,1,102,0
chr13-16781927_16782029,cPa583,1,1,16781977,16781977,cPa583,1,102,0
chr13-16818953_16819055,cPa260,0.653846153846154,5,16819054,16818955,cPa15_cPa228_cPa228-unknown_cPa260_cPa260-cPa118-hybrid,1_4_3_17_1,102,99
chr13-16819128_16819230,cPa260,1,1,16819178,16819129,cPa260,2,102,49
chr13-16957777_16957879,cPa75,1,1,16957827,16957827,cPa75,1,102,0
chr13-1720808_1720913,S71_repbase_HERVS71_LTR6A,0.5,4,1720882,1720858,cPa125_cPa293_cPa62_S71_repbase_HERVS71_LTR6A,1_1_1_3,105,24
chr13-1723050_1723152,cPa539,0.952380952380952,2,1723147,1723057,cPa539_cPa539-cPa75-hybrid,20_1,102,90
chr13-1723601_1723703,cPa539-cPa75-hybrid,1,1,1723651,1723651,cPa539-cPa75-hybrid,1,102,0
chr13-1726304_1726452,cPa75,0.666666666666667,2,1726409,1726354,cPa419_cPa75,1_2,148,55
chr13-17487803_17487907,cPa434_cPa434-cPa75-hybrid,0.5,2,17487855,17487853,cPa434_cPa434-cPa75-hybrid,1_1,104,2
chr13-17661985_17662087,cPa75-unknown,1,1,17662035,17662035,cPa75-unknown,1,102,0
chr13-18033906_18034008,cPa15,1,1,18033956,18033956,cPa15,1,102,0
chr13-18098677_18098779,cPa339_cPa465-cPa339-hybrid,0.5,2,18098727,18098679,cPa339_cPa465-cPa339-hybrid,1_1,102,48
chr13-18100045_18100147,cPa176,1,1,18100109,18100083,cPa176,21,102,26
chr13-18106692_18106854,cPa254,0.4,4,18106828,18106742,cPa254_cPa404_cPa425_cPa47-cPa174-hybrid,2_1_1_1,162,86
chr13-18198421_18198523,cPa34-cPa363-hybrid,0.571428571428571,6,18198481,18198434,cPa188-cPa363-hybrid_cPa188-cPa456-hybrid_cPa34-cPa308-hybrid_cPa34-cPa363-hybrid_cPa34-cPa452-hybrid_cPa34-cPa75-hybrid,2_1_1_8_1_1,102,47
chr13-18227066_18227182,cPa308-HERV-W_repbase_HERV17_LTR17-hybrid_HERV-W_repbase_HERV17_LTR17_HTLV2_M10060-HERV-W_repbase_HERV17_LTR17-hybrid,0.333333333333333,3,18227140,18227116,cPa308-HERV-W_repbase_HERV17_LTR17-hybrid_HERV-W_repbase_HERV17_LTR17_HTLV2_M10060-HERV-W_repbase_HERV17_LTR17-hybrid,1_1_1,116,24
chr13-18231582_18231684,cPa419,1,1,18231632,18231632,cPa419,1,102,0
chr13-18294917_18295019,cPa61,1,1,18294972,18294936,cPa61,6,102,36
chr13-18311037_18311139,cPa61,1,1,18311115,18311087,cPa61,9,102,28
chr13-18312383_18312580,cPa229_cPa419_FrMuLV_NC001362,0.2,7,18312536,18312408,cPa223-cPa67-hybrid_cPa229_cPa419_FrMuLV_NC001362_FrMuLV_NC001362-cPa56-hybrid_FrMuLV_NC001362-cPa61-hybrid_FrMuLV_NC001362-unknown,1_2_2_2_1_1_1,197,128
chr13-18312583_18312685,FrMuLV_NC001362,1,1,18312633,18312633,FrMuLV_NC001362,1,102,0
chr13-18312780_18312882,cPa62,0.666666666666667,2,18312852,18312820,cPa62_MMTV_NC001503-cPa62-hybrid,2_1,102,32
chr13-18312885_18312987,cPa62,0.428571428571429,5,18312986,18312935,cPa229-cPa391-hybrid_cPa229-cPa62-hybrid_cPa419_cPa62_FrMuLV_NC001362-cPa254-hybrid,1_1_1_3_1,102,51
chr13-18327581_18327683,cPa419,1,1,18327646,18327631,cPa419,2,102,15
chr13-18327925_18328027,cPa419,1,1,18327987,18327975,cPa419,2,102,12
chr13-18338709_18338889,cPa62-cPa363-hybrid_cPa62-cPa75-hybrid_cPa75,0.235294117647059,7,18338862,18338718,cPa16-cPa75-hybrid_cPa452-cPa75-hybrid_cPa62_cPa62-cPa363-hybrid_cPa62-cPa75-hybrid_cPa62-unknown_cPa75,1_1_1_4_4_2_4,180,144
chr13-1886498_1886600,cPa260,1,1,1886597,1886548,cPa260,2,102,49
chr13-1886716_1886818,cPa260,1,1,1886766,1886766,cPa260,1,102,0
chr13-1945389_1945491,cPa285-unknown_cPa62-cPa285-hybrid_cPa62-unknown,0.333333333333333,3,1945471,1945439,cPa285-unknown_cPa62-cPa285-hybrid_cPa62-unknown,1_1_1,102,32
chr13-1995503_1995605,cPa75,1,1,1995553,1995553,cPa75,1,102,0
chr13-2159986_2160088,cPa62_cPa75,0.5,2,2160053,2160036,cPa62_cPa75,1_1,102,17
chr13-2572763_2572865,cPa419,1,1,2572813,2572813,cPa419,1,102,0
chr13-2579622_2579724,cPa16_cPa260_WDSV_NC001867,0.25,5,2579709,2579672,cPa16_cPa260_HERVHcons-cPa16-hybrid_HERVHcons-cPa379-hybrid_WDSV_NC001867,2_2_1_1_2,102,37
chr13-2642874_2642976,cPa543-cPa75-hybrid,1,1,2642924,2642924,cPa543-cPa75-hybrid,1,102,0
chr13-2643080_2643182,cPa482-cPa75-hybrid,1,1,2643130,2643130,cPa482-cPa75-hybrid,1,102,0
chr13-2715471_2715573,cPa62,0.75,2,2715568,2715480,cPa285_cPa62,1_3,102,88
chr13-2715575_2715798,cPa62,0.666666666666667,4,2715746,2715602,cPa285-cPa62-hybrid_cPa285-unknown_cPa293-cPa62-hybrid_cPa62,1_1_1_6,223,144
chr13-2754234_2754466,cPa62,0.9375,2,2754419,2754272,cPa285_cPa62,1_15,232,147
chr13-2837208_2837310,cPa75,1,1,2837300,2837258,cPa75,3,102,42
chr13-2837322_2837480,cPa75,0.785714285714286,3,2837444,2837322,cPa75_cPa75-cPa62-hybrid_cPa75-unknown,11_1_2,158,122
chr13-2837525_2837974,cPa75,0.884615384615385,2,2837949,2837575,cPa75_cPa75-unknown,23_3,449,374
chr13-2837977_2838079,cPa75,1,1,2838027,2838027,cPa75,1,102,0
chr13-3089933_3090048,cPa553,0.725,5,3089996,3089978,cPa273_cPa482_cPa482-cPa553-hybrid_cPa553_cPa553-cPa273-hybrid,7_1_2_29_1,115,18
chr13-335887_335989,cPa419,1,1,335937,335937,cPa419,1,102,0
chr13-5080379_5080481,cPa75-unknown,1,1,5080429,5080429,cPa75-unknown,1,102,0
chr13-521857_521959,cPa158,1,1,521907,521907,cPa158,1,102,0
chr13-5493720_5493822,cPa450,0.4,4,5493806,5493770,cPa199_cPa450_cPa482-cPa273-hybrid_cPa553,1_2_1_1,102,36
chr13-5937709_5937811,cPa62,1,1,5937764,5937759,cPa62,2,102,5
chr13-6007021_6007217,cPa293,0.388888888888889,5,6007172,6007027,cPa285_cPa293_cPa293-cPa285-hybrid_cPa293-unknown_cPa62,5_7_1_2_3,196,145
chr13-601641_601743,cPa117,1,1,601735,601691,cPa117,4,102,44
chr13-6070000_6070102,cPa62,0.925925925925926,3,6070050,6070034,cPa254_cPa62_cPa62-unknown,1_25_1,102,16
chr13-6219736_6219849,cPa62-cPa75-hybrid,1,1,6219797,6219786,cPa62-cPa75-hybrid,2,113,11
chr13-6303149_6303251,cPa492,1,1,6303232,6303155,cPa492,10,102,77
chr13-6303264_6303418,cPa492,1,1,6303417,6303263,cPa492,12,154,154
chr13-6344082_6344193,cPa254_cPa425_cPa47,0.285714285714286,4,6344144,6344132,cPa174-cPa404-hybrid_cPa254_cPa425_cPa47,1_2_2_2,111,12
chr13-650944_651073,cPa118,1,1,651021,650994,cPa118,3,129,27
chr13-678281_678780,cPa434,1,1,678759,678310,cPa434,82,499,449
chr13-6802182_6802284,cPa75,1,1,6802232,6802232,cPa75,7,102,0
chr13-691968_692118,cPa194,0.529411764705882,2,692117,692006,cPa194_cPa67,9_8,150,111
chr13-692373_692591,cPa194_cPa67,0.444444444444444,3,692539,692412,cPa194_cPa194-cPa67-hybrid_cPa67,4_1_4,218,127
chr13-692621_693035,cPa67,0.62962962962963,4,692987,692653,cPa194_cPa345_cPa345-cPa67-hybrid_cPa67,3_6_1_17,414,334
chr13-693121_693241,cPa345,0.636363636363636,2,693199,693130,cPa345_cPa67,7_4,120,69
chr13-700704_700806,cPa75,0.666666666666667,2,700757,700746,cPa241-unknown_cPa75,1_2,102,11
chr13-707712_707814,cPa75-cPa308-hybrid,1,1,707762,707762,cPa75-cPa308-hybrid,1,102,0
chr13-716448_716550,cPa75,1,1,716508,716498,cPa75,3,102,10
chr13-745604_745910,HTLV2_M10060-cPa75-hybrid,0.8,3,745858,745654,cPa260-cPa75-hybrid_cPa62-cPa75-hybrid_HTLV2_M10060-cPa75-hybrid,2_1_12,306,204
chr13-7565995_7566097,cPa363_cPa452_cPa71,0.333333333333333,3,7566045,7566042,cPa363_cPa452_cPa71,1_1_1,102,3
chr13-8019188_8019290,cPa62,1,1,8019238,8019238,cPa62,1,102,0
chr13-8024339_8024441,cPa62,1,1,8024410,8024385,cPa62,5,102,25
chr13-8451413_8451531,cPa323,0.8125,3,8451520,8451439,cPa323_cPa333_cPa362,13_2_1,118,81
chr13-8709609_8709711,cPa75,0.333333333333333,6,8709665,8709617,cPa62-cPa260-hybrid_cPa62-cPa75-hybrid_cPa75_cPa75-cPa260-hybrid_cPa75-HERV-W_repbase_HERV17_LTR17-hybrid_cPa75-unknown,2_1_3_1_1_1,102,48
chr13-8829135_8829237,cPa62_cPa62-cPa75-hybrid_cPa75,0.333333333333333,3,8829185,8829173,cPa62_cPa62-cPa75-hybrid_cPa75,1_1_1,102,12
chr13-8829486_8829588,cPa75_cPa75-HERV-W_repbase_HERV17_LTR17-hybrid,0.5,2,8829553,8829536,cPa75_cPa75-HERV-W_repbase_HERV17_LTR17-hybrid,1_1,102,17
chr13-8829971_8830073,cPa75,1,1,8830021,8829977,cPa75,4,102,44
chr13-9058089_9058191,cPa75-unknown,1,1,9058139,9058139,cPa75-unknown,1,102,0
chr13-9323290_9323660,cPa75-cPa62-hybrid,0.482352941176471,9,9323659,9323340,cPa62_cPa71-cPa62-hybrid_cPa71-unknown_cPa75_cPa75-cPa62-hybrid_cPa75-unknown_HERV-W_repbase_HERV17_LTR17_HERV-W_repbase_HERV17_LTR17-cPa419-hybrid_HERV-W_repbase_HERV17_LTR17-cPa75-hybrid,5_1_1_16_41_18_1_1_1,370,319
chr13-9549727_9549829,cPa75,1,1,9549777,9549777,cPa75,1,102,0
chr13-9872067_9872174,cPa62,0.846153846153846,3,9872157,9872102,cPa285_cPa62_cPa62-cPa419-hybrid,1_11_1,107,55
chr13-995992_996226,cPa62-unknown,0.3125,8,996219,996042,cPa486_cPa486-cPa75-hybrid_cPa486-WDSV_NC001867-hybrid_cPa62_cPa62-cPa486-hybrid_cPa62-unknown_WDSV_NC001867_WDSV_NC001867-cPa75-hybrid,1_1_1_3_1_5_3_1,234,177
chr14-12094528_12094630,cPa452,0.428571428571429,4,12094589,12094561,cPa176-cPa16-hybrid_cPa363_cPa452_cPa71,1_2_3_1,102,28
chr14-1211388_1211490,cPa75,1,1,1211438,1211391,cPa75,5,102,47
chr14-1211726_1211828,cPa75,1,1,1211776,1211776,cPa75,1,102,0
chr14-1211830_1212057,cPa75,1,1,1212010,1211880,cPa75,15,227,130
chr14-1212127_1212321,cPa75,1,1,1212269,1212174,cPa75,7,194,95
chr14-12176480_12176584,cPa456,0.4,8,12176582,12176499,cPa363_cPa363-cPa452-hybrid_cPa456_cPa456-cPa117-hybrid_cPa456-cPa452-hybrid_cPa456-unknown_cPa587-cPa452-hybrid_cPa75-cPa452-hybrid,12_1_14_2_1_2_2_1,104,83
chr14-12205013_12205115,cPa75-cPa472-hybrid,1,1,12205063,12205063,cPa75-cPa472-hybrid,1,102,0
chr14-12300995_12301097,cPa62,0.952380952380952,2,12301088,12301040,cPa62_cPa62-unknown,20_1,102,48
chr14-13702035_13702140,cPa15,0.615384615384615,2,13702101,13702083,cPa118_cPa15,5_8,105,18
chr14-14268209_14268311,cPa62,1,1,14268269,14268259,cPa62,3,102,10
chr14-14277843_14277945,cPa199,1,1,14277893,14277850,cPa199,5,102,43
chr14-14290312_14290433,cPa75,0.515151515151515,7,14290386,14290314,cPa62_cPa62-cPa260-hybrid_cPa62-cPa293-hybrid_cPa62-cPa413-hybrid_cPa62-cPa75-hybrid_cPa62-unknown_cPa75,4_1_1_2_4_4_17,121,72
chr14-14290536_14290752,cPa75,0.447368421052632,8,14290750,14290586,cPa260_cPa413_cPa62_cPa62-cPa293-hybrid_cPa62-cPa413-hybrid_cPa62-cPa75-hybrid_cPa62-unknown_cPa75,1_1_3_2_1_4_9_17,216,164
chr14-14290755_14290936,cPa62-unknown,0.25,7,14290922,14290805,cPa260_cPa413_cPa62_cPa62-cPa413-hybrid_cPa62-cPa75-hybrid_cPa62-unknown_cPa75,1_1_1_1_1_2_1,181,117
chr14-14861496_14861598,cPa260_WDSV_NC001867,0.5,2,14861546,14861538,cPa260_WDSV_NC001867,1_1,102,8
chr14-1493226_1493328,cPa260,1,1,1493276,1493226,cPa260,15,102,50
chr14-1536603_1536777,cPa75,1,1,1536776,1536653,cPa75,4,174,123
chr14-15448701_15448834,cPa15,0.6,3,15448782,15448708,cPa118_cPa15_cPa268,1_3_1,133,74
chr14-15467035_15467137,cPa452,0.5,3,15467088,15467085,cPa363-cPa452-hybrid_cPa363-unknown_cPa452,1_1_2,102,3
chr14-1561226_1561510,HERV-W_repbase_HERV17_LTR17,0.816326530612245,6,1561458,1561227,cPa75_cPa75-unknown_HERV-W_repbase_HERV17_LTR17_KoRV_AF151794_KoRV_AF151794-cPa75-hybrid_PERV_AJ293656,1_1_40_3_1_3,284,231
chr14-1561580_1561682,HERV-W_repbase_HERV17_LTR17,0.666666666666667,2,1561630,1561617,cPa75_HERV-W_repbase_HERV17_LTR17,1_2,102,13
chr14-1561847_1562728,HERV-W_repbase_HERV17_LTR17,0.892307692307692,8,1562681,1561860,cPa228-HERV-W_repbase_HERV17_LTR17-hybrid_cPa260-cPa62-hybrid_cPa75_HERV-W_repbase_HERV17_LTR17_HERV-W_repbase_HERV17_LTR17-cPa62-hybrid_HERV-W_repbase_HERV17_LTR17-cPa75-hybrid_KoRV_AF151794_KoRV_AF151794-HERV-W_repbase_HERV17_LTR17-hybrid,1_1_1_58_1_1_1_1,881,821
chr14-1570724_1570826,cPa450-cPa62-hybrid_cPa505-cPa62-hybrid_HML1b_repbase_HERV-K14I_LTR14A-cPa62-hybrid,0.333333333333333,3,1570787,1570774,cPa450-cPa62-hybrid_cPa505-cPa62-hybrid_HML1b_repbase_HERV-K14I_LTR14A-cPa62-hybrid,1_1_1,102,13
chr14-15974041_15974144,cPa456,0.666666666666667,2,15974095,15974045,cPa363_cPa456,3_6,103,50
chr14-16190352_16190468,cPa62,1,1,16190425,16190384,cPa62,46,116,41
chr14-16311492_16311636,cPa62,1,1,16311584,16311518,cPa62,8,144,66
chr14-16311977_16312186,cPa62,0.9,2,16312134,16312027,cPa285-cPa62-hybrid_cPa62,1_9,209,107
chr14-16312322_16312424,cPa62,1,1,16312372,16312372,cPa62,1,102,0
chr14-16437038_16437140,cPa67,0.428571428571429,3,16437098,16437075,cPa194_cPa345_cPa67,2_2_3,102,23
chr14-16466732_16467174,cPa428,0.634146341463415,4,16467173,16466782,cPa356_cPa356-unknown_cPa428_cPa428-cPa356-hybrid,57_2_104_1,442,391
chr14-16467936_16468069,cPa428,0.526315789473684,2,16468044,16467975,cPa356_cPa428,9_10,133,69
chr14-16468553_16468655,cPa356_cPa428,0.5,2,16468603,16468602,cPa356_cPa428,1_1,102,1
chr14-16469636_16469909,cPa428,0.566265060240964,2,16469909,16469636,cPa356_cPa428,36_47,273,273
chr14-16469957_16470059,cPa356_cPa428,0.5,2,16470058,16469979,cPa356_cPa428,12_12,102,79
chr14-16470352_16470534,cPa356,0.527472527472527,2,16470533,16470353,cPa356_cPa428,48_43,182,180
chr14-16470588_16470690,cPa356,0.555555555555556,2,16470689,16470594,cPa356_cPa428,20_16,102,95
chr14-16470802_16470904,cPa356_cPa428,0.5,2,16470904,16470806,cPa356_cPa428,24_24,102,98
chr14-16471209_16471311,cPa428,0.526315789473684,2,16471294,16471215,cPa356_cPa428,9_10,102,79
chr14-16472015_16472117,cPa428,0.52,2,16472116,16472020,cPa356_cPa428,12_13,102,96
chr14-1659131_1659233,cPa268,0.428571428571429,4,1659214,1659177,cPa140_cPa140-unknown_cPa268_cPa510,1_1_3_2,102,37
chr14-1864438_1864575,cPa75,1,1,1864523,1864488,cPa75,2,137,35
chr14-1864670_1865061,cPa75,1,1,1865009,1864688,cPa75,9,391,321
chr14-1865119_1865310,cPa75,1,1,1865258,1865120,cPa75,11,191,138
chr14-1900393_1900495,cPa568-cPa323-hybrid,0.333333333333333,7,1900449,1900432,cPa323_cPa333_cPa333-cPa371-hybrid_cPa568-cPa323-hybrid_cPa568-cPa333-hybrid_cPa568-cPa371-hybrid_cPa568-unknown,3_2_1_7_2_5_1,102,17
chr14-1900546_1900677,cPa568-cPa323-hybrid,0.476190476190476,4,1900663,1900583,cPa323_cPa568-cPa323-hybrid_cPa568-cPa333-hybrid_cPa568-cPa371-hybrid,5_10_1_5,131,80
chr14-1970673_1970775,cPa75,1,1,1970723,1970723,cPa75,1,102,0
chr14-1972095_1972197,cPa75,1,1,1972145,1972145,cPa75,1,102,0
chr14-1975224_1975326,cPa75,1,1,1975274,1975274,cPa75,1,102,0
chr14-2006344_2006446,cPa117,1,1,2006394,2006388,cPa117,2,102,6
chr14-2029856_2029992,cPa117,0.666666666666667,2,2029940,2029906,cPa117_cPa117-unknown,2_1,136,34
chr14-2030015_2030281,cPa117,0.692307692307692,4,2030229,2030065,cPa117_cPa117-cPa75-hybrid_cPa117-unknown_cPa452,9_1_2_1,266,164
chr14-2287333_2287435,HTLV1_NC001436,1,1,2287383,2287383,HTLV1_NC001436,1,102,0
chr14-2480013_2480193,cPa260-cPa75-hybrid,0.923076923076923,2,2480141,2480063,cPa260-cPa75-hybrid_cPa75,12_1,180,78
chr14-2480317_2480419,cPa260-cPa75-hybrid,1,1,2480367,2480367,cPa260-cPa75-hybrid,1,102,0
chr14-2565784_2565886,cPa117,1,1,2565834,2565834,cPa117,1,102,0
chr14-2565957_2566223,cPa117,0.736842105263158,4,2566171,2566007,cPa117_cPa117-cPa452-hybrid_cPa117-unknown_cPa452,28_1_6_3,266,164
chr14-260307_260409,cPa363_cPa452,0.333333333333333,4,260395,260344,cPa363_cPa452_cPa452-cPa71-hybrid_cPa71,3_3_1_2,102,51
chr14-2762002_2762104,cPa260,1,1,2762052,2762052,cPa260,1,102,0
chr14-290713_290815,cPa356_cPa428,0.5,2,290790,290732,cPa356_cPa428,2_2,102,58
chr14-291744_291846,cPa356,0.666666666666667,2,291820,291794,cPa356_cPa428,4_2,102,26
chr14-292316_292418,cPa356_cPa428,0.5,2,292372,292365,cPa356_cPa428,4_4,102,7
chr14-292535_292637,cPa428,1,1,292585,292585,cPa428,1,102,0
chr14-292737_292857,cPa428,0.7,2,292805,292757,cPa356_cPa428,9_21,120,48
chr14-293144_293324,cPa428,0.833333333333333,2,293272,293194,cPa356_cPa428,1_5,180,78
chr14-293512_293654,cPa428,0.5,3,293628,293550,cPa356_cPa356-cPa428-hybrid_cPa428,19_1_20,142,78
chr14-294367_294536,cPa428,1,1,294485,294417,cPa428,4,169,68
chr14-295147_295249,cPa356_cPa428,0.5,2,295197,295197,cPa356_cPa428,1_1,102,0
chr14-308750_308879,cPa356_cPa428,0.428571428571429,3,308827,308800,cPa356_cPa428_cPa428-cPa356-hybrid,3_3_1,129,27
chr14-3111684_3111786,cPa62-cPa75-hybrid,1,1,3111734,3111734,cPa62-cPa75-hybrid,1,102,0
chr14-3121846_3121948,cPa62,1,1,3121896,3121858,cPa62,6,102,38
chr14-315484_315697,cPa356,0.75,2,315645,315534,cPa356_cPa428,3_1,213,111
chr14-315774_315876,cPa356_cPa428,0.5,2,315824,315824,cPa356_cPa428,1_1,102,0
chr14-317719_317821,cPa428,1,1,317769,317769,cPa428,1,102,0
chr14-317958_318280,cPa356,0.514705882352941,3,318262,317969,cPa356_cPa419_cPa428,70_1_65,322,293
chr14-321120_321222,cPa356_cPa428,0.5,2,321181,321170,cPa356_cPa428,3_3,102,11
chr14-3214678_3214780,cPa75,1,1,3214728,3214728,cPa75,1,102,0
chr14-321819_321921,cPa428,0.529411764705882,2,321911,321824,cPa356_cPa428,8_9,102,87
chr14-326395_326497,cPa356,0.666666666666667,2,326467,326439,cPa356_cPa428,4_2,102,28
chr14-326805_326907,cPa356,0.540540540540541,2,326875,326833,cPa356_cPa428,20_17,102,42
chr14-327174_327323,cPa428,0.5625,2,327319,327196,cPa356_cPa428,7_9,149,123
chr14-327878_327980,cPa356,0.6,2,327978,327878,cPa356_cPa428,15_10,102,100
chr14-328479_328589,cPa428,0.529411764705882,2,328562,328478,cPa356_cPa428,8_9,110,84
chr14-328872_329015,cPa356,0.515625,2,329015,328922,cPa356_cPa428,33_31,143,93
chr14-3297343_3297445,cPa15,0.5,4,3297410,3297391,cPa118_cPa15_cPa268_cPa268-cPa118-hybrid,19_22_2_1,102,19
chr14-330088_330196,cPa356,0.583333333333333,2,330172,330138,cPa356_cPa428,7_5,108,34
chr14-331831_332166,cPa428,0.553191489361702,3,332114,331853,cPa356_cPa428_cPa428-cPa356-hybrid,41_52_1,335,261
chr14-332202_332352,cPa428,0.75,2,332329,332252,cPa356_cPa428,1_3,150,77
chr14-332810_333108,cPa428,0.6,2,333056,332825,cPa356_cPa428,12_18,298,231
chr14-333984_334086,cPa356,1,1,334034,334034,cPa356,1,102,0
chr14-335155_335366,cPa15,0.592592592592593,15,335360,335205,cPa118_cPa118-cPa15-hybrid_cPa118-unknown_cPa15_cPa15-cPa356-hybrid_cPa248-cPa118-hybrid_cPa248-cPa15-hybrid_cPa248-cPa356-hybrid_cPa248-cPa428-hybrid_cPa248-cPa516-hybrid_cPa248-unknown_cPa268-cPa118-hybrid_cPa268-cPa15-hybrid_cPa268-unknown_cPa443,35_1_1_80_1_1_3_1_1_1_1_3_2_1_3,211,155
chr14-3488609_3488711,cPa75,1,1,3488659,3488659,cPa75,1,102,0
chr14-3533487_3533698,cPa62,0.39622641509434,7,3533696,3533487,cPa293-cPa62-hybrid_cPa413-cPa62-hybrid_cPa413-unknown_cPa62_cPa75_cPa75-cPa62-hybrid_cPa75-unknown,1_6_1_21_2_8_14,211,209
chr14-3607017_3607119,cPa75,1,1,3607067,3607067,cPa75,1,102,0
chr14-3612291_3612393,cPa363-cPa391-hybrid,0.6,2,3612390,3612330,cPa363-cPa391-hybrid_cPa71-cPa391-hybrid,3_2,102,60
chr14-3612409_3612511,cPa391,1,1,3612459,3612459,cPa391,1,102,0
chr14-4424111_4424245,cPa75-unknown,1,1,4424202,4424161,cPa75-unknown,13,134,41
chr14-4424325_4424438,cPa75-unknown,0.666666666666667,2,4424386,4424341,cPa75-HFV_NC001736-hybrid_cPa75-unknown,1_2,113,45
chr14-4424442_4424568,cPa75-unknown,0.8,2,4424528,4424492,cPa75-HFV_NC001736-hybrid_cPa75-unknown,1_4,126,36
chr14-4633337_4633439,cPa75,1,1,4633387,4633387,cPa75,1,102,0
chr14-4633442_4633544,cPa75,1,1,4633492,4633492,cPa75,1,102,0
chr14-4633860_4633962,cPa75,1,1,4633910,4633910,cPa75,1,102,0
chr14-4726916_4727018,cPa75-unknown,0.909090909090909,2,4726966,4726952,cPa75_cPa75-unknown,1_10,102,14
chr14-4948921_4949023,cPa75,1,1,4949009,4948942,cPa75,4,102,67
chr14-5042964_5043114,cPa260_cPa71,0.5,2,5043062,5043014,cPa260_cPa71,1_1,150,48
chr14-5179124_5179226,cPa505,0.5,3,5179188,5179139,cPa199_cPa201_cPa505,2_1_3,102,49
chr14-5256534_5256855,cPa75,1,1,5256803,5256584,cPa75,11,321,219
chr14-5256869_5256971,cPa75,1,1,5256919,5256919,cPa75,1,102,0
chr14-5392534_5392744,cPa75,1,1,5392706,5392584,cPa75,9,210,122
chr14-5394333_5394435,cPa293_cPa293-cPa75-hybrid,0.5,2,5394428,5394383,cPa293_cPa293-cPa75-hybrid,1_1,102,45
chr14-5498914_5499038,cPa117_cPa117-cPa75-hybrid,0.5,2,5498986,5498964,cPa117_cPa117-cPa75-hybrid,1_1,124,22
chr14-6034567_6034687,cPa75,1,1,6034642,6034603,cPa75,11,120,39
chr14-6555845_6555947,cPa62,1,1,6555895,6555895,cPa62,1,102,0
chr14-6698034_6698143,cPa363_cPa452_cPa71,0.333333333333333,3,6698120,6698079,cPa363_cPa452_cPa71,3_3_3,109,41
chr14-6800006_6800108,cPa62,1,1,6800056,6800056,cPa62,1,102,0
chr14-6851219_6851321,cPa75,1,1,6851269,6851238,cPa75,2,102,31
chr14-6937984_6938086,cPa75,0.666666666666667,3,6938034,6938009,cPa75_cPa75-cPa285-hybrid_cPa75-unknown,4_1_1,102,25
chr14-710473_710575,cPa199,0.75,2,710539,710523,cPa199_cPa199-unknown,3_1,102,16
chr14-716626_716728,cPa75,0.583333333333333,6,716725,716638,cPa62-cPa67-hybrid_cPa62-cPa75-hybrid_cPa62-HERV-W_repbase_HERV17_LTR17-hybrid_cPa62-unknown_cPa75_cPa75-unknown,5_2_1_6_21_1,102,87
chr14-7286657_7286759,cPa371,1,1,7286707,7286656,cPa371,2,102,51
chr14-7286796_7286898,cPa371,0.666666666666667,2,7286863,7286846,cPa323-cPa371-hybrid_cPa371,1_2,102,17
chr14-7446740_7446842,cPa62,1,1,7446839,7446764,cPa62,9,102,75
chr14-7446894_7447237,cPa62,0.763157894736842,4,7447208,7446897,cPa285_cPa293_cPa62_cPa62-unknown,6_2_29_1,343,311
chr14-8082808_8082910,cPa539_cPa539-unknown,0.5,2,8082858,8082858,cPa539_cPa539-unknown,1_1,102,0
chr14-8764666_8764768,cPa419,1,1,8764716,8764716,cPa419,1,102,0
chr14-906863_907020,cPa75,0.75,2,906968,906877,cPa75_cPa75-unknown,3_1,157,91
chr14-907065_907168,cPa75,1,1,907150,907082,cPa75,8,103,68
chr14-9100563_9100742,cPa117,1,1,9100690,9100584,cPa117,5,179,106
chr14-9142416_9142530,cPa75-unknown,0.769230769230769,2,9142522,9142461,cPa75_cPa75-unknown,3_10,114,61
chr14-9837242_9837583,HERV-W_repbase_HERV17_LTR17,0.769230769230769,7,9837575,9837255,cPa62_cPa75_cPa75-cPa62-hybrid_HERV-F_repbase_HERVFH19I_LTR19A-cPa62-hybrid_HERV-W_repbase_HERV17_LTR17_HERV-W_repbase_HERV17_LTR17-cPa62-hybrid_HERV-W_repbase_HERV17_LTR17-unknown,2_4_2_1_50_5_1,341,320
chr14-9837584_9837784,HERV-W_repbase_HERV17_LTR17,1,1,9837732,9837585,HERV-W_repbase_HERV17_LTR17,5,200,147
chr14-9858173_9858275,cPa62,0.973684210526316,2,9858271,9858172,cPa293-cPa62-hybrid_cPa62,1_37,102,99
chr14-9948834_9948936,cPa62,1,1,9948884,9948864,cPa62,2,102,20
chr14-996957_997059,cPa75-cPa177-hybrid,1,1,997007,996977,cPa75-cPa177-hybrid,2,102,30
chr15-1072635_1072744,cPa118-cPa268-hybrid_cPa15,0.5,2,1072692,1072685,cPa118-cPa268-hybrid_cPa15,1_1,109,7
chr15-10739_11248,cPa254-cPa157-hybrid,0.328537170263789,32,11218,10740,cPa118-cPa157-hybrid_cPa14-cPa157-hybrid_cPa14-cPa285-hybrid_cPa14-cPa419-hybrid_cPa14-cPa62-hybrid_cPa14-SIV_NC001870-hybrid_cPa223-cPa157-hybrid_cPa254_cPa254-cPa157-hybrid_cPa254-cPa260-hybrid_cPa254-cPa285-hybrid_cPa254-cPa62-hybrid_cPa254-unknown_cPa257-cPa157-hybrid_cPa257-cPa285-hybrid_cPa257-cPa62-hybrid_cPa257-SIV_NC001870-hybrid_cPa257-unknown_cPa260-cPa157-hybrid_cPa293_cPa293-cPa157-hybrid_cPa419_cPa419-cPa62-hybrid_cPa419-SIV_NC001870-hybrid_cPa546-cPa157-hybrid_cPa62_cPa62-cPa157-hybrid_cPa75-cPa157-hybrid_EIAV_NC001450-cPa157-hybrid_EIAV_NC001450-cPa62-hybrid_HERV-E_repbase_HERVE_LTR2-cPa157-hybrid_WDSV_NC001867-cPa157-hybrid,1_17_1_1_1_1_54_9_137_1_2_3_16_58_3_4_1_27_12_1_1_6_1_1_7_8_5_19_6_1_9_3,509,478
chr15-1166637_1166742,cPa223-cPa273-hybrid_cPa450_cPa553,0.333333333333333,3,1166690,1166687,cPa223-cPa273-hybrid_cPa450_cPa553,1_1_1,105,3
chr15-11825052_11825154,cPa302,0.333333333333333,5,11825102,11825064,cPa150-cPa246-hybrid_cPa150-unknown_cPa255-cPa246-hybrid_cPa302_cPa419,1_1_1_2_1,102,38
chr15-11828317_11828419,cPa419,0.666666666666667,2,11828379,11828367,cPa419_HTLV1_NC001436,2_1,102,12
chr15-11892365_11892469,cPa75,1,1,11892452,11892415,cPa75,4,104,37
chr15-11892597_11892803,cPa75,1,1,11892792,11892647,cPa75,13,206,145
chr15-11943390_11943492,cPa75,1,1,11943440,11943440,cPa75,1,102,0
chr15-11948653_11948935,cPa75,0.978723404255319,2,11948883,11948676,cPa75_cPa75-HML5_repbase_HERVK22I_LTR22-hybrid,46_1,282,207
chr15-11984638_11984740,cPa15_cPa248-cPa118-hybrid,0.5,2,11984688,11984688,cPa15_cPa248-cPa118-hybrid,1_1,102,0
chr15-12034018_12034582,cPa117,0.816901408450704,3,12034559,12034068,cPa117_cPa452_HIV1_NC001802-cPa117-hybrid,58_12_1,564,491
chr15-12094936_12095038,cPa75_cPa75-cPa113-hybrid,0.5,2,12094995,12094986,cPa75_cPa75-cPa113-hybrid,1_1,102,9
chr15-12095045_12095247,cPa75,0.5,11,12095195,12095090,cPa113_cPa16_cPa293_cPa293-unknown_cPa379_cPa62-cPa16-hybrid_cPa62-cPa293-hybrid_cPa62-unknown_cPa75_cPa75-cPa413-hybrid_PERVC_HM159246-cPa75-hybrid,4_1_1_1_1_1_1_1_13_1_1,202,105
chr15-12099853_12099955,cPa75,1,1,12099903,12099903,cPa75,1,102,0
chr15-12211643_12211745,CAEV_NC001463-cPa199-hybrid,0.409090909090909,9,12211738,12211664,CAEV_NC001463-cPa199-hybrid_CAEV_NC001463-cPa223-hybrid_CAEV_NC001463-unknown_cPa199_cPa260-cPa199-hybrid_cPa450-cPa223-hybrid_cPa542-cPa199-hybrid_cPa542-cPa223-hybrid_cPa553-cPa223-hybrid,9_5_1_2_1_1_1_1_1,102,74
chr15-12270923_12271651,cPa75,1,1,12271599,12270973,cPa75,34,728,626
chr15-12271680_12272102,cPa75,1,1,12272050,12271730,cPa75,11,422,320
chr15-12272113_12272215,cPa75,1,1,12272183,12272163,cPa75,2,102,20
chr15-12292332_12292434,cPa75,1,1,12292382,12292382,cPa75,1,102,0
chr15-12292925_12293027,cPa75,1,1,12292975,12292975,cPa75,1,102,0
chr15-12293255_12293595,cPa75,1,1,12293543,12293297,cPa75,12,340,246
chr15-12293773_12293875,cPa75,1,1,12293823,12293823,cPa75,1,102,0
chr15-12295016_12295118,cPa75,1,1,12295066,12295066,cPa75,1,102,0
chr15-12308154_12308256,cPa75,1,1,12308204,12308204,cPa75,1,102,0
chr15-12308276_12308428,cPa75,1,1,12308376,12308326,cPa75,4,152,50
chr15-12308968_12309070,cPa75,1,1,12309018,12309018,cPa75,1,102,0
chr15-12310203_12310409,cPa75,1,1,12310357,12310210,cPa75,21,206,147
chr15-1233348_1233450,cPa402,0.791666666666667,3,1233448,1233396,cPa402_cPa402-cPa74-hybrid_cPa74,19_3_2,102,52
chr15-12342488_12342754,cPa75,1,1,12342702,12342515,cPa75,23,266,187
chr15-12342812_12342914,cPa75,1,1,12342862,12342845,cPa75,3,102,17
chr15-12347626_12347728,cPa75,1,1,12347676,12347676,cPa75,1,102,0
chr15-12361382_12361559,cPa323,0.375,4,12361507,12361384,cPa323_cPa323-cPa371-hybrid_cPa371_cPa371-unknown,3_1_2_2,177,123
chr15-1236447_1236549,cPa223,0.666666666666667,2,1236497,1236469,cPa106-cPa223-hybrid_cPa223,1_2,102,28
chr15-12382668_12382770,cPa75,1,1,12382718,12382718,cPa75,1,102,0
chr15-12383030_12383132,cPa75,1,1,12383080,12383080,cPa75,1,102,0
chr15-12383983_12384085,cPa75,1,1,12384033,12384033,cPa75,1,102,0
chr15-12410677_12411252,cPa75,1,1,12411200,12410727,cPa75,42,575,473
chr15-12411326_12411661,cPa75,1,1,12411609,12411376,cPa75,7,335,233
chr15-12411759_12411935,cPa75,1,1,12411883,12411809,cPa75,11,176,74
chr15-12412231_12412333,cPa75,1,1,12412281,12412281,cPa75,1,102,0
chr15-12412532_12412736,cPa75,1,1,12412684,12412582,cPa75,6,204,102
chr15-12464935_12465085,cPa75,1,1,12465033,12464985,cPa75,3,150,48
chr15-12465131_12465233,cPa75,1,1,12465181,12465181,cPa75,1,102,0
chr15-12473344_12473518,cPa117,1,1,12473466,12473344,cPa117,10,174,122
chr15-12473573_12473764,cPa117,1,1,12473733,12473623,cPa117,8,191,110
chr15-12473771_12473885,cPa117,1,1,12473877,12473789,cPa117,5,114,88
chr15-12740418_12740520,cPa75,1,1,12740468,12740468,cPa75,1,102,0
chr15-12771346_12771507,cPa75,1,1,12771455,12771396,cPa75,3,161,59
chr15-12771854_12771993,cPa75,1,1,12771941,12771904,cPa75,3,139,37
chr15-12773092_12773241,cPa75,1,1,12773189,12773142,cPa75,2,149,47
chr15-1278971_1279076,cPa293_cPa391,0.333333333333333,4,1279024,1278980,cPa287-cPa426-hybrid_cPa287-unknown_cPa293_cPa391,1_1_2_2,105,44
chr15-12904576_12904739,cPa75,1,1,12904687,12904626,cPa75,5,163,61
chr15-12905199_12905390,cPa75,1,1,12905338,12905249,cPa75,14,191,89
chr15-12917061_12917170,cPa223,0.307692307692308,7,12917167,12917090,cPa223_cPa227_cPa273-cPa450-hybrid_cPa345_cPa450_cPa450-unknown_cPa553,4_2_1_3_1_1_1,109,77
chr15-12931377_12931479,cPa75,1,1,12931427,12931404,cPa75,3,102,23
chr15-12931575_12931677,cPa75,1,1,12931625,12931625,cPa75,1,102,0
chr15-13007072_13007174,cPa363,1,1,13007133,13007122,cPa363,2,102,11
chr15-13017178_13017280,cPa339,0.833333333333333,2,13017264,13017228,cPa339_cPa339-cPa542-hybrid,5_1,102,36
chr15-13017792_13017894,cPa339_cPa339-cPa138-hybrid,0.5,2,13017869,13017842,cPa339_cPa339-cPa138-hybrid,1_1,102,27
chr15-13018068_13018170,cPa339-cPa138-hybrid,1,1,13018118,13018118,cPa339-cPa138-hybrid,1,102,0
chr15-13135193_13135295,cPa260,1,1,13135243,13135243,cPa260,1,102,0
chr15-13151443_13151545,cPa228,1,1,13151493,13151493,cPa228,1,102,0
chr15-13162933_13163084,cPa205,0.473684210526316,5,13163040,13162983,cPa205_cPa205-cPa62-hybrid_cPa205-unknown_cPa298-cPa62-hybrid_cPa62,9_3_3_1_3,151,57
chr15-13163119_13163221,cPa62,0.5,5,13163195,13163118,cPa205_cPa205-cPa62-hybrid_cPa205-unknown_cPa260_cPa62,9_1_1_2_13,102,77
chr15-13213721_13213842,cPa118-unknown,1,1,13213790,13213771,cPa118-unknown,2,121,19
chr15-13220715_13220889,cPa118_cPa15_cPa443-cPa268-hybrid_cPa516-cPa268-hybrid,0.25,4,13220837,13220765,cPa118_cPa15_cPa443-cPa268-hybrid_cPa516-cPa268-hybrid,1_1_1_1,174,72
chr15-13260102_13260204,HML1b_repbase_HERV-K14I_LTR14A-cPa345-hybrid_HML1b_repbase_HERV-K14I_LTR14A-unknown,0.5,2,13260152,13260148,HML1b_repbase_HERV-K14I_LTR14A-cPa345-hybrid_HML1b_repbase_HERV-K14I_LTR14A-unknown,1_1,102,4
chr15-13260330_13260474,HML1b_repbase_HERV-K14I_LTR14A-cPa67-hybrid,0.6,3,13260452,13260380,HML1b_repbase_HERV-K14I_LTR14A-cPa345-hybrid_HML1b_repbase_HERV-K14I_LTR14A-cPa67-hybrid_HML1b_repbase_HERV-K14I_LTR14A-unknown,1_3_1,144,72
chr15-13262111_13262213,cPa194-cPa75-hybrid,0.636363636363636,5,13262174,13262134,cPa194-cPa75-hybrid_cPa345-cPa75-hybrid_cPa452-cPa75-hybrid_cPa555-cPa75-hybrid_cPa75,7_1_1_1_1,102,40
chr15-13342523_13342706,cPa363_cPa363-unknown,0.5,2,13342654,13342573,cPa363_cPa363-unknown,1_1,183,81
chr15-13400838_13400940,cPa371,0.8,2,13400940,13400840,cPa371_cPa371-cPa323-hybrid,4_1,102,100
chr15-1340880_1340982,cPa15_cPa268,0.5,2,1340930,1340925,cPa15_cPa268,2_2,102,5
chr15-13419761_13419863,cPa308,0.666666666666667,3,13419836,13419804,cPa158_cPa228-cPa158-hybrid_cPa308,1_1_4,102,32
chr15-13419870_13420062,cPa308,0.4,4,13420046,13419920,cPa158-cPa308-hybrid_cPa308_cPa308-cPa260-hybrid_cPa315-cPa308-hybrid,1_2_1_1,192,126
chr15-13436578_13436680,cPa345,0.666666666666667,3,13436630,13436577,cPa345_cPa67_cPa67-unknown,6_2_1,102,53
chr15-13446311_13446413,cPa228-cPa75-hybrid_HERV-W_repbase_HERV17_LTR17,0.5,2,13446386,13446361,cPa228-cPa75-hybrid_HERV-W_repbase_HERV17_LTR17,1_1,102,25
chr15-13461837_13461943,cPa434,0.5,4,13461911,13461845,cPa434_cPa434-unknown_cPa566_cPa566-unknown,3_1_1_1,106,66
chr15-13462152_13462293,cPa566,0.571428571428571,3,13462241,13462158,cPa434_cPa434-unknown_cPa566,2_1_4,141,83
chr15-13498208_13498473,cPa117,1,1,13498421,13498258,cPa117,5,265,163
chr15-13501771_13501927,cPa75,1,1,13501875,13501821,cPa75,2,156,54
chr15-13501942_13502044,cPa75,1,1,13501992,13501992,cPa75,1,102,0
chr15-13502083_13502185,cPa75,1,1,13502133,13502133,cPa75,1,102,0
chr15-13553118_13553220,cPa75,1,1,13553168,13553168,cPa75,1,102,0
chr15-13561518_13561620,cPa450_cPa553,0.333333333333333,4,13561570,13561568,cPa199-cPa273-hybrid_cPa199-cPa542-hybrid_cPa450_cPa553,1_1_2_2,102,2
chr15-1359082_1359184,cPa75,1,1,1359132,1359118,cPa75,2,102,14
chr15-1360110_1360212,cPa75,1,1,1360160,1360160,cPa75,1,102,0
chr15-1360434_1360536,cPa75,1,1,1360484,1360484,cPa75,1,102,0
chr15-13624303_13624405,cPa553,1,1,13624353,13624353,cPa553,1,102,0
chr15-13687962_13688064,cPa223,1,1,13688058,13687968,cPa223,35,102,90
chr15-13692540_13692642,cPa260,1,1,13692590,13692590,cPa260,1,102,0
chr15-13692934_13693036,cPa260,1,1,13692984,13692984,cPa260,1,102,0
chr15-13695002_13695104,cPa118_cPa15_cPa268,0.333333333333333,3,13695052,13695052,cPa118_cPa15_cPa268,1_1_1,102,0
chr15-13703304_13703406,cPa363_cPa452-cPa363-hybrid,0.5,2,13703373,13703354,cPa363_cPa452-cPa363-hybrid,1_1,102,19
chr15-13703725_13703925,cPa363,0.620689655172414,5,13703898,13703775,cPa363_cPa452_cPa452-cPa363-hybrid_cPa452-cPa456-hybrid_cPa456,18_5_2_2_2,200,123
chr15-13743644_13744012,cPa75,1,1,13743960,13743694,cPa75,14,368,266
chr15-13744146_13744252,cPa75,1,1,13744200,13744196,cPa75,2,106,4
chr15-13936853_13936955,cPa308-unknown,0.952380952380952,2,13936948,13936867,cPa308_cPa308-unknown,1_20,102,81
chr15-13956141_13956392,cPa75,1,1,13956374,13956182,cPa75,8,251,192
chr15-1400357_1400459,cPa223,1,1,1400442,1400407,cPa223,4,102,35
chr15-14025214_14025316,cPa357,1,1,14025264,14025264,cPa357,1,102,0
chr15-14083518_14083620,cPa419,1,1,14083568,14083568,cPa419,1,102,0
chr15-14084326_14084428,cPa419,1,1,14084376,14084376,cPa419,1,102,0
chr15-14085497_14085640,cPa75,0.316666666666667,10,14085598,14085539,cPa419_cPa419-HERV-W_repbase_HERV17_LTR17-hybrid_cPa62-cPa419-hybrid_cPa62-cPa75-hybrid_cPa62-HERV-W_repbase_HERV17_LTR17-hybrid_cPa75_cPa75-cPa419-hybrid_cPa75-HERV-W_repbase_HERV17_LTR17-hybrid_cPa75-PERV_AJ293656-hybrid_HERV-W_repbase_HERV17_LTR17,3_1_1_1_11_19_1_9_1_13,143,59
chr15-14085713_14085859,HERV-W_repbase_HERV17_LTR17,0.5,7,14085834,14085735,cPa62_cPa62-cPa75-hybrid_cPa62-HERV-W_repbase_HERV17_LTR17-hybrid_cPa62-unknown_cPa75_cPa75-HERV-W_repbase_HERV17_LTR17-hybrid_HERV-W_repbase_HERV17_LTR17,1_1_3_1_18_2_26,146,99
chr15-14085880_14085982,cPa75-HERV-W_repbase_HERV17_LTR17-hybrid,0.5,3,14085978,14085930,cPa75-cPa419-hybrid_cPa75-HERV-W_repbase_HERV17_LTR17-hybrid_HERV-W_repbase_HERV17_LTR17,1_2_1,102,48
chr15-15862_16081,cPa224-unknown,0.956521739130435,2,16029,15871,cPa224-unknown_cPa360-unknown,66_3,219,158
chr15-1655801_1655944,cPa75,1,1,1655895,1655828,cPa75,4,143,67
chr15-1667950_1668078,cPa199,0.565789473684211,11,1668048,1667954,cPa199_cPa199-cPa482-hybrid_cPa199-unknown_cPa482_cPa482-cPa199-hybrid_cPa482-cPa505-hybrid_cPa482-cPa539-hybrid_cPa482-unknown_cPa505_cPa505-cPa539-hybrid_cPa539,43_1_2_19_1_1_2_1_2_1_3,128,94
chr15-1686276_1686537,cPa223-unknown,0.857142857142857,2,1686485,1686326,cPa223-cPa106-hybrid_cPa223-unknown,1_6,261,159
chr15-1726225_1726490,cPa62,0.9375,2,1726438,1726255,cPa62_cPa62-unknown,15_1,265,183
chr15-216632_216734,cPa62,1,1,216726,216661,cPa62,21,102,65
chr15-2360845_2360981,cPa118,0.798319327731092,6,2360974,2360890,cPa118_cPa118-cPa308-hybrid_cPa118-unknown_cPa308_cPa308-unknown_cPa419,95_2_7_13_1_1,136,84
chr15-2441_2565,cPa438,0.846153846153846,6,2547,2465,cPa438_cPa438-cPa290-hybrid_cPa438-unknown_cPa544_cPa544-cPa438-hybrid_cPa544-unknown,88_1_2_8_1_4,124,82
chr15-2773681_2773783,WDSV_NC001867,0.75,2,2773774,2773731,cPa260_WDSV_NC001867,1_3,102,43
chr15-2872390_2872492,cPa119,0.5,5,2872480,2872418,cPa119_cPa119-cPa492-hybrid_cPa492_cPa539_cPa539-cPa492-hybrid,7_2_3_1_1,102,62
chr15-3579113_3579215,cPa539,1,1,3579163,3579152,cPa539,4,102,11
chr15-3587538_3587657,cPa223,0.285714285714286,7,3587605,3587553,cPa199_cPa199-unknown_cPa223_cPa273-cPa542-hybrid_cPa273-unknown_cPa450_cPa553,3_1_4_1_1_1_3,119,52
chr15-3770985_3771133,cPa308,0.4,5,3771129,3771008,cPa308_cPa62-cPa260-hybrid_cPa62-cPa308-hybrid_cPa75-cPa308-hybrid_cPa75-unknown,4_1_1_3_1,148,121
chr15-3775430_3775532,cPa75,1,1,3775480,3775480,cPa75,1,102,0
chr15-3775560_3775716,cPa260-cPa75-hybrid_cPa75,0.5,2,3775676,3775608,cPa260-cPa75-hybrid_cPa75,3_3,156,68
chr15-3775875_3775977,cPa419_cPa75,0.5,2,3775949,3775925,cPa419_cPa75,1_1,102,24
chr15-3804771_3804959,cPa323,0.689655172413793,4,3804959,3804795,cPa323_cPa323-cPa285-hybrid_cPa371_cPa371-cPa323-hybrid,20_1_6_2,188,164
chr15-3876880_3876982,cPa539,1,1,3876930,3876930,cPa539,1,102,0
chr15-4204579_4204688,cPa323,0.7,2,4204658,4204629,cPa323_cPa371,14_6,109,29
chr15-4204746_4205101,cPa323,0.767441860465116,5,4205095,4204796,cPa323_cPa323-cPa371-hybrid_cPa371_cPa371-cPa323-hybrid_cPa371-unknown,33_2_6_1_1,355,299
chr15-4205186_4205288,cPa323_cPa371,0.444444444444444,3,4205265,4205186,cPa323_cPa323-cPa371-hybrid_cPa371,4_1_4,102,79
chr15-4574821_4574980,cPa62,0.875,2,4574928,4574825,cPa285_cPa62,1_7,159,103
chr15-458448_458765,cPa434,1,1,458716,458498,cPa434,8,317,218
chr15-458855_459064,cPa434,1,1,459012,458883,cPa434,5,209,129
chr15-459071_459178,cPa434,1,1,459128,459115,cPa434,4,107,13
chr15-4602023_4602125,cPa199_cPa199-cPa227-hybrid_cPa199-cPa450-hybrid_cPa345_cPa553,0.2,5,4602121,4602027,cPa199_cPa199-cPa227-hybrid_cPa199-cPa450-hybrid_cPa345_cPa553,1_1_1_1_1,102,94
chr15-4602135_4602416,cPa199,0.282258064516129,20,4602376,4602136,cPa199_cPa199-cPa227-hybrid_cPa199-cPa345-hybrid_cPa199-cPa542-hybrid_cPa199-cPa553-hybrid_cPa199-unknown_cPa223-cPa199-hybrid_cPa223-cPa227-hybrid_cPa223-cPa345-hybrid_cPa223-cPa553-hybrid_cPa227_cPa227-cPa345-hybrid_cPa273_cPa273-cPa345-hybrid_cPa345_cPa419_cPa450-cPa345-hybrid_cPa542_cPa542-cPa553-hybrid_cPa553,35_2_16_2_7_2_2_1_1_2_6_1_5_1_19_1_1_4_1_15,281,240
chr15-4609567_4609721,cPa205,0.571428571428571,3,4609674,4609586,cPa205_cPa205-unknown_cPa61,24_1_17,154,88
chr15-462065_462167,cPa450,0.580645161290323,10,462131,462110,cPa199-cPa273-hybrid_cPa227-cPa553-hybrid_cPa345_cPa345-cPa227-hybrid_cPa345-cPa553-hybrid_cPa450_cPa450-cPa553-hybrid_cPa482-cPa273-hybrid_cPa482-cPa450-hybrid_cPa553,1_1_1_1_1_18_1_2_1_4,102,21
chr15-4654454_4654556,cPa539-cPa542-hybrid,0.428571428571429,5,4654512,4654472,cPa345_cPa539-cPa199-hybrid_cPa539-cPa345-hybrid_cPa539-cPa542-hybrid_cPa539-unknown,1_2_4_6_1,102,40
chr15-4757590_4757692,cPa327,0.4,5,4757687,4757640,cPa183-cPa327-hybrid_cPa223_cPa327_cPa424_cPa446,1_1_4_1_3,102,47
chr15-4883358_4883513,HERV-W_repbase_HERV17_LTR17,0.807692307692308,3,4883511,4883387,cPa75_HERV-W_repbase_HERV17_LTR17_HERV-W_repbase_HERV17_LTR17-cPa75-hybrid,3_21_2,155,124
chr15-4886185_4886287,cPa413,1,1,4886285,4886184,cPa413,16,102,101
chr15-495816_496138,cPa75,0.75,2,496086,495839,cPa75_cPa75-unknown,6_2,322,247
chr15-5039984_5040086,cPa426,1,1,5040068,5040017,cPa426,3,102,51
chr15-5272729_5272831,cPa47,1,1,5272779,5272779,cPa47,1,102,0
chr15-6268518_6268620,cPa419,1,1,6268568,6268568,cPa419,1,102,0
chr15-698_800,cPa290,1,1,763,697,cPa290,3,102,66
chr15-7336_7438,cPa308,0.7,3,7434,7342,cPa308_cPa419_HFV_NC001736,7_2_1,102,92
chr15-7502456_7502592,cPa75,0.5,3,7502540,7502474,cPa62_cPa62-cPa75-hybrid_cPa75,3_2_5,136,66
chr15-7502823_7502925,cPa75,1,1,7502893,7502873,cPa75,3,102,20
chr15-7502971_7503073,cPa62_cPa75,0.428571428571429,3,7503073,7502978,cPa62_cPa62-cPa75-hybrid_cPa75,3_1_3,102,95
chr15-7503313_7503429,cPa62,0.523809523809524,5,7503402,7503323,cPa113-cPa293-hybrid_cPa62_cPa62-cPa75-hybrid_cPa62-unknown_cPa75,1_22_6_1_12,116,79
chr15-7503466_7503568,cPa62,0.619047619047619,5,7503559,7503475,cPa293_cPa62_cPa62-cPa413-hybrid_cPa62-unknown_cPa75,1_13_1_2_4,102,84
chr15-8287906_8288012,cPa456,0.338983050847458,12,8288011,8287910,cPa117-cPa302-hybrid_cPa117-cPa363-hybrid_cPa117-cPa456-hybrid_cPa117-cPa587-hybrid_cPa117-unknown_cPa363_cPa452-cPa363-hybrid_cPa452-cPa419-hybrid_cPa452-cPa456-hybrid_cPa452-cPa587-hybrid_cPa456_cPa456-cPa587-hybrid,1_6_1_7_1_11_2_1_2_6_20_1,106,101
chr15-8313_8415,HML3_repbase_HERVK9I_MER9-unknown,1,1,8363,8363,HML3_repbase_HERVK9I_MER9-unknown,1,102,0
chr15-8765616_8765718,cPa101_cPa419,0.5,2,8765666,8765624,cPa101_cPa419,1_1,102,42
chr15-9323935_9324116,cPa75,1,1,9324064,9323985,cPa75,4,181,79
chr15-9325646_9325748,cPa75,1,1,9325696,9325675,cPa75,2,102,21
chr15-9415087_9415189,cPa75,1,1,9415137,9415137,cPa75,1,102,0
chr15-9427398_9427500,cPa62,0.666666666666667,2,9427457,9427444,cPa62_cPa75-cPa62-hybrid,4_2,102,13
chr15-9436705_9436814,cPa62-cPa75-hybrid,0.666666666666667,2,9436762,9436755,cPa62-cPa75-hybrid_cPa75,2_1,109,7
chr15-9440896_9440998,cPa117,1,1,9440946,9440946,cPa117,1,102,0
chr15-9481187_9481289,cPa419,1,1,9481237,9481237,cPa419,1,102,0
chr15-9520965_9521286,HERV-W_repbase_HERV17_LTR17,0.804347826086957,6,9521283,9520965,cPa419_cPa62_cPa75_HERV-W_repbase_HERV17_LTR17_HERV-W_repbase_HERV17_LTR17-cPa62-hybrid_KoRV_AF151794-HIV2_NC001722-hybrid,1_1_1_37_5_1,321,318
chr15-9521309_9521411,HERV-W_repbase_HERV17_LTR17,1,1,9521359,9521359,HERV-W_repbase_HERV17_LTR17,1,102,0
chr15-9521480_9521617,HERV-W_repbase_HERV17_LTR17,0.75,2,9521609,9521481,HERV-W_repbase_HERV17_LTR17_MER52A_repbase_MER52AI_MER52A-HERV-W_repbase_HERV17_LTR17-hybrid,3_1,137,128
chr15-9521666_9521852,HERV-W_repbase_HERV17_LTR17,0.75,2,9521800,9521716,HERV-W_repbase_HERV17_LTR17_HERV-W_repbase_HERV17_LTR17-cPa62-hybrid,3_1,186,84
chr15-9561378_9561480,cPa75,1,1,9561428,9561428,cPa75,1,102,0
chr15-9592315_9592498,cPa285_cPa75,0.3,5,9592495,9592317,cPa285_cPa285-cPa62-hybrid_cPa285-cPa75-hybrid_cPa75_cPa75-cPa62-hybrid,3_1_1_3_2,183,178
chr15-9592526_9592945,cPa75,0.442622950819672,14,9592933,9592570,cPa224_cPa285_cPa285-cPa224-hybrid_cPa285-cPa293-hybrid_cPa285-cPa62-hybrid_cPa285-unknown_cPa293-cPa62-hybrid_cPa62_cPa75_cPa75-cPa224-hybrid_cPa75-cPa285-hybrid_cPa75-cPa62-hybrid_cPa75-unknown_GaLV_M26927,1_24_1_1_8_3_1_6_54_1_1_17_3_1,419,363
chr15-9592967_9593069,cPa75,0.454545454545455,5,9593043,9592968,cPa285_cPa285-cPa62-hybrid_cPa293-cPa62-hybrid_cPa75_cPa75-cPa62-hybrid,1_1_2_5_2,102,75
chr15-9657939_9658058,cPa75,1,1,9658006,9657989,cPa75,2,119,17
chr15-9662183_9662285,cPa75,1,1,9662234,9662233,cPa75,3,102,1
chr15-9669295_9669397,cPa75,0.916666666666667,2,9669366,9669309,cPa75_cPa75-unknown,11_1,102,57
chr15-9669411_9669513,cPa75,1,1,9669461,9669461,cPa75,1,102,0
chr15-9669971_9670073,cPa75,1,1,9670050,9669982,cPa75,6,102,68
chr15-9670090_9670192,cPa75,0.75,2,9670140,9670110,cPa75_cPa75-cPa201-hybrid,3_1,102,30
chr15-9670494_9670640,cPa75,1,1,9670591,9670533,cPa75,6,146,58
chr15-9670775_9670877,cPa75,0.625,7,9670867,9670774,cPa62-cPa201-hybrid_cPa62-cPa285-hybrid_cPa62-unknown_cPa75_cPa75-cPa201-hybrid_cPa75-cPa285-hybrid_cPa75-unknown,1_2_3_15_1_1_1,102,93
chr15-9674354_9674456,cPa158,0.916666666666667,2,9674453,9674380,cPa158_cPa333-cPa158-hybrid,11_1,102,73
chr15-9674830_9674932,cPa75,0.777777777777778,3,9674906,9674880,cPa158_cPa158-cPa75-hybrid_cPa75,1_1_7,102,26
chr15-9682964_9683066,cPa158,1,1,9683014,9683014,cPa158,1,102,0
chr15-9683192_9683350,cPa158_cPa333,0.5,2,9683298,9683242,cPa158_cPa333,1_1,158,56
chr15-9726214_9726329,cPa75,1,1,9726277,9726264,cPa75,9,115,13
chr17-10158541_10158643,cPa118-cPa345-hybrid,1,1,10158591,10158591,cPa118-cPa345-hybrid,1,102,0
chr17-10158928_10159048,cPa67,0.5625,5,10159042,10158950,cPa194_cPa194-cPa345-hybrid_cPa194-unknown_cPa345_cPa67,2_2_1_2_9,120,92
chr17-10159105_10159207,cPa67,0.75,2,10159161,10159137,cPa345_cPa67,1_3,102,24
chr17-10286136_10286254,cPa75,1,1,10286220,10286186,cPa75,3,118,34
chr17-10452283_10452385,cPa260,0.666666666666667,2,10452376,10452310,cPa260_cPa260-unknown,2_1,102,66
chr17-10463250_10463352,cPa260,0.666666666666667,2,10463300,10463271,cPa228_cPa260,1_2,102,29
chr17-10692087_10692189,cPa15,0.7,4,10692156,10692120,cPa118_cPa118-unknown_cPa15_cPa268,2_2_14_2,102,36
chr17-10754682_10754784,cPa118_cPa15_cPa419,0.333333333333333,3,10754732,10754720,cPa118_cPa15_cPa419,1_1_1,102,12
chr17-11373434_11373536,cPa308-unknown,1,1,11373484,11373441,cPa308-unknown,2,102,43
chr17-11394924_11395026,cPa345,0.8,2,11395021,11394974,cPa345_cPa345-cPa61-hybrid,4_1,102,47
chr17-11395800_11396070,cPa345,0.383928571428571,14,11396018,11395807,cPa163_cPa163-cPa223-hybrid_cPa163-cPa257-hybrid_cPa163-cPa345-hybrid_cPa163-cPa553-hybrid_cPa285_cPa285-cPa15-hybrid_cPa285-cPa553-hybrid_cPa290_cPa345_cPa60_cPa60-cPa118-hybrid_cPa60-cPa227-hybrid_cPa60-cPa553-hybrid,42_1_3_2_1_4_1_1_9_43_2_1_1_1,270,211
chr17-11426951_11427055,cPa339,0.363636363636364,7,11427013,11426988,cPa339_cPa345_cPa345-cPa447-hybrid_cPa444-cPa390-hybrid_cPa444-cPa62-hybrid_cPa444-unknown_cPa447,4_1_1_1_1_1_2,104,25
chr17-11439111_11439213,cPa363,0.416666666666667,7,11439207,11439129,Cer1_U15406-cPa500-hybrid_cPa356-cPa113-hybrid_cPa363_cPa456-cPa157-hybrid_cPa456-cPa363-hybrid_cPa75-cPa157-hybrid_cPa75-cPa452-hybrid,1_1_5_1_2_1_1,102,78
chr17-11453311_11453430,cPa298,0.3125,13,11453424,11453335,cPa199_cPa298_cPa298-cPa254-hybrid_cPa298-cPa512-hybrid_cPa298-cPa74-hybrid_cPa402_cPa402-cPa74-hybrid_cPa482-cPa402-hybrid_cPa482-cPa74-hybrid_cPa512_cPa74_HFV_NC001736-cPa254-hybrid_HFV_NC001736-cPa404-hybrid,2_10_2_1_3_5_1_2_1_2_1_1_1,119,89
chr17-11454330_11454432,cPa482,0.461538461538462,7,11454412,11454357,cPa199-cPa419-hybrid_cPa482_cPa512_cPa553-cPa512-hybrid_cPa75-cPa482-hybrid_HFV_NC001736-cPa512-hybrid_HFV_NC001736-cPa74-hybrid,1_6_2_1_1_1_1,102,55
chr17-11454715_11454817,cPa482,0.636363636363636,3,11454768,11454717,cPa402-cPa512-hybrid_cPa482_cPa512,1_7_3,102,51
chr17-11456046_11456187,cPa75_cPa75-cPa512-hybrid,0.3,5,11456135,11456096,cPa419_cPa75_cPa75-cPa188-hybrid_cPa75-cPa327-hybrid_cPa75-cPa512-hybrid,1_3_2_1_3,141,39
chr17-11457845_11457992,cPa452,0.238095238095238,18,11457951,11457864,cPa199_cPa199-cPa157-hybrid_cPa223_cPa327_cPa363_cPa446-cPa223-hybrid_cPa446-cPa363-hybrid_cPa450-cPa34-hybrid_cPa452_cPa452-cPa199-hybrid_cPa452-cPa223-hybrid_cPa452-unknown_cPa542-cPa34-hybrid_cPa71-cPa223-hybrid_cPa75-cPa223-hybrid_cPa75-cPa327-hybrid_cPa75-cPa363-hybrid_cPa75-cPa452-hybrid,1_1_1_1_1_4_1_1_10_1_2_1_1_1_9_3_2_1,147,87
chr17-11458017_11458162,cPa452,0.363636363636364,14,11458110,11458058,cPa183-cPa327-hybrid_cPa199_cPa199-cPa363-hybrid_cPa223_cPa327_cPa327-cPa313-hybrid_cPa363_cPa419_cPa419-cPa223-hybrid_cPa450_cPa452_cPa542-cPa75-hybrid_cPa553-cPa188-hybrid_cPa75-cPa452-hybrid,1_2_1_3_2_1_2_3_1_2_12_1_1_1,145,52
chr17-11461901_11462003,cPa223,1,1,11461951,11461951,cPa223,1,102,0
chr17-11462262_11462364,cPa223_cPa223-cPa315-hybrid_cPa223-unknown,0.333333333333333,3,11462363,11462276,cPa223_cPa223-cPa315-hybrid_cPa223-unknown,1_1_1,102,87
chr17-11462969_11463071,cPa174_cPa425,0.5,2,11463030,11463019,cPa174_cPa425,1_1,102,11
chr17-11464372_11464474,cPa47,0.318181818181818,7,11464432,11464377,cPa125-cPa404-hybrid_cPa15-cPa404-hybrid_cPa174_cPa404_cPa425_cPa47_cPa47-cPa315-hybrid,1_3_2_2_5_7_2,102,55
chr17-11478795_11478897,cPa75,0.428571428571429,5,11478860,11478845,cPa174_cPa363-cPa75-hybrid_cPa47_cPa75_cPa75-unknown,1_1_1_3_1,102,15
chr17-11479836_11479938,cPa174,0.266666666666667,8,11479938,11479858,cPa118_cPa125-cPa199-hybrid_cPa174_cPa254_cPa404_cPa425_cPa47_cPa47-cPa254-hybrid,3_1_4_1_2_1_2_1,102,80
chr17-2310609_2310711,cPa75,1,1,2310659,2310659,cPa75,1,102,0
chr17-2670717_2670819,cPa113,1,1,2670767,2670767,cPa113,1,102,0
chr17-2670894_2671014,cPa113,0.75,2,2670974,2670944,cPa113_cPa113-cPa75-hybrid,3_1,120,30
chr17-2789998_2790100,cPa199,0.833333333333333,2,2790087,2789999,cPa199_cPa505-cPa199-hybrid,5_1,102,88
chr17-2790244_2790346,cPa199,0.666666666666667,2,2790294,2790243,cPa199_cPa201-cPa199-hybrid,4_2,102,51
chr17-2802631_2802778,cPa62,1,1,2802770,2802681,cPa62,27,147,89
chr17-2802846_2802948,cPa62,1,1,2802897,2802860,cPa62,10,102,37
chr17-2810372_2810698,cPa434,0.987179487179487,2,2810657,2810422,cPa363-cPa434-hybrid_cPa434,1_77,326,235
chr17-2853182_2853284,cPa62,1,1,2853246,2853232,cPa62,2,102,14
chr17-2853365_2853467,cPa62,1,1,2853415,2853404,cPa62,2,102,11
chr17-2861633_2861770,cPa323,0.636363636363636,4,2861743,2861682,cPa323_cPa323-cPa371-hybrid_cPa371_cPa50,14_2_5_1,137,61
chr17-2861910_2862099,cPa323_cPa371,0.416666666666667,4,2862099,2861960,cPa323_cPa323-cPa371-hybrid_cPa371_cPa50,5_1_5_1,189,139
chr17-2883688_2883910,cPa75,0.875,2,2883858,2883733,cPa75_cPa75-unknown,7_1,222,125
chr17-2890786_2890915,cPa62,1,1,2890863,2890793,cPa62,4,129,70
chr17-2899542_2899644,cPa62-WDSV_NC001867-hybrid,0.666666666666667,2,2899592,2899553,cPa62-WDSV_NC001867-hybrid_WDSV_NC001867,2_1,102,39
chr17-2973567_2973669,cPa75,1,1,2973617,2973617,cPa75,1,102,0
chr17-3068295_3068397,cPa75,1,1,3068345,3068345,cPa75,1,102,0
chr17-3068636_3068738,cPa75,1,1,3068686,3068686,cPa75,1,102,0
chr17-3072859_3072969,cPa62,1,1,3072917,3072909,cPa62,2,110,8
chr17-3141033_3141167,cPa75,1,1,3141132,3141083,cPa75,3,134,49
chr17-3141193_3141295,cPa75,1,1,3141243,3141243,cPa75,1,102,0
chr17-3141378_3141846,cPa75,0.842105263157895,2,3141794,3141415,cPa75_cPa75-unknown,16_3,468,379
chr17-3141864_3141966,cPa75,1,1,3141929,3141914,cPa75,2,102,15
chr17-3142454_3142556,cPa75,1,1,3142512,3142490,cPa75,3,102,22
chr17-3142565_3142669,cPa75,1,1,3142635,3142615,cPa75,6,104,20
chr17-3142732_3142968,cPa75,0.714285714285714,3,3142943,3142782,cPa201-PERVB_AY099324-hybrid_cPa402_cPa75,1_1_5,236,161
chr17-3153141_3153243,cPa75_cPa75-unknown,0.5,2,3153191,3153173,cPa75_cPa75-unknown,1_1,102,18
chr17-3156627_3156729,cPa223,0.466666666666667,6,3156715,3156639,cPa199_cPa199-cPa75-hybrid_cPa223_cPa223-cPa75-hybrid_cPa553_cPa553-cPa75-hybrid,1_1_7_1_4_1,102,76
chr17-3156906_3157014,cPa199-cPa75-hybrid_cPa553-cPa75-hybrid,0.5,2,3156962,3156956,cPa199-cPa75-hybrid_cPa553-cPa75-hybrid,1_1,108,6
chr17-3157741_3157860,cPa223-cPa75-hybrid,0.625,4,3157810,3157766,cPa223-cPa62-hybrid_cPa223-cPa75-hybrid_cPa542-cPa75-hybrid_cPa553-cPa75-hybrid,1_5_1_1,119,44
chr17-3246396_3246498,cPa452,0.6,3,3246474,3246426,cPa363_cPa452_cPa71,1_3_1,102,48
chr17-3341353_3341589,cPa71,0.640625,8,3341539,3341352,cPa379-cPa62-hybrid_cPa526_cPa526-cPa62-hybrid_cPa526-cPa75-hybrid_cPa71_cPa71-cPa62-hybrid_cPa71-unknown_WDSV_NC001867-cPa62-hybrid,2_1_5_1_41_6_7_1,236,187
chr17-3342313_3342415,cPa71-HML6_repbase_HERVK3I_LTR3-hybrid,1,1,3342363,3342363,cPa71-HML6_repbase_HERVK3I_LTR3-hybrid,1,102,0
chr17-3354299_3354401,cPa227_cPa345,0.357142857142857,5,3354396,3354328,cPa199_cPa227_cPa227-cPa482-hybrid_cPa345_cPa482,1_5_1_5_2,102,68
chr17-3438647_3438749,cPa539-HML4_repbase_HERVK13I_LTR13-hybrid,1,1,3438697,3438697,cPa539-HML4_repbase_HERVK13I_LTR13-hybrid,1,102,0
chr17-3438867_3439043,cPa539-HML4_repbase_HERVK13I_LTR13-hybrid,0.6,2,3438991,3438917,cPa539-HML4_repbase_HERVK13I_LTR13-hybrid_cPa539-unknown,3_2,176,74
chr17-3440590_3440696,cPa62,1,1,3440644,3440640,cPa62,2,106,4
chr17-3471334_3471436,cPa254-cPa75-hybrid,1,1,3471384,3471384,cPa254-cPa75-hybrid,1,102,0
chr17-3471448_3471550,WDSV_NC001867,0.666666666666667,2,3471498,3471461,cPa62_WDSV_NC001867,1_2,102,37
chr17-3475864_3475966,HERV30_repbase_HERV30I_LTR30,1,1,3475914,3475914,HERV30_repbase_HERV30I_LTR30,1,102,0
chr17-3558684_3558860,PERVE_NC003059,0.964285714285714,3,3558808,3558712,cPa419_PERVE_NC003059_PERVE_NC003059-unknown,1_81_2,176,96
chr17-3598399_3598523,cPa75,1,1,3598471,3598449,cPa75,2,124,22
chr17-3598567_3598709,cPa75_cPa75-unknown,0.5,2,3598657,3598617,cPa75_cPa75-unknown,1_1,142,40
chr17-3652433_3652535,cPa62,1,1,3652484,3652466,cPa62,27,102,18
chr17-3801930_3802032,cPa71,1,1,3801980,3801980,cPa71,1,102,0
chr17-3872322_3872424,cPa193-cPa75-hybrid,1,1,3872372,3872372,cPa193-cPa75-hybrid,1,102,0
chr17-3897529_3897650,cPa75,1,1,3897602,3897579,cPa75,12,121,23
chr17-4534_4636,cPa75,1,1,4584,4584,cPa75,1,102,0
chr17-4846614_4846716,cPa75-unknown,0.6,2,4846701,4846636,cPa75_cPa75-unknown,2_3,102,65
chr17-4856354_4856456,cPa62_cPa75,0.444444444444444,3,4856454,4856401,cPa62_cPa62-cPa75-hybrid_cPa75,4_1_4,102,53
chr17-4857944_4858046,cPa75,1,1,4857994,4857994,cPa75,1,102,0
chr17-5117027_5117129,cPa62,1,1,5117106,5117058,cPa62,11,102,48
chr17-5160760_5160862,cPa419_cPa75,0.5,2,5160840,5160810,cPa419_cPa75,1_1,102,30
chr17-5160956_5161094,cPa75,1,1,5161042,5161006,cPa75,2,138,36
chr17-5166201_5166355,cPa75,0.45,7,5166303,5166251,cPa285_cPa285-cPa62-hybrid_cPa62_cPa75_cPa75-cPa285-hybrid_cPa75-cPa62-hybrid_cPa75-unknown,2_1_2_9_2_3_1,154,52
chr17-5449519_5449621,cPa199_cPa201,0.5,2,5449569,5449525,cPa199_cPa201,1_1,102,44
chr17-5766727_5766829,cPa62,0.75,2,5766778,5766777,cPa62_cPa62-unknown,3_1,102,1
chr17-6040957_6041110,cPa75,1,1,6041058,6041007,cPa75,6,153,51
chr17-6041256_6041394,cPa75,1,1,6041342,6041306,cPa75,3,138,36
chr17-6739646_6739748,cPa167-cPa260-hybrid,1,1,6739696,6739696,cPa167-cPa260-hybrid,1,102,0
chr17-6772282_6772419,cPa71,0.952380952380952,2,6772392,6772304,cPa62-unknown_cPa71,1_20,137,88
chr17-6892628_6892809,cPa323_cPa371,0.464285714285714,4,6892771,6892678,cPa323_cPa333_cPa371_cPa371-cPa323-hybrid,13_1_13_1,181,93
chr17-6893044_6893146,cPa323,0.75,2,6893119,6893093,cPa323_cPa371,3_1,102,26
chr17-6893178_6893280,cPa371,0.666666666666667,2,6893228,6893188,cPa323_cPa371,1_2,102,40
chr17-6893538_6893640,cPa323-cPa227-hybrid_cPa371,0.5,2,6893622,6893588,cPa323-cPa227-hybrid_cPa371,1_1,102,34
chr17-7025718_7025835,cPa62,0.916666666666667,2,7025789,7025761,cPa62_cPa62-unknown,11_1,117,28
chr17-7060755_7060857,cPa62,1,1,7060829,7060796,cPa62,8,102,33
chr17-7166051_7166214,cPa62,0.909090909090909,3,7166172,7166079,cPa285-cPa62-hybrid_cPa419_cPa62,1_1_20,163,93
chr17-7285846_7285957,cPa446,0.25,7,7285905,7285866,cPa183-cPa327-hybrid_cPa183-cPa424-hybrid_cPa183-cPa446-hybrid_cPa223_cPa223-cPa446-hybrid_cPa379_cPa446,1_1_1_1_1_1_2,111,39
chr17-7326907_7327009,HTLV1_NC001436,0.864864864864865,3,7326962,7326907,cPa542_cPa542-CAEV_NC001463-hybrid_HTLV1_NC001436,4_1_32,102,55
chr17-7352318_7352420,cPa62-cPa492-hybrid,1,1,7352368,7352368,cPa62-cPa492-hybrid,1,102,0
chr17-7352783_7352891,cPa492,1,1,7352891,7352833,cPa492,7,108,58
chr17-7352916_7353039,cPa492,1,1,7353024,7352923,cPa492,15,123,101
chr17-7415039_7415141,cPa62,0.9,2,7415111,7415038,cPa62_cPa62-unknown,9_1,102,73
chr17-7415927_7416029,cPa62-cPa158-hybrid,1,1,7415977,7415977,cPa62-cPa158-hybrid,1,102,0
chr17-7419516_7419618,cPa345_cPa67,0.472222222222222,4,7419596,7419517,cPa345_cPa345-cPa194-hybrid_cPa345-cPa67-hybrid_cPa67,17_1_1_17,102,79
chr17-7444868_7444970,cPa452,1,1,7444918,7444918,cPa452,1,102,0
chr17-7493088_7493190,cPa62,1,1,7493173,7493138,cPa62,8,102,35
chr17-7493300_7493402,cPa62,1,1,7493399,7493312,cPa62,5,102,87
chr17-7560081_7560183,cPa62,1,1,7560131,7560100,cPa62,4,102,31
chr17-7560319_7560421,cPa285-cPa293-hybrid_cPa293,0.5,2,7560369,7560363,cPa285-cPa293-hybrid_cPa293,1_1,102,6
chr17-7569632_7569739,cPa345_cPa419_cPa553,0.333333333333333,3,7569687,7569682,cPa345_cPa419_cPa553,1_1_1,107,5
chr17-7746576_7746686,cPa62,1,1,7746634,7746626,cPa62,3,110,8
chr17-7746768_7746899,cPa62,1,1,7746847,7746808,cPa62,12,131,39
chr17-7764837_7764939,cPa62,1,1,7764887,7764887,cPa62,1,102,0
chr17-7870313_7870415,cPa413-unknown_cPa434-unknown,0.5,2,7870363,7870334,cPa413-unknown_cPa434-unknown,1_1,102,29
chr17-7872260_7872517,cPa229-unknown_cPa313-unknown,0.4,3,7872465,7872310,cPa229-cPa254-hybrid_cPa229-unknown_cPa313-unknown,1_2_2,257,155
chr17-7873585_7873687,cPa413-cPa223-hybrid_cPa413-cPa254-hybrid_cPa419,0.333333333333333,3,7873635,7873601,cPa413-cPa223-hybrid_cPa413-cPa254-hybrid_cPa419,1_1_1,102,34
chr17-7874977_7875079,cPa75,1,1,7875027,7875027,cPa75,1,102,0
chr17-8060400_8060502,cPa75,0.5,3,8060494,8060450,cPa62-cPa75-hybrid_cPa62-unknown_cPa75,1_1_2,102,44
chr17-8114122_8114265,cPa62,0.791666666666667,3,8114258,8114143,cPa62_cPa62-unknown_cPa62-WDSV_NC001867-hybrid,19_3_2,143,115
chr17-8263719_8263826,cPa95,0.307692307692308,7,8263776,8263719,cPa14-cPa247-hybrid_cPa14-cPa529-hybrid_cPa541-cPa247-hybrid_cPa545_cPa545-cPa247-hybrid_cPa545-cPa95-hybrid_cPa95,1_2_1_2_1_2_4,107,57
chr17-8317393_8317495,cPa62,1,1,8317443,8317443,cPa62,1,102,0
chr17-8494633_8494759,cPa482,0.5,4,8494757,8494671,cPa109_cPa482_cPa482-cPa109-hybrid_cPa505,1_9_1_7,126,86
chr17-8495331_8495433,cPa109-cPa67-hybrid,1,1,8495381,8495381,cPa109-cPa67-hybrid,1,102,0
chr17-8542682_8542784,cPa194_cPa67,0.357142857142857,4,8542770,8542683,cPa194_cPa194-cPa345-hybrid_cPa194-cPa67-hybrid_cPa67,5_2_2_5,102,87
chr17-8583871_8583973,cPa62-cPa75-hybrid_cPa75,0.5,2,8583921,8583883,cPa62-cPa75-hybrid_cPa75,1_1,102,38
chr17-8621942_8622044,cPa62-cPa16-hybrid,1,1,8621992,8621992,cPa62-cPa16-hybrid,1,102,0
chr17-8622068_8622227,cPa71,0.75,3,8622227,8622118,cPa71_cPa71-cPa16-hybrid_cPa71-cPa379-hybrid,6_1_1,159,109
chr17-8632468_8632570,cPa345,0.380952380952381,6,8632558,8632493,cPa199_cPa227_cPa227-unknown_cPa345_cPa345-unknown_cPa553,6_4_1_8_1_1,102,65
chr17-8637110_8637364,cPa15,0.4,4,8637312,8637160,cPa118_cPa15_cPa260-cPa248-hybrid_cPa357-cPa125-hybrid,1_2_1_1,254,152
chr17-8643972_8644074,cPa223_cPa542-cPa446-hybrid,0.5,2,8644040,8644022,cPa223_cPa542-cPa446-hybrid,1_1,102,18
chr17-8682887_8683173,cPa260,0.947368421052632,3,8683125,8682921,cPa228_cPa260_cPa260-unknown,1_36_1,286,204
chr17-8685113_8685215,cPa260_cPa450-cPa219-hybrid_cPa450-unknown_PERVE_NC003059,0.25,4,8685214,8685128,cPa260_cPa450-cPa219-hybrid_cPa450-unknown_PERVE_NC003059,1_1_1_1,102,86
chr17-8854009_8854190,cPa75,1,1,8854138,8854059,cPa75,3,181,79
chr17-8854575_8854677,cPa75,1,1,8854625,8854625,cPa75,1,102,0
chr17-8868697_8869037,cPa75,0.733333333333333,2,8868989,8868747,cPa75_cPa75-unknown,11_4,340,242
chr17-8887628_8887730,cPa75,0.823529411764706,4,8887701,8887631,cPa260-cPa71-hybrid_cPa260-cPa75-hybrid_cPa443-cPa75-hybrid_cPa75,1_1_1_14,102,70
chr17-8903902_8904157,cPa75,1,1,8904105,8903952,cPa75,4,255,153
chr17-8915656_8915758,cPa173,1,1,8915706,8915706,cPa173,1,102,0
chr17-8915767_8915884,cPa173_cPa75-unknown,0.5,2,8915832,8915817,cPa173_cPa75-unknown,1_1,117,15
chr17-8990550_8990652,cPa62,0.833333333333333,2,8990600,8990551,cPa62_cPa62-unknown,5_1,102,49
chr17-8993720_8993907,cPa62,0.846153846153846,4,8993873,8993742,cPa62_cPa62-cPa201-hybrid_cPa62-cPa75-hybrid_cPa75,33_1_1_4,187,131
chr17-9113211_9113313,cPa157-unknown,1,1,9113261,9113261,cPa157-unknown,1,102,0
chr17-9133921_9134163,cPa371,0.797297297297297,5,9134161,9133967,cPa199-cPa323-hybrid_cPa323_cPa323-cPa542-hybrid_cPa371_cPa371-unknown,1_12_1_59_1,242,194
chr17-9164730_9164853,cPa371,1,1,9164801,9164780,cPa371,2,123,21
chr17-9165140_9165243,cPa371,1,1,9165191,9165190,cPa371,2,103,1
chr17-9236051_9236153,cPa260,0.5,4,9236139,9236054,cPa260_cPa260-HERV30_repbase_HERV30I_LTR30-hybrid_cPa75-unknown_HERV30_repbase_HERV30I_LTR30,3_1_1_1,102,85
chr17-9236164_9236266,cPa260,0.8,2,9236229,9236197,cPa260_cPa308-cPa260-hybrid,4_1,102,32
chr17-9240427_9240529,cPa113-cPa260-hybrid_cPa67-cPa260-hybrid,0.5,2,9240508,9240477,cPa113-cPa260-hybrid_cPa67-cPa260-hybrid,2_2,102,31
chr17-9241264_9241366,cPa67-cPa260-hybrid,1,1,9241314,9241314,cPa67-cPa260-hybrid,1,102,0
chr17-9245028_9245130,cPa75-cPa260-hybrid,1,1,9245078,9245035,cPa75-cPa260-hybrid,2,102,43
chr17-9250177_9250279,cPa260,0.6,3,9250259,9250188,cPa228_cPa260_cPa482,1_3_1,102,71
chr17-9250360_9250462,cPa260,0.740740740740741,5,9250424,9250404,cPa228_cPa228-cPa260-hybrid_cPa260_cPa363-cPa260-hybrid_cPa363-cPa472-hybrid,4_1_20_1_1,102,20
chr17-9354538_9354640,cPa67,0.416666666666667,4,9354640,9354588,cPa194_cPa194-unknown_cPa345_cPa67,4_1_2_5,102,52
chr17-9364223_9364325,WDSV_NC001867,0.538461538461538,5,9364325,9364227,cPa62_PERVC_HM159246_WDSV_NC001867_WDSV_NC001867-cPa62-hybrid_WDSV_NC001867-unknown,1_1_7_2_2,102,98
chr17-9364353_9364455,cPa62,0.666666666666667,2,9364404,9364370,cPa62_WDSV_NC001867,2_1,102,34
chr17-9366139_9366241,cPa62_WDSV_NC001867-cPa62-hybrid,0.5,2,9366189,9366183,cPa62_WDSV_NC001867-cPa62-hybrid,2_2,102,6
chr17-9417371_9417495,cPa62,0.6,3,9417488,9417421,cPa62_cPa62-unknown_cPa62-WDSV_NC001867-hybrid,3_1_1,124,67
chr17-9417532_9417634,cPa62_WDSV_NC001867,0.5,2,9417582,9417531,cPa62_WDSV_NC001867,1_1,102,51
chr17-9432748_9432850,cPa62,1,1,9432798,9432798,cPa62,1,102,0
chr17-9561200_9561302,cPa199_cPa345_cPa450-cPa542-hybrid_cPa450-unknown,0.25,4,9561283,9561250,cPa199_cPa345_cPa450-cPa542-hybrid_cPa450-unknown,1_1_1_1,102,33
chr17-9562605_9562743,cPa450-cPa339-hybrid,0.666666666666667,2,9562691,9562655,cPa450-cPa339-hybrid_cPa482,2_1,138,36
chr17-9635944_9636046,cPa67,0.411764705882353,5,9636041,9635953,cPa194_cPa345-cPa194-hybrid_cPa345-unknown_cPa67_SnRV_NC001724-cPa194-hybrid,6_9_4_14_1,102,88
chr17-9636241_9636343,cPa194_cPa345_cPa345-cPa254-hybrid_cPa67,0.25,4,9636300,9636254,cPa194_cPa345_cPa345-cPa254-hybrid_cPa67,1_1_1_1,102,46
chr17-9636360_9636462,cPa67,0.8,2,9636416,9636389,cPa345-cPa67-hybrid_cPa67,1_4,102,27
chr17-9711523_9711625,cPa308_cPa75-unknown,0.5,2,9711596,9711573,cPa308_cPa75-unknown,1_1,102,23
chr17-9711787_9711958,cPa75-unknown,1,1,9711906,9711810,cPa75-unknown,12,171,96
chr17-9739169_9739271,HERV-W_repbase_HERV17_LTR17,0.454545454545455,4,9739261,9739189,cPa75_HERV-W_repbase_HERV17_LTR17_HERV-W_repbase_HERV17_LTR17-cPa62-hybrid_PERV_AJ293656,2_5_2_2,102,72
chr17-9928533_9928700,WDSV_NC001867,0.933333333333333,2,9928692,9928577,cPa260_WDSV_NC001867,1_14,167,115
chr18-10344084_10344186,cPa308,1,1,10344166,10344127,cPa308,88,102,39
chr18-10352071_10352173,cPa543,1,1,10352121,10352121,cPa543,1,102,0
chr18-10382893_10382995,cPa62,1,1,10382944,10382931,cPa62,4,102,13
chr18-10383332_10383434,cPa62,0.888888888888889,2,10383382,10383364,cPa62_cPa75-cPa62-hybrid,16_2,102,18
chr18-11151347_11151454,cPa452_cPa71,0.272727272727273,7,11151409,11151395,cPa16_cPa16-cPa223-hybrid_cPa176-cPa183-hybrid_cPa176-cPa223-hybrid_cPa363_cPa452_cPa71,1_1_1_1_1_3_3,107,14
chr18-11458216_11458318,cPa293-cPa452-hybrid,1,1,11458266,11458266,cPa293-cPa452-hybrid,1,102,0
chr18-11459194_11459322,cPa293-cPa452-hybrid,0.555555555555556,4,11459270,11459232,cPa293-cPa16-hybrid_cPa293-cPa363-hybrid_cPa293-cPa452-hybrid_cPa293-cPa71-hybrid,1_1_5_2,128,38
chr18-11459901_11460003,cPa293-cPa363-hybrid,1,1,11459951,11459951,cPa293-cPa363-hybrid,1,102,0
chr18-11460397_11460521,cPa16,0.2,11,11460480,11460414,cPa16_cPa16-cPa363-hybrid_cPa16-cPa391-hybrid_cPa16-cPa452-hybrid_cPa16-cPa71-hybrid_cPa293-cPa452-hybrid_cPa452_cPa71_cPa75-cPa16-hybrid_cPa75-cPa452-hybrid_cPa75-cPa71-hybrid,3_1_1_2_1_1_1_2_1_1_1,124,66
chr18-11463557_11463671,cPa391-cPa62-hybrid,1,1,11463622,11463607,cPa391-cPa62-hybrid,4,114,15
chr18-11464455_11464652,cPa446,0.28,12,11464610,11464505,cPa21-cPa16-hybrid_cPa254-cPa452-hybrid_cPa254-unknown_cPa285-cPa446-hybrid_cPa363_cPa379_cPa419_cPa419-cPa16-hybrid_cPa446_cPa452_cPa62_cPa62-unknown,1_1_2_1_1_1_1_1_7_1_2_6,197,105
chr18-11464667_11464784,cPa62,0.321428571428571,12,11464750,11464710,cPa254_cPa254-cPa176-hybrid_cPa285-cPa452-hybrid_cPa363_cPa379_cPa379-unknown_cPa446_cPa446-cPa16-hybrid_cPa452_cPa62_cPa62-cPa16-hybrid_cPa62-unknown,2_1_1_2_3_1_3_1_3_9_1_1,117,40
chr18-11466792_11466925,cPa452,0.454545454545455,5,11466873,11466842,cPa254-cPa363-hybrid_cPa363_cPa452_cPa71_cPa71-cPa452-hybrid,1_1_5_3_1,133,31
chr18-115302_115499,cPa118,0.375,11,115479,115309,cPa118_cPa125_cPa15_cPa248_cPa248-cPa125-hybrid_cPa264_cPa264-cPa419-hybrid_cPa443_cPa516_cPa516-cPa419-hybrid_cPa516-unknown,12_3_1_1_1_2_1_1_7_1_2,197,170
chr18-1196250_1196352,cPa456,0.666666666666667,3,1196318,1196298,cPa117-cPa363-hybrid_cPa363_cPa456,1_1_4,102,20
chr18-12079142_12079244,cPa168-cPa205-hybrid,1,1,12079192,12079192,cPa168-cPa205-hybrid,1,102,0
chr18-1325686_1325872,cPa62-cPa71-hybrid,0.423076923076923,8,1325871,1325685,cPa62-cPa71-hybrid_cPa62-cPa75-hybrid_cPa62-HERV-W_repbase_HERV17_LTR17-hybrid_cPa62-unknown_cPa71_cPa75_HERV-W_repbase_HERV17_LTR17_KoRV_AF151794,22_6_2_4_1_12_4_1,186,186
chr18-134318_134485,cPa482,0.428571428571429,4,134433,134357,cPa199_cPa450_cPa482_WDSV_NC001867,1_1_3_2,167,76
chr18-1530052_1530185,cPa360,0.75,3,1530137,1530102,cPa224_cPa360_cPa363,1_6_1,133,35
chr18-210456_210558,cPa345,1,1,210556,210456,cPa345,16,102,100
chr18-2658181_2658283,cPa75-cPa308-hybrid,1,1,2658231,2658231,cPa75-cPa308-hybrid,1,102,0
chr18-2658411_2658513,cPa75-unknown,1,1,2658461,2658461,cPa75-unknown,1,102,0
chr18-2680475_2680577,cPa419,1,1,2680525,2680525,cPa419,1,102,0
chr18-2691010_2691112,cPa182,1,1,2691060,2691060,cPa182,1,102,0
chr18-2746175_2746277,cPa75,1,1,2746225,2746225,cPa75,1,102,0
chr18-2746478_2746580,cPa75,1,1,2746528,2746528,cPa75,1,102,0
chr18-2754111_2754213,cPa566,0.875,2,2754161,2754122,cPa434_cPa566,2_14,102,39
chr18-2924697_2924799,cPa539,0.980392156862745,2,2924747,2924724,cPa446_cPa539,1_50,102,23
chr18-3090677_3090845,HERV-W_repbase_HERV17_LTR17,0.714285714285714,6,3090840,3090680,cPa419_cPa62_HERV-W_repbase_HERV17_LTR17_HERV-W_repbase_HERV17_LTR17-cPa62-hybrid_HERV-W_repbase_HERV17_LTR17-cPa75-hybrid_HERV-W_repbase_HERV17_LTR17-unknown,1_2_30_3_1_5,168,160
chr18-3252822_3252924,cPa62,1,1,3252872,3252872,cPa62,1,102,0
chr18-3309281_3309383,cPa118,0.363636363636364,7,3309374,3309326,cPa118_cPa118-cPa566-hybrid_cPa268-cPa248-hybrid_cPa434_cPa443_cPa566_cPa566-cPa443-hybrid,4_1_1_1_2_1_1,102,48
chr18-3313540_3313716,cPa75-unknown,1,1,3313668,3313590,cPa75-unknown,6,176,78
chr18-3471682_3471784,cPa75,0.666666666666667,3,3471776,3471732,cPa260-unknown_cPa293_cPa75,1_1_4,102,44
chr18-3527405_3527507,cPa339,0.4,4,3527458,3527455,cPa339_cPa444-cPa447-hybrid_cPa444-unknown_cPa447,2_1_1_1,102,3
chr18-3598731_3598833,cPa71,1,1,3598833,3598730,cPa71,13,102,103
chr18-3622205_3622307,cPa260-cPa75-hybrid_cPa75,0.5,2,3622284,3622255,cPa260-cPa75-hybrid_cPa75,2_2,102,29
chr18-3662800_3662902,cPa67,0.666666666666667,2,3662897,3662850,cPa345_cPa67,1_2,102,47
chr18-3662937_3663047,cPa345,0.565217391304348,6,3663032,3662955,cPa194_cPa194-cPa67-hybrid_cPa345_cPa345-cPa67-hybrid_cPa67_cPa67-unknown,2_1_13_1_5_1,110,77
chr18-3725_3843,cPa434-cPa285-hybrid,0.4,4,3793,3775,cPa419_cPa434-cPa16-hybrid_cPa434-cPa285-hybrid_HML7_repbase_HERVK11DI_MER11D,3_2_4_1,118,18
chr18-3765486_3765588,cPa379-cPa61-hybrid,0.479166666666667,13,3765577,3765485,cPa285_cPa363_cPa363-cPa61-hybrid_cPa379_cPa379-cPa285-hybrid_cPa379-cPa61-hybrid_cPa379-unknown_cPa542-cPa285-hybrid_cPa542-cPa61-hybrid_cPa583-cPa542-hybrid_cPa583-cPa61-hybrid_cPa583-unknown_cPa61,2_1_1_5_2_23_3_1_1_1_1_1_6,102,92
chr18-3830569_3830671,cPa486-unknown,0.333333333333333,5,3830645,3830602,cPa486-cPa62-hybrid_cPa486-unknown_cPa62_WDSV_NC001867_WDSV_NC001867-cPa62-hybrid,3_4_2_2_1,102,43
chr18-3830686_3830825,cPa486-cPa62-hybrid,0.5,3,3830801,3830736,cPa486_cPa486-cPa62-hybrid_WDSV_NC001867,1_3_2,139,65
chr18-3830877_3831070,cPa486-cPa62-hybrid,0.217391304347826,10,3831030,3830927,cPa254-cPa62-hybrid_cPa486_cPa486-cPa62-hybrid_cPa486-unknown_cPa486-WDSV_NC001867-hybrid_cPa62_cPa75-cPa486-hybrid_cPa75-cPa62-hybrid_WDSV_NC001867_WDSV_NC001867-cPa62-hybrid,1_5_10_5_1_7_1_1_9_6,193,103
chr18-3831078_3831180,WDSV_NC001867,1,1,3831178,3831128,WDSV_NC001867,3,102,50
chr18-3831215_3831317,WDSV_NC001867,1,1,3831304,3831265,WDSV_NC001867,3,102,39
chr18-3831429_3831531,WDSV_NC001867,0.833333333333333,2,3831482,3831428,cPa486-WDSV_NC001867-hybrid_WDSV_NC001867,1_5,102,54
chr18-3831597_3831699,WDSV_NC001867,1,1,3831668,3831612,WDSV_NC001867,4,102,56
chr18-3831780_3831905,WDSV_NC001867,1,1,3831901,3831809,WDSV_NC001867,13,125,92
chr18-3848414_3848516,cPa539,1,1,3848464,3848427,cPa539,2,102,37
chr18-3885780_3885978,cPa62,1,1,3885974,3885809,cPa62,34,198,165
chr18-3983875_3983977,cPa62_WDSV_NC001867,0.5,2,3983977,3983925,cPa62_WDSV_NC001867,1_1,102,52
chr18-3984220_3984322,cPa539,1,1,3984270,3984270,cPa539,1,102,0
chr18-4028032_4028134,cPa260-cPa523-hybrid,1,1,4028082,4028082,cPa260-cPa523-hybrid,1,102,0
chr18-4043692_4043794,cPa199,1,1,4043779,4043742,cPa199,2,102,37
chr18-4161782_4162113,cPa62-unknown,0.766666666666667,3,4162061,4161788,cPa62-cPa75-hybrid_cPa62-unknown_cPa75,4_23_3,331,273
chr18-4165408_4165510,cPa539,1,1,4165458,4165458,cPa539,1,102,0
chr18-4170844_4170956,cPa62,1,1,4170922,4170864,cPa62,12,112,58
chr18-4183445_4183563,cPa62-cPa75-hybrid,0.333333333333333,5,4183511,4183473,cPa260_cPa62-cPa260-hybrid_cPa62-cPa75-hybrid_cPa62-unknown_cPa75,1_1_3_2_2,118,38
chr18-4183664_4183895,cPa62-cPa75-hybrid,0.394736842105263,5,4183870,4183682,cPa62_cPa62-cPa293-hybrid_cPa62-cPa75-hybrid_cPa62-unknown_cPa75,3_2_15_4_14,231,188
chr18-4183998_4184100,cPa75,0.6,3,4184065,4184043,cPa62-cPa260-hybrid_cPa62-cPa75-hybrid_cPa75,1_1_3,102,22
chr18-4307942_4308044,cPa118,0.333333333333333,5,4307997,4307992,cPa118_cPa118-cPa434-hybrid_cPa118-unknown_cPa268-unknown_cPa443,2_1_1_1_1,102,5
chr18-4308128_4308391,cPa118,0.391304347826087,11,4308389,4308176,cPa118_cPa118-cPa516-hybrid_cPa118-cPa566-hybrid_cPa248_cPa248-cPa566-hybrid_cPa248-unknown_cPa268-cPa118-hybrid_cPa434_cPa443_cPa566_cPa566-cPa118-hybrid,9_1_1_1_2_1_1_1_3_2_1,263,213
chr18-4360394_4360503,cPa75-unknown,1,1,4360479,4360441,cPa75-unknown,6,109,38
chr18-4360533_4360635,cPa75-cPa254-hybrid_cPa75-unknown,0.5,2,4360597,4360583,cPa75-cPa254-hybrid_cPa75-unknown,1_1,102,14
chr18-4390609_4390729,cPa566,0.365853658536585,10,4390729,4390608,cPa118_cPa118-cPa434-hybrid_cPa118-cPa566-hybrid_cPa118-unknown_cPa140-cPa15-hybrid_cPa140-cPa434-hybrid_cPa434_cPa443_cPa443-cPa434-hybrid_cPa566,10_1_2_1_1_1_6_3_1_15,120,121
chr18-4391082_4391184,cPa434,0.333333333333333,5,4391166,4391132,cPa118_cPa118-cPa566-hybrid_cPa248_cPa434_cPa566,1_1_1_2_1,102,34
chr18-4463834_4463936,cPa75-unknown,0.555555555555556,2,4463933,4463871,cPa75_cPa75-unknown,4_5,102,62
chr18-4464067_4464258,cPa75-unknown,0.666666666666667,2,4464219,4464117,cPa75-cPa62-hybrid_cPa75-unknown,2_4,191,102
chr18-4470531_4470678,cPa260_cPa75-cPa308-hybrid,0.5,2,4470626,4470581,cPa260_cPa75-cPa308-hybrid,1_1,147,45
chr18-4470955_4471089,cPa260,0.888888888888889,2,4471046,4470965,cPa260_cPa75-cPa260-hybrid,8_1,134,81
chr18-4471100_4471211,cPa260,0.909090909090909,2,4471210,4471102,cPa260_cPa75-cPa308-hybrid,10_1,111,108
chr18-4471249_4471588,cPa260,0.916666666666667,5,4471536,4471264,cPa260_cPa62-cPa260-hybrid_cPa62-cPa308-hybrid_cPa75-cPa260-hybrid_cPa75-cPa308-hybrid,44_1_1_1_1,339,272
chr18-4471621_4471723,cPa138-HML5_repbase_HERVK22I_LTR22-hybrid,1,1,4471671,4471671,cPa138-HML5_repbase_HERVK22I_LTR22-hybrid,1,102,0
chr18-4472872_4472974,cPa113,0.444444444444444,6,4472941,4472920,cPa113_cPa553-cPa308-hybrid_cPa67_cPa67-unknown_cPa75-unknown_KWERV_GQ222416,4_1_1_1_1_1,102,21
chr18-4473068_4473263,cPa113,0.611111111111111,4,4473211,4473107,cPa113_cPa113-unknown_cPa67_cPa75-unknown,11_1_3_3,195,104
chr18-4486807_4486909,cPa260-cPa223-hybrid_EIAV_NC001450-cPa223-hybrid_WDSV_NC001867_WDSV_NC001867-cPa223-hybrid,0.25,4,4486890,4486857,cPa260-cPa223-hybrid_EIAV_NC001450-cPa223-hybrid_WDSV_NC001867_WDSV_NC001867-cPa223-hybrid,1_1_1_1,102,33
chr18-4579833_4579935,cPa75,1,1,4579885,4579883,cPa75,2,102,2
chr18-4580076_4580189,cPa75,1,1,4580137,4580126,cPa75,2,113,11
chr18-4580521_4580623,cPa75,1,1,4580571,4580571,cPa75,1,102,0
chr18-4580873_4580975,cPa75,1,1,4580923,4580923,cPa75,1,102,0
chr18-4582821_4582993,cPa62,1,1,4582941,4582861,cPa62,7,172,80
chr18-4583295_4583397,cPa62,1,1,4583345,4583334,cPa62,2,102,11
chr18-4583498_4583607,cPa62,1,1,4583564,4583533,cPa62,4,109,31
chr18-4599410_4599512,cPa75-unknown,0.666666666666667,3,4599481,4599417,cPa75_cPa75-ALV_NC001408-hybrid_cPa75-unknown,1_1_4,102,64
chr18-4623090_4623273,WDSV_NC001867,1,1,4623221,4623140,WDSV_NC001867,2,183,81
chr18-4628686_4628788,cPa62,1,1,4628772,4628736,cPa62,2,102,36
chr18-4628894_4628996,cPa62,0.857142857142857,2,4628951,4628937,cPa62_cPa62-cPa75-hybrid,6_1,102,14
chr18-4631882_4631984,cPa62,1,1,4631932,4631932,cPa62,1,102,0
chr18-4666476_4666578,cPa75-cPa568-hybrid,0.6,3,4666548,4666507,cPa75_cPa75-cPa323-hybrid_cPa75-cPa568-hybrid,1_1_3,102,41
chr18-4666600_4666790,cPa75-cPa568-hybrid,0.5,4,4666738,4666650,cPa371-cPa568-hybrid_cPa75-cPa323-hybrid_cPa75-cPa333-hybrid_cPa75-cPa568-hybrid,1_1_1_3,190,88
chr18-4669913_4670037,cPa62,1,1,4669985,4669963,cPa62,3,124,22
chr18-4705855_4705957,cPa62,0.384615384615385,5,4705945,4705868,cPa62_cPa62-cPa67-hybrid_cPa62-cPa75-hybrid_cPa62-unknown_cPa75,5_1_3_2_2,102,77
chr18-4705984_4706086,cPa62-cPa75-hybrid,0.5,4,4706068,4706030,cPa62_cPa62-cPa75-hybrid_cPa62-unknown_cPa75,1_3_1_1,102,38
chr18-4719933_4720035,cPa75,0.75,2,4720008,4719950,cPa285-unknown_cPa75,1_3,102,58
chr18-4720042_4720144,cPa285_cPa75-cPa62-hybrid,0.5,2,4720092,4720044,cPa285_cPa75-cPa62-hybrid,1_1,102,48
chr18-4724_4826,cPa449,0.619047619047619,7,4826,4739,cPa419_cPa449_cPa449-cPa16-hybrid_cPa449-cPa285-hybrid_cPa449-cPa446-hybrid_cPa449-unknown_HML7_repbase_HERVK11DI_MER11D,2_13_1_2_1_1_1,102,87
chr18-4725111_4725213,cPa75-unknown,0.857142857142857,2,4725188,4725146,cPa75-cPa260-hybrid_cPa75-unknown,1_6,102,42
chr18-4725351_4725453,cPa75-cPa260-hybrid_cPa75-unknown,0.5,2,4725434,4725354,cPa75-cPa260-hybrid_cPa75-unknown,5_5,102,80
chr18-4734971_4735304,cPa62,0.941176470588235,2,4735301,4734980,cPa293-cPa75-hybrid_cPa62,1_16,333,321
chr18-4763450_4763586,cPa260,0.6,3,4763535,4763500,CAEV_NC001463_cPa260_PERVC_HM159246,1_3_1,136,35
chr18-4775061_4775213,cPa75,1,1,4775177,4775111,cPa75,3,152,66
chr18-4775265_4775489,cPa75,1,1,4775465,4775315,cPa75,5,224,150
chr18-4775516_4775618,cPa75,1,1,4775566,4775566,cPa75,1,102,0
chr18-4792668_4792811,cPa75,1,1,4792759,4792718,cPa75,2,143,41
chr18-4792872_4792980,cPa75,1,1,4792928,4792922,cPa75,3,108,6
chr18-4792994_4793096,cPa75,1,1,4793044,4793044,cPa75,1,102,0
chr18-4793270_4793381,cPa75,1,1,4793329,4793320,cPa75,2,111,9
chr18-4793913_4794104,cPa75,1,1,4794052,4793963,cPa75,7,191,89
chr18-4932699_4932801,cPa75,1,1,4932749,4932749,cPa75,1,102,0
chr18-4954633_4954854,cPa75,1,1,4954802,4954683,cPa75,3,221,119
chr18-4954975_4955248,cPa75,1,1,4955196,4955025,cPa75,3,273,171
chr18-4955277_4955379,cPa75,1,1,4955327,4955327,cPa75,1,102,0
chr18-5031320_5031446,cPa75,1,1,5031394,5031370,cPa75,4,126,24
chr18-5031530_5031632,cPa62-cPa75-hybrid_cPa75,0.5,2,5031582,5031580,cPa62-cPa75-hybrid_cPa75,1_1,102,2
chr18-5032156_5032258,cPa75,1,1,5032206,5032206,cPa75,1,102,0
chr18-5032803_5032905,cPa62-cPa75-hybrid,1,1,5032853,5032853,cPa62-cPa75-hybrid,1,102,0
chr18-5106685_5106787,cPa434,1,1,5106768,5106735,cPa434,2,102,33
chr18-5206556_5206658,cPa117,1,1,5206606,5206606,cPa117,1,102,0
chr18-5569526_5569719,cPa75,0.833333333333333,2,5569667,5569576,cPa75_REV_NC006934-cPa75-hybrid,5_1,193,91
chr18-557550_557652,cPa199,0.666666666666667,2,557631,557600,cPa199_cPa345,2_1,102,31
chr18-5736_6002,cPa419,0.552631578947368,17,5950,5772,cPa16-cPa419-hybrid_cPa419_cPa449-cPa419-hybrid_GaLV_M26927_HERV-W_repbase_HERV17_LTR17_HERV-W_repbase_HERV17_LTR17-cPa285-hybrid_HERV-W_repbase_HERV17_LTR17-cPa419-hybrid_HERV-W_repbase_HERV17_LTR17-HML2_repbase_HERVK_LTR5-hybrid_HERV-W_repbase_HERV17_LTR17-unknown_HML4_repbase_HERVK13I_LTR13-cPa419-hybrid_HML4_repbase_HERVK13I_LTR13-cPa449-hybrid_KoRV_AF151794-unknown_MLV_Xmv43-cPa419-hybrid_MSEV_CT990572-HML2_repbase_HERVK_LTR5-hybrid_PERV_AJ293656-unknown_PERVC_HM159246-cPa419-hybrid_SIV_NC001870-unknown,1_42_1_2_1_1_7_1_9_2_1_2_1_1_1_2_1,266,178
chr18-59758_59860,cPa117,1,1,59835,59808,cPa117,2,102,27
chr18-6041_6321,cPa419,0.466666666666667,4,6287,6042,cPa419_HERV-W_repbase_HERV17_LTR17-cPa419-hybrid_HERV-W_repbase_HERV17_LTR17-unknown_SIV_NC001870-unknown,14_8_7_1,280,245
chr18-6438_6613,cPa419,0.8,2,6589,6488,cPa419_GaLV_M26927-cPa419-hybrid,4_1,175,101
chr18-6511981_6512083,cPa75,1,1,6512031,6512031,cPa75,1,102,0
chr18-6523803_6523905,cPa456,1,1,6523853,6523853,cPa456,1,102,0
chr18-6570564_6570860,cPa75,1,1,6570848,6570614,cPa75,17,296,234
chr18-6599143_6599245,cPa75-unknown,1,1,6599193,6599193,cPa75-unknown,1,102,0
chr18-6704_6806,cPa419,1,1,6794,6754,cPa419,2,102,40
chr18-6735295_6735397,cPa75,1,1,6735345,6735345,cPa75,1,102,0
chr18-6783511_6783613,cPa62,1,1,6783563,6783556,cPa62,3,102,7
chr18-6835871_6835973,cPa543-unknown,1,1,6835921,6835921,cPa543-unknown,1,102,0
chr18-7085_7187,cPa419,1,1,7186,7135,cPa419,4,102,51
chr18-7162629_7162731,cPa75,1,1,7162679,7162679,cPa75,1,102,0
chr18-7193626_7193778,WDSV_NC001867-cPa62-hybrid,0.392857142857143,4,7193776,7193676,cPa62_WDSV_NC001867_WDSV_NC001867-cPa62-hybrid_WDSV_NC001867-unknown,5_10_11_2,152,100
chr18-7337464_7337566,cPa443,0.503937007874016,11,7337565,7337481,cPa118_cPa140_cPa140-cPa264-hybrid_cPa140-cPa486-hybrid_cPa140-unknown_cPa248_cPa248-unknown_cPa248-WDSV_NC001867-hybrid_cPa264_cPa443_cPa443-unknown,1_12_1_1_6_31_7_1_1_64_2,102,84
chr18-7365944_7366046,WDSV_NC001867,1,1,7366010,7365994,WDSV_NC001867,2,102,16
chr18-7387257_7387359,cPa62-WDSV_NC001867-hybrid,1,1,7387307,7387307,cPa62-WDSV_NC001867-hybrid,1,102,0
chr18-7387489_7387591,cPa62,0.666666666666667,2,7387539,7387490,cPa62_cPa62-cPa254-hybrid,2_1,102,49
chr18-746550_746652,cPa62-unknown,0.4,4,746616,746598,cPa62_cPa62-unknown_cPa75_MSEV_CT990572-cPa75-hybrid,1_2_1_1,102,18
chr18-7687306_7687408,cPa62,0.933333333333333,2,7687404,7687326,cPa62_cPa62-unknown,28_2,102,78
chr18-7745_8049,cPa419,1,1,8044,7755,cPa419,51,304,289
chr18-7804653_7804755,cPa75,1,1,7804703,7804703,cPa75,1,102,0
chr18-7860194_7860296,cPa254-cPa502-hybrid_cPa293-cPa502-hybrid,0.5,2,7860267,7860244,cPa254-cPa502-hybrid_cPa293-cPa502-hybrid,2_2,102,23
chr18-7863682_7863786,cPa419,1,1,7863741,7863718,cPa419,7,104,23
chr18-7863966_7864068,cPa419,1,1,7864016,7864016,cPa419,1,102,0
chr18-7867956_7868058,cPa419,0.5,4,7868007,7867957,cPa117_cPa419_cPa542-HERV-W_repbase_HERV17_LTR17-hybrid_cPa542-STLV2_NC001815-hybrid,1_3_1_1,102,50
chr18-7868153_7868273,cPa419,0.5,3,7868260,7868155,cPa419_cPa542-cPa158-hybrid_RELIK_ERVK,3_2_1,120,105
chr18-7868744_7868852,cPa542-cPa158-hybrid,0.393939393939394,8,7868810,7868747,cPa117-cPa158-hybrid_cPa158_cPa419_cPa419-cPa530-hybrid_cPa542-cPa158-hybrid_cPa542-cPa530-hybrid_cPa542-MER52A_repbase_MER52AI_MER52A-hybrid_cPa542-unknown,1_3_7_1_13_1_1_6,108,63
chr18-7868879_7869044,cPa158,0.727272727272727,5,7868992,7868929,cPa158_cPa419_cPa542-cPa158-hybrid_cPa542-HML3_repbase_HERVK9I_MER9-hybrid_HML3_repbase_HERVK9I_MER9,16_2_2_1_1,165,63
chr18-7870477_7870666,cPa190,0.986111111111111,2,7870616,7870527,cPa190_cPa190-unknown,71_1,189,89
chr18-7909277_7909379,cPa75,1,1,7909327,7909327,cPa75,1,102,0
chr18-7909612_7909714,cPa75,1,1,7909699,7909662,cPa75,2,102,37
chr18-8154492_8154594,cPa113,0.75,2,8154544,8154507,cPa113_cPa67,3_1,102,37
chr18-8191887_8192076,cPa62,0.888888888888889,2,8192024,8191903,cPa62_WDSV_NC001867,8_1,189,121
chr18-8195761_8195960,cPa62,0.368421052631579,7,8195946,8195761,cPa113_cPa62_cPa62-unknown_cPa75_cPa75-PERVC_HM159246-hybrid_cPa75-unknown_PERVC_HM159246,2_7_2_3_1_3_1,199,185
chr18-8541501_8541606,cPa15,0.444444444444444,3,8541573,8541527,cPa118_cPa15_cPa268,3_4_2,105,46
chr18-9043839_9043941,cPa199,1,1,9043938,9043889,cPa199,3,102,49
chr18-9091735_9091837,cPa452,0.583333333333333,3,9091785,9091758,cPa363_cPa452_cPa71,4_7_1,102,27
chr18-9139840_9139965,cPa75-unknown,1,1,9139913,9139857,cPa75-unknown,7,125,56
chr18-9165369_9165471,cPa67,0.6,3,9165426,9165395,cPa194_cPa67_cPa67-cPa194-hybrid,1_3_1,102,31
chr18-9457262_9457364,WDSV_NC001867,1,1,9457312,9457312,WDSV_NC001867,1,102,0
chr18-9699801_9699903,cPa75,0.666666666666667,3,9699889,9699824,cPa285-cPa260-hybrid_cPa75_cPa75-cPa260-hybrid,1_4_1,102,65
chr18-9700183_9700320,cPa75,0.636363636363636,4,9700310,9700207,cPa62_cPa62-cPa293-hybrid_cPa62-cPa413-hybrid_cPa75,2_1_1_7,137,103
chr18-9700360_9700462,cPa75,0.75,2,9700458,9700396,cPa62_cPa75,1_3,102,62
chr18-9700498_9700600,cPa75,0.714285714285714,3,9700593,9700513,cPa62_cPa62-cPa75-hybrid_cPa75,1_1_5,102,80
chr18-9700624_9700726,cPa75,1,1,9700674,9700674,cPa75,1,102,0
chr18-9796999_9797101,cPa363_cPa452,0.434782608695652,4,9797082,9797047,cPa363_cPa452_cPa71_cPa71-unknown,10_10_2_1,102,35
chr18-9811207_9811309,cPa62-SMRV_NC001514-hybrid_cPa75-unknown,0.5,2,9811257,9811246,cPa62-SMRV_NC001514-hybrid_cPa75-unknown,1_1,102,11
chr18-9811416_9811518,SMRV_NC001514,0.666666666666667,2,9811466,9811432,cPa75-cPa260-hybrid_SMRV_NC001514,1_2,102,34
chr18-9844914_9845016,cPa67,0.416666666666667,5,9844994,9844915,cPa194-cPa339-hybrid_cPa194-cPa345-hybrid_cPa194-unknown_cPa345_cPa67,1_2_1_3_5,102,79
chr18-9892182_9892317,cPa75-cPa260-hybrid,0.6,4,9892287,9892195,cPa260_cPa75-cPa260-hybrid_cPa75-HTLV2_M10060-hybrid_cPa75-unknown,2_6_1_1,135,92
chr18-9896955_9897057,cPa15,0.8,3,9897010,9896995,cPa15_cPa268-cPa140-hybrid_cPa75-cPa118-hybrid,8_1_1,102,15
chr18-9942844_9942946,WDSV_NC001867,0.454545454545455,3,9942932,9942882,cPa62_cPa62-WDSV_NC001867-hybrid_WDSV_NC001867,2_4_5,102,50
chr18-9953421_9953645,cPa75,1,1,9953593,9953471,cPa75,4,224,122
chr19-10059622_10059724,cPa62,1,1,10059677,10059670,cPa62,4,102,7
chr19-10328720_10328822,cPa75,1,1,10328770,10328746,cPa75,2,102,24
chr19-10329190_10329333,cPa75,1,1,10329289,10329240,cPa75,4,143,49
chr19-10329500_10329860,cPa75,1,1,10329808,10329550,cPa75,14,360,258
chr19-10584868_10584970,cPa75,1,1,10584926,10584888,cPa75,5,102,38
chr19-11158027_11158129,cPa293,1,1,11158077,11158077,cPa293,1,102,0
chr19-1132198_1132300,cPa345,0.857142857142857,2,1132267,1132207,cPa345_cPa527,6_1,102,60
chr19-1147073_1147214,cPa254,0.26865671641791,11,1147162,1147072,cPa174_cPa254_cPa254-cPa174-hybrid_cPa254-unknown_cPa392_cPa425_cPa425-cPa174-hybrid_cPa47_cPa47-cPa174-hybrid_cPa47-cPa425-hybrid_cPa47-unknown,10_18_3_1_4_10_1_8_2_2_8,141,90
chr19-1362561_1362663,WDSV_NC001867,1,1,1362611,1362611,WDSV_NC001867,1,102,0
chr19-1362789_1362891,cPa62-unknown,0.666666666666667,2,1362839,1362835,cPa62-unknown_WDSV_NC001867,2_1,102,4
chr19-1630989_1631091,cPa539,1,1,1631091,1631039,cPa539,2,102,52
chr19-1650045_1650147,cPa75,1,1,1650095,1650095,cPa75,1,102,0
chr19-1650178_1650280,cPa75_cPa75-unknown,0.5,2,1650228,1650209,cPa75_cPa75-unknown,1_1,102,19
chr19-1660230_1660332,cPa16,0.631578947368421,3,1660331,1660239,cPa16_cPa379_cPa71-cPa379-hybrid,12_6_1,102,92
chr19-1711582_1711684,cPa67,0.6,3,1711632,1711593,cPa67_cPa75-cPa113-hybrid_cPa75-unknown,3_1_1,102,39
chr19-1750337_1750439,cPa345,0.225806451612903,22,1750387,1750354,cPa199_cPa199-cPa450-hybrid_cPa199-cPa542-hybrid_cPa199-cPa553-hybrid_cPa199-unknown_cPa223_cPa227_cPa227-cPa450-hybrid_cPa273_cPa273-cPa345-hybrid_cPa273-cPa450-hybrid_cPa273-cPa542-hybrid_cPa273-unknown_cPa345_cPa450_cPa542_cPa542-cPa345-hybrid_cPa553_cPa553-cPa227-hybrid_cPa553-cPa345-hybrid_cPa553-cPa450-hybrid_cPa553-cPa542-hybrid,9_1_1_1_1_2_8_1_12_1_1_1_1_21_7_3_1_17_1_1_1_1,102,33
chr19-1877675_1877777,cPa75-unknown,0.75,2,1877762,1877717,cPa482-cPa260-hybrid_cPa75-unknown,1_3,102,45
chr19-1877902_1878004,cPa75-unknown,1,1,1877985,1877931,cPa75-unknown,4,102,54
chr19-1913626_1913736,cPa293_cPa391,0.5,2,1913684,1913676,cPa293_cPa391,1_1,110,8
chr19-1928145_1928250,cPa62-cPa450-hybrid,0.363636363636364,7,1928241,1928147,cPa345_cPa450_cPa553-cPa273-hybrid_cPa62-cPa273-hybrid_cPa62-cPa450-hybrid_cPa62-cPa542-hybrid_cPa62-cPa553-hybrid,1_1_1_1_4_1_2,105,94
chr19-1930544_1930646,cPa62,0.75,2,1930594,1930545,cPa62_cPa62-cPa67-hybrid,3_1,102,49
chr19-1988967_1989069,cPa227_cPa345,0.25,7,1989050,1989002,cPa199_cPa199-cPa227-hybrid_cPa227_cPa345_cPa345-cPa505-hybrid_cPa450_cPa450-cPa227-hybrid,1_2_3_3_1_1_1,102,48
chr19-2238208_2238328,cPa402,0.666666666666667,2,2238276,2238258,cPa402_cPa74,2_1,120,18
chr19-235993_236095,cPa323,1,1,236043,236043,cPa323,1,102,0
chr19-2360977_2361079,cPa228-unknown,1,1,2361027,2361027,cPa228-unknown,1,102,0
chr19-2361139_2361241,cPa228,1,1,2361237,2361189,cPa228,4,102,48
chr19-236292_236473,cPa323_cPa371,0.5,2,236421,236312,cPa323_cPa371,3_3,181,109
chr19-236542_236732,cPa323_cPa371,0.5,2,236717,236592,cPa323_cPa371,2_2,190,125
chr19-239513_239642,cPa446,0.666666666666667,2,239590,239563,cPa379_cPa446,1_2,129,27
chr19-239755_239857,cPa446-cPa363-hybrid,1,1,239805,239805,cPa446-cPa363-hybrid,1,102,0
chr19-239870_239972,cPa379_cPa446_cPa452,0.333333333333333,3,239920,239918,cPa379_cPa446_cPa452,1_1_1,102,2
chr19-2419549_2419654,cPa62-cPa273-hybrid,0.375,5,2419606,2419592,cPa450_cPa62_cPa62-cPa273-hybrid_cPa62-cPa450-hybrid_cPa62-cPa75-hybrid,1_2_3_1_1,105,14
chr19-2419657_2419809,cPa62-cPa273-hybrid,0.4,4,2419757,2419707,cPa62_cPa62-cPa273-hybrid_cPa62-cPa75-hybrid_cPa62-unknown,1_2_1_1,152,50
chr19-2419854_2419979,cPa450,0.416666666666667,7,2419949,2419899,cPa199_cPa199-cPa553-hybrid_cPa223-cPa273-hybrid_cPa450_cPa62-cPa273-hybrid_cPa62-cPa542-hybrid_cPa62-cPa553-hybrid,2_1_1_5_1_1_1,125,50
chr19-2424971_2425073,cPa223,0.666666666666667,3,2425052,2424994,cPa223_cPa223-cPa61-hybrid_cPa61,4_1_1,102,58
chr19-2477277_2477385,cPa75,1,1,2477333,2477327,cPa75,2,108,6
chr19-2477481_2477644,cPa75_cPa75-unknown,0.5,2,2477592,2477531,cPa75_cPa75-unknown,3_3,163,61
chr19-2927719_2927821,cPa174_cPa254,0.3,6,2927777,2927765,cPa174_cPa174-cPa254-hybrid_cPa174-cPa404-hybrid_cPa174-cPa47-hybrid_cPa254_cPa425-cPa404-hybrid,3_1_1_1_3_1,102,12
chr19-2959949_2960054,rRVRV_JQ303225-unknown,0.91304347826087,2,2960030,2959964,rRVRV_JQ303225-cPa539-hybrid_rRVRV_JQ303225-unknown,2_21,105,66
chr19-3023976_3024078,cPa323_cPa371,0.392857142857143,5,3024073,3024002,cPa323_cPa323-unknown_cPa371_cPa371-cPa323-hybrid_cPa371-unknown,11_1_11_2_3,102,71
chr19-3024309_3024411,cPa323,0.5,3,3024359,3024319,cPa323_cPa323-unknown_cPa371,2_1_1,102,40
chr19-3035889_3035991,cPa75-unknown,1,1,3035939,3035939,cPa75-unknown,1,102,0
chr19-3117243_3117345,cPa260,1,1,3117293,3117293,cPa260,1,102,0
chr19-3117407_3117509,cPa260,1,1,3117499,3117457,cPa260,2,102,42
chr19-3188871_3189050,cPa75-unknown,0.666666666666667,2,3188998,3188921,cPa75-cPa260-hybrid_cPa75-unknown,1_2,179,77
chr19-3232997_3233099,cPa413,0.944444444444444,2,3233074,3233004,cPa413_cPa419,17_1,102,70
chr19-3262215_3262317,cPa75,1,1,3262265,3262265,cPa75,1,102,0
chr19-3262960_3263062,cPa75,1,1,3263010,3263010,cPa75,1,102,0
chr19-3324992_3325094,cPa546,0.555555555555556,3,3325076,3325036,cPa450_cPa546_cPa75,2_5_2,102,40
chr19-3325113_3325215,cPa450,0.285714285714286,6,3325193,3325124,cPa450_cPa546_cPa62-cPa260-hybrid_cPa75_cPa75-cPa450-hybrid_cPa75-cPa546-hybrid,2_1_1_1_1_1,102,69
chr19-3368369_3368557,cPa228_cPa260,0.5,2,3368505,3368419,cPa228_cPa260,1_1,188,86
chr19-3399162_3399264,cPa75,1,1,3399248,3399212,cPa75,2,102,36
chr19-3399465_3399567,cPa413_cPa75-unknown,0.5,2,3399515,3399467,cPa413_cPa75-unknown,1_1,102,48
chr19-3399606_3399708,cPa413,1,1,3399656,3399656,cPa413,1,102,0
chr19-3538323_3538425,cPa111-unknown_cPa285-cPa260-hybrid,0.5,2,3538405,3538373,cPa111-unknown_cPa285-cPa260-hybrid,1_1,102,32
chr19-3569108_3569210,cPa75-cPa15-hybrid,1,1,3569158,3569158,cPa75-cPa15-hybrid,1,102,0
chr19-3569458_3569560,cPa75,1,1,3569508,3569508,cPa75,1,102,0
chr19-3630799_3630929,cPa75,0.6,3,3630881,3630826,cPa62_cPa62-cPa75-hybrid_cPa75,1_3_6,130,55
chr19-3631093_3631195,cPa75,0.368421052631579,6,3631188,3631112,cPa260_cPa293_cPa62_cPa62-cPa293-hybrid_cPa62-cPa75-hybrid_cPa75,1_1_8_2_12_14,102,76
chr19-3631327_3631429,cPa75,0.75,2,3631400,3631331,cPa62-cPa75-hybrid_cPa75,1_3,102,69
chr19-3947400_3947502,cPa62,1,1,3947450,3947439,cPa62,3,102,11
chr19-4128768_4128870,cPa345,1,1,4128862,4128818,cPa345,7,102,44
chr19-413710_413866,cPa62,0.964285714285714,2,413814,413755,cPa109-unknown_cPa62,1_27,156,59
chr19-4207964_4208066,cPa419-cPa248-hybrid_cPa67,0.5,2,4208014,4207988,cPa419-cPa248-hybrid_cPa67,1_1,102,26
chr19-4208189_4208291,cPa456,0.75,2,4208261,4208191,cPa456_cPa67,3_1,102,70
chr19-4212007_4212170,cPa75,1,1,4212118,4212057,cPa75,2,163,61
chr19-4256539_4256650,cPa426,0.428571428571429,3,4256603,4256558,cPa293_cPa391_cPa426,2_2_3,111,45
chr19-4257008_4257110,cPa363_cPa452_cPa553,0.333333333333333,3,4257073,4257058,cPa363_cPa452_cPa553,1_1_1,102,15
chr19-4257646_4257748,cPa21-cPa75-hybrid,1,1,4257696,4257696,cPa21-cPa75-hybrid,1,102,0
chr19-4260684_4260786,cPa345,0.526315789473684,5,4260781,4260734,cPa345_cPa345-cPa62-hybrid_cPa345-unknown_cPa62_cPa62-cPa450-hybrid,10_1_4_3_1,102,47
chr19-4260891_4261226,cPa345,0.509803921568627,6,4261192,4260911,cPa247-cPa450-hybrid_cPa345_cPa345-cPa62-hybrid_cPa345-unknown_cPa62_cPa62-unknown,1_26_2_1_19_2,335,281
chr19-4363769_4363874,cPa118_cPa15,0.5,2,4363822,4363819,cPa118_cPa15,2_2,105,3
chr19-4445749_4445851,cPa67,0.571428571428571,2,4445819,4445764,cPa194_cPa67,3_4,102,55
chr19-4487382_4487497,cPa62,0.979166666666667,2,4487457,4487426,cPa62_PERVB_AY099324-cPa62-hybrid,47_1,115,31
chr19-4767618_4767720,cPa75,0.777777777777778,3,4767717,4767638,cPa260_cPa75_HERV-W_repbase_HERV17_LTR17-cPa75-hybrid,1_7_1,102,79
chr19-5045461_5045590,cPa75-unknown,1,1,5045562,5045461,cPa75-unknown,10,129,101
chr19-5163316_5163418,cPa75,1,1,5163366,5163366,cPa75,1,102,0
chr19-5299478_5299580,cPa62-cPa75-hybrid,1,1,5299528,5299528,cPa62-cPa75-hybrid,1,102,0
chr19-5300732_5300834,cPa62-cPa75-hybrid,1,1,5300782,5300782,cPa62-cPa75-hybrid,1,102,0
chr19-5301334_5301453,cPa75,1,1,5301412,5301343,cPa75,10,119,69
chr19-5504470_5504572,cPa199,0.4,4,5504565,5504520,cPa199_cPa273_cPa553_HERV-ADP_repbase_HERVP71A_I_LTR71A,2_1_1_1,102,45
chr19-5536493_5536595,cPa339-unknown,1,1,5536543,5536543,cPa339-unknown,1,102,0
chr19-5717895_5717997,cPa75,1,1,5717945,5717945,cPa75,1,102,0
chr19-5718001_5718103,cPa75,1,1,5718051,5718051,cPa75,1,102,0
chr19-5724476_5724578,cPa75,1,1,5724527,5724526,cPa75,2,102,1
chr19-5724640_5724742,cPa75,1,1,5724690,5724690,cPa75,1,102,0
chr19-5765490_5765592,cPa62,1,1,5765540,5765540,cPa62,1,102,0
chr19-5867471_5867573,cPa106-cPa482-hybrid_cPa199-cPa482-hybrid_cPa199-cPa539-hybrid,0.333333333333333,3,5867521,5867505,cPa106-cPa482-hybrid_cPa199-cPa482-hybrid_cPa199-cPa539-hybrid,1_1_1,102,16
chr19-5931940_5932042,cPa62,1,1,5931990,5931990,cPa62,1,102,0
chr19-6730243_6730345,cPa113,0.5,5,6730314,6730271,cPa113_cPa67_cPa67-cPa113-hybrid_HERV-W_repbase_HERV17_LTR17_HERV-W_repbase_HERV17_LTR17-cPa62-hybrid,4_1_1_1_1,102,43
chr19-71977_72079,cPa371,0.6,2,72078,72015,cPa323_cPa371,2_3,102,63
chr19-7198589_7198691,cPa285,1,1,7198639,7198639,cPa285,1,102,0
chr19-7212247_7212433,cPa75,1,1,7212381,7212297,cPa75,3,186,84
chr19-7212720_7212828,cPa75,1,1,7212776,7212765,cPa75,11,108,11
chr19-72348_72450,cPa371,1,1,72398,72398,cPa371,1,102,0
chr19-72460_72562,cPa323-cPa371-hybrid,1,1,72510,72510,cPa323-cPa371-hybrid,1,102,0
chr19-760367_760482,cPa308-unknown,0.526315789473684,3,760450,760386,cPa308_cPa308-cPa75-hybrid_cPa308-unknown,3_6_10,115,64
chr19-8240628_8240730,cPa62,0.636363636363636,3,8240687,8240636,cPa62_cPa75_cPa75-cPa62-hybrid,7_2_2,102,51
chr19-8256178_8256306,cPa539,0.5,3,8256301,8256228,cPa199_cPa419_cPa539,3_1_4,128,73
chr19-8533415_8533517,cPa75,0.8,2,8533516,8533418,cPa75_cPa75-unknown,4_1,102,98
chr19-875567_875669,cPa419_cPa419-unknown,0.5,2,875617,875616,cPa419_cPa419-unknown,1_1,102,1
chr19-881_983,cPa356,0.52,2,946,907,cPa356_cPa428,13_12,102,39
chr19-882659_882800,cPa268,0.666666666666667,2,882788,882709,cPa268_cPa268-unknown,2_1,141,79
chr19-882895_882997,cPa268,1,1,882945,882939,cPa268,10,102,6
chr19-8838553_8838655,cPa118_cPa15,0.5,2,8838603,8838603,cPa118_cPa15,1_1,102,0
chr19-894639_894741,cPa419,1,1,894689,894689,cPa419,1,102,0
chr19-9408773_9408884,cPa62,1,1,9408832,9408812,cPa62,13,111,20
chr19-9408902_9409004,cPa419_cPa62,0.5,2,9408952,9408940,cPa419_cPa62,1_1,102,12
chr19-9699171_9699273,cPa62,1,1,9699221,9699219,cPa62,2,102,2
chr19-9712038_9712140,cPa75,1,1,9712088,9712088,cPa75,1,102,0
chr19-975287_975389,cPa75,1,1,975337,975326,cPa75,2,102,11
chr19-9783049_9783151,cPa62-WDSV_NC001867-hybrid,1,1,9783099,9783099,cPa62-WDSV_NC001867-hybrid,1,102,0
chr19-9783224_9783326,cPa62-WDSV_NC001867-hybrid,0.8,2,9783325,9783261,cPa62-WDSV_NC001867-hybrid_WDSV_NC001867,4_1,102,64
chr19-9783623_9783795,cPa62-unknown,0.5,4,9783788,9783634,cPa62_cPa62-unknown_cPa62-WDSV_NC001867-hybrid_WDSV_NC001867,1_7_4_2,172,154
chr19-9850656_9851015,HERV-W_repbase_HERV17_LTR17,0.979591836734694,2,9851006,9850658,HERV-W_repbase_HERV17_LTR17_MLV_Xmv43,48_1,359,348
chr19-98534_98636,cPa395-unknown_cPa419,0.5,2,98587,98535,cPa395-unknown_cPa419,2_2,102,52
chr1A-10012261_10012404,cPa450,0.505747126436782,13,10012400,10012300,cPa199_cPa199-cPa553-hybrid_cPa227_cPa273_cPa273-cPa199-hybrid_cPa273-cPa227-hybrid_cPa450_cPa542_cPa542-cPa199-hybrid_cPa542-cPa553-hybrid_cPa542-unknown_cPa553_cPa553-unknown,2_1_14_4_1_1_44_1_1_1_1_15_1,143,100
chr1A-1020986_1021114,cPa194,0.714285714285714,3,1021071,1021024,cPa109_cPa194_cPa194-cPa67-hybrid,1_5_1,128,47
chr1A-10216389_10216504,cPa62,0.85,4,10216455,10216390,cPa254_cPa62_cPa62-cPa254-hybrid_cPa62-unknown,1_17_1_1,115,65
chr1A-10216615_10216717,cPa62,0.8,3,10216686,10216643,cPa254_cPa62_cPa62-cPa254-hybrid,2_12_1,102,43
chr1A-10327955_10328057,cPa62-HERV-W_repbase_HERV17_LTR17-hybrid,0.6,3,10328054,10327968,cPa62-HERV-W_repbase_HERV17_LTR17-hybrid_HERV-W_repbase_HERV17_LTR17_KWERV_GQ222416,3_1_1,102,86
chr1A-10328062_10328216,cPa62-HERV-W_repbase_HERV17_LTR17-hybrid,0.6,5,10328204,10328066,cPa62-HERV-W_repbase_HERV17_LTR17-hybrid_cPa75_HERV-W_repbase_HERV17_LTR17_KWERV_GQ222416_KWERV_GQ222416-HERV-W_repbase_HERV17_LTR17-hybrid,9_1_3_1_1,154,138
chr1A-10328525_10328657,cPa62-HERV-W_repbase_HERV17_LTR17-hybrid,1,1,10328605,10328537,cPa62-HERV-W_repbase_HERV17_LTR17-hybrid,4,132,68
chr1A-10328915_10329017,HERV-W_repbase_HERV17_LTR17,0.714285714285714,2,10329014,10328944,cPa62-HERV-W_repbase_HERV17_LTR17-hybrid_HERV-W_repbase_HERV17_LTR17,2_5,102,70
chr1A-10333346_10333478,cPa255,0.170731707317073,16,10333466,10333349,cPa131_cPa131-cPa255-hybrid_cPa131-cPa438-hybrid_cPa150-cPa255-hybrid_cPa150-cPa438-hybrid_cPa255_cPa260_cPa260-cPa255-hybrid_cPa419_cPa479_cPa62_cPa75_cPa75-cPa255-hybrid_cPa75-cPa438-hybrid_cPa75-cPa479-hybrid_cPa75-cPa62-hybrid,4_1_2_2_2_7_1_1_1_4_1_3_4_2_2_4,132,117
chr1A-1034343_1034619,WDSV_NC001867,0.5,5,1034590,1034393,cPa62_cPa62-cPa529-hybrid_cPa62-unknown_cPa62-WDSV_NC001867-hybrid_WDSV_NC001867,1_1_3_1_6,276,197
chr1A-1034813_1034915,WDSV_NC001867,1,1,1034863,1034863,WDSV_NC001867,1,102,0
chr1A-10422875_10422977,cPa62,1,1,10422925,10422925,cPa62,1,102,0
chr1A-10423030_10423136,cPa62,0.954545454545455,2,10423087,10423050,cPa62_cPa62-unknown,21_1,106,37
chr1A-1042312_1042414,cPa426,1,1,1042362,1042362,cPa426,1,102,0
chr1A-1063984_1064086,WDSV_NC001867,1,1,1064034,1064034,WDSV_NC001867,1,102,0
chr1A-10872437_10872539,cPa392_cPa47,0.284210526315789,13,10872529,10872452,cPa254_cPa254-cPa174-hybrid_cPa254-cPa392-hybrid_cPa254-cPa404-hybrid_cPa254-cPa425-hybrid_cPa254-cPa47-hybrid_cPa254-unknown_cPa392_cPa392-cPa425-hybrid_cPa404_cPa425_cPa425-unknown_cPa47,11_3_1_1_1_1_1_27_1_1_17_3_27,102,77
chr1A-1093699_1093801,cPa75,1,1,1093749,1093749,cPa75,1,102,0
chr1A-11016092_11016291,cPa75,0.285714285714286,6,11016239,11016094,cPa113-cPa75-hybrid_cPa67-FeFV_NC001871-hybrid_cPa75_cPa75-HERV-W_repbase_HERV17_LTR17-hybrid_HTLV1_NC001436-cPa75-hybrid_KWERV_GQ222416-cPa113-hybrid,1_1_2_1_1_1,199,145
chr1A-11016590_11016813,cPa75,0.4,6,11016781,11016640,cPa113_cPa113-cPa75-hybrid_cPa113-FeFV_NC001871-hybrid_cPa62-HERV-W_repbase_HERV17_LTR17-hybrid_cPa75_cPa75-cPa113-hybrid,2_1_1_1_4_1,223,141
chr1A-11017008_11017327,cPa75,0.411764705882353,9,11017279,11017058,cPa113_cPa113-cPa75-hybrid_cPa113-HERV-W_repbase_HERV17_LTR17-hybrid_cPa62_cPa62-HERV-W_repbase_HERV17_LTR17-hybrid_cPa75_cPa75-cPa113-hybrid_cPa75-HTLV1_NC001436-hybrid_HERV-W_repbase_HERV17_LTR17,1_1_1_1_2_7_1_1_2,319,221
chr1A-11160848_11160950,cPa363,1,1,11160898,11160898,cPa363,1,102,0
chr1A-1117491_1117593,cPa111,1,1,1117541,1117541,cPa111,1,102,0
chr1A-11212106_11212217,cPa15,0.454545454545455,5,11212165,11212123,cPa118_cPa118-cPa264-hybrid_cPa15_cPa248-cPa264-hybrid_cPa248-unknown,3_1_5_1_1,111,42
chr1A-11215417_11215519,cPa555-cPa257-hybrid,0.5,3,11215479,11215467,cPa546-cPa257-hybrid_cPa555-cPa257-hybrid_cPa555-cPa285-hybrid,2_3_1,102,12
chr1A-11221537_11221639,cPa456,1,1,11221587,11221540,cPa456,3,102,47
chr1A-11229516_11229618,cPa392,1,1,11229591,11229566,cPa392,3,102,25
chr1A-11231225_11231327,EqFV_NC002201,1,1,11231275,11231275,EqFV_NC002201,1,102,0
chr1A-11236364_11236599,cPa392,0.941176470588235,2,11236586,11236405,cPa392_cPa392-unknown,16_1,235,181
chr1A-11241650_11241752,cPa392,1,1,11241750,11241665,cPa392,23,102,85
chr1A-11242279_11242381,cPa392,1,1,11242329,11242329,cPa392,1,102,0
chr1A-11242455_11242557,cPa392,1,1,11242518,11242505,cPa392,2,102,13
chr1A-11242565_11242667,cPa392,1,1,11242667,11242580,cPa392,7,102,87
chr1A-11437518_11437651,cPa518-unknown,1,1,11437599,11437567,cPa518-unknown,6,133,32
chr1A-1147009_1147165,cPa199,0.411764705882353,7,1147120,1147047,cPa199_cPa482_cPa482-cPa505-hybrid_cPa505_cPa505-cPa199-hybrid_cPa505-unknown_cPa539,7_2_1_3_1_1_2,156,73
chr1A-1156824_1157076,cPa260,0.785714285714286,3,1157034,1156853,cPa260_cPa323_cPa323-cPa260-hybrid,22_5_1,252,181
chr1A-11688166_11688268,cPa541,0.352941176470588,6,11688216,11688201,cPa18_cPa18-cPa104-hybrid_cPa4_cPa541_cPa541-cPa104-hybrid_cPa545-cPa104-hybrid,1_1_5_6_2_2,102,15
chr1A-1183292_1183394,cPa260,1,1,1183342,1183342,cPa260,1,102,0
chr1A-12099170_12099365,cPa75-unknown,0.75,2,12099313,12099220,cPa62-unknown_cPa75-unknown,1_3,195,93
chr1A-1214955_1215312,cPa199,0.606060606060606,7,1215266,1214960,cPa109_cPa199_cPa199-unknown_cPa201_cPa482_cPa505-cPa539-hybrid_cPa539,1_20_1_1_2_1_7,357,306
chr1A-12221534_12221636,cPa62,0.941176470588235,3,12221588,12221567,cPa419_cPa62_cPa62-unknown,1_48_2,102,21
chr1A-12335598_12335700,cPa62,1,1,12335649,12335637,cPa62,6,102,12
chr1A-1244153_1244270,cPa62-cPa260-hybrid_cPa75_cPa75-cPa260-hybrid_cPa75-cPa425-hybrid_cPa75-unknown,0.2,5,1244218,1244192,cPa62-cPa260-hybrid_cPa75_cPa75-cPa260-hybrid_cPa75-cPa425-hybrid_cPa75-unknown,1_1_1_1_1,117,26
chr1A-12477437_12477545,cPa219-cPa104-hybrid,0.25,8,12477545,12477449,cPa104_cPa18-cPa104-hybrid_cPa18-unknown_cPa190_cPa219_cPa219-cPa104-hybrid_cPa219-unknown_cPa220,3_1_1_3_2_4_1_1,108,96
chr1A-12576138_12576254,cPa254_cPa425_cPa47,0.25,5,12576202,12576188,cPa174_cPa174-cPa404-hybrid_cPa254_cPa425_cPa47,1_1_2_2_2,116,14
chr1A-126822_126924,cPa75,1,1,126872,126872,cPa75,1,102,0
chr1A-1276760_1276871,cPa444,0.577777777777778,9,1276821,1276780,cPa199_cPa339_cPa339-cPa199-hybrid_cPa339-cPa444-hybrid_cPa345_cPa444_cPa447_cPa482-cPa199-hybrid_cPa553,2_5_5_1_1_26_2_2_1,111,41
chr1A-12972368_12972470,cPa285_cPa62-unknown,0.5,2,12972418,12972400,cPa285_cPa62-unknown,1_1,102,18
chr1A-129891_129998,cPa75,1,1,129950,129941,cPa75,7,107,9
chr1A-12994901_12995003,cPa117,1,1,12994967,12994951,cPa117,2,102,16
chr1A-131008_131110,cPa75,1,1,131058,131058,cPa75,1,102,0
chr1A-13127950_13128061,cPa117-cPa587-hybrid_cPa363_cPa452-cPa587-hybrid_cPa456,0.25,4,13128009,13128000,cPa117-cPa587-hybrid_cPa363_cPa452-cPa587-hybrid_cPa456,1_1_1_1,111,9
chr1A-13226030_13226132,cPa452,0.461538461538462,4,13226084,13226034,cPa16-cPa446-hybrid_cPa363_cPa452_cPa71,1_4_6_2,102,50
chr1A-132338_132440,cPa75,1,1,132388,132388,cPa75,1,102,0
chr1A-13314394_13314496,cPa174_cPa254_cPa47-cPa404-hybrid,0.333333333333333,3,13314451,13314444,cPa174_cPa254_cPa47-cPa404-hybrid,1_1_1,102,7
chr1A-13386359_13386461,cPa254,1,1,13386420,13386409,cPa254,2,102,11
chr1A-13582675_13582777,cPa419,1,1,13582725,13582725,cPa419,1,102,0
chr1A-1363789_1363891,cPa419,1,1,1363839,1363839,cPa419,1,102,0
chr1A-14021090_14021192,cPa62,0.925925925925926,3,14021167,14021119,cPa62_cPa62-unknown_cPa75-cPa62-hybrid,25_1_1,102,48
chr1A-1405401_1405503,cPa539,0.6,3,1405453,1405435,cPa199-cPa539-hybrid_cPa539_cPa539-cPa199-hybrid,1_3_1,102,18
chr1A-1415654_1415756,cPa75,1,1,1415704,1415704,cPa75,1,102,0
chr1A-1421668_1421770,cPa75,1,1,1421718,1421718,cPa75,1,102,0
chr1A-1421777_1422053,cPa75,1,1,1422001,1421827,cPa75,7,276,174
chr1A-1424704_1424806,cPa62,1,1,1424754,1424754,cPa62,1,102,0
chr1A-1424860_1424962,cPa62,1,1,1424910,1424871,cPa62,2,102,39
chr1A-1425140_1425298,cPa62,0.888888888888889,2,1425246,1425163,cPa62_cPa62-unknown,8_1,158,83
chr1A-14372864_14372973,cPa15,0.75,3,14372921,14372896,cPa118_cPa15_cPa268,1_6_1,109,25
chr1A-1460798_1460900,cPa260,0.473684210526316,5,1460865,1460798,cPa260_cPa260-cPa75-hybrid_cPa260-unknown_cPa523_cPa523-cPa75-hybrid,9_1_6_1_2,102,67
chr1A-1473515_1473617,cPa106,0.5,5,1473565,1473527,cPa106_cPa106-unknown_cPa194-cPa293-hybrid_cPa194-cPa75-hybrid_cPa260,4_1_1_1_1,102,38
chr1A-1488650_1488752,cPa539,1,1,1488700,1488700,cPa539,1,102,0
chr1A-1491749_1491851,cPa62,0.666666666666667,2,1491837,1491781,cPa293_cPa62,1_2,102,56
chr1A-1491852_1491954,cPa62,1,1,1491902,1491902,cPa62,1,102,0
chr1A-1514038_1514296,cPa62,1,1,1514244,1514062,cPa62,12,258,182
chr1A-1514326_1514722,cPa62,0.96078431372549,3,1514672,1514348,cPa285_cPa62_cPa62-unknown,1_49_1,396,324
chr1A-1514770_1514872,cPa62,1,1,1514820,1514820,cPa62,1,102,0
chr1A-1527087_1527189,cPa62,1,1,1527150,1527137,cPa62,2,102,13
chr1A-15302937_15303039,cPa529,1,1,15302987,15302987,cPa529,1,102,0
chr1A-15358120_15358231,cPa95,0.285714285714286,6,15358222,15358145,cPa529_cPa545_cPa545-cPa131-hybrid_cPa545-cPa133-hybrid_cPa95_cPa95-cPa133-hybrid,1_1_1_1_2_1,111,77
chr1A-15446941_15447046,cPa452,0.527272727272727,10,15446998,15446943,cPa16-cPa452-hybrid_cPa363_cPa363-cPa452-hybrid_cPa452_cPa452-cPa363-hybrid_cPa452-unknown_cPa71_cPa71-cPa183-hybrid_cPa71-cPa363-hybrid_cPa71-unknown,1_37_1_58_1_1_8_1_1_1,105,55
chr1A-15510527_15510629,cPa15,0.5,3,15510589,15510577,cPa118_cPa118-unknown_cPa15,1_1_2,102,12
chr1A-15584709_15584811,cPa193,0.371428571428571,9,15584763,15584747,cPa157_cPa183_cPa193_cPa193-cPa157-hybrid_cPa229_cPa229-cPa157-hybrid_cPa229-cPa500-hybrid_cPa229-unknown_cPa500,1_1_13_1_3_2_1_2_11,102,16
chr1A-15652900_15653006,cPa450,0.487179487179487,18,15652991,15652906,cPa199_cPa199-cPa223-hybrid_cPa223_cPa227_cPa227-cPa223-hybrid_cPa273-cPa223-hybrid_cPa273-cPa345-hybrid_cPa345_cPa450_cPa450-cPa223-hybrid_cPa450-unknown_cPa542-cPa199-hybrid_cPa542-cPa223-hybrid_cPa542-cPa450-hybrid_cPa542-unknown_cPa553_cPa553-cPa223-hybrid_cPa553-unknown,9_4_1_3_4_13_1_5_95_3_1_2_9_1_1_23_19_1,106,85
chr1A-15701069_15701171,cPa118_cPa15_cPa248-unknown,0.333333333333333,3,15701130,15701119,cPa118_cPa15_cPa248-unknown,1_1_1,102,11
chr1A-15722962_15723064,PERVC_HM159246,1,1,15723012,15723012,PERVC_HM159246,1,102,0
chr1A-15857971_15858081,cPa118_cPa15_cPa268,0.333333333333333,3,15858029,15858021,cPa118_cPa15_cPa268,1_1_1,110,8
chr1A-1595810_1595912,cPa260,1,1,1595886,1595822,cPa260,7,102,64
chr1A-1598794_1598896,cPa323_cPa568-cPa323-hybrid,0.5,2,1598889,1598844,cPa323_cPa568-cPa323-hybrid,1_1,102,45
chr1A-1598909_1599011,cPa323,0.5,3,1598959,1598944,cPa323_cPa568-cPa323-hybrid_cPa568-cPa371-hybrid,3_2_1,102,15
chr1A-16021418_16021520,cPa539,1,1,16021468,16021468,cPa539,1,102,0
chr1A-16184241_16184355,cPa391,0.666666666666667,2,16184304,16184291,cPa293_cPa391,1_2,114,13
chr1A-16380852_16380954,cPa223_cPa223-cPa62-hybrid,0.5,2,16380902,16380879,cPa223_cPa223-cPa62-hybrid,1_1,102,23
chr1A-16382508_16382610,cPa62,0.90625,4,16382576,16382555,cPa223-cPa62-hybrid_cPa293_cPa419_cPa62,1_1_1_29,102,21
chr1A-16393846_16393972,cPa425,0.882352941176471,3,16393967,16393847,cPa404_cPa425_cPa47,1_15_1,126,120
chr1A-16526626_16526736,cPa529,0.875,3,16526736,16526668,cPa14-cPa247-hybrid_cPa247_cPa529,2_1_21,110,68
chr1A-1653587_1653869,cPa183,0.372881355932203,10,1653866,1653610,cPa183_cPa183-cPa223-hybrid_cPa183-cPa363-hybrid_cPa183-unknown_cPa223_cPa223-cPa183-hybrid_cPa223-unknown_cPa363_cPa379_cPa452,22_3_1_5_16_1_1_6_2_2,282,256
chr1A-16555843_16555945,cPa555,0.555555555555556,5,16555900,16555863,cPa257_cPa546-cPa257-hybrid_cPa546-unknown_cPa555_cPa555-cPa285-hybrid,1_1_1_5_1,102,37
chr1A-16578919_16579021,cPa16-cPa71-hybrid_cPa363_cPa452,0.333333333333333,3,16578969,16578969,cPa16-cPa71-hybrid_cPa363_cPa452,1_1_1,102,0
chr1A-16600434_16600536,cPa62-cPa71-hybrid,0.4,11,16600526,16600434,cPa62-cPa71-hybrid_cPa62-cPa75-hybrid_cPa62-HERV-W_repbase_HERV17_LTR17-hybrid_cPa62-unknown_cPa71_cPa71-cPa75-hybrid_cPa71-HERV-W_repbase_HERV17_LTR17-hybrid_cPa75_cPa75-cPa71-hybrid_HERV-W_repbase_HERV17_LTR17_KoRV_AF151794,14_2_1_1_4_1_1_7_1_2_1,102,92
chr1A-16600760_16600904,cPa75,0.75,2,16600883,16600810,cPa62-cPa75-hybrid_cPa75,1_3,144,73
chr1A-166049_166395,cPa75,1,1,166348,166093,cPa75,38,346,255
chr1A-166416_166518,cPa75,1,1,166466,166466,cPa75,1,102,0
chr1A-16648408_16648510,cPa363_cPa456,0.428571428571429,3,16648468,16648458,cPa363_cPa456_cPa587-cPa117-hybrid,3_3_1,102,10
chr1A-16648676_16648797,cPa104_cPa190_cPa219-unknown_cPa220,0.2,6,16648750,16648714,cPa104_cPa18-cPa104-hybrid_cPa18-unknown_cPa190_cPa219-unknown_cPa220,2_1_1_2_2_2,121,36
chr1A-16651716_16651818,cPa190,0.4,5,16651770,16651735,cPa104_cPa104-cPa18-hybrid_cPa104-cPa220-hybrid_cPa190_cPa220,1_2_2_4_1,102,35
chr1A-166599_166879,cPa75,1,1,166827,166649,cPa75,5,280,178
chr1A-16678473_16678575,cPa443,1,1,16678523,16678523,cPa443,1,102,0
chr1A-16715396_16715508,cPa75-unknown,1,1,16715456,16715446,cPa75-unknown,2,112,10
chr1A-16715666_16715768,cPa75-unknown,1,1,16715716,16715707,cPa75-unknown,2,102,9
chr1A-16753298_16753717,cPa345,0.984375,2,16753676,16753348,cPa345_cPa527-cPa15-hybrid,63_1,419,328
chr1A-1683521_1683665,cPa425-unknown_cPa505,0.5,2,1683613,1683571,cPa425-unknown_cPa505,1_1,144,42
chr1A-1683667_1683769,cPa505-unknown,1,1,1683717,1683717,cPa505-unknown,1,102,0
chr1A-16932440_16932542,cPa419,1,1,16932490,16932490,cPa419,1,102,0
chr1A-17235253_17235355,cPa75,0.666666666666667,3,17235320,17235303,cPa75_cPa75-cPa62-hybrid_cPa75-unknown,4_1_1,102,17
chr1A-17242573_17242675,cPa452,0.5,3,17242636,17242573,cPa363_cPa452_cPa71,2_5_3,102,63
chr1A-1727746_1727848,cPa75,1,1,1727796,1727796,cPa75,1,102,0
chr1A-1727896_1727998,cPa75-unknown,1,1,1727946,1727946,cPa75-unknown,1,102,0
chr1A-17347565_17347731,cPa302,0.275862068965517,11,17347695,17347615,cPa150_cPa150-cPa246-hybrid_cPa150-unknown_cPa255-cPa246-hybrid_cPa255-cPa302-hybrid_cPa255-cPa478-hybrid_cPa255-unknown_cPa302_cPa479_cPa479-cPa478-hybrid_cPa479-unknown,5_1_1_1_3_2_2_8_4_1_1,166,80
chr1A-17361858_17361963,cPa223,0.940298507462687,4,17361956,17361857,cPa174-cPa223-hybrid_cPa174-unknown_cPa223_cPa392-unknown,1_1_63_2,105,99
chr1A-1736195_1736455,cPa71,0.428571428571429,4,1736403,1736245,cPa62-cPa71-hybrid_cPa71_cPa75_cPa75-cPa71-hybrid,1_3_1_2,260,158
chr1A-17372856_17372958,cPa425,0.3,7,17372918,17372906,cPa174_cPa174-cPa392-hybrid_cPa174-cPa47-hybrid_cPa254_cPa254-cPa392-hybrid_cPa425_cPa47,1_1_1_1_1_3_2,102,12
chr1A-17388124_17388226,cPa125-unknown_cPa15_cPa516-cPa15-hybrid,0.333333333333333,3,17388217,17388174,cPa125-unknown_cPa15_cPa516-cPa15-hybrid,1_1_1,102,43
chr1A-1743831_1743933,cPa539,1,1,1743919,1743881,cPa539,1,102,38
chr1A-17460613_17460722,cPa492,1,1,17460715,17460663,cPa492,5,109,52
chr1A-1746119_1746303,cPa199,0.428571428571429,5,1746251,1746130,cPa199_cPa345-unknown_cPa450-unknown_cPa539-WDSV_NC001867-hybrid_cPa553-unknown,3_1_1_1_1,184,121
chr1A-1751730_1751863,HIV1_NC001802-cPa332-hybrid,0.666666666666667,2,1751811,1751760,HIV1_NC001802-cPa177-hybrid_HIV1_NC001802-cPa332-hybrid,1_2,133,51
chr1A-1752937_1753039,HIV1_NC001802-cPa332-hybrid,1,1,1752987,1752987,HIV1_NC001802-cPa332-hybrid,1,102,0
chr1A-1753724_1753826,cPa113_cPa315-cPa332-hybrid_cPa402-cPa332-hybrid_cPa74-cPa332-hybrid,0.2,6,1753822,1753774,cPa113_cPa315-cPa332-hybrid_cPa402-cPa332-hybrid_cPa419-cPa332-hybrid_cPa446-cPa332-hybrid_cPa74-cPa332-hybrid,2_2_2_1_1_2,102,48
chr1A-1754655_1754757,cPa363,1,1,1754705,1754705,cPa363,1,102,0
chr1A-17560152_17560272,cPa113,0.673469387755102,5,17560266,17560159,cPa113_cPa62-cPa113-hybrid_cPa75-cPa113-hybrid_cPa75-KWERV_GQ222416-hybrid_cPa75-unknown,33_4_7_1_4,120,107
chr1A-17621756_17621948,cPa255-cPa150-hybrid,0.222222222222222,9,17621930,17621806,cPa150_cPa255-cPa104-hybrid_cPa255-cPa131-hybrid_cPa255-cPa150-hybrid_cPa255-cPa190-hybrid_cPa255-cPa302-hybrid_cPa419_cPa438-cPa150-hybrid_cPa438-cPa220-hybrid,3_1_2_4_1_3_1_1_2,192,124
chr1A-17731738_17731840,cPa419,1,1,17731788,17731788,cPa419,1,102,0
chr1A-17815275_17815383,cPa450,0.619047619047619,10,17815331,17815302,cPa199_cPa227_cPa450_cPa450-cPa199-hybrid_cPa450-unknown_cPa542-cPa199-hybrid_cPa542-cPa553-hybrid_cPa542-unknown_cPa553_cPa553-unknown,3_2_26_3_2_1_1_1_2_1,108,29
chr1A-1781929_1782031,cPa333,0.225806451612903,12,1782022,1781972,cPa106_cPa106-unknown_cPa256_cPa260_cPa333_cPa333-cPa106-hybrid_cPa333-cPa260-hybrid_cPa362_cPa362-cPa50-hybrid_cPa50_cPa523_cPa523-cPa260-hybrid,5_1_2_5_7_1_1_2_1_3_2_1,102,50
chr1A-17853988_17854090,cPa104-cPa18-hybrid_cPa220-cPa219-hybrid,0.5,2,17854041,17854038,cPa104-cPa18-hybrid_cPa220-cPa219-hybrid,1_1,102,3
chr1A-17882665_17882767,cPa260,1,1,17882715,17882715,cPa260,1,102,0
chr1A-18014754_18014856,cPa14-cPa18-hybrid_cPa529,0.5,2,18014804,18014804,cPa14-cPa18-hybrid_cPa529,1_1,102,0
chr1A-18018715_18018817,cPa254_cPa404,0.3,6,18018765,18018750,cPa174_cPa174-cPa425-hybrid_cPa174-unknown_cPa254_cPa404_cPa425,1_1_1_3_3_1,102,15
chr1A-18042214_18042316,cPa104-cPa14-hybrid_cPa4_cPa541,0.333333333333333,3,18042264,18042264,cPa104-cPa14-hybrid_cPa4_cPa541,1_1_1,102,0
chr1A-18051271_18051515,cPa450,0.428571428571429,10,18051496,18051302,cPa199_cPa227-cPa199-hybrid_cPa273-cPa199-hybrid_cPa273-cPa223-hybrid_cPa273-cPa227-hybrid_cPa273-cPa345-hybrid_cPa273-unknown_cPa450_cPa542-cPa199-hybrid_cPa542-cPa223-hybrid,4_1_6_4_1_1_1_15_1_1,244,194
chr1A-1815710_1815812,cPa194_cPa67,0.5,2,1815760,1815760,cPa194_cPa67,1_1,102,0
chr1A-1815931_1816033,cPa194,0.466666666666667,5,1815984,1815936,cPa194_cPa360_cPa543_cPa543-cPa194-hybrid_cPa67,7_1_1_1_5,102,48
chr1A-1822271_1822375,cPa452,0.256410256410256,24,1822367,1822273,cPa176_cPa176-cPa183-hybrid_cPa176-cPa363-hybrid_cPa176-cPa446-hybrid_cPa176-cPa452-hybrid_cPa176-unknown_cPa183_cPa183-cPa446-hybrid_cPa200-cPa176-hybrid_cPa200-cPa363-hybrid_cPa200-cPa452-hybrid_cPa223_cPa223-cPa183-hybrid_cPa223-cPa446-hybrid_cPa223-cPa452-hybrid_cPa223-unknown_cPa363_cPa363-cPa446-hybrid_cPa363-cPa452-hybrid_cPa363-unknown_cPa379_cPa392-unknown_cPa446_cPa452,16_3_2_2_10_7_19_1_1_2_1_2_2_4_2_6_23_1_1_2_2_1_6_40,104,94
chr1A-18452434_18452561,cPa117-cPa363-hybrid_cPa456,0.428571428571429,3,18452509,18452465,cPa117-cPa363-hybrid_cPa363_cPa456,3_1_3,127,44
chr1A-18452649_18452914,cPa117-cPa363-hybrid_cPa363,0.285714285714286,7,18452862,18452699,cPa117-cPa363-hybrid_cPa117-cPa452-hybrid_cPa117-cPa456-hybrid_cPa363_cPa452_cPa456_cPa587-cPa456-hybrid,6_1_1_6_2_4_1,265,163
chr1A-18453222_18453331,cPa117-cPa363-hybrid,0.428571428571429,6,18453321,18453272,cPa117-cPa363-hybrid_cPa117-cPa452-hybrid_cPa117-cPa456-hybrid_cPa363_cPa456_cPa456-cPa452-hybrid,6_1_1_1_4_1,109,49
chr1A-18453433_18453535,cPa117-cPa363-hybrid_cPa363_cPa456,0.333333333333333,3,18453483,18453451,cPa117-cPa363-hybrid_cPa363_cPa456,1_1_1,102,32
chr1A-18489817_18489920,HERV-W_repbase_HERV17_LTR17,0.625,3,18489913,18489832,cPa62-unknown_cPa75_HERV-W_repbase_HERV17_LTR17,1_2_5,103,81
chr1A-18497885_18497987,cPa62,1,1,18497935,18497918,cPa62,3,102,17
chr1A-18501300_18501402,cPa62-cPa75-hybrid,0.4,5,18501378,18501309,cPa62-cPa293-hybrid_cPa62-cPa75-hybrid_cPa62-unknown_cPa75_cPa75-unknown,2_6_1_5_1,102,69
chr1A-18501466_18501615,cPa75,0.297872340425532,8,18501585,18501513,cPa293_cPa62_cPa62-cPa293-hybrid_cPa62-cPa75-hybrid_cPa62-HERV-W_repbase_HERV17_LTR17-hybrid_cPa62-unknown_cPa75_PERVA_AY099323-cPa62-hybrid,6_2_6_12_1_5_14_1,149,72
chr1A-1857978_1858100,cPa174-cPa47-hybrid_cPa254_cPa392-cPa174-hybrid_cPa413-cPa174-hybrid_cPa425,0.2,5,1858048,1858028,cPa174-cPa47-hybrid_cPa254_cPa392-cPa174-hybrid_cPa413-cPa174-hybrid_cPa425,1_1_1_1_1,122,20
chr1A-18632053_18632155,cPa419,1,1,18632103,18632103,cPa419,1,102,0
chr1A-1868474_1868576,cPa256,1,1,1868524,1868524,cPa256,1,102,0
chr1A-18752334_18752436,cPa75_cPa75-unknown,0.333333333333333,4,18752389,18752345,cPa75_cPa75-cPa62-hybrid_cPa75-unknown_HERV-W_repbase_HERV17_LTR17,2_1_2_1,102,44
chr1A-18824773_18824876,cPa18-cPa104-hybrid,0.320754716981132,9,18824853,18824781,cPa104_cPa18-cPa104-hybrid_cPa18-unknown_cPa190_cPa219_cPa219-cPa104-hybrid_cPa219-unknown_cPa220_cPa258-cPa104-hybrid,6_17_4_15_1_4_2_3_1,103,72
chr1A-1883928_1884361,HERV-W_repbase_HERV17_LTR17,0.669014084507042,20,1884309,1883944,cPa419_cPa581_cPa62-cPa75-hybrid_cPa62-HERV-W_repbase_HERV17_LTR17-hybrid_cPa62-unknown_cPa75_cPa75-cPa581-hybrid_cPa75-HERV-W_repbase_HERV17_LTR17-hybrid_cPa75-unknown_HERV-F_repbase_HERVFH19I_LTR19A_HERV-F_repbase_HERVFH19I_LTR19A-cPa75-hybrid_HERV-F_repbase_HERVFH19I_LTR19A-S71_repbase_HERVS71_LTR6A-hybrid_HERV-W_repbase_HERV17_LTR17_HERV-W_repbase_HERV17_LTR17-unknown_KoRV_AF151794_KoRV_AF151794-cPa75-hybrid_MLV_Mpmv5_PERV_AJ293656_PERV_AJ293656-cPa75-hybrid_S71_repbase_HERVS71_LTR6A-cPa75-hybrid,1_1_1_1_1_7_1_1_7_1_1_1_95_1_9_1_5_5_1_1,433,365
chr1A-18919102_18919204,cPa104-cPa18-hybrid,1,1,18919152,18919152,cPa104-cPa18-hybrid,1,102,0
chr1A-19016570_19016698,cPa75-cPa62-hybrid,0.425,6,19016697,19016597,cPa293-cPa62-hybrid_cPa62_cPa75_cPa75-cPa62-hybrid_cPa75-unknown_HERV-W_repbase_HERV17_LTR17-unknown,1_6_8_17_7_1,128,100
chr1A-1973603_1973825,cPa16,0.611111111111111,2,1973815,1973653,cPa16_cPa379,11_7,222,162
chr1A-2006397_2006643,cPa285,0.714285714285714,4,2006591,2006447,cPa224-cPa293-hybrid_cPa285_cPa285-cPa62-hybrid_cPa62,1_10_1_2,246,144
chr1A-20255872_20256012,cPa62,0.833333333333333,2,20256012,20255922,cPa62_cPa67-cPa62-hybrid,5_1,140,90
chr1A-2033788_2033890,cPa62,0.952380952380952,2,2033850,2033814,cPa293-unknown_cPa62,1_20,102,36
chr1A-20445160_20445262,cPa419,1,1,20445210,20445177,cPa419,2,102,33
chr1A-20678743_20679032,cPa482,0.798319327731092,4,20678993,20678757,cPa199-cPa482-hybrid_cPa199-unknown_cPa482_cPa482-unknown,15_8_95_1,289,236
chr1A-20743317_20743468,cPa62,0.846153846153846,6,20743435,20743353,cPa285_cPa293_cPa293-unknown_cPa419_cPa62_cPa62-unknown,1_1_1_1_33_2,151,82
chr1A-21017926_21018028,cPa14,0.794117647058823,5,21017989,21017939,cPa14_cPa14-unknown_cPa18-unknown_cPa4_cPa4-unknown,27_1_1_4_1,102,50
chr1A-21065904_21066006,cPa4,0.477272727272727,7,21065964,21065945,cPa14_cPa14-cPa4-hybrid_cPa14-unknown_cPa4_cPa541-cPa14-hybrid_cPa541-cPa4-hybrid_cPa541-unknown,13_3_1_21_1_2_3,102,19
chr1A-21079554_21079656,cPa62-HERV-W_repbase_HERV17_LTR17-hybrid,1,1,21079604,21079604,cPa62-HERV-W_repbase_HERV17_LTR17-hybrid,1,102,0
chr1A-21079670_21079804,cPa62-HERV-F_repbase_HERVFH19I_LTR19A-hybrid,0.428571428571429,3,21079752,21079707,cPa62-HERV-F_repbase_HERVFH19I_LTR19A-hybrid_cPa62-HERV-W_repbase_HERV17_LTR17-hybrid_cPa75,3_2_2,134,45
chr1A-21080219_21080387,cPa62-HERV-W_repbase_HERV17_LTR17-hybrid,0.333333333333333,5,21080355,21080236,cPa62-cPa75-hybrid_cPa62-HERV-F_repbase_HERVFH19I_LTR19A-hybrid_cPa62-HERV-W_repbase_HERV17_LTR17-hybrid_cPa75_HERV-W_repbase_HERV17_LTR17,1_4_5_2_3,168,119
chr1A-21093735_21093837,cPa456,0.714285714285714,5,21093802,21093774,cPa363_cPa363-BLV_NC001414-hybrid_cPa363-cPa117-hybrid_cPa456_cPa456-BLV_NC001414-hybrid,3_1_1_15_1,102,28
chr1A-21094083_21094185,cPa4_cPa541,0.5,2,21094133,21094133,cPa4_cPa541,1_1,102,0
chr1A-21098493_21098595,cPa62,1,1,21098551,21098519,cPa62,7,102,32
chr1A-211217_211319,cPa75,1,1,211314,211267,cPa75,2,102,47
chr1A-21179123_21179225,cPa419,1,1,21179173,21179173,cPa419,1,102,0
chr1A-212364_212466,cPa75,1,1,212417,212414,cPa75,5,102,3
chr1A-21251531_21251633,cPa246,0.5,4,21251586,21251573,cPa246_cPa246-cPa255-hybrid_cPa246-cPa302-hybrid_cPa479,4_1_2_1,102,13
chr1A-21282087_21282246,cPa117,1,1,21282207,21282137,cPa117,8,159,70
chr1A-21282567_21282669,cPa117,1,1,21282617,21282596,cPa117,3,102,21
chr1A-21297401_21297510,cPa62,1,1,21297469,21297433,cPa62,34,109,36
chr1A-213005_213200,cPa75,1,1,213148,213055,cPa75,3,195,93
chr1A-213204_213306,cPa75,1,1,213254,213254,cPa75,1,102,0
chr1A-213635_213758,cPa75,1,1,213706,213685,cPa75,3,123,21
chr1A-21433198_21433311,cPa11_cPa127_cPa241-cPa515-hybrid_cPa290-cPa515-hybrid_cPa540,0.2,5,21433259,21433248,cPa11_cPa127_cPa241-cPa515-hybrid_cPa290-cPa515-hybrid_cPa540,1_1_1_1_1,113,11
chr1A-21524319_21524445,cPa529,0.305555555555556,8,21524408,21524369,cPa14-cPa529-hybrid_cPa247_cPa529_cPa545-cPa247-hybrid_cPa545-cPa529-hybrid_cPa545-unknown_cPa95-cPa529-hybrid_cPa95-unknown,1_1_11_4_9_6_3_1,126,39
chr1A-2159440_2159542,cPa67,0.5,3,2159534,2159475,cPa194_cPa67_cPa67-unknown,2_3_1,102,59
chr1A-2159634_2159907,cPa67,0.5,4,2159855,2159642,cPa194_cPa194-unknown_cPa67_cPa67-unknown,9_3_13_1,273,213
chr1A-2159951_2160063,cPa67,0.7,2,2160012,2159991,cPa194_cPa67,3_7,112,21
chr1A-2168466_2168568,cPa260_cPa260-unknown,0.5,2,2168516,2168468,cPa260_cPa260-unknown,2_2,102,48
chr1A-21905773_21905875,cPa293_cPa391_cPa426,0.333333333333333,3,21905823,21905823,cPa293_cPa391_cPa426,1_1_1,102,0
chr1A-21939972_21940074,cPa419-cPa260-hybrid,1,1,21940022,21940022,cPa419-cPa260-hybrid,1,102,0
chr1A-219485_219656,cPa75,1,1,219604,219516,cPa75,4,171,88
chr1A-219882_220059,cPa75,1,1,220007,219932,cPa75,4,177,75
chr1A-220063_220206,cPa75,1,1,220154,220113,cPa75,14,143,41
chr1A-220228_220804,cPa75,1,1,220752,220278,cPa75,18,576,474
chr1A-220822_221137,cPa75,1,1,221085,220872,cPa75,21,315,213
chr1A-221165_221267,cPa75,1,1,221215,221215,cPa75,1,102,0
chr1A-2229650_2229752,cPa260,0.7,3,2229710,2229664,cPa260_cPa523_cPa75-cPa260-hybrid,7_1_2,102,46
chr1A-2229823_2229925,cPa260,0.75,2,2229914,2229831,cPa223-cPa260-hybrid_cPa260,1_3,102,83
chr1A-223248_223596,cPa75,1,1,223581,223298,cPa75,6,348,283
chr1A-2236883_2236985,cPa486,1,1,2236960,2236933,cPa486,2,102,27
chr1A-2240338_2240553,cPa62-cPa260-hybrid,0.428571428571429,4,2240501,2240346,cPa62-cPa260-hybrid_cPa62-cPa413-hybrid_cPa62-unknown_cPa75,3_1_1_2,215,155
chr1A-2240621_2240723,cPa260,1,1,2240711,2240631,cPa260,5,102,80
chr1A-2240963_2241065,cPa260,1,1,2241060,2241013,cPa260,14,102,47
chr1A-22548361_22548463,cPa75,0.666666666666667,3,22548460,22548407,cPa62_cPa75_cPa75-cPa62-hybrid,2_6_1,102,53
chr1A-22548561_22548663,cPa75,0.666666666666667,4,22548658,22548582,cPa293-cPa62-hybrid_cPa62_cPa75_cPa75-unknown,1_3_10_1,102,76
chr1A-2259362_2259464,cPa260,0.428571428571429,4,2259455,2259376,cPa260_cPa475_cPa75-cPa260-hybrid_cPa75-unknown,3_2_1_1,102,79
chr1A-22754023_22754125,cPa75,0.666666666666667,2,22754106,22754039,cPa75_HERV-F_repbase_HERVFH19I_LTR19A-cPa75-hybrid,4_2,102,67
chr1A-22754208_22754310,cPa75,0.833333333333333,2,22754258,22754223,cPa75_HERV-F_repbase_HERVFH19I_LTR19A-cPa75-hybrid,5_1,102,35
chr1A-23077542_23077659,cPa113-cPa332-hybrid,0.4,4,23077620,23077592,cPa113_cPa113-cPa332-hybrid_cPa255-cPa332-hybrid_cPa511-cPa332-hybrid,1_2_1_1,117,28
chr1A-232341_232443,cPa75,1,1,232391,232391,cPa75,1,102,0
chr1A-23311382_23311540,cPa469,0.849557522123894,2,23311488,23311432,cPa469_cPa469-unknown,96_17,158,56
chr1A-23336761_23336868,cPa118_cPa15_cPa268,0.333333333333333,3,23336816,23336811,cPa118_cPa15_cPa268,1_1_1,107,5
chr1A-2334039_2334274,cPa75-cPa62-hybrid,0.5,3,2334250,2334081,cPa62_cPa75-cPa62-hybrid_cPa75-unknown,10_13_3,235,169
chr1A-23364316_23364424,cPa14_cPa541,0.333333333333333,4,23364383,23364360,cPa14_cPa18_cPa18-unknown_cPa541,2_1_1_2,108,23
chr1A-23399509_23399611,cPa150_cPa255-cPa131-hybrid_cPa479,0.142857142857143,11,23399607,23399557,cPa150_cPa246-cPa131-hybrid_cPa246-cPa150-hybrid_cPa246-cPa479-hybrid_cPa246-unknown_cPa255_cPa255-cPa131-hybrid_cPa255-cPa150-hybrid_cPa255-cPa479-hybrid_cPa302_cPa479,2_1_1_1_1_1_2_1_1_1_2,102,50
chr1A-23442447_23442576,cPa18_cPa4_cPa541,0.25,6,23442540,23442497,cPa14_cPa14-unknown_cPa18_cPa4_cPa4-cPa541-hybrid_cPa541,1_1_3_3_1_3,129,43
chr1A-23469535_23469637,cPa479-cPa131-hybrid_cPa563,0.5,2,23469585,23469582,cPa479-cPa131-hybrid_cPa563,1_1,102,3
chr1A-23481563_23481665,cPa15,0.857142857142857,2,23481619,23481612,cPa118-cPa15-hybrid_cPa15,1_6,102,7
chr1A-2373534_2373636,cPa62,1,1,2373584,2373584,cPa62,1,102,0
chr1A-2373706_2373819,cPa62,1,1,2373767,2373744,cPa62,3,113,23
chr1A-2380748_2380850,cPa62,0.916666666666667,4,2380813,2380793,cPa194-cPa62-hybrid_cPa285_cPa62_cPa62-cPa285-hybrid,2_1_44_1,102,20
chr1A-239408_239510,cPa75,1,1,239502,239422,cPa75,4,102,80
chr1A-239581_239806,cPa75,1,1,239783,239631,cPa75,20,225,152
chr1A-239941_240050,cPa75,1,1,239998,239991,cPa75,2,109,7
chr1A-240115_240514,cPa75,1,1,240468,240165,cPa75,34,399,303
chr1A-24248707_24248854,cPa62-unknown_cPa75,0.222222222222222,15,24248849,24248749,CAEV_NC001463-cPa392-hybrid_CAEV_NC001463-cPa75-hybrid_CAEV_NC001463-unknown_cPa260_cPa392_cPa392-cPa260-hybrid_cPa392-unknown_cPa419_cPa572_cPa572-cPa260-hybrid_cPa62-cPa75-hybrid_cPa62-unknown_cPa75_cPa75-cPa260-hybrid_cPa75-unknown,1_1_1_2_1_1_1_1_1_1_2_6_6_1_1,147,100
chr1A-24299028_24299166,cPa452,0.416666666666667,5,24299118,24299040,cPa16-cPa327-hybrid_cPa176_cPa363_cPa452_cPa71,1_1_7_10_5,138,78
chr1A-244058_244267,cPa75,1,1,244215,244106,cPa75,4,209,109
chr1A-244295_244446,cPa75,1,1,244394,244345,cPa75,2,151,49
chr1A-244452_245291,cPa75,1,1,245264,244502,cPa75,40,839,762
chr1A-2447258_2447436,cPa482,1,1,2447384,2447289,cPa482,4,178,95
chr1A-25118994_25119129,cPa75_HERV-W_repbase_HERV17_LTR17,0.3,5,25119096,25118999,cPa260-cPa62-hybrid_cPa75_cPa75-cPa62-hybrid_HERV-W_repbase_HERV17_LTR17_HERV-W_repbase_HERV17_LTR17-cPa62-hybrid,2_3_1_3_1,135,97
chr1A-25119226_25119456,cPa62,0.5,3,25119433,25119276,cPa62_cPa75_cPa75-cPa62-hybrid,5_2_3,230,157
chr1A-25119616_25119727,cPa75-cPa62-hybrid_HERV-W_repbase_HERV17_LTR17-cPa62-hybrid,0.5,2,25119675,25119666,cPa75-cPa62-hybrid_HERV-W_repbase_HERV17_LTR17-cPa62-hybrid,1_1,111,9
chr1A-252863_253034,cPa75,1,1,252982,252913,cPa75,3,171,69
chr1A-25294501_25294603,cPa492,1,1,25294551,25294551,cPa492,1,102,0
chr1A-253061_253190,cPa75,1,1,253138,253111,cPa75,2,129,27
chr1A-253531_253640,cPa75,1,1,253588,253581,cPa75,3,109,7
chr1A-253764_253973,cPa75,1,1,253965,253814,cPa75,4,209,151
chr1A-25399555_25399657,cPa257,0.244897959183673,11,25399650,25399568,cPa199-cPa555-hybrid_cPa257_cPa257-cPa546-hybrid_cPa257-cPa555-hybrid_cPa257-unknown_cPa285_cPa285-cPa546-hybrid_cPa285-cPa555-hybrid_cPa482-cPa555-hybrid_cPa546_cPa555,1_12_8_6_2_1_3_2_3_2_9,102,82
chr1A-2551397_2551516,cPa75,0.448275862068966,9,2551497,2551412,cPa260-cPa62-hybrid_cPa293_cPa293-cPa419-hybrid_cPa293-cPa62-hybrid_cPa293-unknown_cPa62_cPa75_cPa75-cPa62-hybrid_cPa75-unknown,1_3_1_4_2_2_13_2_1,119,85
chr1A-2551526_2551684,cPa75,0.545454545454545,8,2551676,2551533,cPa260_cPa293_cPa293-cPa62-hybrid_cPa413-cPa62-hybrid_cPa62_cPa75_cPa75-cPa62-hybrid_cPa75-unknown,1_3_8_1_2_30_8_2,158,143
chr1A-26144035_26144137,cPa62,0.846153846153846,3,26144096,26144068,cPa254-unknown_cPa285_cPa62,1_1_11,102,28
chr1A-26145020_26145122,cPa62,1,1,26145070,26145028,cPa62,2,102,42
chr1A-26374020_26374122,cPa419_cPa447,0.5,2,26374070,26374070,cPa419_cPa447,1_1,102,0
chr1A-26421063_26421165,cPa16,1,1,26421113,26421113,cPa16,1,102,0
chr1A-26506018_26506120,cPa456,0.666666666666667,2,26506095,26506068,cPa363_cPa456,3_6,102,27
chr1A-266474_266578,cPa75,1,1,266526,266524,cPa75,7,104,2
chr1A-26712623_26712736,cPa118_cPa15,0.5,2,26712684,26712673,cPa118_cPa15,1_1,113,11
chr1A-267392_267662,cPa75,1,1,267610,267442,cPa75,15,270,168
chr1A-26805185_26805287,cPa363_cPa452,0.333333333333333,5,26805241,26805201,cPa176_cPa183-cPa16-hybrid_cPa363_cPa452_cPa71,1_1_4_4_2,102,40
chr1A-271475_271577,cPa75,1,1,271526,271525,cPa75,2,102,1
chr1A-271672_271774,cPa75,1,1,271722,271722,cPa75,1,102,0
chr1A-271786_271921,cPa75,1,1,271869,271822,cPa75,3,135,47
chr1A-272024_272343,cPa75,1,1,272291,272074,cPa75,6,319,217
chr1A-27230129_27230285,cPa117,1,1,27230233,27230151,cPa117,7,156,82
chr1A-27231223_27231325,cPa117-cPa452-hybrid,1,1,27231273,27231273,cPa117-cPa452-hybrid,1,102,0
chr1A-27231578_27231680,cPa117,1,1,27231628,27231628,cPa117,1,102,0
chr1A-272767_272907,cPa75,1,1,272855,272817,cPa75,6,140,38
chr1A-27318980_27319087,cPa15,0.5,5,27319043,27318983,cPa118_cPa118-unknown_cPa15_cPa174_cPa268,2_2_12_1_7,107,60
chr1A-27344887_27344989,cPa439-unknown,0.95,2,27344937,27344903,cPa439-cPa62-hybrid_cPa439-unknown,1_19,102,34
chr1A-27352325_27352427,cPa223,1,1,27352375,27352334,cPa223,2,102,41
chr1A-27356364_27356565,cPa117-cPa456-hybrid_cPa363_cPa452_cPa456_cPa75-cPa587-hybrid,0.2,5,27356513,27356405,cPa117-cPa456-hybrid_cPa363_cPa452_cPa456_cPa75-cPa587-hybrid,1_1_1_1_1,201,108
chr1A-27366526_27366628,cPa452,0.459770114942529,10,27366587,27366563,cPa176-cPa16-hybrid_cPa176-cPa363-hybrid_cPa176-unknown_cPa327-cPa71-hybrid_cPa363_cPa363-unknown_cPa452_cPa71_cPa71-cPa363-hybrid_cPa71-unknown,1_1_1_1_25_2_40_14_1_1,102,24
chr1A-27471994_27472157,cPa223-cPa425-hybrid_cPa254_cPa404_cPa425,0.25,4,27472136,27472044,cPa223-cPa425-hybrid_cPa254_cPa404_cPa425,1_1_1_1,163,92
chr1A-27472311_27472511,cPa254,0.352941176470588,8,27472508,27472338,cPa254_cPa404_cPa404-cPa174-hybrid_cPa425_cPa425-cPa174-hybrid_cPa425-cPa254-hybrid_cPa47_cPa47-cPa254-hybrid,18_12_1_9_2_3_5_1,200,170
chr1A-27590151_27590260,cPa456,0.5,3,27590252,27590201,cPa363_cPa363-cPa452-hybrid_cPa456,1_1_2,109,51
chr1A-27595229_27595331,cPa113_cPa62-cPa113-hybrid_cPa62-unknown,0.25,5,27595315,27595230,cPa113_cPa62-cPa113-hybrid_cPa62-unknown_cPa67-cPa113-hybrid_cPa75-cPa67-hybrid,2_2_2_1_1,102,85
chr1A-27698698_27698803,cPa219-cPa104-hybrid_cPa220,0.25,6,27698767,27698716,cPa104_cPa18-cPa104-hybrid_cPa219_cPa219-cPa104-hybrid_cPa219-cPa190-hybrid_cPa220,1_1_1_2_1_2,105,51
chr1A-28088081_28088183,cPa117,1,1,28088156,28088101,cPa117,3,102,55
chr1A-28590861_28590963,cPa452,0.511627906976744,5,28590921,28590897,cPa363_cPa363-cPa452-hybrid_cPa363-unknown_cPa452_cPa71,15_1_1_22_4,102,24
chr1A-28596241_28596343,cPa450,0.333333333333333,5,28596303,28596291,cPa199_cPa273-cPa199-hybrid_cPa273-cPa223-hybrid_cPa450_cPa542-cPa223-hybrid,1_1_1_2_1,102,12
chr1A-28681576_28681678,cPa15_cPa419-cPa118-hybrid,0.5,2,28681626,28681600,cPa15_cPa419-cPa118-hybrid,1_1,102,26
chr1A-28937410_28937512,cPa62,1,1,28937460,28937448,cPa62,2,102,12
chr1A-29087057_29087297,cPa75,0.463414634146341,6,29087251,29087091,cPa62_cPa62-cPa75-hybrid_cPa62-HERV-W_repbase_HERV17_LTR17-hybrid_cPa62-KWERV_GQ222416-hybrid_cPa75_HERV-W_repbase_HERV17_LTR17-KWERV_GQ222416-hybrid,2_14_3_2_19_1,240,160
chr1A-29087748_29087975,cPa75,0.491228070175439,6,29087960,29087780,cPa62_cPa62-cPa75-hybrid_cPa62-HERV-W_repbase_HERV17_LTR17-hybrid_cPa71_cPa71-HERV-W_repbase_HERV17_LTR17-hybrid_cPa75,5_17_2_4_1_28,227,180
chr1A-29088452_29088588,cPa75,0.666666666666667,2,29088582,29088459,cPa62-cPa75-hybrid_cPa75,2_4,136,123
chr1A-29181213_29181451,HERV-W_repbase_HERV17_LTR17,0.555555555555556,2,29181399,29181263,cPa75_HERV-W_repbase_HERV17_LTR17,4_5,238,136
chr1A-29181616_29181738,cPa75_HERV-W_repbase_HERV17_LTR17,0.4,3,29181686,29181666,cPa75_HERV-W_repbase_HERV17_LTR17_HERV-W_repbase_HERV17_LTR17-cPa62-hybrid,2_2_1,122,20
chr1A-29182030_29182404,HERV-W_repbase_HERV17_LTR17,0.761904761904762,5,29182352,29182060,cPa62_cPa75_cPa75-cPa62-hybrid_HERV-W_repbase_HERV17_LTR17_HERV-W_repbase_HERV17_LTR17-cPa62-hybrid,1_1_2_16_1,374,292
chr1A-29182626_29182728,HERV-W_repbase_HERV17_LTR17,1,1,29182676,29182676,HERV-W_repbase_HERV17_LTR17,1,102,0
chr1A-29308184_29308286,cPa450,0.36,7,29308253,29308183,cPa199_cPa227-cPa199-hybrid_cPa450_cPa450-cPa199-hybrid_cPa542-cPa199-hybrid_cPa542-cPa227-hybrid_cPa553,2_3_9_1_1_1_8,102,70
chr1A-296292_296402,cPa15,0.425531914893617,7,296351,296311,cPa118_cPa118-cPa15-hybrid_cPa118-cPa248-hybrid_cPa118-unknown_cPa15_cPa75-cPa248-hybrid_cPa75-cPa268-hybrid,17_1_2_1_20_4_2,110,40
chr1A-30306999_30307101,cPa62,0.818181818181818,2,30307075,30307046,cPa419_cPa62,2_9,102,29
chr1A-30331825_30331927,cPa363,0.368421052631579,5,30331875,30331859,cPa176-cPa183-hybrid_cPa363_cPa452_cPa452-unknown_cPa71,1_7_6_1_4,102,16
chr1A-3040279_3040381,cPa205-cPa327-hybrid_cPa273-cPa183-hybrid_cPa273-cPa327-hybrid_cPa273-unknown_cPa452_cPa505-cPa327-hybrid_cPa505-unknown_cPa61-cPa446-hybrid,0.125,8,3040374,3040279,cPa205-cPa327-hybrid_cPa273-cPa183-hybrid_cPa273-cPa327-hybrid_cPa273-unknown_cPa452_cPa505-cPa327-hybrid_cPa505-unknown_cPa61-cPa446-hybrid,1_1_1_1_1_1_1_1,102,95
chr1A-3054602_3054704,cPa379_cPa424_cPa446,0.333333333333333,3,3054652,3054652,cPa379_cPa424_cPa446,1_1_1,102,0
chr1A-3058125_3058234,cPa587,0.583333333333333,5,3058182,3058164,cPa363-cPa587-hybrid_cPa452_cPa452-unknown_cPa456-cPa587-hybrid_cPa587,1_2_1_1_7,109,18
chr1A-30669023_30669125,cPa15,0.388888888888889,6,30669074,30669060,cPa118_cPa118-cPa443-hybrid_cPa15_cPa248-cPa118-hybrid_cPa268-cPa15-hybrid_cPa443,4_1_7_1_1_4,102,14
chr1A-3080368_3080470,cPa62-unknown_cPa75,0.25,6,3080418,3080372,cPa308-cPa75-hybrid_cPa62-unknown_cPa75_cPa75-KWERV_GQ222416-hybrid_cPa75-unknown_HERV-W_repbase_HERV17_LTR17,1_2_2_1_1_1,102,46
chr1A-30834874_30834976,HERV-W_repbase_HERV17_LTR17-cPa62-hybrid,0.321428571428571,8,30834975,30834900,cPa62_cPa75_cPa75-cPa62-hybrid_cPa75-unknown_HERV-W_repbase_HERV17_LTR17_HERV-W_repbase_HERV17_LTR17-cPa62-hybrid_HERV-W_repbase_HERV17_LTR17-KoRV_AF151794-hybrid_KoRV_AF151794-cPa75-hybrid,3_4_3_2_5_9_1_1,102,75
chr1A-30874101_30874203,cPa62,0.972972972972973,2,30874161,30874122,cPa62_cPa62-cPa285-hybrid,36_1,102,39
chr1A-30942939_30943041,cPa62,1,1,30942997,30942974,cPa62,13,102,23
chr1A-31028769_31028875,cPa553,0.384,19,31028842,31028780,cPa199_cPa223-cPa199-hybrid_cPa223-cPa227-hybrid_cPa223-cPa273-hybrid_cPa223-cPa450-hybrid_cPa223-cPa542-hybrid_cPa227_cPa227-cPa199-hybrid_cPa227-cPa273-hybrid_cPa227-cPa542-hybrid_cPa273_cPa345_cPa345-cPa199-hybrid_cPa345-cPa227-hybrid_cPa345-cPa273-hybrid_cPa345-cPa542-hybrid_cPa450_cPa553_cPa553-cPa542-hybrid,2_26_2_2_5_1_11_1_1_1_1_3_13_1_2_2_2_48_1,106,62
chr1A-31033713_31033815,cPa391,0.375,4,31033767,31033755,cPa287-cPa426-hybrid_cPa287-unknown_cPa293_cPa391,1_2_2_3,102,12
chr1A-31258865_31258967,cPa62,0.72,4,31258941,31258880,cPa285_cPa293_cPa62_cPa62-unknown,5_1_18_1,102,61
chr1A-31377313_31377415,cPa456,0.666666666666667,3,31377363,31377355,cPa363_cPa363-unknown_cPa456,1_1_4,102,8
chr1A-31590443_31590545,cPa302,0.222222222222222,17,31590529,31590448,cPa150_cPa150-cPa190-hybrid_cPa150-cPa246-hybrid_cPa150-cPa302-hybrid_cPa255-cPa104-hybrid_cPa255-cPa150-hybrid_cPa255-cPa190-hybrid_cPa255-cPa219-hybrid_cPa255-cPa302-hybrid_cPa255-cPa478-hybrid_cPa302_cPa438-cPa219-hybrid_cPa438-cPa302-hybrid_cPa479-cPa220-hybrid_cPa479-cPa246-hybrid_cPa479-cPa302-hybrid_cPa479-cPa478-hybrid,1_1_1_3_1_1_1_1_1_1_6_1_1_1_1_4_1,102,81
chr1A-3175819_3176020,cPa62,0.941176470588235,2,3175997,3175852,cPa118-cPa62-hybrid_cPa62,1_16,201,145
chr1A-3178246_3178348,cPa118-cPa379-hybrid_cPa138-cPa62-hybrid_cPa15-cPa273-hybrid_cPa452,0.25,4,3178297,3178270,cPa118-cPa379-hybrid_cPa138-cPa62-hybrid_cPa15-cPa273-hybrid_cPa452,1_1_1_1,102,27
chr1A-32493067_32493169,HERV-W_repbase_HERV17_LTR17,0.666666666666667,2,32493127,32493117,cPa75_HERV-W_repbase_HERV17_LTR17,1_2,102,10
chr1A-32515564_32515666,cPa357,1,1,32515614,32515569,cPa357,2,102,45
chr1A-32521778_32521880,cPa452,0.4,8,32521880,32521813,cPa363_cPa363-HERV-W_repbase_HERV17_LTR17-hybrid_cPa363-KoRV_AF151794-hybrid_cPa452_cPa452-cPa75-hybrid_cPa62-cPa452-hybrid_cPa71_HERV-W_repbase_HERV17_LTR17,4_1_1_8_1_1_2_2,102,67
chr1A-32522281_32522426,HERV-W_repbase_HERV17_LTR17,0.409090909090909,13,32522410,32522296,cPa260_cPa452-cPa75-hybrid_cPa62-HERV-W_repbase_HERV17_LTR17-hybrid_cPa62-unknown_cPa71-HERV-W_repbase_HERV17_LTR17-hybrid_cPa75_cPa75-HERV-W_repbase_HERV17_LTR17-hybrid_cPa75-unknown_HERV-F_repbase_HERVFH19I_LTR19A-cPa75-hybrid_HERV-W_repbase_HERV17_LTR17_HERV-W_repbase_HERV17_LTR17-cPa75-hybrid_KoRV_AF151794_S71_repbase_HERVS71_LTR6A,1_1_5_1_1_7_3_1_1_18_1_3_1,145,114
chr1A-32739414_32739516,cPa62,1,1,32739464,32739464,cPa62,1,102,0
chr1A-32914765_32914875,cPa339,0.375,5,32914827,32914815,cPa339_cPa339-unknown_cPa444-cPa62-hybrid_cPa444-unknown_cPa447,3_1_1_1_2,110,12
chr1A-33195369_33195503,cPa62-HERV-W_repbase_HERV17_LTR17-hybrid,0.607142857142857,7,33195460,33195371,cPa62-cPa75-hybrid_cPa62-HERV-W_repbase_HERV17_LTR17-hybrid_cPa62-KoRV_AF151794-hybrid_cPa62-unknown_cPa75-HERV-W_repbase_HERV17_LTR17-hybrid_HERV-W_repbase_HERV17_LTR17_KoRV_AF151794,1_17_1_2_1_5_1,134,89
chr1A-33439769_33439871,cPa62,1,1,33439822,33439802,cPa62,27,102,20
chr1A-33511511_33511613,cPa15,0.428571428571429,4,33511562,33511541,cPa118_cPa15_cPa248-unknown_cPa443-cPa118-hybrid,2_3_1_1,102,21
chr1A-33602767_33602984,cPa75-cPa62-hybrid,0.2625,13,33602984,33602817,cPa174-cPa62-hybrid_cPa62_cPa71_cPa71-cPa62-hybrid_cPa71-cPa75-hybrid_cPa75_cPa75-cPa254-hybrid_cPa75-cPa62-hybrid_cPa75-cPa71-hybrid_cPa75-unknown_HERV-W_repbase_HERV17_LTR17_HERV-W_repbase_HERV17_LTR17-cPa62-hybrid_HERV-W_repbase_HERV17_LTR17-unknown,1_12_5_5_2_18_1_21_1_4_7_2_1,217,167
chr1A-33603901_33604003,cPa254,0.3125,8,33603979,33603934,cPa174_cPa174-cPa254-hybrid_cPa174-cPa47-hybrid_cPa254_cPa254-cPa404-hybrid_cPa425_cPa75-cPa254-hybrid_cPa75-cPa47-hybrid,1_1_1_5_1_4_1_2,102,45
chr1A-33874202_33874304,cPa293_cPa391,0.333333333333333,4,33874252,33874239,cPa293_cPa391_cPa426_cPa426-cPa287-hybrid,2_2_1_1,102,13
chr1A-33916587_33916689,cPa419,1,1,33916637,33916637,cPa419,1,102,0
chr1A-33924948_33925053,cPa174-cPa404-hybrid_cPa425,0.333333333333333,4,33925002,33924998,cPa174-cPa404-hybrid_cPa254_cPa425_cPa47,2_1_2_1,105,4
chr1A-341580_341682,cPa138_cPa285_cPa293_cPa308_cPa75_SMRV_NC001514,0.166666666666667,6,341652,341605,cPa138_cPa285_cPa293_cPa308_cPa75_SMRV_NC001514,1_1_1_1_1_1,102,47
chr1A-34740005_34740114,cPa456,0.774193548387097,6,34740068,34740012,cPa363_cPa363-cPa452-hybrid_cPa363-unknown_cPa452_cPa456_cPa456-unknown,1_1_1_3_24_1,109,56
chr1A-3486903_3487005,cPa75,1,1,3486953,3486918,cPa75,3,102,35
chr1A-3487010_3487112,cPa75,1,1,3487060,3487060,cPa75,1,102,0
chr1A-35605465_35605567,cPa419,1,1,35605515,35605515,cPa419,1,102,0
chr1A-35976097_35976199,cPa419-unknown,0.6,3,35976148,35976132,cPa16_cPa419_cPa419-unknown,1_1_3,102,16
chr1A-36092207_36092309,cPa62,0.9,2,36092265,36092256,cPa254-unknown_cPa62,1_9,102,9
chr1A-36164394_36164496,cPa425_cPa47,0.4,3,36164450,36164444,cPa254_cPa425_cPa47,1_2_2,102,6
chr1A-36431031_36431133,cPa62,1,1,36431108,36431081,cPa62,3,102,27
chr1A-36483053_36483155,cPa75,1,1,36483103,36483103,cPa75,1,102,0
chr1A-3655488_3655804,cPa15,0.464285714285714,9,3655752,3655518,cPa118_cPa118-unknown_cPa140-unknown_cPa15_cPa248-PERVC_HM159246-hybrid_cPa248-unknown_cPa268-cPa356-hybrid_cPa268-PERVC_HM159246-hybrid_cPa419,4_1_1_13_1_1_1_2_4,316,234
chr1A-3657023_3657125,cPa15_cPa419,0.333333333333333,6,3657076,3657058,cPa131-cPa15-hybrid_cPa15_cPa268-cPa15-hybrid_cPa268-cPa426-hybrid_cPa356-cPa15-hybrid_cPa419,3_6_1_1_1_6,102,18
chr1A-3657179_3657282,cPa131-cPa15-hybrid,0.555555555555556,4,3657230,3657229,cPa131-cPa15-hybrid_cPa15_cPa419_cPa563-cPa15-hybrid,5_1_2_1,103,1
chr1A-3658038_3658140,cPa419-cPa11-hybrid_cPa563-cPa380-hybrid,0.5,2,3658088,3658071,cPa419-cPa11-hybrid_cPa563-cPa380-hybrid,1_1,102,17
chr1A-3662867_3662969,cPa47,0.363636363636364,5,3662918,3662869,cPa174-cPa47-hybrid_cPa254_cPa425_cPa425-unknown_cPa47,1_2_3_1_4,102,49
chr1A-36733386_36733488,cPa419,1,1,36733436,36733436,cPa419,1,102,0
chr1A-36849533_36849635,cPa62,0.846153846153846,3,36849594,36849583,cPa285_cPa285-unknown_cPa62,1_1_11,102,11
chr1A-36979193_36979298,cPa15,0.588235294117647,5,36979248,36979232,cPa118_cPa118-cPa268-hybrid_cPa118-unknown_cPa15_cPa268,1_3_2_10_1,105,16
chr1A-37279002_37279116,cPa452,0.666666666666667,6,37279098,37279026,cPa363_cPa363-unknown_cPa452_cPa452-cPa363-hybrid_cPa71_cPa71-cPa363-hybrid,12_3_36_1_1_1,114,72
chr1A-37431273_37431375,cPa113,1,1,37431323,37431323,cPa113,1,102,0
chr1A-37509361_37509463,cPa583,0.533333333333333,4,37509419,37509386,cPa251_cPa251-cPa298-hybrid_cPa358_cPa583,2_1_4_8,102,33
chr1A-38299497_38299599,cPa15_cPa268,0.5,2,38299547,38299528,cPa15_cPa268,1_1,102,19
chr1A-38627446_38627548,cPa62,1,1,38627496,38627488,cPa62,3,102,8
chr1A-38892187_38892301,cPa157-cPa34-hybrid_cPa183_cPa193-cPa34-hybrid_cPa500,0.181818181818182,7,38892267,38892208,cPa157-cPa188-hybrid_cPa157-cPa34-hybrid_cPa183_cPa193_cPa193-cPa34-hybrid_cPa500_cPa500-cPa34-hybrid,1_2_2_1_2_2_1,114,59
chr1A-39066678_39066797,cPa131_cPa255,0.333333333333333,4,39066757,39066727,cPa131_cPa255_cPa478_cPa479-cPa438-hybrid,2_2_1_1,119,30
chr1A-39162609_39162711,PRIMA41_repbase_PRIMA41_MER41A,0.8,2,39162670,39162659,cPa419_PRIMA41_repbase_PRIMA41_MER41A,1_4,102,11
chr1A-39209505_39209613,cPa193,0.3,5,39209561,39209545,cPa157_cPa183_cPa193_cPa229_cPa500,2_1_3_2_2,108,16
chr1A-3931643_3931745,PRIMA41_repbase_PRIMA41_MER41A,1,1,3931700,3931693,PRIMA41_repbase_PRIMA41_MER41A,2,102,7
chr1A-39639232_39639361,cPa75,0.833333333333333,2,39639309,39639260,cPa75_cPa75-cPa62-hybrid,5_1,129,49
chr1A-39639455_39639557,cPa75-cPa62-hybrid,0.583333333333333,2,39639557,39639469,cPa75_cPa75-cPa62-hybrid,5_7,102,88
chr1A-39683936_39684043,cPa254,0.302857142857143,17,39684005,39683941,cPa174-cPa254-hybrid_cPa174-cPa392-hybrid_cPa174-cPa404-hybrid_cPa174-cPa425-hybrid_cPa174-cPa47-hybrid_cPa174-unknown_cPa254_cPa254-cPa47-hybrid_cPa254-unknown_cPa392_cPa404_cPa425_cPa425-cPa254-hybrid_cPa425-unknown_cPa47_cPa47-cPa254-hybrid_cPa47-cPa404-hybrid,3_5_3_1_2_5_53_4_3_6_2_47_1_1_37_1_1,107,64
chr1A-39721660_39721762,cPa104,0.388059701492537,7,39721717,39721664,cPa104_cPa104-cPa4-hybrid_cPa104-cPa541-hybrid_cPa190_cPa190-cPa541-hybrid_cPa220_cPa220-unknown,26_2_1_14_1_22_1,102,53
chr1A-3987639_3987746,cPa199-cPa273-hybrid_cPa542,0.333333333333333,5,3987694,3987682,cPa199-cPa273-hybrid_cPa345_cPa450_cPa542_cPa553,3_1_1_3_1,107,12
chr1A-4053932_4054046,cPa523,0.333333333333333,6,4054034,4053982,CAEV_NC001463_cPa260_cPa308_cPa523_cPa523-unknown_cPa572,1_2_1_3_1_1,114,52
chr1A-4054289_4054407,cPa260,0.5,5,4054383,4054339,cPa260_cPa308_HIV1_NC001802_HIV1_NC001802-cPa260-hybrid_HIV1_NC001802-cPa75-hybrid,9_3_4_1_1,118,44
chr1A-405470_405613,cPa260,0.375,9,405613,405474,cPa101_cPa106_cPa106-cPa260-hybrid_cPa106-cPa362-hybrid_cPa256_cPa256-cPa106-hybrid_cPa256-unknown_cPa260_cPa523,1_11_1_1_2_1_1_12_2,143,139
chr1A-4054810_4054963,cPa260,1,1,4054911,4054860,cPa260,2,153,51
chr1A-40572546_40572648,cPa220,0.5,3,40572596,40572550,cPa104_cPa190_cPa220,1_1_2,102,46
chr1A-40577399_40577501,cPa426-cPa287-hybrid,0.30952380952381,7,40577465,40577434,cPa287_cPa293_cPa293-cPa287-hybrid_cPa391_cPa391-cPa287-hybrid_cPa426_cPa426-cPa287-hybrid,2_9_2_7_5_4_13,102,31
chr1A-40580258_40580400,cPa75_HERV-W_repbase_HERV17_LTR17,0.386363636363636,6,40580369,40580307,cPa75_cPa75-cPa62-hybrid_cPa75-unknown_HERV-W_repbase_HERV17_LTR17_HERV-W_repbase_HERV17_LTR17-cPa62-hybrid_PERVC_HM159246,17_5_3_17_1_1,142,62
chr1A-40580411_40580513,cPa75,0.555555555555556,4,40580496,40580451,cPa75_cPa75-cPa62-hybrid_cPa75-unknown_HERV-W_repbase_HERV17_LTR17,10_2_1_5,102,45
chr1A-40635691_40635793,cPa313-cPa465-hybrid,1,1,40635741,40635741,cPa313-cPa465-hybrid,1,102,0
chr1A-40635940_40636042,cPa313-cPa465-hybrid,0.75,2,40635991,40635990,cPa188-cPa465-hybrid_cPa313-cPa465-hybrid,1_3,102,1
chr1A-40743464_40743571,cPa391_cPa426,0.4,3,40743519,40743514,cPa293_cPa391_cPa426,1_2_2,107,5
chr1A-40786966_40787086,cPa47,0.310606060606061,15,40787065,40786967,cPa174_cPa174-cPa254-hybrid_cPa174-cPa392-hybrid_cPa174-cPa425-hybrid_cPa174-cPa47-hybrid_cPa174-unknown_cPa254_cPa254-cPa174-hybrid_cPa254-unknown_cPa404-cPa392-hybrid_cPa425_cPa425-cPa254-hybrid_cPa425-cPa47-hybrid_cPa425-unknown_cPa47,32_18_1_6_6_13_23_1_3_1_75_1_1_1_82,120,98
chr1A-40894620_40894722,cPa62,1,1,40894670,40894636,cPa62,10,102,34
chr1A-40898472_40898574,cPa62,1,1,40898536,40898522,cPa62,2,102,14
chr1A-40973956_40974058,cPa62,0.96875,3,40974029,40973987,cPa293-cPa62-hybrid_cPa293-unknown_cPa62,1_1_62,102,42
chr1A-41006578_41006719,cPa142,0.915254237288136,3,41006695,41006595,cPa101_cPa142_cPa539-cPa101-hybrid,4_54_1,141,100
chr1A-41213130_41213232,cPa62-unknown,0.272727272727273,6,41213228,41213154,cPa62_cPa62-cPa492-hybrid_cPa62-cPa75-hybrid_cPa62-unknown_cPa75_HERV-W_repbase_HERV17_LTR17,2_1_2_3_2_1,102,74
chr1A-41213281_41213472,cPa62-unknown,0.36,7,41213461,41213316,cPa62-cPa71-hybrid_cPa62-cPa75-hybrid_cPa62-HERV-W_repbase_HERV17_LTR17-hybrid_cPa62-unknown_cPa75_HERV-W_repbase_HERV17_LTR17_HERV-W_repbase_HERV17_LTR17-cPa75-hybrid,1_2_6_9_3_3_1,191,145
chr1A-41219714_41219816,cPa62,0.9,2,41219764,41219723,cPa62_cPa62-unknown,9_1,102,41
chr1A-41412090_41412213,cPa62,1,1,41412203,41412094,cPa62,7,123,109
chr1A-41412216_41412323,cPa62,0.86046511627907,4,41412285,41412220,cPa254-cPa62-hybrid_cPa254-unknown_cPa62_HERV30_repbase_HERV30I_LTR30-unknown,1_2_37_3,107,65
chr1A-41640939_41641065,cPa62,0.904761904761905,3,41641021,41640989,cPa176-unknown_cPa530-cPa62-hybrid_cPa62,1_1_19,126,32
chr1A-420908_421010,cPa260-unknown,1,1,420958,420958,cPa260-unknown,1,102,0
chr1A-4231969_4232071,PERVE_NC003059,0.666666666666667,2,4232070,4232019,cPa62_PERVE_NC003059,1_2,102,51
chr1A-42339135_42339237,cPa419,1,1,42339185,42339185,cPa419,1,102,0
chr1A-42846407_42846551,cPa541,0.235294117647059,14,42846518,42846445,cPa104-cPa18-hybrid_cPa104-cPa4-hybrid_cPa104-cPa529-hybrid_cPa104-cPa95-hybrid_cPa18_cPa18-cPa541-hybrid_cPa190-cPa18-hybrid_cPa190-cPa529-hybrid_cPa190-cPa95-hybrid_cPa219-cPa541-hybrid_cPa220-cPa18-hybrid_cPa4_cPa4-cPa95-hybrid_cPa541,5_1_1_2_5_1_1_1_2_1_1_4_1_8,144,73
chr1A-43016067_43016376,HERV-W_repbase_HERV17_LTR17,0.25,9,43016376,43016092,cPa62_cPa62-cPa71-hybrid_cPa62-cPa75-hybrid_cPa62-HERV-W_repbase_HERV17_LTR17-hybrid_cPa62-unknown_cPa75_HERV-W_repbase_HERV17_LTR17_HERV-W_repbase_HERV17_LTR17-cPa75-hybrid_KWERV_GQ222416,18_4_13_5_7_19_23_1_2,309,284
chr1A-43045598_43045700,cPa452-cPa223-hybrid,0.483870967741935,8,43045655,43045607,cPa16-cPa379-hybrid_cPa183_cPa183-cPa424-hybrid_cPa223_cPa363-cPa223-hybrid_cPa363-cPa327-hybrid_cPa363-cPa424-hybrid_cPa452-cPa223-hybrid,1_1_1_5_5_1_2_15,102,48
chr1A-43045873_43046000,cPa452-cPa223-hybrid,0.388235294117647,10,43045990,43045923,cPa183_cPa183-cPa223-hybrid_cPa183-cPa379-hybrid_cPa223_cPa363-cPa223-hybrid_cPa363-cPa327-hybrid_cPa363-cPa424-hybrid_cPa452-cPa223-hybrid_cPa452-cPa424-hybrid_cPa71-cPa223-hybrid,1_5_1_13_20_1_8_33_2_1,127,67
chr1A-43320999_43321121,cPa450,0.307692307692308,6,43321069,43321010,cPa199_cPa223-cPa273-hybrid_cPa227_cPa450_cPa482_cPa553,1_3_1_4_1_3,122,59
chr1A-43335645_43335747,cPa62,1,1,43335695,43335644,cPa62,31,102,51
chr1A-43373964_43374066,cPa18_cPa4_cPa541_cPa95-cPa104-hybrid,0.25,4,43374014,43374014,cPa18_cPa4_cPa541_cPa95-cPa104-hybrid,1_1_1_1,102,0
chr1A-43888483_43888585,cPa62,1,1,43888555,43888527,cPa62,14,102,28
chr1A-4397983_4398212,HERV-W_repbase_HERV17_LTR17,0.625,8,4398197,4398033,cPa62_cPa71-cPa62-hybrid_cPa71-HERV-W_repbase_HERV17_LTR17-hybrid_cPa71-unknown_cPa75-cPa62-hybrid_cPa75-unknown_HERV-W_repbase_HERV17_LTR17_HERV-W_repbase_HERV17_LTR17-unknown,1_2_1_1_1_1_15_2,229,164
chr1A-43991801_43991903,cPa62,0.684210526315789,4,43991901,43991801,cPa254_cPa62_cPa62-cPa285-hybrid_cPa75,1_13_1_4,102,100
chr1A-44066333_44066435,cPa419,1,1,44066383,44066383,cPa419,1,102,0
chr1A-44465730_44465844,cPa444,0.375,4,44465792,44465780,cPa390_cPa444_cPa447_cPa62,1_3_2_2,114,12
chr1A-45085338_45085440,cPa419,1,1,45085388,45085388,cPa419,1,102,0
chr1A-4518304_4518412,cPa254_cPa285_cPa62-cPa419-hybrid,0.333333333333333,3,4518360,4518354,cPa254_cPa285_cPa62-cPa419-hybrid,1_1_1,108,6
chr1A-4518525_4518627,cPa62,0.714285714285714,3,4518575,4518555,cPa254_cPa419-cPa62-hybrid_cPa62,1_1_5,102,20
chr1A-4523220_4523346,cPa62,1,1,4523294,4523270,cPa62,2,126,24
chr1A-45298414_45298516,cPa456,0.375,4,45298479,45298464,cPa117-unknown_cPa363_cPa452-unknown_cPa456,2_2_1_3,102,15
chr1A-45374354_45374485,cPa62,0.435897435897436,12,45374467,45374390,cPa109_cPa125_cPa125-REV_NC006934-hybrid_cPa264_cPa285_cPa285-cPa109-hybrid_cPa293_cPa419_cPa62_cPa62-unknown_REV_NC006934_REV_NC006934-cPa293-hybrid,2_3_1_1_3_1_4_1_17_4_1_1,131,77
chr1A-4551452_4551566,cPa62,1,1,4551522,4551473,cPa62,12,114,49
chr1A-4568190_4568299,cPa113-cPa62-hybrid_cPa113-cPa75-hybrid_cPa113-HERV-W_repbase_HERV17_LTR17-hybrid_cPa75,0.25,4,4568247,4568240,cPa113-cPa62-hybrid_cPa113-cPa75-hybrid_cPa113-HERV-W_repbase_HERV17_LTR17-hybrid_cPa75,1_1_1_1,109,7
chr1A-45976520_45976622,cPa363_cPa456,0.3,5,45976570,45976553,cPa117-cPa456-hybrid_cPa117-cPa587-hybrid_cPa117-unknown_cPa363_cPa456,1_2_1_3_3,102,17
chr1A-46072490_46072600,cPa357-unknown,1,1,46072575,46072540,cPa357-unknown,4,110,35
chr1A-46491611_46491719,cPa444-cPa447-hybrid,0.392857142857143,7,46491672,46491613,cPa339_cPa339-cPa447-hybrid_cPa444-cPa339-hybrid_cPa444-cPa390-hybrid_cPa444-cPa447-hybrid_cPa444-cPa62-hybrid_cPa447,10_1_1_2_11_1_2,108,59
chr1A-46846312_46846425,cPa254_cPa47,0.375,3,46846373,46846359,cPa254_cPa47_cPa47-cPa174-hybrid,3_3_2,113,14
chr1A-47258549_47258651,cPa62,0.933333333333333,3,47258611,47258568,cPa254_cPa62_HFV_NC001736-cPa62-hybrid,1_28_1,102,43
chr1A-4738391_4738585,cPa62-cPa75-hybrid_cPa62-unknown,0.305555555555556,7,4738533,4738438,cPa62_cPa62-cPa71-hybrid_cPa62-cPa75-hybrid_cPa62-HERV-W_repbase_HERV17_LTR17-hybrid_cPa62-unknown_cPa75_cPa75-unknown,1_4_11_1_11_7_1,194,95
chr1A-4738588_4739018,cPa75,0.333333333333333,9,4738982,4738638,cPa62_cPa62-cPa71-hybrid_cPa62-cPa75-hybrid_cPa62-HERV-W_repbase_HERV17_LTR17-hybrid_cPa62-unknown_cPa71_cPa71-unknown_cPa75_HERV-W_repbase_HERV17_LTR17,6_2_16_2_17_1_1_23_1,430,344
chr1A-47681330_47681432,cPa363,1,1,47681380,47681352,cPa363,2,102,28
chr1A-47933835_47933938,cPa425,0.3,5,47933925,47933858,cPa174_cPa174-unknown_cPa254_cPa425_cPa47,2_1_2_3_2,103,67
chr1A-48376954_48377056,cPa419_cPa544-cPa419-hybrid,0.5,2,48377033,48377004,cPa419_cPa544-cPa419-hybrid,1_1,102,29
chr1A-48453380_48453482,cPa163,0.315789473684211,7,48453448,48453392,cPa163_cPa224_cPa224-cPa163-hybrid_cPa224-cPa360-hybrid_cPa224-unknown_cPa360_cPa360-unknown,12_10_2_1_2_10_1,102,56
chr1A-4937559_4937661,cPa452,0.454545454545455,3,4937619,4937596,cPa363_cPa452_cPa71,3_5_3,102,23
chr1A-49738092_49738194,cPa75,0.666666666666667,3,49738146,49738101,cPa62_cPa75_cPa75-cPa62-hybrid,1_4_1,102,45
chr1A-4999918_5000054,cPa392_cPa419-unknown,0.5,2,5000002,4999968,cPa392_cPa419-unknown,1_1,136,34
chr1A-5054572_5054674,cPa75-cPa62-hybrid,0.25,10,5054671,5054603,cPa293_cPa293-cPa62-hybrid_cPa62_cPa75_cPa75-cPa62-hybrid_cPa75-unknown_HERV-W_repbase_HERV17_LTR17_HERV-W_repbase_HERV17_LTR17-cPa62-hybrid_PERV_AJ293656-cPa62-hybrid_PERVC_HM159246-cPa62-hybrid,1_1_2_2_4_1_2_1_1_1,102,68
chr1A-512375_512477,cPa260_cPa75,0.5,2,512425,512389,cPa260_cPa75,1_1,102,36
chr1A-512687_512789,cPa75,1,1,512737,512737,cPa75,1,102,0
chr1A-51331745_51331894,cPa450,0.5,16,51331868,51331795,cPa223_cPa227_cPa273_cPa273-cPa223-hybrid_cPa273-cPa227-hybrid_cPa419_cPa450_cPa542_cPa542-cPa199-hybrid_cPa542-cPa223-hybrid_cPa542-cPa227-hybrid_cPa542-cPa345-hybrid_cPa542-cPa450-hybrid_cPa542-unknown_cPa553_cPa553-cPa223-hybrid,1_2_2_3_1_1_30_5_4_1_3_1_1_1_3_1,149,73
chr1A-51534434_51534536,cPa363_cPa456,0.333333333333333,4,51534484,51534473,cPa363_cPa456_cPa456-cPa452-hybrid_cPa587-cPa117-hybrid,2_2_1_1,102,11
chr1A-51672953_51673055,cPa176-cPa16-hybrid_cPa363_cPa452_cPa71,0.25,4,51673003,51673003,cPa176-cPa16-hybrid_cPa363_cPa452_cPa71,1_1_1_1,102,0
chr1A-52006156_52006264,cPa450,0.428571428571429,6,52006220,52006186,cPa227_cPa273-cPa223-hybrid_cPa450_cPa553_cPa553-cPa223-hybrid_cPa585-cPa223-hybrid,1_2_6_2_2_1,108,34
chr1A-5323754_5323856,cPa75,0.411764705882353,9,5323838,5323762,cPa542_cPa542-cPa75-hybrid_cPa542-HERV-W_repbase_HERV17_LTR17-hybrid_cPa62-HERV-W_repbase_HERV17_LTR17-hybrid_cPa71_cPa75_cPa75-KoRV_AF151794-hybrid_HERV-W_repbase_HERV17_LTR17_HTLV1_NC001436-cPa75-hybrid,1_2_1_1_1_7_1_2_1,102,76
chr1A-53322271_53322563,cPa15,0.5,4,53322511,53322321,cPa15_cPa15-cPa118-hybrid_cPa15-cPa443-hybrid_cPa15-cPa516-hybrid,6_3_2_1,292,190
chr1A-53322896_53322998,cPa15_cPa15-cPa443-hybrid,0.5,2,53322946,53322924,cPa15_cPa15-cPa443-hybrid,1_1,102,22
chr1A-5332858_5332960,cPa62,1,1,5332922,5332879,cPa62,41,102,43
chr1A-5333033_5333140,cPa62,1,1,5333091,5333054,cPa62,7,107,37
chr1A-5333280_5333393,cPa62,1,1,5333341,5333330,cPa62,3,113,11
chr1A-5333682_5333784,cPa62,0.96875,2,5333750,5333731,cPa254_cPa62,1_31,102,19
chr1A-53347507_53347626,cPa345,1,1,53347592,53347557,cPa345,8,119,35
chr1A-53347634_53347736,cPa345,1,1,53347710,53347641,cPa345,3,102,69
chr1A-53347799_53347901,cPa345,1,1,53347887,53347804,cPa345,9,102,83
chr1A-5362532_5362634,HERV-W_repbase_HERV17_LTR17,0.421052631578947,6,5362604,5362531,cPa62-cPa75-hybrid_cPa62-HERV-W_repbase_HERV17_LTR17-hybrid_cPa62-unknown_cPa75_cPa75-HERV-W_repbase_HERV17_LTR17-hybrid_HERV-W_repbase_HERV17_LTR17,1_3_1_5_1_8,102,73
chr1A-5362650_5362752,cPa75,1,1,5362700,5362700,cPa75,1,102,0
chr1A-5362849_5362957,HERV-W_repbase_HERV17_LTR17,0.555555555555556,6,5362939,5362885,cPa62-cPa67-hybrid_cPa62-cPa75-hybrid_cPa62-HERV-W_repbase_HERV17_LTR17-hybrid_cPa62-unknown_cPa75_HERV-W_repbase_HERV17_LTR17,1_2_1_2_2_10,108,54
chr1A-5363036_5363254,HERV-W_repbase_HERV17_LTR17,0.325,8,5363234,5363049,cPa62_cPa62-cPa75-hybrid_cPa62-HERV-W_repbase_HERV17_LTR17-hybrid_cPa62-unknown_cPa75_cPa75-HERV-W_repbase_HERV17_LTR17-hybrid_cPa75-unknown_HERV-W_repbase_HERV17_LTR17,1_1_5_11_7_1_1_13,218,185
chr1A-53640069_53640171,cPa75,0.857142857142857,2,53640134,53640105,cPa62-HERV-W_repbase_HERV17_LTR17-hybrid_cPa75,1_6,102,29
chr1A-53641092_53641329,cPa75,0.918918918918919,2,53641289,53641142,cPa75_cPa75-HERV-W_repbase_HERV17_LTR17-hybrid,34_3,237,147
chr1A-53642107_53642209,cPa75,1,1,53642206,53642157,cPa75,5,102,49
chr1A-53707545_53707651,cPa152-unknown,1,1,53707623,53707590,cPa152-unknown,35,106,33
chr1A-53712994_53713096,cPa254_cPa308-cPa254-hybrid_cPa47_cPa47-cPa174-hybrid,0.25,4,53713077,53713044,cPa254_cPa308-cPa254-hybrid_cPa47_cPa47-cPa174-hybrid,1_1_1_1,102,33
chr1A-53873141_53873245,cPa583,0.833333333333333,2,53873213,53873191,cPa358_cPa583,1_5,104,22
chr1A-53874509_53874690,cPa502,0.444444444444444,12,53874678,53874511,cPa118-cPa101-hybrid_cPa118-cPa177-hybrid_cPa118-cPa47-hybrid_cPa15-cPa177-hybrid_cPa15-cPa392-hybrid_cPa15-cPa449-hybrid_cPa15-cPa47-hybrid_cPa15-cPa583-hybrid_cPa15-unknown_cPa456-cPa363-hybrid_cPa502_cPa502-cPa583-hybrid,1_2_3_2_1_1_2_4_2_1_16_1,181,167
chr1A-53875143_53875245,cPa502,0.833333333333333,2,53875238,53875170,cPa15-unknown_cPa502,1_5,102,68
chr1A-53875308_53875431,cPa502,0.833333333333333,3,53875417,53875307,cPa42-cPa177-hybrid_cPa502_cPa502-cPa357-hybrid,1_10_1,123,110
chr1A-5397644_5397746,cPa62,1,1,5397709,5397658,cPa62,21,102,51
chr1A-53995799_53995901,cPa449,0.27906976744186,6,53995898,53995798,cPa223_cPa229_cPa287-VISNA_S55323-hybrid_cPa313_cPa419_cPa449,6_11_3_10_1_12,102,100
chr1A-53996511_53996613,cPa449,0.206896551724138,10,53996601,53996511,cPa199_cPa223_cPa229_cPa313_cPa332_cPa419_cPa449_cPa450_cPa450-cPa426-hybrid_cPa456,1_3_3_5_4_3_6_1_1_2,102,90
chr1A-53997062_53997350,cPa449,0.174757281553398,31,53997330,53997061,cPa174_cPa174-cPa199-hybrid_cPa174-cPa542-hybrid_cPa199_cPa223_cPa229_cPa229-cPa273-hybrid_cPa287-cPa456-hybrid_cPa313_cPa332_cPa345-cPa199-hybrid_cPa357-cPa15-hybrid_cPa392-cPa426-hybrid_cPa395-cPa391-hybrid_cPa404-cPa426-hybrid_cPa419_cPa449_cPa450_cPa450-cPa357-hybrid_cPa450-cPa426-hybrid_cPa450-cPa456-hybrid_cPa452-cPa174-hybrid_cPa456_cPa456-cPa174-hybrid_cPa456-cPa199-hybrid_cPa456-cPa293-hybrid_cPa456-cPa357-hybrid_cPa47-cPa199-hybrid_cPa553-cPa199-hybrid_cPa75-cPa450-hybrid_cPa75-cPa456-hybrid,2_1_1_6_67_68_1_1_71_58_1_1_1_1_1_6_72_4_1_1_2_1_33_1_2_1_1_2_1_1_2,288,269
chr1A-53998322_53998567,cPa449,0.443298969072165,11,53998566,53998322,cPa199_cPa223_cPa229_cPa313_cPa419_cPa449_cPa47_cPa47-cPa542-hybrid_cPa553_cPa75-cPa273-hybrid_cPa75-cPa542-hybrid,1_2_21_23_2_43_1_1_1_1_1,245,244
chr1A-53999405_53999507,cPa449,0.351851851851852,10,53999507,53999406,cPa229_cPa313_cPa404-cPa456-hybrid_cPa419_cPa449_cPa75-cPa199-hybrid_cPa75-cPa229-hybrid_cPa75-cPa254-hybrid_cPa75-cPa357-hybrid_cPa75-cPa553-hybrid,8_15_1_2_19_2_1_2_3_1,102,101
chr1A-53999725_53999827,cPa449,0.5,4,53999823,53999755,cPa313_cPa419_cPa449_cPa75-unknown,10_1_12_1,102,68
chr1A-54015020_54015124,cPa333,0.444444444444444,5,54015112,54015069,cPa254-cPa482-hybrid_cPa333_cPa62_cPa62-HERV30_repbase_HERV30I_LTR30-hybrid_HERV30_repbase_HERV30I_LTR30,1_4_1_1_2,104,43
chr1A-54019341_54019506,cPa332,0.375,5,54019486,54019391,cPa199_cPa332_cPa332-cPa199-hybrid_cPa456_cPa456-unknown,1_3_1_2_1,165,95
chr1A-54021863_54021965,cPa419,0.923076923076923,2,54021962,54021877,cPa419_cPa553,12_1,102,85
chr1A-54022916_54023018,cPa75,0.555555555555556,4,54023015,54022966,cPa223-cPa75-hybrid_cPa62-cPa75-hybrid_cPa62-unknown_cPa75,1_1_2_5,102,49
chr1A-54027931_54028046,cPa456-cPa62-hybrid,0.5,3,54027994,54027981,cPa363-unknown_cPa456-cPa452-hybrid_cPa456-cPa62-hybrid,1_1_2,115,13
chr1A-54035427_54035529,cPa419,1,1,54035528,54035477,cPa419,10,102,51
chr1A-54035631_54035844,cPa419,1,1,54035792,54035681,cPa419,8,213,111
chr1A-54035924_54036026,cPa419,1,1,54036011,54035968,cPa419,5,102,43
chr1A-54036789_54036979,cPa419,1,1,54036927,54036789,cPa419,13,190,138
chr1A-54037138_54037367,cPa419,1,1,54037315,54037141,cPa419,13,229,174
chr1A-54037433_54037535,cPa419,1,1,54037483,54037464,cPa419,4,102,19
chr1A-54037600_54037702,cPa419,1,1,54037650,54037615,cPa419,3,102,35
chr1A-54038034_54038136,cPa419,1,1,54038084,54038084,cPa419,1,102,0
chr1A-54038162_54038473,cPa419,1,1,54038427,54038208,cPa419,39,311,219
chr1A-54038618_54038802,cPa419,1,1,54038779,54038667,cPa419,10,184,112
chr1A-54038845_54039017,cPa419,1,1,54039005,54038864,cPa419,25,172,141
chr1A-54039182_54039306,cPa419,1,1,54039303,54039231,cPa419,39,124,72
chr1A-54039705_54039820,cPa419,1,1,54039778,54039745,cPa419,8,115,33
chr1A-54041602_54041704,cPa419,1,1,54041660,54041606,cPa419,27,102,54
chr1A-54042242_54042344,cPa419,1,1,54042343,54042269,cPa419,4,102,74
chr1A-54046994_54047096,cPa419,1,1,54047058,54046995,cPa419,6,102,63
chr1A-54047207_54047309,cPa419,1,1,54047307,54047256,cPa419,9,102,51
chr1A-54048568_54048741,cPa419,1,1,54048741,54048618,cPa419,24,173,123
chr1A-54049056_54049158,cPa419,1,1,54049152,54049057,cPa419,14,102,95
chr1A-54049217_54049574,cPa419,1,1,54049551,54049220,cPa419,66,357,331
chr1A-54049659_54049796,cPa419,1,1,54049787,54049687,cPa419,11,137,100
chr1A-542432_542534,cPa75,1,1,542482,542482,cPa75,1,102,0
chr1A-54269719_54269821,cPa62-cPa75-hybrid,0.818181818181818,2,54269779,54269737,cPa62_cPa62-cPa75-hybrid,2_9,102,42
chr1A-54270795_54270897,cPa62-cPa75-hybrid,1,1,54270868,54270845,cPa62-cPa75-hybrid,4,102,23
chr1A-542751_543293,cPa75,1,1,543241,542801,cPa75,16,542,440
chr1A-543353_543455,cPa75,1,1,543403,543403,cPa75,1,102,0
chr1A-543493_543628,cPa75,1,1,543576,543543,cPa75,2,135,33
chr1A-54428299_54428401,cPa62,0.904761904761905,3,54428372,54428304,cPa285_cPa285-unknown_cPa62,1_1_19,102,68
chr1A-54486562_54486664,cPa62,1,1,54486661,54486612,cPa62,8,102,49
chr1A-54488265_54488367,cPa62,1,1,54488315,54488315,cPa62,1,102,0
chr1A-54488854_54488956,cPa293-cPa62-hybrid_cPa62,0.5,2,54488904,54488855,cPa293-cPa62-hybrid_cPa62,1_1,102,49
chr1A-5508526_5508688,cPa113_cPa75-cPa113-hybrid,0.5,2,5508636,5508576,cPa113_cPa75-cPa113-hybrid,1_1,162,60
chr1A-5508800_5509001,cPa113_cPa419-cPa413-hybrid_cPa75_cPa75-cPa113-hybrid,0.25,4,5508949,5508850,cPa113_cPa419-cPa413-hybrid_cPa75_cPa75-cPa113-hybrid,1_1_1_1,201,99
chr1A-55109158_55109260,cPa15,0.741935483870968,5,55109218,55109157,cPa15_cPa15-cPa75-hybrid_cPa268_cPa268-cPa118-hybrid_cPa268-cPa75-hybrid,23_1_2_4_1,102,61
chr1A-55346624_55346726,cPa75-unknown,1,1,55346726,55346674,cPa75-unknown,2,102,52
chr1A-55346879_55347053,cPa75_HERV-W_repbase_HERV17_LTR17_HERV-W_repbase_HERV17_LTR17-cPa75-hybrid,0.333333333333333,3,55347001,55346894,cPa75_HERV-W_repbase_HERV17_LTR17_HERV-W_repbase_HERV17_LTR17-cPa75-hybrid,1_1_1,174,107
chr1A-55437013_55437115,cPa75,1,1,55437063,55437063,cPa75,1,102,0
chr1A-55520304_55520406,cPa62,1,1,55520354,55520354,cPa62,1,102,0
chr1A-55605521_55605623,cPa75,1,1,55605571,55605571,cPa75,1,102,0
chr1A-55605917_55606019,cPa75,1,1,55605967,55605967,cPa75,1,102,0
chr1A-55606178_55606405,cPa75,1,1,55606353,55606228,cPa75,3,227,125
chr1A-55830896_55831187,HERV-W_repbase_HERV17_LTR17,0.70873786407767,5,55831187,55830896,cPa62-HERV-W_repbase_HERV17_LTR17-hybrid_cPa62-unknown_cPa75-unknown_HERV-W_repbase_HERV17_LTR17_KoRV_AF151794,9_19_1_73_1,291,291
chr1A-55937232_55937334,cPa62,0.814814814814815,3,55937292,55937274,cPa419_cPa62_cPa62-unknown,1_22_4,102,18
chr1A-55991211_55991423,cPa75-unknown_HERV-W_repbase_HERV17_LTR17-unknown,0.272727272727273,5,55991396,55991230,cPa75_cPa75-HERV-W_repbase_HERV17_LTR17-hybrid_cPa75-unknown_HERV-W_repbase_HERV17_LTR17_HERV-W_repbase_HERV17_LTR17-unknown,1_2_3_2_3,212,166
chr1A-55991486_55991588,cPa75,1,1,55991536,55991536,cPa75,1,102,0
chr1A-55996153_55996255,cPa75_HERV-W_repbase_HERV17_LTR17-cPa62-hybrid,0.5,2,55996224,55996203,cPa75_HERV-W_repbase_HERV17_LTR17-cPa62-hybrid,1_1,102,21
chr1A-56022306_56022408,cPa362-cPa199-hybrid_cPa585-cPa199-hybrid,0.5,2,56022383,56022356,cPa362-cPa199-hybrid_cPa585-cPa199-hybrid,1_1,102,27
chr1A-56047640_56047925,cPa62,0.714285714285714,3,56047873,56047690,cPa419_cPa62_cPa75,1_10_3,285,183
chr1A-56257082_56257192,cPa62,1,1,56257152,56257131,cPa62,55,110,21
chr1A-56318678_56318882,cPa419,1,1,56318847,56318706,cPa419,15,204,141
chr1A-56319936_56320038,cPa419,1,1,56319994,56319940,cPa419,9,102,54
chr1A-56320084_56320334,cPa419,1,1,56320312,56320084,cPa419,102,250,228
chr1A-56333012_56333123,HERV-W_repbase_HERV17_LTR17,0.36,8,56333097,56333050,cPa71_cPa75_cPa75-cPa62-hybrid_HERV-W_repbase_HERV17_LTR17_HERV-W_repbase_HERV17_LTR17-cPa75-hybrid_HERV-W_repbase_HERV17_LTR17-unknown_PERV_AJ293656_S71_repbase_HERVS71_LTR6A,1_4_1_9_1_7_1_1,111,47
chr1A-56333200_56333336,HERV-W_repbase_HERV17_LTR17-unknown,0.433333333333333,8,56333284,56333250,cPa62_cPa75_cPa75-cPa62-hybrid_cPa75-HERVHcons-hybrid_cPa75-unknown_HERV-W_repbase_HERV17_LTR17_HERV-W_repbase_HERV17_LTR17-cPa75-hybrid_HERV-W_repbase_HERV17_LTR17-unknown,1_22_2_1_2_22_1_39,136,34
chr1A-56334516_56334717,cPa419,0.975609756097561,2,56334717,56334558,cPa419_cPa419-cPa229-hybrid,40_1,201,159
chr1A-56335758_56335860,cPa419,0.666666666666667,2,56335858,56335808,cPa419_cPa419-cPa229-hybrid,2_1,102,50
chr1A-56337386_56337500,cPa223,0.2,10,56337499,56337387,cPa223_cPa223-cPa15-hybrid_cPa223-cPa229-hybrid_cPa293_cPa313_cPa332_cPa391_cPa426-cPa287-hybrid_cPa426-cPa456-hybrid_cPa449-cPa229-hybrid,3_1_1_2_1_2_2_1_1_1,114,112
chr1A-56338108_56338210,cPa223,0.6,3,56338206,56338134,cPa223_cPa332_cPa449,3_1_1,102,72
chr1A-56784929_56785031,cPa395,0.6,2,56785009,56784948,cPa395_PERVC_HM159246,3_2,102,61
chr1A-56785155_56785308,cPa395_PERVC_HM159246,0.5,2,56785256,56785205,cPa395_PERVC_HM159246,2_2,153,51
chr1A-56962158_56962260,cPa75,0.666666666666667,2,56962248,56962184,cPa75_cPa75-cPa486-hybrid,2_1,102,64
chr1A-56966658_56966982,HERV-W_repbase_HERV17_LTR17,0.491803278688525,12,56966982,56966691,cPa419-cPa62-hybrid_cPa62_cPa75_cPa75-cPa62-hybrid_cPa75-unknown_HERV-W_repbase_HERV17_LTR17_HERV-W_repbase_HERV17_LTR17-cPa419-hybrid_HERV-W_repbase_HERV17_LTR17-cPa62-hybrid_HERV-W_repbase_HERV17_LTR17-cPa75-hybrid_HERV-W_repbase_HERV17_LTR17-unknown_KoRV_AF151794-unknown_Xen1_AJ506107-cPa62-hybrid,1_4_11_1_1_30_1_4_1_5_1_1,324,291
chr1A-56967006_56967108,cPa75,1,1,56967056,56967056,cPa75,1,102,0
chr1A-56968009_56968191,cPa419,1,1,56968184,56968050,cPa419,20,182,134
chr1A-5704498_5704600,cPa75,0.625,13,5704590,5704502,cPa113_cPa113-cPa62-hybrid_cPa113-cPa75-hybrid_cPa293-cPa62-hybrid_cPa530-cPa75-hybrid_cPa67-cPa75-hybrid_cPa67-PERVA_AY099323-hybrid_cPa75_cPa75-cPa62-hybrid_HERV-W_repbase_HERV17_LTR17-unknown_MSEV_CT990572-cPa62-hybrid_MSEV_CT990572-unknown_PERVC_HM159246,6_1_1_1_1_1_1_30_2_1_1_1_1,102,88
chr1A-570759_570861,cPa75,1,1,570809,570809,cPa75,1,102,0
chr1A-571379_571481,cPa75,1,1,571429,571429,cPa75,1,102,0
chr1A-5727861_5727963,cPa456,0.4,7,5727948,5727874,cPa117-cPa363-hybrid_cPa117-cPa587-hybrid_cPa117-unknown_cPa363_cPa363-unknown_cPa452-unknown_cPa456,1_1_1_7_1_1_8,102,74
chr1A-57713266_57713368,cPa118_cPa118-cPa443-hybrid_cPa434_cPa566-cPa443-hybrid,0.25,4,57713327,57713316,cPa118_cPa118-cPa443-hybrid_cPa434_cPa566-cPa443-hybrid,1_1_1_1,102,11
chr1A-577491_577593,cPa75,1,1,577557,577541,cPa75,3,102,16
chr1A-58147629_58147731,cPa62,1,1,58147685,58147661,cPa62,5,102,24
chr1A-581856_581958,cPa75,1,1,581906,581894,cPa75,2,102,12
chr1A-582506_582888,cPa75,1,1,582836,582556,cPa75,14,382,280
chr1A-583049_583508,cPa75,1,1,583456,583099,cPa75,24,459,357
chr1A-583632_583734,cPa75,1,1,583682,583682,cPa75,1,102,0
chr1A-58625678_58625780,cPa62,1,1,58625728,58625681,cPa62,2,102,47
chr1A-58625781_58625916,cPa62-unknown,0.470588235294118,4,58625914,58625801,cPa285_cPa62_cPa62-cPa285-hybrid_cPa62-unknown,1_7_1_8,135,113
chr1A-58835056_58835158,HERV-W_repbase_HERV17_LTR17,0.952380952380952,2,58835157,58835084,cPa419_HERV-W_repbase_HERV17_LTR17,1_20,102,73
chr1A-5907683_5907989,cPa75,0.703125,8,5907938,5907696,cPa201_cPa308_cPa419_cPa75_cPa75-cPa293-hybrid_cPa75-cPa62-hybrid_cPa75-unknown_HERV-W_repbase_HERV17_LTR17,1_1_1_45_1_5_8_2,306,242
chr1A-592965_593067,cPa75,1,1,593015,593015,cPa75,1,102,0
chr1A-59408345_59408447,cPa62,1,1,59408444,59408395,cPa62,16,102,49
chr1A-59567026_59567128,cPa75,1,1,59567089,59567076,cPa75,2,102,13
chr1A-596390_596492,cPa158,1,1,596440,596440,cPa158,1,102,0
chr1A-59769478_59769580,cPa62,0.857142857142857,3,59769573,59769493,cPa419-cPa254-hybrid_cPa62_cPa62-unknown,1_24_3,102,80
chr1A-59881230_59881352,cPa492,1,1,59881308,59881240,cPa492,34,122,68
chr1A-59939368_59939470,cPa402,0.4,4,59939437,59939386,cPa285_cPa402_cPa402-cPa62-hybrid_cPa62,3_6_1_5,102,51
chr1A-59977809_59977911,HERV-W_repbase_HERV17_LTR17,0.6,2,59977898,59977813,cPa75_HERV-W_repbase_HERV17_LTR17,2_3,102,85
chr1A-59977955_59978154,HERV-W_repbase_HERV17_LTR17,0.75,4,59978149,59977967,cPa62-HERV-W_repbase_HERV17_LTR17-hybrid_HERV-W_repbase_HERV17_LTR17_HERV-W_repbase_HERV17_LTR17-cPa75-hybrid_PERV_AJ293656-cPa75-hybrid,1_9_1_1,199,182
chr1A-59978223_59978407,HERV-W_repbase_HERV17_LTR17,0.5,6,59978404,59978224,cPa62_cPa62-HERV-W_repbase_HERV17_LTR17-hybrid_HERV-W_repbase_HERV17_LTR17_HERV-W_repbase_HERV17_LTR17-cPa75-hybrid_KoRV_AF151794_PERV_AJ293656,2_2_12_4_2_2,184,180
chr1A-60280421_60280526,HML1a_repbase_HERV-K14CI_LTR14C,0.857142857142857,2,60280500,60280460,cPa199_HML1a_repbase_HERV-K14CI_LTR14C,2_12,105,40
chr1A-60280552_60280654,cPa199,1,1,60280652,60280576,cPa199,6,102,76
chr1A-60280661_60280774,cPa199,0.957446808510638,2,60280773,60280687,cPa199_cPa199-unknown,45_2,113,86
chr1A-603198_603300,cPa75,1,1,603248,603248,cPa75,2,102,0
chr1A-60414804_60414906,cPa62,0.9,2,60414859,60414840,cPa254-cPa62-hybrid_cPa62,1_9,102,19
chr1A-60434409_60434511,HERV-W_repbase_HERV17_LTR17,0.454545454545455,6,60434468,60434417,cPa113-unknown_HERV-W_repbase_HERV17_LTR17_HERV-W_repbase_HERV17_LTR17-cPa75-hybrid_HERV-W_repbase_HERV17_LTR17-KoRV_AF151794-hybrid_MoMLV_J02255_PERV_AJ293656,1_5_1_1_1_2,102,51
chr1A-60447761_60447863,cPa199_cPa199-unknown,0.5,2,60447811,60447765,cPa199_cPa199-unknown,1_1,102,46
chr1A-60457926_60458028,cPa199,0.25,9,60457989,60457967,cPa199_cPa223_cPa345_cPa345-cPa223-hybrid_cPa419_cPa450_cPa482_cPa542_cPa553,4_1_1_1_1_1_3_2_2,102,22
chr1A-60667049_60667151,cPa339-cPa539-hybrid,1,1,60667099,60667099,cPa339-cPa539-hybrid,1,102,0
chr1A-60893184_60893286,cPa117,1,1,60893234,60893234,cPa117,1,102,0
chr1A-61011804_61011906,cPa118_cPa15,0.5,2,61011861,61011854,cPa118_cPa15,3_3,102,7
chr1A-61020229_61020342,cPa62,1,1,61020335,61020279,cPa62,13,113,56
chr1A-61020423_61020615,cPa62,0.948275862068966,4,61020581,61020449,cPa285_cPa402-unknown_cPa62_cPa62-unknown,1_1_55_1,192,132
chr1A-61216214_61216320,cPa62,1,1,61216291,61216264,cPa62,16,106,27
chr1A-61480091_61480285,cPa223-cPa450-hybrid,0.4,4,61480247,61480141,cPa199-cPa227-hybrid_cPa223-cPa450-hybrid_cPa345_cPa345-cPa227-hybrid,1_2_1_1,194,106
chr1A-61503525_61503627,cPa62,0.888888888888889,2,61503580,61503562,cPa62_HERV30_repbase_HERV30I_LTR30-cPa62-hybrid,8_1,102,18
chr1A-61656918_61657032,cPa174_cPa254_cPa425_cPa47,0.25,4,61656980,61656968,cPa174_cPa254_cPa425_cPa47,1_1_1_1,114,12
chr1A-61714224_61714326,cPa539,1,1,61714274,61714274,cPa539,1,102,0
chr1A-619380_619482,cPa75,1,1,619430,619430,cPa75,1,102,0
chr1A-619662_619764,cPa75,1,1,619712,619712,cPa75,1,102,0
chr1A-619769_619880,cPa75,1,1,619828,619819,cPa75,3,111,9
chr1A-619895_619997,cPa75,1,1,619945,619945,cPa75,1,102,0
chr1A-620245_620347,cPa75,1,1,620305,620295,cPa75,2,102,10
chr1A-620366_620485,cPa75,1,1,620433,620408,cPa75,4,119,25
chr1A-62086904_62087006,cPa75,1,1,62086954,62086954,cPa75,1,102,0
chr1A-62987274_62987467,cPa62,0.666666666666667,2,62987415,62987324,cPa62_cPa75-cPa62-hybrid,2_1,193,91
chr1A-63114647_63114749,cPa71,0.4,7,63114746,63114661,cPa62-cPa71-hybrid_cPa62-HERV-W_repbase_HERV17_LTR17-hybrid_cPa62-unknown_cPa71_cPa75-PERV_AJ293656-hybrid_cPa75-unknown_HERV-W_repbase_HERV17_LTR17,1_1_1_4_1_1_1,102,85
chr1A-63114848_63114950,cPa62-unknown,0.7,4,63114945,63114864,cPa62_cPa62-cPa71-hybrid_cPa62-HERV-W_repbase_HERV17_LTR17-hybrid_cPa62-unknown,1_1_1_7,102,81
chr1A-63933055_63933216,cPa62,0.6,3,63933164,63933105,cPa285_cPa285-cPa62-hybrid_cPa62,1_1_3,161,59
chr1A-63933419_63933612,cPa75,0.315789473684211,14,63933560,63933467,cPa224_cPa224-cPa285-hybrid_cPa224-cPa62-hybrid_cPa224-cPa75-hybrid_cPa285-cPa62-hybrid_cPa285-cPa75-hybrid_cPa293_cPa402-cPa75-hybrid_cPa62_cPa75_GaLV_M26927_GaLV_M26927-cPa62-hybrid_HERV-F_repbase_HERVFH19I_LTR19A_PERVC_HM159246,3_2_1_1_1_1_1_1_10_12_2_1_1_1,193,93
chr1A-63933682_63933784,cPa62,1,1,63933732,63933732,cPa62,1,102,0
chr1A-64064996_64065139,cPa75,0.590909090909091,8,64065129,64065046,cPa293_cPa62-cPa260-hybrid_cPa62-cPa75-hybrid_cPa62-unknown_cPa75_cPa75-cPa260-hybrid_cPa75-HERV-F_repbase_HERVFH19I_LTR19A-hybrid_cPa75-unknown,1_1_2_1_13_2_1_1,143,83
chr1A-64065178_64065280,cPa75,0.411764705882353,5,64065259,64065199,cPa62-cPa413-hybrid_cPa62-cPa75-hybrid_cPa62-unknown_cPa75_cPa75-unknown,2_4_2_7_2,102,60
chr1A-64235232_64235420,cPa62,0.906976744186046,3,64235380,64235255,cPa62_cPa75-cPa62-hybrid_cPa75-unknown,39_3_1,188,125
chr1A-64238521_64238623,cPa75,0.666666666666667,2,64238571,64238571,cPa62_cPa75,1_2,102,0
chr1A-64671060_64671162,cPa62,1,1,64671110,64671110,cPa62,1,102,0
chr1A-646842_647032,cPa75,1,1,646980,646892,cPa75,3,190,88
chr1A-647127_647229,cPa75,1,1,647177,647177,cPa75,1,102,0
chr1A-647610_647712,cPa75,1,1,647660,647660,cPa75,1,102,0
chr1A-64850086_64850245,cPa363_cPa452_cPa71,0.333333333333333,3,64850193,64850136,cPa363_cPa452_cPa71,1_1_1,159,57
chr1A-64899414_64899522,cPa62,1,1,64899495,64899417,cPa62,40,108,78
chr1A-65069152_65069254,cPa419,1,1,65069202,65069202,cPa419,1,102,0
chr1A-65198352_65198454,cPa254_cPa419_cPa425,0.333333333333333,3,65198402,65198379,cPa254_cPa419_cPa425,1_1_1,102,23
chr1A-65310407_65310509,cPa62,0.888888888888889,2,65310462,65310445,cPa62_cPa62-unknown,16_2,102,17
chr1A-65696950_65697052,cPa62,1,1,65697000,65696989,cPa62,2,102,11
chr1A-65827057_65827159,cPa75,1,1,65827118,65827076,cPa75,7,102,42
chr1A-65877750_65877852,cPa62,0.951219512195122,3,65877815,65877773,cPa285_cPa293_cPa62,1_1_39,102,42
chr1A-659998_660100,cPa75,1,1,660048,660041,cPa75,2,102,7
chr1A-660601_660703,cPa75,1,1,660651,660651,cPa75,1,102,0
chr1A-66340418_66340520,cPa15,1,1,66340468,66340468,cPa15,1,102,0
chr1A-66413097_66413199,cPa450,0.5,8,66413158,66413139,cPa199_cPa199-cPa273-hybrid_cPa199-cPa553-hybrid_cPa223-cPa273-hybrid_cPa223-cPa553-hybrid_cPa227_cPa450_cPa553,4_2_1_1_1_1_13_3,102,19
chr1A-66676994_66677096,cPa428,1,1,66677044,66677009,cPa428,8,102,35
chr1A-66732088_66732271,cPa75,0.5,3,66732219,66732138,cPa293_cPa62_cPa75,1_1_2,183,81
chr1A-66732283_66732487,cPa293_cPa62-cPa75-hybrid_cPa75,0.333333333333333,3,66732435,66732333,cPa293_cPa62-cPa75-hybrid_cPa75,1_1_1,204,102
chr1A-66943338_66943464,cPa260,0.833333333333333,2,66943444,66943337,cPa260_cPa260-unknown,10_2,126,107
chr1A-66943586_66943688,cPa75-unknown,1,1,66943636,66943636,cPa75-unknown,1,102,0
chr1A-6697240_6697342,cPa113_cPa113-cPa75-hybrid_cPa67-cPa75-hybrid_cPa75_cPa75-unknown,0.2,5,6697342,6697290,cPa113_cPa113-cPa75-hybrid_cPa67-cPa75-hybrid_cPa75_cPa75-unknown,1_1_1_1_1,102,52
chr1A-6697349_6697451,cPa75,0.75,2,6697439,6697399,cPa113-cPa75-hybrid_cPa75,1_3,102,40
chr1A-67041664_67041766,cPa62,0.976190476190476,2,67041742,67041699,cPa62_cPa62-unknown,41_1,102,43
chr1A-67050202_67050335,cPa223-cPa363-hybrid_cPa223-cPa452-hybrid,0.272727272727273,11,67050318,67050204,cPa183_cPa183-cPa363-hybrid_cPa183-cPa452-hybrid_cPa223_cPa223-cPa183-hybrid_cPa223-cPa363-hybrid_cPa223-cPa452-hybrid_cPa327-cPa363-hybrid_cPa424-cPa363-hybrid_cPa424-cPa452-hybrid_cPa446-cPa363-hybrid,4_4_2_2_1_15_15_1_8_2_1,133,114
chr1A-67671974_67672154,cPa482,0.857142857142857,2,67672112,67672024,cPa152-cPa482-hybrid_cPa482,1_6,180,88
chr1A-67780071_67780173,cPa285_cPa285-cPa62-hybrid_cPa293-cPa62-hybrid,0.333333333333333,3,67780141,67780120,cPa285_cPa285-cPa62-hybrid_cPa293-cPa62-hybrid,1_1_1,102,21
chr1A-67859167_67859269,cPa113_cPa113-cPa62-hybrid,0.2,8,67859266,67859217,cPa113_cPa113-cPa62-hybrid_cPa113-cPa75-hybrid_cPa293-cPa62-hybrid_cPa419-unknown_cPa75-cPa62-hybrid_HERV-W_repbase_HERV17_LTR17-cPa75-hybrid_PERV_AJ293656,2_2_1_1_1_1_1_1,102,49
chr1A-67859334_67859534,cPa113_cPa75,0.310344827586207,10,67859532,67859336,cPa113_cPa113-cPa75-hybrid_cPa113-unknown_cPa293_cPa293-cPa113-hybrid_cPa402-cPa62-hybrid_cPa402-cPa75-hybrid_cPa75_HERV-W_repbase_HERV17_LTR17-unknown_PERVC_HM159246-PERV_AJ293656-hybrid,9_3_2_1_1_1_1_9_1_1,200,196
chr1A-6788184_6788286,cPa452,0.439024390243902,10,6788278,6788199,cPa176-cPa16-hybrid_cPa223-cPa16-hybrid_cPa327-cPa16-hybrid_cPa363-cPa16-hybrid_cPa452_cPa452-cPa16-hybrid_cPa452-cPa176-hybrid_cPa71_cPa71-cPa16-hybrid_cPa71-cPa176-hybrid,1_1_1_4_18_3_1_5_6_1,102,79
chr1A-68236339_68236441,cPa199,1,1,68236424,68236383,cPa199,11,102,41
chr1A-68237458_68237608,cPa199,0.962264150943396,3,68237604,68237483,cPa199_cPa482_cPa505,51_1_1,150,121
chr1A-68287033_68287256,cPa75,0.466666666666667,7,68287204,68287039,cPa62-cPa75-hybrid_cPa62-HERV-W_repbase_HERV17_LTR17-hybrid_cPa62-unknown_cPa75_cPa75-cPa260-hybrid_cPa75-KWERV_GQ222416-hybrid_cPa75-unknown,1_1_2_7_1_1_2,223,165
chr1A-68289936_68290038,cPa62,1,1,68290001,68289975,cPa62,8,102,26
chr1A-68309704_68309806,cPa285-unknown_cPa62,0.5,2,68309754,68309754,cPa285-unknown_cPa62,1_1,102,0
chr1A-68354029_68354131,cPa424_cPa424-unknown,0.5,2,68354081,68354079,cPa424_cPa424-unknown,1_1,102,2
chr1A-6842500_6842602,cPa75,1,1,6842567,6842550,cPa75,16,102,17
chr1A-6842688_6842893,cPa75,1,1,6842841,6842738,cPa75,7,205,103
chr1A-68624744_68624882,cPa62,0.583333333333333,3,68624858,68624794,cPa62_cPa75_cPa75-cPa62-hybrid,7_4_1,138,64
chr1A-68625115_68625266,cPa75,0.6,6,68625219,68625145,cPa62_cPa75_cPa75-cPa62-hybrid_GaLV_M26927-cPa285-hybrid_HERV-W_repbase_HERV17_LTR17-cPa293-hybrid_PERV_AJ293656-cPa293-hybrid,5_15_2_1_1_1,151,74
chr1A-68635427_68635590,cPa75,0.625,4,68635540,68635477,cPa285-cPa62-hybrid_cPa75_cPa75-cPa62-hybrid_cPa75-unknown,1_10_4_1,163,63
chr1A-68635612_68635714,cPa75,1,1,68635662,68635662,cPa75,1,102,0
chr1A-68715728_68715886,cPa395,0.8125,4,68715834,68715749,cPa395_cPa395-unknown_cPa482_cPa62-cPa395-hybrid,13_1_1_1,158,85
chr1A-68723635_68723756,cPa287-cPa426-hybrid_cPa293_cPa391,0.333333333333333,3,68723704,68723685,cPa287-cPa426-hybrid_cPa293_cPa391,2_2_2,121,19
chr1A-68738616_68738721,cPa62,0.454545454545455,4,68738678,68738656,cPa62_cPa62-unknown_HERV30_repbase_HERV30I_LTR30-cPa62-hybrid_HERV30_repbase_HERV30I_LTR30-unknown,5_1_4_1,105,22
chr1A-68828928_68829030,cPa62,1,1,68829020,68828978,cPa62,2,102,42
chr1A-68829116_68829218,cPa62,1,1,68829166,68829117,cPa62,2,102,49
chr1A-68843086_68843188,cPa62,0.96875,2,68843165,68843122,cPa62_cPa62-unknown,31_1,102,43
chr1A-68843254_68843356,cPa327,1,1,68843304,68843290,cPa327,2,102,14
chr1A-68876686_68876788,cPa285,0.636363636363636,2,68876775,68876726,cPa285_cPa293,7_4,102,49
chr1A-69138441_69138543,cPa424,0.5,3,69138491,69138457,cPa379_cPa424_cPa452-cPa183-hybrid,1_2_1,102,34
chr1A-69448583_69448685,cPa62,1,1,69448664,69448585,cPa62,22,102,79
chr1A-69646257_69646359,cPa62,1,1,69646334,69646307,cPa62,3,102,27
chr1A-69650280_69650501,HERV-W_repbase_HERV17_LTR17,0.923076923076923,3,69650493,69650279,HERV-W_repbase_HERV17_LTR17_HERV-W_repbase_HERV17_LTR17-unknown_KoRV_AF151794-PERV_AJ293656-hybrid,24_1_1,221,214
chr1A-69784978_69785080,cPa75,1,1,69785028,69785028,cPa75,1,102,0
chr1A-70430278_70430392,cPa199_cPa273-cPa223-hybrid_cPa450_cPa553,0.25,4,70430340,70430328,cPa199_cPa273-cPa223-hybrid_cPa450_cPa553,1_1_1_1,114,12
chr1A-70562508_70562719,cPa583_cPa583-unknown,0.238095238095238,9,70562697,70562519,cPa482_cPa482-cPa201-hybrid_cPa539_cPa583_cPa583-cPa106-hybrid_cPa583-cPa109-hybrid_cPa583-cPa201-hybrid_cPa583-cPa482-hybrid_cPa583-unknown,2_1_1_5_2_1_2_2_5,211,178
chr1A-70570344_70570446,cPa62,1,1,70570394,70570394,cPa62,1,102,0
chr1A-71089721_71089823,cPa138,1,1,71089771,71089771,cPa138,1,102,0
chr1A-71536180_71536282,cPa62,1,1,71536230,71536229,cPa62,2,102,1
chr1A-71536336_71536438,cPa62,1,1,71536386,71536367,cPa62,3,102,19
chr1A-7169296_7169398,cPa273-cPa62-hybrid_cPa553_cPa62,0.333333333333333,3,7169361,7169328,cPa273-cPa62-hybrid_cPa553_cPa62,1_1_1,102,33
chr1A-7169464_7169641,cPa450,0.344827586206897,14,7169589,7169514,cPa199_cPa227_cPa227-cPa223-hybrid_cPa285-cPa223-hybrid_cPa450_cPa450-cPa199-hybrid_cPa450-cPa223-hybrid_cPa456-cPa223-hybrid_cPa542-cPa223-hybrid_cPa553-cPa117-hybrid_cPa553-cPa199-hybrid_cPa553-cPa223-hybrid_cPa553-cPa227-hybrid_cPa553-unknown,3_1_2_1_10_1_1_1_2_1_2_2_1_1,177,75
chr1A-71701857_71701959,cPa356-unknown,0.948717948717949,2,71701916,71701896,cPa356-cPa131-hybrid_cPa356-unknown,2_37,102,20
chr1A-71749723_71749825,cPa62,0.909090909090909,2,71749820,71749723,cPa62_cPa62-unknown,10_1,102,97
chr1A-71807940_71808105,S71_repbase_HERVS71_LTR6A,0.568965517241379,7,71808086,71807960,cPa62-cPa67-hybrid_cPa67_cPa67-HERV-F_repbase_HERVFH19I_LTR19A-hybrid_cPa67-S71_repbase_HERVS71_LTR6A-hybrid_cPa67-unknown_S71_repbase_HERVS71_LTR6A_S71_repbase_HERVS71_LTR6A-unknown,1_18_1_2_1_33_2,165,126
chr1A-71949996_71950109,cPa75,1,1,71950065,71950038,cPa75,6,113,27
chr1A-71970587_71970689,cPa62,1,1,71970646,71970630,cPa62,8,102,16
chr1A-71984736_71984838,cPa450,0.2,14,71984837,71984735,cPa199_cPa199-cPa482-hybrid_cPa199-cPa542-hybrid_cPa199-cPa553-hybrid_cPa227_cPa273_cPa273-cPa345-hybrid_cPa345_cPa345-cPa199-hybrid_cPa345-cPa450-hybrid_cPa450_cPa482_cPa542_cPa553,3_1_1_1_4_2_1_1_1_1_5_1_1_2,102,102
chr1A-72039219_72039361,cPa62,1,1,72039309,72039269,cPa62,17,142,40
chr1A-725878_725980,cPa260,1,1,725928,725928,cPa260,1,102,0
chr1A-7541196_7541298,cPa511-unknown,1,1,7541246,7541214,cPa511-unknown,7,102,32
chr1A-7675641_7675743,cPa75,1,1,7675691,7675691,cPa75,1,102,0
chr1A-7707797_7707925,cPa293-cPa62-hybrid_cPa75,0.3,6,7707919,7707804,cPa260-cPa75-hybrid_cPa293_cPa293-cPa62-hybrid_cPa75_cPa75-cPa62-hybrid_SMRV_NC001514-cPa62-hybrid,1_1_3_3_1_1,128,115
chr1A-771691_771832,cPa62-unknown_cPa62-WDSV_NC001867-hybrid,0.466666666666667,3,771794,771697,cPa62-unknown_cPa62-WDSV_NC001867-hybrid_WDSV_NC001867,7_7_1,141,97
chr1A-8019972_8020074,cPa199-cPa254-hybrid_cPa482,0.5,2,8020022,8020015,cPa199-cPa254-hybrid_cPa482,1_1,102,7
chr1A-8090149_8090251,cPa363,1,1,8090199,8090199,cPa363,1,102,0
chr1A-8118240_8118342,cPa392,1,1,8118290,8118266,cPa392,2,102,24
chr1A-8118497_8118715,cPa392,0.744186046511628,6,8118710,8118497,cPa254-unknown_cPa392_cPa404-unknown_cPa425-unknown_cPa47-unknown_cPa62,7_64_1_5_8_1,218,213
chr1A-8119027_8119129,cPa392,0.84,3,8119102,8119039,cPa254-unknown_cPa392_EIAV_NC001450,2_21_2,102,63
chr1A-8163669_8163771,cPa75,0.481481481481481,8,8163724,8163669,cPa260_cPa62_cPa62-cPa260-hybrid_cPa62-cPa293-hybrid_cPa62-cPa413-hybrid_cPa62-cPa75-hybrid_cPa62-unknown_cPa75,1_2_3_2_3_1_2_13,102,55
chr1A-819716_819818,cPa456_HIV1_NC001802,0.5,2,819766,819743,cPa456_HIV1_NC001802,1_1,102,23
chr1A-8213767_8213869,cPa254,0.25,9,8213831,8213802,cPa174_cPa254_cPa392_cPa404_cPa404-cPa174-hybrid_cPa425_cPa425-cPa174-hybrid_cPa425-unknown_cPa47-cPa174-hybrid,2_6_1_3_4_5_1_1_1,102,29
chr1A-821585_821687,cPa75-HERV30_repbase_HERV30I_LTR30-hybrid,1,1,821636,821608,cPa75-HERV30_repbase_HERV30I_LTR30-hybrid,6,102,28
chr1A-8385676_8385778,cPa75,0.303571428571429,8,8385778,8385677,cPa62_cPa62-cPa75-hybrid_cPa62-HERV-W_repbase_HERV17_LTR17-hybrid_cPa62-unknown_cPa75_HERV-W_repbase_HERV17_LTR17_HERV-W_repbase_HERV17_LTR17-cPa75-hybrid_S71_repbase_HERVS71_LTR6A-HERV-W_repbase_HERV17_LTR17-hybrid,1_10_4_6_17_16_1_1,102,101
chr1A-8620489_8620664,cPa117,0.914285714285714,2,8620649,8620530,cPa117_cPa452,32_3,175,119
chr1A-878624_878726,cPa75-unknown,1,1,878674,878674,cPa75-unknown,1,102,0
chr1A-878740_879154,cPa75,1,1,879102,878754,cPa75,15,414,348
chr1A-8817586_8817688,cPa62,1,1,8817687,8817630,cPa62,24,102,57
chr1A-9060938_9061105,cPa62,0.976744186046512,2,9061062,9060944,cPa293_cPa62,1_42,167,118
chr1A-9165925_9166027,cPa18_cPa541,0.333333333333333,4,9165982,9165969,cPa14-cPa529-hybrid_cPa18_cPa4_cPa541,1_3_2_3,102,13
chr1A-926405_926632,cPa450,0.333333333333333,11,926580,926455,cPa199-cPa273-hybrid_cPa227_cPa260_cPa273_cPa450_cPa450-cPa223-hybrid_cPa450-cPa273-hybrid_cPa450-cPa542-hybrid_cPa450-unknown_cPa542_cPa553,1_2_1_2_8_1_1_3_1_1_3,227,125
chr1A-926643_926745,cPa227-cPa450-hybrid,1,1,926693,926693,cPa227-cPa450-hybrid,1,102,0
chr1A-9358750_9359020,cPa62,0.86046511627907,4,9359017,9358768,cPa285_cPa62_cPa62-cPa75-hybrid_cPa75,1_74_2_9,270,249
chr1A-9364690_9364792,cPa199_cPa273,0.5,2,9364740,9364740,cPa199_cPa273,1_1,102,0
chr1A-9387105_9387207,cPa62,0.8,2,9387167,9387152,cPa285_cPa62,1_4,102,15
chr1A-9387340_9387463,cPa62,0.625,9,9387411,9387388,cPa285_cPa285-cPa62-hybrid_cPa285-unknown_cPa293_cPa293-cPa285-hybrid_cPa293-cPa62-hybrid_cPa62_cPa62-cPa285-hybrid_cPa62-unknown,8_1_1_4_1_1_30_1_1,123,23
chr1A-957125_957321,cPa260,0.542857142857143,7,957300,957161,cPa241_cPa260_cPa472_cPa472-cPa199-hybrid_cPa472-cPa260-hybrid_cPa472-cPa505-hybrid_cPa472-unknown,2_76_3_5_1_3_50,196,139
chr1A-971999_972101,WDSV_NC001867,0.8,2,972066,972028,cPa260-WDSV_NC001867-hybrid_WDSV_NC001867,1_4,102,38
chr1A-9775839_9775941,cPa51,0.352941176470588,7,9775900,9775844,cPa256_cPa256-cPa51-hybrid_cPa51_cPa543-cPa145-hybrid_cPa543-cPa256-hybrid_cPa551_cPa582,2_1_6_2_1_4_1,102,56
chr1A-9879272_9879374,cPa452-cPa223-hybrid,0.352941176470588,8,9879364,9879271,cPa363-cPa223-hybrid_cPa363-cPa327-hybrid_cPa363-cPa379-hybrid_cPa363-cPa424-hybrid_cPa363-cPa446-hybrid_cPa452-cPa223-hybrid_cPa452-cPa424-hybrid_cPa452-cPa446-hybrid,10_1_2_1_3_12_2_3,102,93
chr2-1000631_1000733,cPa425,0.6,3,1000728,1000637,cPa404_cPa425_cPa47,1_6_3,102,91
chr2-1001279_1001474,cPa425_cPa47,0.25,10,1001443,1001329,cPa125_cPa140_cPa15_cPa174_cPa199-cPa125-hybrid_cPa268_cPa404_cPa425_cPa443_cPa47,1_1_1_8_1_1_8_11_1_11,195,114
chr2-100157254_100157654,HERV-W_repbase_HERV17_LTR17,1,1,100157649,100157275,HERV-W_repbase_HERV17_LTR17,71,400,374
chr2-100158588_100158697,cPa419,1,1,100158665,100158588,cPa419,7,109,77
chr2-1002578_1002782,cPa47,0.4,8,1002730,1002577,cPa125_cPa125-cPa583-hybrid_cPa140_cPa15_cPa174_cPa254_cPa404_cPa47,1_1_1_1_4_2_2_8,204,153
chr2-1003321_1003423,cPa47,0.294117647058824,10,1003401,1003351,cPa118_cPa125-cPa404-hybrid_cPa174_cPa254_cPa254-cPa248-hybrid_cPa404_cPa425_cPa443_cPa443-cPa47-hybrid_cPa47,1_1_2_2_1_2_1_1_1_5,102,50
chr2-100471530_100471632,cPa419,1,1,100471605,100471529,cPa419,8,102,76
chr2-100472044_100472206,cPa419,1,1,100472154,100472054,cPa419,3,162,100
chr2-100476347_100476470,cPa419,0.972972972972973,2,100476419,100476395,cPa360-unknown_cPa419,1_36,123,24
chr2-100476569_100476683,cPa419,1,1,100476631,100476619,cPa419,4,114,12
chr2-100477430_100477569,cPa419,1,1,100477517,100477480,cPa419,2,139,37
chr2-100478282_100478384,cPa419,1,1,100478332,100478332,cPa419,1,102,0
chr2-100700067_100700176,cPa62,0.958333333333333,2,100700141,100700117,cPa419_cPa62,1_23,109,24
chr2-100843369_100843471,cPa62,0.666666666666667,4,100843431,100843405,cPa402-cPa62-hybrid_cPa62_cPa62-cPa75-hybrid_cPa62-unknown,1_8_1_2,102,26
chr2-101122059_101122173,cPa131-cPa150-hybrid_cPa255-cPa150-hybrid_cPa255-cPa258-hybrid_cPa438-cPa150-hybrid,0.25,4,101122123,101122109,cPa131-cPa150-hybrid_cPa255-cPa150-hybrid_cPa255-cPa258-hybrid_cPa438-cPa150-hybrid,1_1_1_1,114,14
chr2-101154552_101154654,cPa75-unknown,0.555555555555556,3,101154647,101154575,cPa75_cPa75-cPa62-hybrid_cPa75-unknown,11_1_15,102,72
chr2-101296949_101297051,cPa452,0.472972972972973,14,101297043,101296968,cPa16_cPa16-cPa327-hybrid_cPa16-cPa363-hybrid_cPa16-cPa71-hybrid_cPa176-cPa327-hybrid_cPa363_cPa363-cPa327-hybrid_cPa363-cPa71-hybrid_cPa452_cPa452-cPa363-hybrid_cPa71_cPa71-cPa223-hybrid_cPa71-cPa327-hybrid_cPa71-cPa363-hybrid,1_3_1_1_2_5_1_1_35_1_20_1_1_1,102,75
chr2-101431908_101432010,cPa62-unknown,0.666666666666667,2,101431974,101431924,cPa62-cPa260-hybrid_cPa62-unknown,1_2,102,50
chr2-101485912_101486014,cPa15,0.5,3,101485977,101485962,cPa118_cPa118-unknown_cPa15,2_1_3,102,15
chr2-101557028_101557130,cPa62,0.846153846153846,3,101557083,101557060,cPa254_cPa62_cPa62-unknown,1_11_1,102,23
chr2-102109370_102109536,HERV-W_repbase_HERV17_LTR17,0.51063829787234,11,102109516,102109370,cPa62_cPa62-cPa71-hybrid_cPa62-cPa75-hybrid_cPa62-HERV-W_repbase_HERV17_LTR17-hybrid_cPa62-KoRV_AF151794-hybrid_cPa62-unknown_cPa75_cPa75-cPa71-hybrid_cPa75-HERV-W_repbase_HERV17_LTR17-hybrid_HERV-W_repbase_HERV17_LTR17_HERV-W_repbase_HERV17_LTR17-unknown,1_3_1_4_1_2_8_1_1_24_1,166,146
chr2-102384224_102384338,cPa220,0.625,5,102384286,102384228,cPa104_cPa219-cPa104-hybrid_cPa219-cPa190-hybrid_cPa219-cPa220-hybrid_cPa220,1_6_1_1_15,114,58
chr2-102452036_102452221,HERV-W_repbase_HERV17_LTR17,0.855072463768116,6,102452221,102452035,cPa75_cPa75-HERV-W_repbase_HERV17_LTR17-hybrid_HERV-F_repbase_HERVFH19I_LTR19A_HERV-W_repbase_HERV17_LTR17_KoRV_AF151794_PERV_AJ293656,5_1_1_59_2_1,185,186
chr2-102673358_102673460,cPa62,1,1,102673408,102673399,cPa62,2,102,9
chr2-102680767_102680952,cPa456,0.4,5,102680934,102680817,cPa363_cPa363-cPa117-hybrid_cPa456_cPa456-cPa117-hybrid_cPa587-cPa117-hybrid,6_1_8_4_1,185,117
chr2-103160773_103160902,cPa450,0.454545454545455,11,103160893,103160798,cPa199-unknown_cPa223-cPa227-hybrid_cPa223-cPa273-hybrid_cPa223-cPa553-hybrid_cPa227_cPa227-unknown_cPa273_cPa345-cPa227-hybrid_cPa345-unknown_cPa450_cPa553,1_2_1_1_1_1_1_1_1_15_8,129,95
chr2-103236311_103236413,cPa62,0.888888888888889,2,103236361,103236344,cPa285_cPa62,1_8,102,17
chr2-104035086_104035188,cPa363,0.428571428571429,4,104035178,104035136,cPa363_cPa446-cPa16-hybrid_cPa452_cPa71,3_1_2_1,102,42
chr2-104090223_104090365,cPa113,0.758620689655172,5,104090364,104090261,cPa113_cPa62-cPa113-hybrid_cPa62-unknown_cPa75-cPa113-hybrid_cPa75-unknown,66_3_1_13_4,142,103
chr2-104586367_104586469,cPa113,1,1,104586417,104586417,cPa113,1,102,0
chr2-104797759_104797861,cPa308,1,1,104797809,104797771,cPa308,2,102,38
chr2-105107858_105107966,cPa583,0.504672897196262,6,105107954,105107870,cPa251_cPa358_cPa358-cPa251-hybrid_cPa358-unknown_cPa583_cPa62-cPa251-hybrid,3_43_3_3_54_1,108,84
chr2-105846822_105846924,cPa285-cPa293-hybrid,1,1,105846872,105846872,cPa285-cPa293-hybrid,1,102,0
chr2-105846963_105847225,cPa62,0.821428571428571,4,105847194,105847001,cPa285_cPa62_cPa75_cPa75-cPa62-hybrid,2_23_2_1,262,193
chr2-105847456_105847558,cPa62,1,1,105847524,105847506,cPa62,3,102,18
chr2-105847596_105847853,cPa62,0.487179487179487,8,105847806,105847646,cPa199_cPa285_cPa293_cPa62_cPa75_cPa75-cPa285-hybrid_cPa75-cPa293-hybrid_cPa75-cPa62-hybrid,1_5_3_19_6_1_1_3,257,160
chr2-105847910_105848049,cPa62,1,1,105848031,105847960,cPa62,7,139,71
chr2-105848100_105848202,cPa62,1,1,105848159,105848150,cPa62,2,102,9
chr2-105848221_105848356,cPa62,0.666666666666667,2,105848304,105848271,cPa285_cPa62,1_2,135,33
chr2-106060277_106060379,cPa419,1,1,106060327,106060327,cPa419,1,102,0
chr2-106135069_106135172,cPa363_cPa456,0.5,2,106135120,106135119,cPa363_cPa456,1_1,103,1
chr2-106521112_106521214,cPa419_cPa62_cPa71,0.333333333333333,3,106521163,106521162,cPa419_cPa62_cPa71,1_1_1,102,1
chr2-106654592_106654694,cPa260-cPa75-hybrid,0.428571428571429,4,106654660,106654625,cPa260_cPa260-cPa75-hybrid_cPa260-unknown_cPa308-cPa75-hybrid,2_6_2_4,102,35
chr2-106973091_106973193,cPa118,0.8,2,106973141,106973141,cPa118_cPa15-unknown,4_1,102,0
chr2-10750292_10750394,cPa62,1,1,10750342,10750342,cPa62,1,102,0
chr2-10753471_10753573,cPa529,0.4,4,10753527,10753498,cPa247_cPa529_cPa529-cPa247-hybrid_cPa545-unknown,1_2_1_1,102,29
chr2-107901876_107901978,cPa62,0.931818181818182,4,107901956,107901926,cPa285_cPa419-cPa293-hybrid_cPa62_cPa62-unknown,1_1_41_1,102,30
chr2-10822543_10822651,cPa425_cPa47_cPa47-cPa174-hybrid_cPa62,0.25,4,10822645,10822593,cPa425_cPa47_cPa47-cPa174-hybrid_cPa62,1_1_1_1,108,52
chr2-10851890_10852004,cPa273-cPa199-hybrid_cPa450_cPa553-cPa199-hybrid,0.333333333333333,3,10851952,10851940,cPa273-cPa199-hybrid_cPa450_cPa553-cPa199-hybrid,1_1_1,114,12
chr2-1086242_1086344,cPa75,1,1,1086292,1086292,cPa75,1,102,0
chr2-1086435_1086537,cPa75,1,1,1086485,1086485,cPa75,1,102,0
chr2-1086548_1086650,cPa75,1,1,1086598,1086598,cPa75,1,102,0
chr2-1086785_1086923,cPa75,1,1,1086871,1086835,cPa75,3,138,36
chr2-108692972_108693074,cPa452_cPa456_cPa456-cPa452-hybrid_cPa456-unknown,0.25,4,108693060,108693022,cPa452_cPa456_cPa456-cPa452-hybrid_cPa456-unknown,1_1_1_1,102,38
chr2-1086987_1087089,cPa75,1,1,1087037,1087037,cPa75,1,102,0
chr2-10872319_10872447,cPa62,1,1,10872415,10872354,cPa62,63,128,61
chr2-108804828_108804931,cPa450,0.464285714285714,14,108804895,108804838,cPa199_cPa199-cPa273-hybrid_cPa223-cPa199-hybrid_cPa223-cPa273-hybrid_cPa223-cPa450-hybrid_cPa223-cPa542-hybrid_cPa223-cPa553-hybrid_cPa223-unknown_cPa227_cPa450_cPa450-cPa542-hybrid_cPa553_cPa553-cPa199-hybrid_cPa553-cPa227-hybrid,2_2_5_15_2_10_1_4_2_52_1_14_1_1,103,57
chr2-10903299_10903410,cPa118_cPa15,0.285714285714286,5,10903358,10903332,cPa118_cPa15_cPa248-cPa140-hybrid_cPa268_cPa443-cPa140-hybrid,2_2_1_1_1,111,26
chr2-109034236_109034338,cPa363_cPa452_cPa71,0.333333333333333,3,109034286,109034286,cPa363_cPa452_cPa71,1_1_1,102,0
chr2-109593279_109593381,cPa402,0.6,2,109593355,109593281,cPa402_cPa74,3_2,102,74
chr2-10963345_10963450,cPa118-unknown_cPa15_cPa268-unknown,0.333333333333333,3,10963398,10963395,cPa118-unknown_cPa15_cPa268-unknown,1_1_1,105,3
chr2-109646712_109646820,cPa118,0.5,3,109646811,109646757,cPa118_cPa15_cPa15-cPa140-hybrid,4_3_1,108,54
chr2-109646822_109646924,cPa183_cPa183-cPa248-hybrid_cPa327-cPa183-hybrid_cPa424,0.25,4,109646907,109646869,cPa183_cPa183-cPa248-hybrid_cPa327-cPa183-hybrid_cPa424,1_1_1_1,102,38
chr2-109667437_109667539,cPa363_cPa452,0.3,5,109667487,109667440,cPa176_cPa363_cPa446-cPa16-hybrid_cPa452_cPa71,1_3_1_3_2,102,47
chr2-110073906_110074008,cPa450,0.3,6,110073969,110073934,cPa273-cPa199-hybrid_cPa273-cPa345-hybrid_cPa450_cPa542-cPa223-hybrid_cPa553_cPa553-cPa450-hybrid,2_1_3_1_1_2,102,35
chr2-1102817_1102919,cPa75,1,1,1102867,1102867,cPa75,1,102,0
chr2-110313538_110313640,cPa15,0.422222222222222,12,110313615,110313539,cPa118_cPa118-cPa125-hybrid_cPa118-cPa248-hybrid_cPa15_cPa264-cPa15-hybrid_cPa268-cPa248-hybrid_cPa443_cPa443-cPa125-hybrid_cPa443-cPa15-hybrid_cPa443-cPa248-hybrid_cPa516-cPa15-hybrid_cPa516-cPa248-hybrid,23_2_2_38_1_1_16_1_2_2_1_1,102,76
chr2-110313809_110313911,cPa15,0.320987654320988,12,110313897,110313814,cPa118_cPa118-cPa125-hybrid_cPa118-cPa15-hybrid_cPa118-cPa248-hybrid_cPa140-cPa15-hybrid_cPa15_cPa15-cPa248-hybrid_cPa248_cPa443_cPa443-cPa248-hybrid_cPa443-unknown_cPa516-cPa125-hybrid,22_2_2_3_1_26_1_1_18_3_1_1,102,83
chr2-110355997_110356102,cPa75,0.833333333333333,2,110356074,110356042,cPa75_cPa75-cPa62-hybrid,20_4,105,32
chr2-110905548_110905650,cPa75,1,1,110905605,110905598,cPa75,2,102,7
chr2-110995135_110995237,cPa62,0.842105263157895,3,110995190,110995172,cPa62_cPa62-unknown_HML4_repbase_HERVK13I_LTR13-cPa62-hybrid,16_2_1,102,18
chr2-112077118_112077220,cPa246,0.625,3,112077169,112077125,cPa246_cPa246-cPa302-hybrid_cPa302,5_1_2,102,44
chr2-112139369_112139493,cPa15,0.454545454545455,4,112139445,112139419,cPa118_cPa15_cPa248-cPa118-hybrid_cPa248-unknown,2_5_2_2,124,26
chr2-11254067_11254169,cPa117-unknown_cPa363_cPa452_cPa456,0.25,4,11254117,11254117,cPa117-unknown_cPa363_cPa452_cPa456,1_1_1_1,102,0
chr2-112600119_112600227,cPa293-cPa62-hybrid_cPa75,0.333333333333333,4,112600177,112600165,cPa260_cPa293-cPa62-hybrid_cPa75_MMTV_NC001503-cPa75-hybrid,1_2_2_1,108,12
chr2-112672370_112672472,cPa419,1,1,112672420,112672420,cPa419,1,102,0
chr2-112700680_112700782,cPa113_cPa113-unknown,0.4,3,112700732,112700696,cPa113_cPa113-cPa75-hybrid_cPa113-unknown,2_1_2,102,36
chr2-112710544_112710646,cPa478,0.333333333333333,5,112710594,112710582,cPa150_cPa150-cPa255-hybrid_cPa246_cPa302-cPa255-hybrid_cPa478,1_1_1_1_2,102,12
chr2-112753880_112753982,cPa75,1,1,112753974,112753888,cPa75,3,102,86
chr2-112810750_112810852,cPa413,0.625,2,112810814,112810749,cPa413_cPa413-unknown,5_3,102,65
chr2-112839922_112840024,cPa62,1,1,112839972,112839972,cPa62,1,102,0
chr2-113014719_113014846,cPa62,1,1,113014794,113014769,cPa62,6,127,25
chr2-113014889_113014991,cPa62,1,1,113014948,113014915,cPa62,3,102,33
chr2-113474177_113474304,cPa62,0.428571428571429,4,113474291,113474227,cPa62_cPa75_cPa75-cPa62-hybrid_cPa75-unknown,9_3_2_7,127,64
chr2-113668972_113669084,cPa62,1,1,113669032,113669022,cPa62,3,112,10
chr2-113737788_113737890,cPa315_cPa587-unknown,0.5,2,113737838,113737838,cPa315_cPa587-unknown,1_1,102,0
chr2-113838835_113838952,cPa450,0.375,13,113838926,113838874,cPa199_cPa199-cPa273-hybrid_cPa199-cPa450-hybrid_cPa199-cPa542-hybrid_cPa199-cPa553-hybrid_cPa199-unknown_cPa223-cPa542-hybrid_cPa227_cPa227-cPa542-hybrid_cPa450_cPa482-cPa227-hybrid_cPa482-cPa542-hybrid_cPa553,1_1_1_2_4_1_1_1_1_15_1_1_10,117,52
chr2-113979507_113979609,cPa223_cPa223-cPa363-hybrid_cPa424-cPa363-hybrid,0.285714285714286,4,113979588,113979557,cPa223_cPa223-cPa363-hybrid_cPa327-cPa363-hybrid_cPa424-cPa363-hybrid,2_2_1_2,102,31
chr2-114118451_114118553,cPa62,1,1,114118550,114118479,cPa62,13,102,71
chr2-114173083_114173185,cPa62,1,1,114173135,114173115,cPa62,35,102,20
chr2-114173242_114173344,cPa62,1,1,114173292,114173292,cPa62,1,102,0
chr2-114829145_114829247,cPa323_cPa323-cPa568-hybrid_cPa333,0.333333333333333,3,114829223,114829195,cPa323_cPa323-cPa568-hybrid_cPa333,1_1_1,102,28
chr2-114909352_114909455,cPa62,1,1,114909403,114909395,cPa62,3,103,8
chr2-114909469_114909571,cPa62,1,1,114909547,114909501,cPa62,12,102,46
chr2-114933795_114933907,cPa95,0.428571428571429,7,114933879,114933829,cPa247_cPa4-cPa541-hybrid_cPa425-cPa545-hybrid_cPa529_cPa529-cPa541-hybrid_cPa545_cPa95,2_1_1_2_1_1_6,112,50
chr2-114935911_114936013,cPa425,0.333333333333333,4,114935989,114935961,cPa174_cPa254_cPa425_cPa47,4_3_6_5,102,28
chr2-11506569_11506684,cPa363_cPa452,0.333333333333333,5,11506632,11506619,cPa16-cPa176-hybrid_cPa16-cPa327-hybrid_cPa363_cPa452_cPa71,1_1_3_3_1,115,13
chr2-115093316_115093419,cPa456,0.5,3,115093367,115093350,cPa363_cPa456_cPa587-cPa452-hybrid,1_2_1,103,17
chr2-115854365_115854467,cPa104_cPa190_cPa219,0.333333333333333,3,115854415,115854415,cPa104_cPa190_cPa219,1_1_1,102,0
chr2-116070139_116070241,cPa174_cPa254-unknown_cPa404_cPa425_cPa47,0.2,5,116070198,116070189,cPa174_cPa254-unknown_cPa404_cPa425_cPa47,1_1_1_1_1,102,9
chr2-116277356_116277458,cPa62,1,1,116277409,116277382,cPa62,8,102,27
chr2-1164178_1164280,cPa75,1,1,1164228,1164228,cPa75,1,102,0
chr2-1164439_1164541,cPa75,1,1,1164489,1164489,cPa75,1,102,0
chr2-117092560_117092662,cPa75,0.428571428571429,4,117092658,117092576,cPa285-cPa75-hybrid_cPa62_cPa62-cPa75-hybrid_cPa75,1_2_1_3,102,82
chr2-117109318_117109420,cPa62,0.5,3,117109375,117109337,cPa392_cPa392-unknown_cPa62,1_1_2,102,38
chr2-117338459_117338561,cPa456,0.571428571428571,7,117338559,117338465,cPa363_cPa363-cPa452-hybrid_cPa456_cPa542-cPa363-hybrid_cPa542-cPa452-hybrid_cPa542-cPa456-hybrid_SIV_NC001549-cPa452-hybrid,2_1_16_1_4_1_3,102,94
chr2-11741323_11741425,cPa452,0.833333333333333,2,11741411,11741325,cPa452_cPa75,5_1,102,86
chr2-11741569_11741683,cPa452,0.875,3,11741679,11741577,cPa452_cPa587-cPa452-hybrid_cPa75-cPa452-hybrid,14_1_1,114,102
chr2-117720396_117720508,HERV-W_repbase_HERV17_LTR17,0.625,6,117720496,117720410,cPa62-cPa71-hybrid_cPa62-HERV-W_repbase_HERV17_LTR17-hybrid_cPa62-unknown_cPa75_HERV-W_repbase_HERV17_LTR17_HERV-W_repbase_HERV17_LTR17-unknown,1_1_1_1_10_2,112,86
chr2-117720608_117720785,cPa62-unknown,0.4375,5,117720733,117720614,cPa62-cPa71-hybrid_cPa62-HERV-W_repbase_HERV17_LTR17-hybrid_cPa62-unknown_cPa75_HERV-W_repbase_HERV17_LTR17,1_1_7_1_6,177,119
chr2-118079996_118080109,cPa390,0.272727272727273,8,118080065,118080005,cPa205-cPa447-hybrid_cPa205-cPa62-hybrid_cPa339_cPa339-cPa447-hybrid_cPa390_cPa390-cPa339-hybrid_cPa444-cPa62-hybrid_cPa447,1_1_1_2_3_1_1_1,113,60
chr2-1181387_1181489,cPa75,1,1,1181437,1181437,cPa75,1,102,0
chr2-118328054_118328156,cPa62,1,1,118328104,118328104,cPa62,1,102,0
chr2-118361044_118361146,cPa62,1,1,118361094,118361049,cPa62,61,102,45
chr2-118910473_118910575,cPa285,0.5,3,118910526,118910523,cPa285_cPa293_cPa62,2_1_1,102,3
chr2-119031677_119031779,cPa75,0.5,3,119031746,119031727,cPa75_cPa75-unknown_HERV-W_repbase_HERV17_LTR17,2_1_1,102,19
chr2-119222648_119222827,cPa402,0.555555555555556,3,119222787,119222698,cPa402_cPa419_cPa74,5_2_2,179,89
chr2-119249463_119249565,cPa363_cPa452,0.4,3,119249513,119249501,cPa363_cPa452_cPa62-cPa16-hybrid,2_2_1,102,12
chr2-119308188_119308290,cPa450,1,1,119308238,119308238,cPa450,1,102,0
chr2-119309061_119309163,cPa450,1,1,119309111,119309072,cPa450,2,102,39
chr2-119454230_119454332,cPa62,1,1,119454292,119454270,cPa62,4,102,22
chr2-119735191_119735293,cPa62-unknown,0.466666666666667,5,119735293,119735230,cPa62_cPa62-cPa413-hybrid_cPa62-unknown_cPa75_PERV_AJ293656,1_1_7_5_1,102,63
chr2-119735346_119735448,cPa75,0.285714285714286,6,119735396,119735347,cPa413_cPa62-cPa293-hybrid_cPa62-cPa413-hybrid_cPa62-cPa75-hybrid_cPa62-unknown_cPa75,1_1_3_2_3_4,102,49
chr2-11982981_11983113,cPa452,0.571428571428571,4,11983061,11983030,cPa16_cPa363_cPa452_cPa71,4_1_8_1,132,31
chr2-120038386_120038493,cPa47,0.60377358490566,6,120038441,120038431,cPa174_cPa254_cPa254-cPa174-hybrid_cPa254-unknown_cPa47_cPa47-cPa254-hybrid,12_6_1_1_32_1,107,10
chr2-1200638_1200740,cPa260,1,1,1200688,1200688,cPa260,1,102,0
chr2-120501672_120501774,cPa62,1,1,120501773,120501722,cPa62,22,102,51
chr2-120673510_120673612,cPa62-unknown,0.37037037037037,6,120673592,120673521,cPa62_cPa62-cPa71-hybrid_cPa62-cPa75-hybrid_cPa62-HERV-W_repbase_HERV17_LTR17-hybrid_cPa62-unknown_cPa75,2_2_1_6_10_6,102,71
chr2-120853315_120853426,cPa62,0.904761904761905,3,120853384,120853361,cPa254_cPa62_cPa62-unknown,1_19_1,111,23
chr2-120855047_120855149,cPa254-cPa75-hybrid,1,1,120855097,120855097,cPa254-cPa75-hybrid,1,102,0
chr2-121285541_121285656,cPa339_cPa444_cPa447,0.333333333333333,3,121285604,121285591,cPa339_cPa444_cPa447,3_3_3,115,13
chr2-121339950_121340056,HERV-W_repbase_HERV17_LTR17-cPa62-hybrid,0.666666666666667,2,121340051,121339990,cPa75-cPa62-hybrid_HERV-W_repbase_HERV17_LTR17-cPa62-hybrid,2_4,106,61
chr2-121340818_121340923,cPa75-cPa62-hybrid_HERV-W_repbase_HERV17_LTR17-cPa62-hybrid,0.4,3,121340901,121340868,cPa62_cPa75-cPa62-hybrid_HERV-W_repbase_HERV17_LTR17-cPa62-hybrid,1_2_2,105,33
chr2-121426601_121426760,HERV-W_repbase_HERV17_LTR17,0.788461538461538,4,121426733,121426620,cPa62-HERV-W_repbase_HERV17_LTR17-hybrid_cPa75_HERV-W_repbase_HERV17_LTR17_KoRV_AF151794,1_9_41_1,159,113
chr2-121475040_121475240,cPa75,0.9375,2,121475239,121475047,cPa75_cPa75-cPa62-hybrid,15_1,200,192
chr2-122067481_122067583,cPa339_cPa447,0.454545454545455,3,122067545,122067531,cPa339_cPa447_cPa62-cPa444-hybrid,5_5_1,102,14
chr2-122295880_122295993,cPa61,0.526315789473684,6,122295989,122295901,cPa61_cPa61-cPa15-hybrid_cPa61-cPa254-hybrid_cPa61-cPa62-hybrid_cPa61-unknown_cPa62,40_1_3_16_3_13,113,88
chr2-122299571_122299673,cPa62,0.92156862745098,2,122299648,122299608,cPa293-cPa62-hybrid_cPa62,4_47,102,40
chr2-122337777_122337893,cPa113,0.75,3,122337843,122337822,cPa113_cPa75-KWERV_GQ222416-hybrid_PERVC_HM159246,6_1_1,116,21
chr2-122820709_122820823,cPa15,0.423076923076923,6,122820771,122820711,cPa118_cPa15_cPa15-cPa125-hybrid_cPa268_cPa268-cPa118-hybrid_cPa268-cPa125-hybrid,9_11_1_1_1_3,114,60
chr2-123200450_123200556,cPa14-cPa4-hybrid_cPa14-unknown_cPa4_cPa541,0.25,4,123200504,123200488,cPa14-cPa4-hybrid_cPa14-unknown_cPa4_cPa541,1_1_1_1,106,16
chr2-123474101_123474203,cPa62_cPa62-cPa254-hybrid,0.5,2,123474151,123474128,cPa62_cPa62-cPa254-hybrid,1_1,102,23
chr2-123474262_123474364,cPa62,0.791666666666667,4,123474312,123474286,cPa254_cPa62_cPa62-cPa254-hybrid_cPa62-unknown,3_19_1_1,102,26
chr2-123537003_123537117,cPa541,0.5,3,123537065,123537019,cPa14_cPa18_cPa541,1_1_2,114,46
chr2-123781681_123781817,cPa456,0.529411764705882,6,123781817,123781685,cPa363_cPa363-cPa62-hybrid_cPa456_cPa456-cPa117-hybrid_cPa456-cPa363-hybrid_cPa456-unknown,3_1_9_1_1_2,136,132
chr2-124017362_124017464,cPa117,1,1,124017413,124017388,cPa117,18,102,25
chr2-124055262_124055364,cPa419,1,1,124055312,124055312,cPa419,1,102,0
chr2-124057346_124057448,cPa117-unknown,0.6,2,124057406,124057395,cPa117-unknown_cPa539-unknown,3_2,102,11
chr2-124073258_124073360,cPa529,0.636363636363636,4,124073328,124073308,cPa14-cPa247-hybrid_cPa14-unknown_cPa247_cPa529,1_1_2_7,102,20
chr2-124230360_124230462,cPa62,1,1,124230419,124230368,cPa62,26,102,51
chr2-124444286_124444388,cPa15_cPa268,0.5,2,124444336,124444336,cPa15_cPa268,1_1,102,0
chr2-124528304_124528406,cPa287-cPa426-hybrid_cPa391_cPa426,0.333333333333333,3,124528354,124528346,cPa287-cPa426-hybrid_cPa391_cPa426,1_1_1,102,8
chr2-124567600_124567702,cPa419,1,1,124567650,124567650,cPa419,1,102,0
chr2-12457612_12457714,cPa62,0.827586206896552,3,12457693,12457620,cPa254_cPa62_cPa62-cPa254-hybrid,3_24_2,102,73
chr2-124653291_124653393,cPa542,0.379166666666667,18,124653366,124653315,cPa199_cPa227-cPa199-hybrid_cPa227-cPa542-hybrid_cPa227-unknown_cPa273-cPa199-hybrid_cPa273-cPa542-hybrid_cPa273-unknown_cPa345_cPa345-cPa199-hybrid_cPa345-cPa542-hybrid_cPa345-unknown_cPa450-cPa199-hybrid_cPa542_cPa542-cPa199-hybrid_cPa542-unknown_cPa553-cPa199-hybrid_cPa553-cPa345-hybrid_cPa553-unknown,70_10_1_2_7_1_2_21_12_2_4_2_91_5_1_5_1_3,102,51
chr2-124822834_124822940,cPa246_cPa302-unknown,0.5,2,124822888,124822884,cPa246_cPa302-unknown,1_1,106,4
chr2-124901582_124901684,cPa62,1,1,124901632,124901617,cPa62,5,102,15
chr2-125282613_125282800,cPa62,1,1,125282762,125282663,cPa62,28,187,99
chr2-125317013_125317115,cPa174-cPa404-hybrid_cPa174-unknown_cPa254_cPa425_cPa47,0.2,5,125317078,125317063,cPa174-cPa404-hybrid_cPa174-unknown_cPa254_cPa425_cPa47,1_1_1_1_1,102,15
chr2-125427571_125427758,cPa363,0.4375,6,125427758,125427613,cPa363_cPa363-cPa452-hybrid_cPa363-unknown_cPa452_cPa452-cPa75-hybrid_cPa456-cPa587-hybrid,7_1_2_4_1_1,187,145
chr2-125477991_125478093,cPa219-cPa104-hybrid,1,1,125478041,125478041,cPa219-cPa104-hybrid,1,102,0
chr2-125550985_125551118,CAEV_NC001463-unknown,0.958333333333333,2,125551071,125551024,CAEV_NC001463-cPa539-hybrid_CAEV_NC001463-unknown,1_23,133,47
chr2-125582824_125582926,cPa419,1,1,125582874,125582874,cPa419,1,102,0
chr2-125902385_125902743,cPa62,0.952380952380952,3,125902734,125902421,cPa285_cPa62_cPa62-unknown,1_60_2,358,313
chr2-12642385_12642487,cPa15,0.444444444444444,4,12642463,12642435,cPa118_cPa118-cPa125-hybrid_cPa15_cPa443,2_2_4_1,102,28
chr2-126612912_126613038,cPa75,0.5,8,126613015,126612911,cPa62_cPa62-cPa75-hybrid_cPa62-HERV-W_repbase_HERV17_LTR17-hybrid_cPa62-unknown_cPa71_cPa75_HERV-W_repbase_HERV17_LTR17_MER52A_repbase_MER52AI_MER52A,1_3_5_4_1_18_3_1,126,104
chr2-126662207_126662309,cPa15,0.7,4,126662276,126662215,cPa118-unknown_cPa15_cPa268_cPa268-unknown,1_7_1_1,102,61
chr2-126701979_126702081,cPa62,1,1,126702042,126702025,cPa62,8,102,17
chr2-126705997_126706099,cPa75,1,1,126706047,126706047,cPa75,1,102,0
chr2-127667090_127667192,cPa113,1,1,127667140,127667140,cPa113,1,102,0
chr2-127684491_127684593,cPa285,0.666666666666667,3,127684591,127684527,cPa285_cPa62_cPa62-cPa285-hybrid,8_3_1,102,64
chr2-127700935_127701037,cPa142,0.678571428571429,4,127700987,127700969,cPa101_cPa101-unknown_cPa142_cPa582-unknown,4_3_19_2,102,18
chr2-127710449_127710551,cPa71,0.333333333333333,6,127710521,127710448,cPa327-cPa363-hybrid_cPa327-cPa71-hybrid_cPa327-unknown_cPa363_cPa452_cPa71,3_1_3_17_12_18,102,73
chr2-128127929_128128031,cPa260-unknown,0.222222222222222,11,128128007,128127945,cPa260_cPa260-cPa293-hybrid_cPa260-cPa62-hybrid_cPa260-cPa75-hybrid_cPa260-unknown_cPa285_cPa293_cPa293-unknown_cPa75_cPa75-cPa62-hybrid_cPa75-unknown,1_1_2_2_4_2_1_1_2_1_1,102,62
chr2-128128047_128128149,cPa260-cPa62-hybrid,0.416666666666667,5,128128124,128128055,cPa260-cPa62-hybrid_cPa260-cPa75-hybrid_cPa260-unknown_cPa62_cPa75,5_2_1_1_3,102,69
chr2-128155264_128155366,cPa15,0.75,2,128155314,128155299,cPa15_cPa268,6_2,102,15
chr2-128606015_128606117,cPa419,1,1,128606065,128606065,cPa419,1,102,0
chr2-128846775_128846879,cPa15,0.575,5,128846868,128846814,cPa118_cPa118-cPa268-hybrid_cPa118-unknown_cPa15_cPa268,3_4_7_23_3,104,54
chr2-128858126_128858288,cPa523-unknown,0.566037735849057,4,128858236,128858176,cPa419_cPa446-cPa545-hybrid_cPa523-cPa545-hybrid_cPa523-unknown,2_2_19_30,162,60
chr2-129196584_129196686,HERV-W_repbase_HERV17_LTR17,0.625,5,129196639,129196628,cPa254-HERV-W_repbase_HERV17_LTR17-hybrid_cPa71_HERV-W_repbase_HERV17_LTR17_KoRV_AF151794_KWERV_GQ222416-KoRV_AF151794-hybrid,1_1_10_3_1,102,11
chr2-129622131_129622233,cPa150_cPa302-cPa255-hybrid,0.5,2,129622181,129622181,cPa150_cPa302-cPa255-hybrid,1_1,102,0
chr2-129712955_129713057,cPa14-cPa4-hybrid_cPa541,0.5,2,129713005,129712998,cPa14-cPa4-hybrid_cPa541,2_2,102,7
chr2-129934378_129934490,cPa449-cPa107-hybrid,0.333333333333333,4,129934438,129934427,cPa449-cPa107-hybrid_cPa449-unknown_cPa545-cPa107-hybrid_cPa545-unknown,3_2_2_2,112,11
chr2-12994837_12994939,cPa75-unknown,1,1,12994887,12994887,cPa75-unknown,1,102,0
chr2-12995247_12995373,cPa75-unknown,1,1,12995321,12995297,cPa75-unknown,2,126,24
chr2-129983495_129983738,cPa450,0.458333333333333,15,129983723,129983500,cPa199_cPa199-cPa273-hybrid_cPa199-cPa542-hybrid_cPa199-cPa553-hybrid_cPa227_cPa227-cPa542-hybrid_cPa227-cPa553-hybrid_cPa227-unknown_cPa273_cPa419-cPa553-hybrid_cPa450_cPa450-cPa273-hybrid_cPa450-unknown_cPa553_cPa553-cPa273-hybrid,2_5_2_1_7_1_1_2_7_1_44_1_1_18_3,243,223
chr2-130080812_130080923,cPa193,0.28735632183908,12,130080884,130080844,cPa157_cPa183_cPa183-cPa157-hybrid_cPa183-cPa193-hybrid_cPa183-unknown_cPa193_cPa193-cPa157-hybrid_cPa229_cPa229-cPa157-hybrid_cPa229-cPa193-hybrid_cPa229-unknown_cPa500,5_7_5_1_1_25_1_7_10_1_1_23,111,40
chr2-13046380_13046482,cPa62,0.866666666666667,3,13046443,13046421,cPa285-cPa62-hybrid_cPa62_cPa62-unknown,1_13_1,102,22
chr2-130484727_130484837,cPa118_cPa15,0.5,2,130484785,130484777,cPa118_cPa15,1_1,110,8
chr2-130489154_130489256,cPa357,0.555555555555556,7,130489250,130489165,cPa15_cPa339_cPa339-cPa251-hybrid_cPa357_cPa357-unknown_cPa419-cPa117-hybrid_cPa444-cPa251-hybrid,1_1_1_10_3_1_1,102,85
chr2-130567294_130567397,cPa163,0.642857142857143,8,130567358,130567330,cPa163_cPa182_cPa182-cPa224-hybrid_cPa224_cPa360_cPa360-cPa224-hybrid_SIV_NC001549-cPa182-hybrid_SIV_NC001549-cPa224-hybrid,72_1_1_8_8_20_1_1,103,28
chr2-130615928_130616030,cPa62,1,1,130616001,130615978,cPa62,12,102,23
chr2-130986566_130986668,cPa190,0.375,4,130986616,130986614,cPa104-cPa18-hybrid_cPa104-unknown_cPa190_cPa220,1_2_3_2,102,2
chr2-131158604_131158706,cPa363_cPa452_cPa71,0.25,5,131158654,131158653,cPa176_cPa363_cPa446-unknown_cPa452_cPa71,1_2_1_2_2,102,1
chr2-131186017_131186127,cPa450_cPa553,0.272727272727273,6,131186078,131186067,cPa199-cPa227-hybrid_cPa199-cPa273-hybrid_cPa227_cPa450_cPa542_cPa553,1_2_1_3_1_3,110,11
chr2-131510475_131510579,cPa452,0.578947368421053,4,131510531,131510516,cPa363_cPa363-cPa327-hybrid_cPa452_cPa71,6_1_11_1,104,15
chr2-1316956_1317062,cPa75,1,1,1317010,1317006,cPa75,3,106,4
chr2-1317216_1317562,cPa75,1,1,1317510,1317266,cPa75,16,346,244
chr2-131784204_131784432,cPa62-cPa293-hybrid,0.266666666666667,7,131784431,131784238,cPa293_cPa62_cPa62-cPa293-hybrid_cPa62-cPa75-hybrid_cPa62-unknown_cPa75_cPa75-unknown,3_1_4_2_3_1_1,228,193
chr2-131784534_131784646,cPa62-cPa293-hybrid,0.540540540540541,7,131784606,131784536,cPa293_cPa62_cPa62-cPa293-hybrid_cPa62-cPa75-hybrid_cPa62-unknown_cPa75_PERVC_HM159246-PERVA_AY099323-hybrid,7_2_20_2_3_2_1,112,70
chr2-1317933_1318035,cPa75,1,1,1317983,1317983,cPa75,1,102,0
chr2-1318058_1318457,cPa75,1,1,1318405,1318108,cPa75,40,399,297
chr2-132412916_132413018,cPa104-cPa219-hybrid_cPa190_cPa220,0.333333333333333,3,132412968,132412966,cPa104-cPa219-hybrid_cPa190_cPa220,1_1_1,102,2
chr2-1329521_1329623,cPa75,1,1,1329571,1329571,cPa75,1,102,0
chr2-133281784_133281886,cPa75_cPa75-cPa62-hybrid,0.277777777777778,7,133281879,133281784,cPa75_cPa75-cPa62-hybrid_cPa75-unknown_HERV-W_repbase_HERV17_LTR17_HERV-W_repbase_HERV17_LTR17-cPa62-hybrid_HERV-W_repbase_HERV17_LTR17-unknown_HML1b_repbase_HERV-K14I_LTR14A,5_5_1_1_2_2_2,102,95
chr2-133281944_133282046,cPa75,0.4,5,133282045,133281961,cPa62_cPa75_cPa75-cPa62-hybrid_cPa75-unknown_KWERV_GQ222416-unknown,2_4_2_1_1,102,84
chr2-133348451_133348553,cPa75,1,1,133348501,133348501,cPa75,1,102,0
chr2-133348741_133348843,cPa75,1,1,133348794,133348791,cPa75,2,102,3
chr2-133572538_133572648,cPa62,1,1,133572600,133572564,cPa62,22,110,36
chr2-133623083_133623194,cPa270-unknown,1,1,133623142,133623133,cPa270-unknown,2,111,9
chr2-133823952_133824069,cPa363_cPa456,0.5,2,133824017,133824002,cPa363_cPa456,2_2,117,15
chr2-134053628_134053730,cPa75,1,1,134053678,134053656,cPa75,3,102,22
chr2-134687905_134688007,cPa419,1,1,134687955,134687955,cPa419,1,102,0
chr2-135614062_135614267,cPa199-unknown,1,1,135614229,135614076,cPa199-unknown,14,205,153
chr2-135614322_135614573,cPa199-unknown,0.931034482758621,4,135614530,135614355,cPa199_cPa199-cPa419-hybrid_cPa199-unknown_cPa419,2_1_54_1,251,175
chr2-135647270_135647470,KoRV_AF151794,0.714285714285714,3,135647418,135647320,cPa419_KoRV_AF151794_KoRV_AF151794-cPa67-hybrid,1_5_1,200,98
chr2-135647482_135647828,KoRV_AF151794,0.833333333333333,3,135647825,135647532,cPa419_KoRV_AF151794_KoRV_AF151794-unknown,1_10_1,346,293
chr2-135656360_135656462,cPa125,0.982456140350877,2,135656417,135656389,cPa125_cPa125-unknown,56_1,102,28
chr2-135656465_135656567,cPa125,1,1,135656558,135656475,cPa125,26,102,83
chr2-135665430_135665536,cPa15,0.452380952380952,8,135665495,135665445,cPa118_cPa118-cPa268-hybrid_cPa118-cPa443-hybrid_cPa118-unknown_cPa140-cPa443-hybrid_cPa15_cPa268_cPa268-cPa443-hybrid,11_1_1_1_1_19_4_4,106,50
chr2-13598650_13598752,cPa62,1,1,13598751,13598700,cPa62,22,102,51
chr2-136166196_136166298,cPa62,0.857142857142857,2,136166290,136166246,cPa62_cPa62-unknown,6_1,102,44
chr2-136281746_136281848,cPa363,0.5,3,136281796,136281788,cPa363_cPa452-cPa75-hybrid_cPa456,3_1_2,102,8
chr2-136502591_136502693,cPa75-cPa293-hybrid,1,1,136502641,136502641,cPa75-cPa293-hybrid,1,102,0
chr2-136502704_136502862,cPa62-unknown,0.411764705882353,4,136502852,136502720,cPa62_cPa62-cPa293-hybrid_cPa62-unknown_cPa75,3_2_7_5,158,132
chr2-136502915_136503017,cPa293_cPa62-cPa75-hybrid,0.5,2,136503006,136502965,cPa293_cPa62-cPa75-hybrid,1_1,102,41
chr2-136503040_136503142,cPa62-unknown_cPa75_cPa75-cPa293-hybrid,0.333333333333333,3,136503090,136503053,cPa62-unknown_cPa75_cPa75-cPa293-hybrid,1_1_1,102,37
chr2-136740724_136740826,HERV-W_repbase_HERV17_LTR17,1,1,136740774,136740774,HERV-W_repbase_HERV17_LTR17,1,102,0
chr2-1369261_1369370,cPa75,0.714285714285714,2,1369318,1369291,cPa75_cPa75-unknown,5_2,109,27
chr2-1369584_1369709,cPa75,1,1,1369657,1369634,cPa75,2,125,23
chr2-136971264_136971366,cPa419,1,1,136971314,136971314,cPa419,1,102,0
chr2-1369866_1370003,cPa75,1,1,1369951,1369916,cPa75,5,137,35
chr2-137262118_137262220,cPa363_cPa456-cPa363-hybrid_cPa456-unknown,0.181818181818182,8,137262200,137262168,cPa117-cPa308-hybrid_cPa117-cPa363-hybrid_cPa363_cPa452-cPa308-hybrid_cPa452-cPa363-hybrid_cPa456_cPa456-cPa363-hybrid_cPa456-unknown,1_1_2_1_1_1_2_2,102,32
chr2-137269842_137269944,cPa118_cPa15,0.428571428571429,4,137269894,137269869,cPa118_cPa15_cPa15-unknown_cPa419,6_6_1_1,102,25
chr2-137391729_137391844,cPa11-cPa127-hybrid_cPa515-cPa241-hybrid_cPa531-cPa241-hybrid,0.333333333333333,3,137391792,137391779,cPa11-cPa127-hybrid_cPa515-cPa241-hybrid_cPa531-cPa241-hybrid,1_1_1,115,13
chr2-137849662_137849764,cPa117,1,1,137849712,137849712,cPa117,1,102,0
chr2-137849799_137849901,cPa117,1,1,137849849,137849849,cPa117,1,102,0
chr2-138035209_138035365,EIAV_NC001450,0.797297297297297,2,138035341,138035259,EIAV_NC001450_EIAV_NC001450-unknown,59_15,156,82
chr2-138122356_138122458,cPa62,1,1,138122406,138122389,cPa62,5,102,17
chr2-138324345_138324450,cPa450,0.490566037735849,13,138324448,138324385,cPa199_cPa199-cPa542-hybrid_cPa199-cPa62-hybrid_cPa223-cPa227-hybrid_cPa227_cPa227-cPa273-hybrid_cPa345-cPa542-hybrid_cPa419_cPa450_cPa450-cPa62-hybrid_cPa482-cPa273-hybrid_cPa553_cPa62-cPa542-hybrid,5_1_2_1_2_1_2_1_26_2_2_7_1,105,63
chr2-138325835_138325937,cPa62,1,1,138325906,138325855,cPa62,10,102,51
chr2-138515986_138516153,cPa298,0.793478260869565,5,138516115,138515993,cPa298_cPa298-unknown_cPa512_cPa512-cPa298-hybrid_cPa512-unknown,73_5_12_1_1,167,122
chr2-13889050_13889164,cPa15,0.555555555555556,7,13889157,13889061,cPa118_cPa15_cPa15-cPa248-hybrid_cPa443_cPa443-cPa118-hybrid_cPa443-cPa248-hybrid_cPa443-unknown,4_15_1_2_1_3_1,114,96
chr2-139202505_139202607,cPa75,0.666666666666667,2,139202590,139202525,cPa75_HERV-W_repbase_HERV17_LTR17,2_1,102,65
chr2-139246024_139246126,cPa14_cPa541,0.5,2,139246082,139246070,cPa14_cPa541,2_2,102,12
chr2-13933449_13933551,cPa583,0.568181818181818,7,13933532,13933487,cPa251_cPa251-cPa298-hybrid_cPa251-cPa358-hybrid_cPa251-unknown_cPa298_cPa358_cPa583,12_1_1_1_1_22_50,102,45
chr2-139547864_139547966,cPa142,0.75,2,139547921,139547914,cPa101-unknown_cPa142,1_3,102,7
chr2-139699855_139699957,cPa113_cPa75,0.5,2,139699905,139699903,cPa113_cPa75,1_1,102,2
chr2-139701469_139701571,cPa529,0.5,4,139701536,139701496,cPa113-cPa4-hybrid_cPa247_cPa247-cPa4-hybrid_cPa529,1_1_1_3,102,40
chr2-139729928_139730030,cPa16,0.727272727272727,4,139729994,139729930,cPa16_cPa379_cPa379-cPa16-hybrid_cPa71,8_1_1_1,102,64
chr2-140254223_140254337,cPa75,0.272727272727273,8,140254311,140254273,cPa285_cPa285-cPa413-hybrid_cPa413_cPa62_cPa62-cPa285-hybrid_cPa62-cPa413-hybrid_cPa62-unknown_cPa75,1_2_1_4_2_5_1_6,114,38
chr2-140317526_140317628,cPa62,0.96969696969697,2,140317597,140317525,cPa62_cPa62-unknown,32_1,102,72
chr2-140412757_140412859,cPa62,1,1,140412807,140412807,cPa62,1,102,0
chr2-140489226_140489328,cPa75,0.4,4,140489316,140489276,cPa62_cPa71-cPa62-hybrid_cPa75_cPa75-unknown,1_1_2_1,102,40
chr2-140584496_140584598,cPa410-cPa117-hybrid,0.60952380952381,4,140584579,140584537,cPa199-cPa117-hybrid_cPa199-unknown_cPa410-cPa117-hybrid_cPa410-unknown,18_3_64_20,102,42
chr2-140692089_140692191,cPa47,0.5,4,140692148,140692089,cPa174_cPa254_cPa425_cPa47,1_1_2_4,102,59
chr2-140770080_140770182,cPa62,1,1,140770130,140770106,cPa62,2,102,24
chr2-140871250_140871358,cPa339_cPa447_cPa447-cPa390-hybrid,0.333333333333333,3,140871306,140871295,cPa339_cPa447_cPa447-cPa390-hybrid,1_1_1,108,11
chr2-140921950_140922054,cPa363,0.375,5,140922011,140922000,cPa16-cPa176-hybrid_cPa363_cPa452_cPa452-unknown_cPa71,1_3_1_1_2,104,11
chr2-141169519_141169663,cPa62,1,1,141169658,141169569,cPa62,9,144,89
chr2-141466001_141466103,cPa404-cPa16-hybrid,0.375,4,141466064,141466042,cPa16-cPa254-hybrid_cPa254_cPa404-cPa16-hybrid_cPa404-cPa174-hybrid,2_2_3_1,102,22
chr2-141485193_141485295,cPa75-unknown,1,1,141485244,141485223,cPa75-unknown,3,102,21
chr2-142034118_142034247,cPa75,0.541666666666667,10,142034222,142034133,cPa113-cPa62-hybrid_cPa113-cPa75-hybrid_cPa293_cPa293-cPa62-hybrid_cPa62_cPa75_cPa75-cPa62-hybrid_cPa75-unknown_HERV-W_repbase_HERV17_LTR17-cPa62-hybrid_PERVC_HM159246-cPa62-hybrid,1_1_1_1_2_13_2_1_1_1,129,89
chr2-142126534_142126636,cPa199_cPa223_cPa273_cPa553-cPa450-hybrid_FeFV_NC001871,0.2,5,142126584,142126584,cPa199_cPa223_cPa273_cPa553-cPa450-hybrid_FeFV_NC001871,1_1_1_1_1,102,0
chr2-142310932_142311047,cPa121-cPa188-hybrid_cPa157-cPa188-hybrid_cPa193-cPa188-hybrid_cPa500-cPa188-hybrid_cPa500-cPa34-hybrid,0.2,5,142310995,142310982,cPa121-cPa188-hybrid_cPa157-cPa188-hybrid_cPa193-cPa188-hybrid_cPa500-cPa188-hybrid_cPa500-cPa34-hybrid,1_1_1_1_1,115,13
chr2-142768589_142768691,cPa62,0.375,4,142768679,142768624,cPa16_cPa285_cPa285-cPa62-hybrid_cPa62,2_2_1_3,102,55
chr2-143888369_143888471,cPa62_cPa62-cPa293-hybrid,0.5,2,143888467,143888419,cPa62_cPa62-cPa293-hybrid,1_1,102,48
chr2-143888474_143888576,cPa62_cPa62-cPa293-hybrid,0.5,2,143888524,143888523,cPa62_cPa62-cPa293-hybrid,1_1,102,1
chr2-143946377_143946479,cPa62,0.5,3,143946459,143946410,cPa285-cPa75-hybrid_cPa62_cPa62-cPa75-hybrid,1_3_2,102,49
chr2-143946726_143946828,cPa62_cPa62-cPa75-hybrid,0.5,2,143946776,143946744,cPa62_cPa62-cPa75-hybrid,1_1,102,32
chr2-143954414_143954516,cPa75-cPa260-hybrid,0.4,4,143954467,143954456,cPa308_cPa75_cPa75-cPa260-hybrid_cPa75-unknown,1_1_2_1,102,11
chr2-144017943_144018057,cPa254,0.333333333333333,6,144018014,144017990,cPa174_cPa254_cPa404_cPa425_cPa47_cPa47-cPa404-hybrid,1_3_1_2_1_1,114,24
chr2-144074710_144074812,cPa75,0.5,3,144074760,144074718,cPa75_cPa75-cPa482-hybrid_cPa75-unknown,2_1_1,102,42
chr2-144085372_144085474,cPa223-cPa75-hybrid,1,1,144085422,144085422,cPa223-cPa75-hybrid,1,102,0
chr2-144086953_144087070,cPa223-cPa75-hybrid,1,1,144087018,144086987,cPa223-cPa75-hybrid,5,117,31
chr2-144111090_144111194,cPa174_cPa254_cPa404-unknown_cPa425_cPa47,0.2,5,144111142,144111140,cPa174_cPa254_cPa404-unknown_cPa425_cPa47,1_1_1_1_1,104,2
chr2-144206583_144206699,cPa15,0.533333333333333,8,144206649,144206632,cPa118_cPa15_cPa248-cPa118-hybrid_cPa248-cPa443-hybrid_cPa248-unknown_cPa268_cPa443_cPa443-unknown,7_24_4_1_2_1_5_1,116,17
chr2-144230439_144230541,HML3_repbase_HERVK9I_MER9,0.666666666666667,2,144230489,144230488,cPa67_HML3_repbase_HERVK9I_MER9,1_2,102,1
chr2-144304507_144304684,cPa492,1,1,144304675,144304557,cPa492,84,177,118
chr2-14452125_14452227,cPa47-cPa174-hybrid,0.3,5,14452193,14452129,cPa254_cPa392-cPa174-hybrid_cPa425_cPa425-cPa174-hybrid_cPa47-cPa174-hybrid,2_2_2_1_3,102,64
chr2-144694210_144694312,cPa62,1,1,144694260,144694260,cPa62,1,102,0
chr2-144795961_144796063,cPa75-unknown,0.75,2,144796054,144795977,cPa75-HERV-F_repbase_HERVFH19I_LTR19A-hybrid_cPa75-unknown,2_6,102,77
chr2-144823090_144823264,cPa452,0.675675675675676,4,144823242,144823089,cPa183_cPa327_cPa452_cPa71,10_1_25_1,174,153
chr2-144985360_144985462,cPa75,0.346938775510204,8,144985454,144985378,cPa62_cPa62-cPa71-hybrid_cPa62-cPa75-hybrid_cPa62-HERV-W_repbase_HERV17_LTR17-hybrid_cPa62-unknown_cPa71_cPa71-unknown_cPa75,7_7_5_3_4_5_1_17,102,76
chr2-145048028_145048130,cPa425,0.333333333333333,5,145048078,145048078,cPa174_cPa174-cPa404-hybrid_cPa254_cPa425_cPa47,1_1_1_2_1,102,0
chr2-145108329_145108431,cPa15,1,1,145108379,145108379,cPa15,1,102,0
chr2-145271129_145271231,cPa75,1,1,145271179,145271173,cPa75,2,102,6
chr2-145302251_145302355,cPa246-cPa302-hybrid,0.444444444444444,4,145302303,145302266,cPa150-cPa255-hybrid_cPa150-cPa302-hybrid_cPa246-cPa255-hybrid_cPa246-cPa302-hybrid,1_3_1_4,104,37
chr2-145543137_145543239,cPa15,0.583333333333333,4,145543198,145543175,cPa118-cPa15-hybrid_cPa118-cPa268-hybrid_cPa118-unknown_cPa15,1_2_2_7,102,23
chr2-145620395_145620557,cPa113,0.454545454545455,5,145620521,145620399,cPa113_cPa113-cPa62-hybrid_cPa419_cPa75_cPa75-cPa62-hybrid,5_3_1_1_1,162,122
chr2-146027801_146027903,cPa75,1,1,146027851,146027851,cPa75,1,102,0
chr2-146369993_146370095,MSEV_CT990572,1,1,146370077,146370043,MSEV_CT990572,2,102,34
chr2-146401976_146402078,cPa199_cPa199-unknown_cPa201,0.333333333333333,3,146402026,146402011,cPa199_cPa199-unknown_cPa201,1_1_1,102,15
chr2-146407991_146408093,cPa62,0.666666666666667,2,146408047,146408034,cPa419_cPa62,1_2,102,13
chr2-146458781_146458883,cPa539,1,1,146458831,146458831,cPa539,1,102,0
chr2-146499056_146499281,cPa75,0.770114942528736,11,146499277,146499080,cPa109_cPa285-cPa201-hybrid_cPa285-unknown_cPa62_cPa71_cPa71-cPa75-hybrid_cPa75_cPa75-unknown_KoRV_AF151794_MoMLV_J02255_MoMLV_J02255-cPa201-hybrid,1_1_1_8_4_1_67_1_1_1_1,225,197
chr2-146555412_146555620,cPa15,0.675675675675676,6,146555584,146555462,cPa118_cPa140-cPa15-hybrid_cPa15_cPa443_cPa443-cPa118-hybrid_cPa443-unknown,2_1_25_6_1_2,208,122
chr2-146766230_146766332,cPa176,1,1,146766280,146766280,cPa176,1,102,0
chr2-146873600_146873702,cPa62,1,1,146873650,146873644,cPa62,2,102,6
chr2-147021475_147021577,cPa62-HERV-W_repbase_HERV17_LTR17-hybrid_cPa75_HERV-W_repbase_HERV17_LTR17,0.333333333333333,3,147021541,147021485,cPa62-HERV-W_repbase_HERV17_LTR17-hybrid_cPa75_HERV-W_repbase_HERV17_LTR17,1_1_1,102,56
chr2-147112354_147112503,cPa75-unknown,0.916666666666667,2,147112451,147112403,cPa75-cPa273-hybrid_cPa75-unknown,1_11,149,48
chr2-147253539_147253641,cPa419_WDSV_NC001867,0.5,2,147253597,147253589,cPa419_WDSV_NC001867,1_1,102,8
chr2-147253918_147254020,cPa199,1,1,147253968,147253968,cPa199,1,102,0
chr2-147265697_147265814,cPa118,0.428571428571429,6,147265773,147265698,cPa118_cPa118-cPa248-hybrid_cPa15_cPa15-cPa260-hybrid_cPa248_cPa268-cPa248-hybrid,9_1_8_1_1_1,117,75
chr2-147460905_147461007,cPa62,1,1,147460977,147460937,cPa62,8,102,40
chr2-147461088_147461202,cPa62,1,1,147461163,147461120,cPa62,18,114,43
chr2-147608819_147608921,HERV-W_repbase_HERV17_LTR17,1,1,147608869,147608869,HERV-W_repbase_HERV17_LTR17,1,102,0
chr2-147618015_147618117,cPa419,1,1,147618065,147618065,cPa419,1,102,0
chr2-147681695_147681843,cPa75-unknown,0.666666666666667,2,147681791,147681745,cPa62-cPa67-hybrid_cPa75-unknown,1_2,148,46
chr2-147776914_147777016,cPa75,1,1,147776964,147776914,cPa75,5,102,50
chr2-147777057_147777207,cPa75,1,1,147777155,147777061,cPa75,4,150,94
chr2-147777264_147777366,cPa75,1,1,147777314,147777314,cPa75,1,102,0
chr2-14780847_14780949,cPa15,0.528846153846154,8,14780914,14780855,cPa118_cPa118-cPa125-hybrid_cPa118-cPa248-hybrid_cPa118-cPa268-hybrid_cPa118-cPa443-hybrid_cPa118-unknown_cPa15_cPa516-cPa443-hybrid,31_3_3_2_1_8_55_1,102,59
chr2-147828055_147828157,cPa223_cPa553,0.272727272727273,6,147828154,147828061,cPa118-cPa223-hybrid_cPa199_cPa223_cPa273_cPa345_cPa553,1_1_3_2_1_3,102,93
chr2-147904403_147904542,cPa75,1,1,147904505,147904453,cPa75,3,139,52
chr2-148094715_148094833,cPa75,0.833333333333333,4,148094812,148094740,cPa113-cPa75-hybrid_cPa67-cPa75-hybrid_cPa75_cPa75-cPa62-hybrid,1_1_15_1,118,72
chr2-148095187_148095289,cPa75,1,1,148095242,148095237,cPa75,2,102,5
chr2-148208271_148208395,cPa62,0.923076923076923,4,148208350,148208290,cPa285_cPa293_cPa62_cPa62-cPa293-hybrid,3_1_60_1,124,60
chr2-148211425_148211597,cPa71,0.5,20,148211592,148211454,cPa16_cPa16-cPa260-hybrid_cPa16-cPa363-hybrid_cPa16-cPa71-hybrid_cPa16-unknown_cPa16-WDSV_NC001867-hybrid_cPa363_cPa363-unknown_cPa363-WDSV_NC001867-hybrid_cPa379_cPa379-cPa16-hybrid_cPa379-cPa260-hybrid_cPa379-unknown_cPa379-WDSV_NC001867-hybrid_cPa419_cPa71_cPa71-cPa260-hybrid_cPa71-cPa62-hybrid_cPa71-unknown_cPa71-WDSV_NC001867-hybrid,15_2_2_1_4_2_7_3_1_14_1_2_1_3_1_69_1_1_5_3,172,138
chr2-148315427_148315529,cPa62,1,1,148315477,148315477,cPa62,1,102,0
chr2-148315573_148316023,cPa62,0.942857142857143,3,148315992,148315623,cPa293_cPa62_cPa62-unknown,1_33_1,450,369
chr2-148411610_148411712,cPa75,0.4,5,148411710,148411657,cPa260-cPa75-hybrid_cPa260-unknown_cPa75_cPa75-cPa293-hybrid_cPa75-unknown,1_2_6_1_5,102,53
chr2-148561339_148561452,cPa450,0.48780487804878,13,148561444,148561372,cPa199_cPa199-cPa273-hybrid_cPa223_cPa223-cPa273-hybrid_cPa223-cPa542-hybrid_cPa227_cPa227-cPa273-hybrid_cPa273_cPa450_cPa450-cPa273-hybrid_cPa482-cPa273-hybrid_cPa553_cPa553-cPa227-hybrid,1_4_1_1_1_1_1_2_20_1_1_6_1,113,72
chr2-148639612_148639714,cPa273_cPa482,0.5,2,148639662,148639662,cPa273_cPa482,1_1,102,0
chr2-148680787_148680889,cPa285,0.6,3,148680889,148680836,cPa16_cPa260-cPa285-hybrid_cPa285,1_1_3,102,53
chr2-148777270_148777444,cPa62_cPa75,0.4,3,148777406,148777320,cPa201_cPa62_cPa75,1_2_2,174,86
chr2-148782910_148783017,cPa62,0.920634920634921,6,148782972,148782931,cPa223-cPa62-hybrid_cPa285_cPa285-cPa62-hybrid_cPa293-unknown_cPa62_cPa62-unknown,1_1_1_1_58_1,107,41
chr2-149228135_149228237,cPa62,1,1,149228185,149228185,cPa62,1,102,0
chr2-149228512_149228614,cPa62,1,1,149228562,149228562,cPa62,1,102,0
chr2-149229049_149229151,cPa62,1,1,149229099,149229099,cPa62,1,102,0
chr2-149292894_149292996,cPa434_cPa566,0.5,2,149292944,149292944,cPa434_cPa566,1_1,102,0
chr2-149503005_149503107,cPa62,0.714285714285714,2,149503095,149503055,cPa62_cPa62-cPa75-hybrid,5_2,102,40
chr2-149504055_149504171,cPa62-cPa75-hybrid,1,1,149504129,149504105,cPa62-cPa75-hybrid,4,116,24
chr2-149504247_149504349,cPa62-cPa75-hybrid_cPa75,0.5,2,149504336,149504297,cPa62-cPa75-hybrid_cPa75,1_1,102,39
chr2-149535490_149535592,cPa308,1,1,149535540,149535540,cPa308,1,102,0
chr2-149730072_149730174,cPa539,1,1,149730122,149730122,cPa539,1,102,0
chr2-149828773_149828875,cPa482,0.666666666666667,2,149828823,149828796,cPa273-cPa505-hybrid_cPa482,1_2,102,27
chr2-149899964_149900066,cPa199,0.461538461538462,4,149900015,149899994,cPa199_cPa482_cPa482-cPa199-hybrid_cPa482-unknown,6_4_1_2,102,21
chr2-149911938_149912040,cPa260_cPa260-unknown_cPa75-SMRV_NC001514-hybrid_SMRV_NC001514,0.25,4,149911993,149911978,cPa260_cPa260-unknown_cPa75-SMRV_NC001514-hybrid_SMRV_NC001514,1_1_1_1,102,15
chr2-149912067_149912169,SMRV_NC001514,1,1,149912129,149912096,SMRV_NC001514,3,102,33
chr2-149935007_149935109,cPa62_cPa75,0.5,2,149935057,149935057,cPa62_cPa75,1_1,102,0
chr2-149935139_149935277,cPa62,0.5,5,149935228,149935165,cPa285-cPa62-hybrid_cPa62_cPa71_cPa75_cPa75-cPa62-hybrid,1_5_1_2_1,138,63
chr2-149935320_149935422,cPa62_cPa75_cPa75-cPa62-hybrid,0.333333333333333,3,149935387,149935349,cPa62_cPa75_cPa75-cPa62-hybrid,1_1_1,102,38
chr2-149935775_149935877,cPa62,0.666666666666667,2,149935853,149935804,cPa62_cPa75-cPa62-hybrid,2_1,102,49
chr2-149958960_149959062,cPa285,0.526315789473684,7,149959014,149958987,cPa109_cPa125-unknown_cPa285_cPa293_cPa402_cPa62_cPa75-cPa285-hybrid,5_1_20_4_6_1_1,102,27
chr2-149984960_149985062,cPa62,1,1,149985010,149984991,cPa62,16,102,19
chr2-150108703_150108805,cPa62,1,1,150108753,150108753,cPa62,1,102,0
chr2-150109309_150109524,cPa62,0.7,3,150109473,150109359,cPa62_cPa62-cPa254-hybrid_cPa62-unknown,7_1_2,215,114
chr2-150109673_150109775,cPa62,0.75,2,150109770,150109715,cPa62_cPa62-unknown,3_1,102,55
chr2-150109783_150110080,cPa62,0.608695652173913,4,150110028,150109787,cPa254_cPa62_cPa62-cPa254-hybrid_cPa62-unknown,2_14_2_5,297,241
chr2-150114404_150114547,cPa75_HERV-W_repbase_HERV17_LTR17-unknown,0.5,2,150114495,150114454,cPa75_HERV-W_repbase_HERV17_LTR17-unknown,1_1,143,41
chr2-150114565_150114743,cPa75,0.6,3,150114691,150114615,cPa75_HERV-W_repbase_HERV17_LTR17-cPa62-hybrid_HERV-W_repbase_HERV17_LTR17-unknown,3_1_1,178,76
chr2-150123377_150123479,cPa199_cPa553,0.25,7,150123461,150123379,cPa199_cPa273_cPa345_cPa450_cPa450-cPa273-hybrid_cPa553_cPa553-cPa273-hybrid,3_2_1_1_1_3_1,102,82
chr2-150123661_150123791,cPa553,0.253164556962025,21,150123789,150123663,cPa199_cPa199-cPa227-hybrid_cPa199-cPa450-hybrid_cPa223-cPa199-hybrid_cPa227_cPa273_cPa273-cPa345-hybrid_cPa345_cPa345-cPa273-hybrid_cPa345-cPa450-hybrid_cPa450_cPa450-cPa199-hybrid_cPa450-cPa273-hybrid_cPa450-cPa542-hybrid_cPa553_cPa553-cPa199-hybrid_cPa553-cPa227-hybrid_cPa553-cPa273-hybrid_cPa553-cPa345-hybrid_cPa553-cPa450-hybrid_cPa553-unknown,13_1_1_1_4_7_1_11_1_1_3_1_1_1_20_1_3_2_1_3_2,130,126
chr2-150123934_150124036,cPa553,0.304347826086957,10,150123991,150123933,cPa199_cPa199-cPa227-hybrid_cPa227_cPa273_cPa345_cPa450_cPa450-cPa227-hybrid_cPa553_cPa553-cPa199-hybrid_cPa553-unknown,3_1_2_2_3_1_1_7_2_1,102,58
chr2-150135914_150136016,cPa157_cPa482-cPa157-hybrid,0.5,2,150135997,150135964,cPa157_cPa482-cPa157-hybrid,1_1,102,33
chr2-150136040_150136142,cPa482_cPa505,0.5,2,150136131,150136090,cPa482_cPa505,1_1,102,41
chr2-150140888_150140990,cPa75,1,1,150140938,150140938,cPa75,1,102,0
chr2-150141019_150141263,cPa75,0.666666666666667,3,150141211,150141061,cPa285_cPa62-cPa109-hybrid_cPa75,1_1_4,244,150
chr2-150255343_150255445,cPa75,0.266666666666667,9,150255412,150255357,cPa201-cPa62-hybrid_cPa260-cPa201-hybrid_cPa260-cPa62-hybrid_cPa62_cPa75_cPa75-cPa62-hybrid_HML2_repbase_HERVK_LTR5-cPa62-hybrid_SMRV_NC001514_SMRV_NC001514-cPa62-hybrid,2_1_1_1_4_1_1_2_2,102,55
chr2-150263875_150263977,cPa62,1,1,150263925,150263925,cPa62,1,102,0
chr2-150265003_150265105,cPa486-cPa62-hybrid,1,1,150265053,150265053,cPa486-cPa62-hybrid,1,102,0
chr2-150412026_150412128,WDSV_NC001867,0.5,3,150412085,150412071,cPa566_cPa62-WDSV_NC001867-hybrid_WDSV_NC001867,2_1_3,102,14
chr2-150426778_150426909,cPa200-unknown_cPa223_cPa223-cPa456-hybrid_cPa223-unknown_HIV1_NC001802,0.2,5,150426866,150426821,cPa200-unknown_cPa223_cPa223-cPa456-hybrid_cPa223-unknown_HIV1_NC001802,1_1_1_1_1,131,45
chr2-150505373_150505475,cPa75,0.363636363636364,5,150505447,150505401,cPa260_cPa260-cPa62-hybrid_cPa260-cPa75-hybrid_cPa260-unknown_cPa75,4_3_6_1_8,102,46
chr2-150574362_150574464,cPa62-unknown,1,1,150574412,150574412,cPa62-unknown,1,102,0
chr2-150610376_150610478,cPa62,1,1,150610471,150610388,cPa62,21,102,83
chr2-150677543_150677645,cPa113-cPa62-hybrid,1,1,150677593,150677593,cPa113-cPa62-hybrid,1,102,0
chr2-150677690_150677792,cPa113-cPa62-hybrid_cPa113-unknown,0.5,2,150677740,150677698,cPa113-cPa62-hybrid_cPa113-unknown,1_1,102,42
chr2-150677805_150677998,cPa113-cPa62-hybrid,0.4,4,150677946,150677855,cPa113-cPa293-hybrid_cPa113-cPa62-hybrid_cPa75_cPa75-cPa62-hybrid,1_2_1_1,193,91
chr2-150855277_150855451,cPa62-HERV-W_repbase_HERV17_LTR17-hybrid,0.666666666666667,3,150855399,150855327,cPa62-HERV-W_repbase_HERV17_LTR17-hybrid_cPa62-unknown_cPa75-HERV-W_repbase_HERV17_LTR17-hybrid,6_1_2,174,72
chr2-150855525_150855627,cPa62-HERV-W_repbase_HERV17_LTR17-hybrid_HERV-W_repbase_HERV17_LTR17,0.5,2,150855575,150855524,cPa62-HERV-W_repbase_HERV17_LTR17-hybrid_HERV-W_repbase_HERV17_LTR17,1_1,102,51
chr2-150855659_150856066,HERV-W_repbase_HERV17_LTR17,0.577777777777778,7,150856029,150855703,cPa62-HERV-W_repbase_HERV17_LTR17-hybrid_cPa71_cPa75-cPa113-hybrid_cPa75-HERV-W_repbase_HERV17_LTR17-hybrid_HERV-W_repbase_HERV17_LTR17_KoRV_AF151794_PERV_AJ293656,10_3_1_3_26_1_1,407,326
chr2-150856084_150856201,HERV-W_repbase_HERV17_LTR17,0.5,4,150856174,150856134,cPa62-HERV-W_repbase_HERV17_LTR17-hybrid_cPa75-KoRV_AF151794-hybrid_HERV-W_repbase_HERV17_LTR17_PERV_AJ293656,2_1_4_1,117,40
chr2-150857276_150857378,cPa62-cPa75-hybrid,1,1,150857326,150857326,cPa62-cPa75-hybrid,1,102,0
chr2-150857595_150857697,cPa75,1,1,150857645,150857645,cPa75,1,102,0
chr2-150943448_150943761,cPa482,0.90625,3,150943725,150943498,cPa482_cPa482-cPa260-hybrid_cPa482-unknown,29_1_2,313,227
chr2-150982915_150983017,cPa75,1,1,150982965,150982965,cPa75,1,102,0
chr2-150985201_150985391,cPa260,1,1,150985374,150985206,cPa260,14,190,168
chr2-151027103_151027299,cPa75,0.625,2,151027293,151027153,cPa75_cPa75-cPa62-hybrid,10_6,196,140
chr2-151027426_151027528,cPa75,0.6,3,151027476,151027438,cPa75_cPa75-cPa62-hybrid_HERV-W_repbase_HERV17_LTR17-cPa62-hybrid,3_1_1,102,38
chr2-151027577_151027733,cPa75,0.470588235294118,3,151027728,151027588,cPa75_cPa75-cPa62-hybrid_HERV-W_repbase_HERV17_LTR17-cPa62-hybrid,24_22_5,156,140
chr2-151029782_151029884,cPa16,0.4,4,151029840,151029810,cPa16_cPa16-cPa438-hybrid_cPa425_cPa71-cPa438-hybrid,2_1_1_1,102,30
chr2-151053404_151053732,cPa194,0.9,4,151053713,151053409,cPa194_cPa260-cPa194-hybrid_cPa302-cPa194-hybrid_cPa67,27_1_1_1,328,304
chr2-151053802_151053913,cPa194,1,1,151053908,151053806,cPa194,5,111,102
chr2-151077264_151077670,cPa75,1,1,151077618,151077314,cPa75,29,406,304
chr2-151083467_151083569,cPa539,0.6,3,151083545,151083517,cPa260_cPa539_WDSV_NC001867,1_3_1,102,28
chr2-15111019_15111121,cPa4,0.461538461538462,7,15111090,15111051,cPa18_cPa18-cPa104-hybrid_cPa18-cPa190-hybrid_cPa4_cPa541_cPa541-cPa190-hybrid_cPa545-cPa190-hybrid,1_1_2_6_1_1_1,102,39
chr2-151118705_151118807,cPa75-unknown,1,1,151118755,151118755,cPa75-unknown,1,102,0
chr2-151235941_151236043,cPa75-unknown,1,1,151236017,151235991,cPa75-unknown,2,102,26
chr2-151257519_151257621,cPa75-PERV_AJ293656-hybrid,1,1,151257569,151257569,cPa75-PERV_AJ293656-hybrid,1,102,0
chr2-151402489_151402641,cPa194,0.875,3,151402597,151402513,cPa194_cPa67_cPa67-cPa194-hybrid,21_2_1,152,84
chr2-151402722_151403038,cPa194,0.538461538461538,3,151402986,151402754,cPa194_cPa360_cPa360-cPa194-hybrid,14_11_1,316,232
chr2-151461006_151461108,cPa106_HERVHcons,0.5,2,151461070,151461056,cPa106_HERVHcons,1_1,102,14
chr2-151491607_151491709,HML1b_repbase_HERV-K14I_LTR14A-cPa260-hybrid,1,1,151491657,151491657,HML1b_repbase_HERV-K14I_LTR14A-cPa260-hybrid,1,102,0
chr2-151545244_151545346,cPa260-unknown,0.6,2,151545308,151545251,cPa260-unknown_HERVHcons,3_2,102,57
chr2-151687274_151687376,cPa345_cPa345-unknown_cPa67,0.333333333333333,3,151687329,151687324,cPa345_cPa345-unknown_cPa67,1_1_1,102,5
chr2-151687384_151687746,cPa194,0.564102564102564,9,151687726,151687385,cPa194_cPa194-cPa75-hybrid_cPa302_cPa345-cPa194-hybrid_cPa345-cPa360-hybrid_cPa345-unknown_cPa360_cPa67_cPa67-cPa194-hybrid,22_1_1_1_1_1_6_5_1,362,341
chr2-151688733_151688974,cPa345-cPa75-hybrid,0.3,7,151688922,151688760,cPa194-cPa75-hybrid_cPa260_cPa345-cPa75-hybrid_cPa360-cPa75-hybrid_cPa549-cPa75-hybrid_cPa67-cPa75-hybrid_cPa75,1_1_3_2_1_1_1,241,162
chr2-151688995_151689097,cPa345-cPa75-hybrid,1,1,151689045,151689045,cPa345-cPa75-hybrid,1,102,0
chr2-151691922_151692024,cPa539,1,1,151691972,151691972,cPa539,1,102,0
chr2-151698531_151698662,cPa16,0.583333333333333,4,151698635,151698567,cPa16_cPa16-unknown_cPa71_EIAV_NC001450-unknown,7_2_2_1,131,68
chr2-151702383_151702485,cPa323-unknown,1,1,151702433,151702428,cPa323-unknown,2,102,5
chr2-151772583_151772685,cPa75,1,1,151772633,151772633,cPa75,1,102,0
chr2-151788869_151788971,cPa323,1,1,151788919,151788919,cPa323,1,102,0
chr2-151790885_151790987,cPa75,1,1,151790935,151790935,cPa75,1,102,0
chr2-151817607_151817820,cPa75,1,1,151817768,151817628,cPa75,8,213,140
chr2-1518290_1518398,cPa47,0.266666666666667,8,1518354,1518316,cPa174_cPa174-cPa404-hybrid_cPa174-cPa425-hybrid_cPa174-cPa47-hybrid_cPa174-unknown_cPa254_cPa425_cPa47,10_1_3_1_1_7_10_12,108,38
chr2-151846723_151846825,cPa539,0.666666666666667,2,151846824,151846737,cPa539_cPa539-cPa371-hybrid,2_1,102,87
chr2-151847409_151847511,cPa323_cPa323-cPa371-hybrid_cPa50-cPa371-hybrid,0.333333333333333,3,151847464,151847459,cPa323_cPa323-cPa371-hybrid_cPa50-cPa371-hybrid,1_1_1,102,5
chr2-151847552_151847762,cPa323,0.611111111111111,5,151847710,151847562,cPa323_cPa323-unknown_cPa371_cPa486-cPa371-hybrid_cPa50-unknown,11_2_3_1_1,210,148
chr2-151865769_151865871,cPa75,1,1,151865819,151865819,cPa75,1,102,0
chr2-151866672_151866774,cPa75,1,1,151866722,151866722,cPa75,1,102,0
chr2-151866839_151866986,cPa75,1,1,151866934,151866889,cPa75,5,147,45
chr2-151867114_151867216,cPa75,1,1,151867164,151867164,cPa75,1,102,0
chr2-151867254_151867513,cPa75,1,1,151867461,151867304,cPa75,7,259,157
chr2-151867795_151867978,cPa75,1,1,151867926,151867845,cPa75,14,183,81
chr2-151867981_151868122,cPa75,1,1,151868115,151868031,cPa75,7,141,84
chr2-151873977_151874079,cPa75,1,1,151874027,151874027,cPa75,1,102,0
chr2-151874221_151874323,cPa75,1,1,151874271,151874271,cPa75,1,102,0
chr2-151878828_151878930,cPa75,1,1,151878878,151878878,cPa75,1,102,0
chr2-151894176_151894278,cPa75,1,1,151894226,151894226,cPa75,1,102,0
chr2-151897259_151897361,cPa75,1,1,151897309,151897309,cPa75,1,102,0
chr2-151897719_151897948,cPa75,1,1,151897896,151897769,cPa75,6,229,127
chr2-151898087_151898189,cPa75,1,1,151898137,151898112,cPa75,2,102,25
chr2-151903747_151903911,cPa75,1,1,151903859,151903790,cPa75,4,164,69
chr2-151904469_151904571,cPa75,1,1,151904554,151904519,cPa75,5,102,35
chr2-151904636_151904738,cPa75,1,1,151904686,151904686,cPa75,1,102,0
chr2-151904975_151905266,cPa75,1,1,151905214,151905025,cPa75,30,291,189
chr2-151908464_151908566,cPa75,1,1,151908514,151908514,cPa75,1,102,0
chr2-151944126_151944228,cPa75,1,1,151944176,151944176,cPa75,1,102,0
chr2-151970506_151970608,cPa260,1,1,151970556,151970537,cPa260,2,102,19
chr2-151970825_151970927,cPa106_cPa260,0.5,2,151970893,151970875,cPa106_cPa260,1_1,102,18
chr2-15383526_15383628,HERV-W_repbase_HERV17_LTR17,0.565217391304348,5,15383609,15383530,cPa62-cPa75-hybrid_cPa75_HERV-W_repbase_HERV17_LTR17_HERV-W_repbase_HERV17_LTR17-unknown_KoRV_AF151794,1_6_13_2_1,102,79
chr2-15383753_15383873,HERV-W_repbase_HERV17_LTR17,0.648648648648649,10,15383865,15383777,cPa62_cPa62-cPa75-hybrid_cPa62-HERV-W_repbase_HERV17_LTR17-hybrid_cPa75_cPa75-unknown_HERV-W_repbase_HERV17_LTR17_HERV-W_repbase_HERV17_LTR17-cPa62-hybrid_HERV-W_repbase_HERV17_LTR17-cPa75-hybrid_HERV-W_repbase_HERV17_LTR17-unknown_KoRV_AF151794-cPa75-hybrid,3_2_1_11_1_48_1_3_3_1,120,88
chr2-15527631_15527769,cPa101,0.375,6,15527747,15527681,cPa101_cPa101-cPa142-hybrid_cPa142_cPa142-cPa582-hybrid_cPa256-cPa51-hybrid_cPa582,9_1_6_2_1_5,138,66
chr2-15536874_15536976,cPa75,0.5,3,15536968,15536873,cPa75_cPa75-cPa62-hybrid_HERV-W_repbase_HERV17_LTR17,3_2_1,102,95
chr2-15563969_15564071,cPa174_cPa254,0.333333333333333,6,15564022,15564011,cPa174_cPa254_cPa404_cPa47-cPa392-hybrid_cPa47-cPa425-hybrid_cPa516-cPa425-hybrid,4_4_1_1_1_1,102,11
chr2-1560693_1560814,cPa15,0.666666666666667,2,1560781,1560743,cPa15_cPa419,2_1,121,38
chr2-15714388_15714490,cPa62,1,1,15714474,15714438,cPa62,9,102,36
chr2-15714561_15714663,cPa220_cPa62,0.333333333333333,4,15714643,15714599,cPa220_cPa258-cPa220-hybrid_cPa62_cPa62-cPa220-hybrid,3_1_3_2,102,44
chr2-15721112_15721214,cPa15,0.7,3,15721170,15721131,cPa118_cPa15_cPa268,1_7_2,102,39
chr2-15727334_15727444,cPa363_cPa456,0.333333333333333,4,15727406,15727384,cPa117-cPa587-hybrid_cPa363_cPa452-cPa587-hybrid_cPa456,1_2_1_2,110,22
chr2-15748292_15748394,cPa199_cPa227_cPa450,0.333333333333333,3,15748342,15748338,cPa199_cPa227_cPa450,1_1_1,102,4
chr2-15749641_15749743,cPa472-unknown_cPa572,0.25,6,15749704,15749691,cPa395-cPa511-hybrid_cPa472_cPa472-unknown_cPa572_cPa575-cPa511-hybrid_cPa575-unknown,1_1_2_2_1_1,102,13
chr2-15830319_15830428,cPa456,0.666666666666667,6,15830414,15830329,cPa363_cPa452-cPa363-hybrid_cPa452-cPa587-hybrid_cPa452-unknown_cPa456_cPa456-cPa363-hybrid,12_5_3_2_46_1,109,85
chr2-15890326_15890428,cPa345,1,1,15890418,15890376,cPa345,4,102,42
chr2-15900651_15900753,cPa75-unknown,1,1,15900701,15900701,cPa75-unknown,1,102,0
chr2-15919425_15919527,cPa434,1,1,15919475,15919475,cPa434,1,102,0
chr2-15972518_15972620,cPa216-cPa255-hybrid,0.2,12,15972580,15972552,cPa216-cPa131-hybrid_cPa216-cPa255-hybrid_cPa216-cPa479-hybrid_cPa438-cPa131-hybrid_cPa463-cPa131-hybrid_cPa463-cPa255-hybrid_cPa479_cPa526-cPa131-hybrid_cPa526-cPa255-hybrid_cPa526-cPa479-hybrid_cPa563_cPa563-cPa131-hybrid,6_8_3_2_1_1_1_7_3_5_2_1,102,28
chr2-1610346_1610448,cPa75,1,1,1610396,1610396,cPa75,1,102,0
chr2-16129209_16129323,cPa479,0.333333333333333,5,16129271,16129259,cPa131-cPa150-hybrid_cPa255_cPa255-cPa150-hybrid_cPa438-cPa150-hybrid_cPa479,1_1_1_1_2,114,12
chr2-16274523_16274625,cPa540,0.236363636363636,15,16274573,16274548,cPa127_cPa127-cPa290-hybrid_cPa127-cPa356-hybrid_cPa127-cPa515-hybrid_cPa241_cPa241-cPa11-hybrid_cPa241-cPa290-hybrid_cPa241-cPa356-hybrid_cPa241-cPa515-hybrid_cPa241-cPa530-hybrid_cPa241-cPa540-hybrid_cPa241-unknown_cPa356_cPa515_cPa540,1_2_2_2_8_3_2_1_1_1_4_5_1_9_13,102,25
chr2-16440762_16440926,cPa75,0.208333333333333,12,16440921,16440812,cPa260_cPa260-cPa62-hybrid_cPa260-cPa75-hybrid_cPa293_cPa293-cPa75-hybrid_cPa572-cPa62-hybrid_cPa572-cPa75-hybrid_cPa572-PERV_AJ293656-hybrid_cPa62_cPa75_cPa75-cPa62-hybrid_PERVC_HM159246,2_2_2_4_1_1_2_1_2_5_1_1,164,109
chr2-16621639_16621792,cPa62,0.890625,4,16621778,16621660,cPa285_cPa285-unknown_cPa62_cPa62-unknown,2_3_57_2,153,118
chr2-16794530_16794658,cPa62,1,1,16794637,16794534,cPa62,59,128,103
chr2-16860246_16860348,cPa216_cPa549-cPa131-hybrid,0.333333333333333,4,16860297,16860285,cPa216_cPa438_cPa438-cPa131-hybrid_cPa549-cPa131-hybrid,2_1_1_2,102,12
chr2-16875337_16875439,cPa402_cPa62-unknown_cPa75,0.333333333333333,3,16875387,16875363,cPa402_cPa62-unknown_cPa75,1_1_1,102,24
chr2-16936334_16936436,cPa425,0.5,3,16936402,16936381,cPa174_cPa425_cPa47,2_3_1,102,21
chr2-16936443_16936545,cPa47,0.25,8,16936542,16936480,cPa174_cPa404_cPa425_cPa425-cPa174-hybrid_cPa425-cPa47-hybrid_cPa425-unknown_cPa47_cPa47-cPa254-hybrid,2_1_2_1_1_1_3_1,102,62
chr2-16985400_16985515,cPa118,0.666666666666667,2,16985463,16985450,cPa118_cPa15,2_1,115,13
chr2-17006418_17006532,cPa545_cPa95,0.333333333333333,4,17006497,17006468,cPa14-unknown_cPa247_cPa545_cPa95,1_1_2_2,114,29
chr2-17007085_17007187,S71_repbase_HERVS71_LTR6A,0.875,2,17007142,17007131,S71_repbase_HERVS71_LTR6A_SIV_NC001549,7_1,102,11
chr2-17047166_17047369,cPa452-cPa117-hybrid_cPa452-cPa75-hybrid,0.4,3,17047317,17047178,cPa452_cPa452-cPa117-hybrid_cPa452-cPa75-hybrid,1_2_2,203,139
chr2-17061761_17061863,cPa452_cPa71,0.333333333333333,4,17061815,17061807,cPa16-cPa363-hybrid_cPa363_cPa452_cPa71,1_2_3_3,102,8
chr2-17209121_17209223,cPa62,1,1,17209178,17209162,cPa62,6,102,16
chr2-17209273_17209377,cPa62,0.76,4,17209328,17209310,cPa285_cPa62_cPa62-cPa285-hybrid_cPa62-unknown,1_19_1_4,104,18
chr2-17767367_17767469,cPa62,0.8,2,17767417,17767411,cPa285_cPa62,1_4,102,6
chr2-17863150_17863320,cPa392,1,1,17863320,17863198,cPa392,12,170,122
chr2-17950320_17950422,cPa75,1,1,17950370,17950370,cPa75,1,102,0
chr2-181567_182027,cPa75,1,1,182025,181576,cPa75,41,460,449
chr2-18177393_18177495,cPa285,1,1,18177443,18177443,cPa285,1,102,0
chr2-182054_182156,cPa75,1,1,182142,182104,cPa75,5,102,38
chr2-182273_182540,cPa75,1,1,182492,182286,cPa75,15,267,206
chr2-18442656_18442772,cPa71,0.276470588235294,19,18442730,18442670,cPa16_cPa16-cPa452-hybrid_cPa223-cPa16-hybrid_cPa223-cPa176-hybrid_cPa223-cPa363-hybrid_cPa223-cPa452-hybrid_cPa327_cPa327-cPa16-hybrid_cPa327-cPa176-hybrid_cPa327-cPa363-hybrid_cPa327-cPa452-hybrid_cPa363_cPa452_cPa71_cPa71-cPa16-hybrid_cPa71-cPa176-hybrid_cPa71-cPa363-hybrid_cPa71-cPa452-hybrid_cPa71-unknown,25_2_3_1_1_4_1_20_2_13_20_3_11_47_8_1_1_5_2,116,60
chr2-18505102_18505212,cPa62,1,1,18505160,18505151,cPa62,24,110,9
chr2-185065_185167,cPa75,1,1,185115,185115,cPa75,1,102,0
chr2-185734_185836,cPa75,1,1,185784,185784,cPa75,1,102,0
chr2-185843_185945,cPa75,1,1,185893,185873,cPa75,2,102,20
chr2-186348_186450,cPa75,1,1,186398,186398,cPa75,1,102,0
chr2-18750077_18750311,cPa62,0.969230769230769,2,18750259,18750087,cPa62_cPa62-unknown,63_2,234,172
chr2-18750332_18750434,cPa62,1,1,18750382,18750375,cPa62,2,102,7
chr2-19046383_19046485,cPa62,1,1,19046446,19046429,cPa62,41,102,17
chr2-19614416_19614518,cPa62-HERV-W_repbase_HERV17_LTR17-hybrid_HERV-W_repbase_HERV17_LTR17,0.454545454545455,3,19614478,19614418,cPa62_cPa62-HERV-W_repbase_HERV17_LTR17-hybrid_HERV-W_repbase_HERV17_LTR17,1_5_5,102,60
chr2-19878871_19878977,cPa104-cPa219-hybrid_cPa190,0.333333333333333,4,19878933,19878921,cPa104_cPa104-cPa219-hybrid_cPa190_cPa190-cPa219-hybrid,1_2_2_1,106,12
chr2-20014115_20014221,cPa515,0.75,2,20014169,20014164,cPa356-unknown_cPa515,1_3,106,5
chr2-20150347_20150449,cPa62,0.866666666666667,3,20150410,20150361,cPa254-cPa285-hybrid_cPa62_cPa62-unknown,1_13_1,102,49
chr2-20253846_20253950,cPa15_cPa268_cPa61-cPa118-hybrid,0.333333333333333,3,20253898,20253896,cPa15_cPa268_cPa61-cPa118-hybrid,1_1_1,104,2
chr2-202714_202873,cPa118-cPa434-hybrid_cPa118-cPa566-hybrid_cPa118-unknown_cPa248_cPa443,0.2,5,202821,202764,cPa118-cPa434-hybrid_cPa118-cPa566-hybrid_cPa118-unknown_cPa248_cPa443,1_1_1_1_1,159,57
chr2-202948_203050,cPa434,0.5,3,203012,202997,cPa118-cPa434-hybrid_cPa118-cPa566-hybrid_cPa434,1_1_2,102,15
chr2-203111_203213,cPa566,1,1,203161,203161,cPa566,1,102,0
chr2-203346_203530,cPa118_cPa566,0.5,2,203478,203396,cPa118_cPa566,1_1,184,82
chr2-203692_203794,cPa118-cPa566-hybrid,1,1,203742,203742,cPa118-cPa566-hybrid,1,102,0
chr2-203980_204120,cPa434_cPa566,0.5,2,204068,204030,cPa434_cPa566,1_1,140,38
chr2-204186_204288,cPa118-cPa434-hybrid,1,1,204236,204236,cPa118-cPa434-hybrid,1,102,0
chr2-204829_204931,cPa125-cPa254-hybrid,1,1,204879,204879,cPa125-cPa254-hybrid,1,102,0
chr2-204992_205104,cPa15-cPa443-hybrid_cPa174_cPa443,0.333333333333333,3,205052,205042,cPa15-cPa443-hybrid_cPa174_cPa443,1_1_1,112,10
chr2-205220_205354,cPa174_cPa443,0.285714285714286,5,205302,205247,cPa118_cPa118-cPa174-hybrid_cPa174_cPa268_cPa443,1_1_2_1_2,134,55
chr2-206646_207008,cPa339,0.295275590551181,31,206992,206653,cPa118-cPa447-hybrid_cPa125-cPa447-hybrid_cPa248-cPa447-hybrid_cPa313-cPa339-hybrid_cPa313-cPa390-hybrid_cPa313-cPa447-hybrid_cPa339_cPa339-cPa264-hybrid_cPa339-cPa390-hybrid_cPa339-cPa447-hybrid_cPa339-unknown_cPa353_cPa353-cPa174-hybrid_cPa353-cPa339-hybrid_cPa353-cPa447-hybrid_cPa443-cPa447-hybrid_cPa444_cPa444-cPa118-hybrid_cPa444-cPa15-hybrid_cPa444-cPa163-hybrid_cPa444-cPa174-hybrid_cPa444-cPa229-hybrid_cPa444-cPa268-hybrid_cPa444-cPa339-hybrid_cPa444-cPa390-hybrid_cPa444-cPa447-hybrid_cPa444-cPa62-hybrid_cPa444-unknown_cPa447_cPa449-cPa353-hybrid_cPa449-cPa447-hybrid,1_1_1_1_1_1_75_1_3_7_1_1_1_1_1_1_1_2_1_1_2_1_1_14_17_56_6_5_47_1_1,362,339
chr2-20811886_20812015,cPa434,1,1,20811963,20811936,cPa434,2,129,27
chr2-20812070_20812172,cPa434,1,1,20812120,20812120,cPa434,1,102,0
chr2-2107825_2107927,cPa75,0.473684210526316,6,2107904,2107826,cPa62_cPa71-cPa62-hybrid_cPa71-cPa75-hybrid_cPa75_cPa75-cPa62-hybrid_HERV-W_repbase_HERV17_LTR17,1_5_1_9_2_1,102,78
chr2-21105763_21105865,cPa434,1,1,21105813,21105813,cPa434,1,102,0
chr2-21121652_21121754,cPa529,0.5,4,21121730,21121696,cPa14-unknown_cPa247_cPa529_cPa95-cPa14-hybrid,1_1_3_1,102,34
chr2-21127653_21128037,cPa529,0.204545454545455,29,21127986,21127665,cPa104_cPa104-cPa14-hybrid_cPa104-cPa18-hybrid_cPa104-cPa529-hybrid_cPa104-cPa541-hybrid_cPa104-unknown_cPa14_cPa14-cPa541-hybrid_cPa18_cPa18-cPa14-hybrid_cPa18-cPa220-hybrid_cPa18-cPa541-hybrid_cPa190-unknown_cPa247_cPa247-cPa529-hybrid_cPa4_cPa4-cPa14-hybrid_cPa4-cPa18-hybrid_cPa4-cPa541-hybrid_cPa4-unknown_cPa529_cPa529-cPa14-hybrid_cPa541_cPa545_cPa545-cPa14-hybrid_cPa545-cPa18-hybrid_cPa545-unknown_cPa95_cPa95-cPa541-hybrid,1_3_1_3_3_1_5_1_10_1_1_1_1_9_2_8_1_1_2_3_18_1_4_2_1_1_1_1_1,384,321
chr2-2125844_2125946,cPa323-cPa333-hybrid_cPa323-cPa568-hybrid_cPa333_cPa371-cPa568-hybrid,0.25,4,2125906,2125894,cPa323-cPa333-hybrid_cPa323-cPa568-hybrid_cPa333_cPa371-cPa568-hybrid,1_1_1_1,102,12
chr2-21271465_21271567,cPa450_cPa553,0.285714285714286,5,21271528,21271515,cPa223-cPa273-hybrid_cPa227_cPa345_cPa450_cPa553,1_1_1_2_2,102,13
chr2-21342436_21342538,cPa419,1,1,21342486,21342486,cPa419,1,102,0
chr2-21412098_21412200,cPa62,0.5,4,21412196,21412109,cPa62_cPa62-cPa113-hybrid_cPa62-unknown_cPa75,10_1_5_4,102,87
chr2-2156403_2156544,cPa62,0.868421052631579,2,2156527,2156409,cPa62_cPa75,33_5,141,118
chr2-2179981_2180083,cPa62-unknown,1,1,2180044,2180031,cPa62-unknown,2,102,13
chr2-220827_220929,cPa75,1,1,220877,220877,cPa75,1,102,0
chr2-2250683_2250785,cPa363_cPa456_cPa587-cPa117-hybrid,0.333333333333333,3,2250733,2250733,cPa363_cPa456_cPa587-cPa117-hybrid,1_1_1,102,0
chr2-22589353_22589455,cPa62,0.923076923076923,2,22589439,22589377,cPa62_cPa62-cPa75-hybrid,12_1,102,62
chr2-22651852_22651954,cPa15,0.8,2,22651902,22651890,cPa118_cPa15,1_4,102,12
chr2-2273902_2274004,cPa62,1,1,2273969,2273943,cPa62,26,102,26
chr2-22776797_22776900,cPa426,0.377049180327869,6,22776861,22776828,cPa293_cPa391_cPa391-cPa287-hybrid_cPa391-cPa293-hybrid_cPa426_cPa426-cPa293-hybrid,14_14_7_2_23_1,103,33
chr2-22900343_22900445,cPa452,0.60377358490566,8,22900435,22900391,cPa16_cPa176_cPa363_cPa363-cPa16-hybrid_cPa363-cPa176-hybrid_cPa452_cPa452-cPa176-hybrid_cPa71,2_2_11_1_1_32_1_3,102,44
chr2-22971207_22971309,cPa75,0.615384615384615,3,22971303,22971216,cPa546_cPa75_cPa75-unknown,1_8_4,102,87
chr2-22971393_22971495,cPa75,0.833333333333333,2,22971484,22971406,cPa75_cPa75-unknown,15_3,102,78
chr2-22973838_22973940,cPa138-unknown,1,1,22973888,22973888,cPa138-unknown,1,102,0
chr2-22984699_22984801,cPa183_cPa223_cPa363-cPa183-hybrid_cPa363-cPa223-hybrid_cPa363-cPa379-hybrid_cPa452-cPa183-hybrid,0.166666666666667,6,22984749,22984731,cPa183_cPa223_cPa363-cPa183-hybrid_cPa363-cPa223-hybrid_cPa363-cPa379-hybrid_cPa452-cPa183-hybrid,1_1_1_1_1_1,102,18
chr2-23009489_23009596,cPa118,0.565217391304348,3,23009555,23009532,cPa118_cPa15_cPa15-unknown,13_9_1,107,23
chr2-23018061_23018163,cPa62,1,1,23018111,23018082,cPa62,4,102,29
chr2-2306862_2306964,cPa62,1,1,2306962,2306863,cPa62,17,102,99
chr2-2308561_2308663,cPa62_cPa75-unknown_HERV-W_repbase_HERV17_LTR17_HERV-W_repbase_HERV17_LTR17-cPa62-hybrid_HERV-W_repbase_HERV17_LTR17-unknown,0.2,5,2308651,2308600,cPa62_cPa75-unknown_HERV-W_repbase_HERV17_LTR17_HERV-W_repbase_HERV17_LTR17-cPa62-hybrid_HERV-W_repbase_HERV17_LTR17-unknown,1_1_1_1_1,102,51
chr2-2322095_2322197,cPa62,1,1,2322145,2322125,cPa62,2,102,20
chr2-2349651_2349753,cPa174_cPa47-cPa254-hybrid,0.5,2,2349701,2349701,cPa174_cPa47-cPa254-hybrid,1_1,102,0
chr2-23582957_23583059,cPa456,0.444444444444444,5,23583030,23583002,cPa363_cPa363-cPa452-hybrid_cPa363-unknown_cPa456_cPa587-cPa452-hybrid,2_1_1_4_1,102,28
chr2-23583144_23583246,cPa419,1,1,23583194,23583194,cPa419,1,102,0
chr2-2360502_2360604,cPa358,0.5,3,2360586,2360525,cPa251_cPa358_cPa402-cPa308-hybrid,2_3_1,102,61
chr2-2361662_2361764,cPa62,1,1,2361717,2361661,cPa62,9,102,56
chr2-23646440_23646627,cPa257-cPa555-hybrid,0.333333333333333,5,23646575,23646490,cPa257_cPa257-cPa555-hybrid_cPa285-cPa546-hybrid_cPa285-cPa555-hybrid_cPa546,1_2_1_1_1,187,85
chr2-2394169_2394271,cPa176-HML1b_repbase_HERV-K14I_LTR14A-hybrid,1,1,2394219,2394219,cPa176-HML1b_repbase_HERV-K14I_LTR14A-hybrid,1,102,0
chr2-2400691_2400793,cPa308-unknown,1,1,2400741,2400741,cPa308-unknown,1,102,0
chr2-24248650_24248752,cPa452,0.454545454545455,6,24248713,24248654,cPa363_cPa363-cPa452-hybrid_cPa452_cPa452-unknown_cPa71_cPa71-unknown,11_2_20_1_9_1,102,59
chr2-24393544_24393646,cPa62,1,1,24393646,24393544,cPa62,13,102,102
chr2-24486155_24486267,cPa450,0.372549019607843,12,24486239,24486201,cPa199-cPa227-hybrid_cPa199-cPa273-hybrid_cPa199-cPa450-hybrid_cPa199-cPa542-hybrid_cPa199-cPa553-hybrid_cPa199-unknown_cPa227_cPa273_cPa450_cPa450-cPa273-hybrid_cPa553_cPa553-cPa273-hybrid,1_8_3_7_3_1_1_1_19_1_4_2,112,38
chr2-24695265_24695378,cPa118_cPa15,0.285714285714286,5,24695344,24695267,cPa118_cPa15_cPa248-cPa443-hybrid_cPa248-unknown_cPa419,2_2_1_1_1,113,77
chr2-24956071_24956173,cPa75,0.5,4,24956149,24956100,cPa293_cPa62_cPa75_cPa75-cPa62-hybrid,1_1_4_2,102,49
chr2-2510425_2510527,cPa264_cPa419,0.5,2,2510511,2510475,cPa264_cPa419,1_1,102,36
chr2-2510569_2510671,cPa434-cPa566-hybrid_cPa566,0.5,2,2510619,2510600,cPa434-cPa566-hybrid_cPa566,1_1,102,19
chr2-25176974_25177088,cPa452,0.363636363636364,4,25177082,25177016,cPa363_cPa452_cPa71_HERV-W_repbase_HERV17_LTR17-cPa176-hybrid,3_4_3_1,114,66
chr2-25177217_25177319,cPa75,0.714285714285714,3,25177307,25177267,cPa363-cPa75-hybrid_cPa452_cPa75,1_1_5,102,40
chr2-25178078_25178274,cPa75,1,1,25178266,25178120,cPa75,13,196,146
chr2-25208645_25208747,cPa62,1,1,25208745,25208695,cPa62,3,102,50
chr2-25222384_25222486,cPa167,1,1,25222434,25222420,cPa167,6,102,14
chr2-25437407_25437524,cPa75,0.75,2,25437472,25437447,cPa62-cPa75-hybrid_cPa75,1_3,117,25
chr2-25437632_25437734,cPa62_cPa75,0.363636363636364,3,25437731,25437634,cPa62_cPa62-cPa75-hybrid_cPa75,4_3_4,102,97
chr2-25437747_25437870,cPa62,0.529411764705882,4,25437837,25437756,cPa62_cPa62-cPa75-hybrid_cPa62-unknown_cPa75,9_1_2_5,123,81
chr2-25703646_25703748,cPa75,1,1,25703696,25703696,cPa75,1,102,0
chr2-25703759_25703861,cPa75,1,1,25703827,25703761,cPa75,7,102,66
chr2-25847711_25847835,HERV-W_repbase_HERV17_LTR17,0.75,4,25847791,25847723,cPa71_cPa75_HERV-W_repbase_HERV17_LTR17_HERV-W_repbase_HERV17_LTR17-unknown,1_1_9_1,124,68
chr2-25848398_25848510,cPa104,0.333333333333333,8,25848464,25848448,cPa104_cPa104-cPa220-hybrid_cPa190_cPa190-cPa219-hybrid_cPa190-cPa258-hybrid_cPa219_cPa220_cPa258,4_1_1_2_1_1_1_1,112,16
chr2-25951307_25951434,cPa456,0.472727272727273,10,25951428,25951325,cPa363_cPa363-cPa117-hybrid_cPa363-cPa452-hybrid_cPa363-unknown_cPa452_cPa456_cPa456-cPa117-hybrid_cPa456-cPa452-hybrid_cPa587-cPa117-hybrid_cPa587-cPa452-hybrid,10_1_4_1_6_26_2_3_1_1,127,103
chr2-25978197_25978299,cPa339,0.363636363636364,6,25978247,25978231,cPa339_cPa444-cPa390-hybrid_cPa444-cPa447-hybrid_cPa444-cPa62-hybrid_cPa444-unknown_cPa447,4_1_1_1_1_3,102,16
chr2-26037081_26037190,cPa452,0.44047619047619,9,26037160,26037123,cPa16_cPa176-cPa327-hybrid_cPa363_cPa363-cPa327-hybrid_cPa363-unknown_cPa452_cPa71_cPa71-cPa327-hybrid_cPa71-unknown,2_6_5_4_1_37_22_6_1,109,37
chr2-2613497_2613599,cPa223,0.714285714285714,5,2613561,2613528,cPa223_cPa223-unknown_cPa229_cPa229-cPa223-hybrid_cPa449,10_1_1_1_1,102,33
chr2-26140917_26141033,cPa527,0.407407407407407,7,26140989,26140957,cPa472_cPa472-cPa575-hybrid_cPa527_cPa527-cPa472-hybrid_cPa527-cPa492-hybrid_cPa527-cPa572-hybrid_cPa527-cPa575-hybrid,7_3_11_1_1_2_2,116,32
chr2-26142582_26142684,cPa492,1,1,26142632,26142599,cPa492,9,102,33
chr2-26163135_26163237,cPa4_cPa541,0.470588235294118,3,26163214,26163177,cPa18_cPa4_cPa541,1_8_8,102,37
chr2-26172232_26172334,cPa14-cPa18-hybrid_cPa4,0.4,3,26172289,26172282,cPa14-cPa18-hybrid_cPa4_cPa541,2_2_1,102,7
chr2-26230874_26230976,cPa298-unknown,1,1,26230924,26230924,cPa298-unknown,1,102,0
chr2-2625603_2625792,cPa62,0.955882352941177,2,2625757,2625644,cPa62_cPa75,65_3,189,113
chr2-2626193_2626295,cPa62,0.75,2,2626259,2626243,cPa62_cPa75,3_1,102,16
chr2-262727_262848,cPa75,1,1,262796,262777,cPa75,3,121,19
chr2-263145_263278,cPa75,1,1,263226,263195,cPa75,5,133,31
chr2-263281_263406,cPa75,1,1,263354,263331,cPa75,4,125,23
chr2-263411_263750,cPa75,1,1,263698,263461,cPa75,13,339,237
chr2-263805_263907,cPa75,1,1,263855,263855,cPa75,1,102,0
chr2-263919_264021,cPa75,1,1,263969,263969,cPa75,1,102,0
chr2-26485968_26486080,cPa583,0.525345622119816,5,26486077,26486013,cPa251_cPa358_cPa358-cPa251-hybrid_cPa358-unknown_cPa583,9_69_16_9_114,112,64
chr2-26600001_26600103,cPa14_FeFV_NC001871-cPa541-hybrid,0.5,2,26600051,26600051,cPa14_FeFV_NC001871-cPa541-hybrid,1_1,102,0
chr2-26623879_26623981,cPa363_cPa452,0.409090909090909,3,26623949,26623878,cPa363_cPa452_cPa71,9_9_4,102,71
chr2-26689781_26689885,cPa62,0.689655172413793,2,26689837,26689790,cPa62_cPa62-unknown,20_9,104,47
chr2-26690236_26690519,cPa529,0.444444444444444,4,26690467,26690286,cPa247_cPa247-cPa14-hybrid_cPa247-cPa4-hybrid_cPa529,3_1_1_4,283,181
chr2-26788075_26788177,cPa75,0.571428571428571,4,26788150,26788089,cPa62-cPa75-hybrid_cPa62-HERV-W_repbase_HERV17_LTR17-hybrid_cPa62-unknown_cPa75,3_1_2_8,102,61
chr2-26788307_26788409,cPa75,1,1,26788396,26788357,cPa75,4,102,39
chr2-26788455_26788586,cPa75,0.625,3,26788580,26788474,cPa62_cPa62-cPa75-hybrid_cPa75,2_1_5,131,106
chr2-26788614_26788775,cPa75,0.5,5,26788766,26788659,cPa62-cPa75-hybrid_cPa62-HERV-W_repbase_HERV17_LTR17-hybrid_cPa62-unknown_cPa75_cPa75-unknown,2_2_5_10_1,161,107
chr2-26788795_26789021,cPa75,0.583333333333333,5,26788969,26788845,cPa62_cPa62-cPa75-hybrid_cPa62-unknown_cPa75_cPa75-HERV-W_repbase_HERV17_LTR17-hybrid,1_1_2_7_1,226,124
chr2-26882082_26882184,cPa452,0.352941176470588,8,26882184,26882083,cPa101_cPa142_cPa363_cPa363-cPa452-hybrid_cPa363-unknown_cPa452_cPa582-cPa101-hybrid_cPa71,1_5_10_1_1_12_1_3,102,101
chr2-26975394_26975509,cPa118_cPa15,0.333333333333333,4,26975458,26975444,cPa118_cPa15_cPa248-unknown_cPa443,4_4_1_3,115,14
chr2-27036699_27036801,cPa260,0.833333333333333,2,27036749,27036709,cPa260_EIAV_NC001450-cPa260-hybrid,5_1,102,40
chr2-27165679_27165781,cPa62,0.666666666666667,2,27165729,27165715,cPa419_cPa62,1_2,102,14
chr2-27216492_27216605,cPa452,0.324074074074074,10,27216602,27216514,cPa117_cPa117-cPa452-hybrid_cPa117-cPa456-hybrid_cPa117-unknown_cPa363_cPa363-unknown_cPa452_cPa452-unknown_cPa456_cPa456-unknown,47_2_4_5_18_2_70_1_64_3,113,88
chr2-27394556_27394658,cPa363,1,1,27394606,27394606,cPa363,1,102,0
chr2-27450011_27450115,cPa563,0.333333333333333,5,27450063,27450018,cPa131-cPa478-hybrid_cPa438-cPa478-hybrid_cPa438-cPa479-hybrid_cPa526-cPa479-hybrid_cPa563,1_1_1_1_2,104,45
chr2-27503188_27503290,cPa363_cPa456,0.3,6,27503250,27503236,cPa117-cPa563-hybrid_cPa363_cPa452-cPa563-hybrid_cPa452-cPa587-hybrid_cPa452-unknown_cPa456,1_3_1_1_1_3,102,14
chr2-27614829_27615010,cPa62,1,1,27614958,27614864,cPa62,63,181,94
chr2-27703386_27703517,cPa62,1,1,27703465,27703436,cPa62,10,131,29
chr2-27703533_27703710,cPa62,0.882352941176471,3,27703659,27703550,cPa264-cPa75-hybrid_cPa285_cPa62,1_1_15,177,109
chr2-28003205_28003314,cPa174_cPa254_cPa425,0.272727272727273,5,28003264,28003245,cPa174_cPa254_cPa404-unknown_cPa425_cPa47,3_3_1_3_1,109,19
chr2-28038876_28038980,cPa302,0.5,3,28038928,28038924,cPa150_cPa190-cPa255-hybrid_cPa302,1_1_2,104,4
chr2-28074114_28074216,cPa62,0.972972972972973,2,28074212,28074117,cPa62_cPa62-unknown,36_1,102,95
chr2-28185986_28186088,cPa62,1,1,28186036,28186036,cPa62,1,102,0
chr2-28394125_28394227,cPa260-cPa293-hybrid,1,1,28394175,28394175,cPa260-cPa293-hybrid,1,102,0
chr2-28394244_28394346,cPa260,1,1,28394294,28394294,cPa260,1,102,0
chr2-2844998_2845100,cPa113_cPa113-unknown_cPa67-unknown_cPa75,0.25,4,2845093,2845017,cPa113_cPa113-unknown_cPa67-unknown_cPa75,1_1_1_1,102,76
chr2-28484804_28484906,cPa583,0.5,5,28484883,28484812,cPa251_cPa358_cPa358-cPa251-hybrid_cPa358-unknown_cPa583,3_9_1_3_16,102,71
chr2-28557238_28557340,cPa15,1,1,28557288,28557288,cPa15,1,102,0
chr2-28718269_28718371,cPa270,0.666666666666667,2,28718321,28718309,cPa270_cPa486,4_2,102,12
chr2-288749_288933,cPa75,1,1,288881,288799,cPa75,4,184,82
chr2-288968_289070,cPa75,1,1,289018,289018,cPa75,1,102,0
chr2-28923373_28923475,cPa199_cPa199-cPa223-hybrid_cPa339,0.333333333333333,3,28923452,28923408,cPa199_cPa199-cPa223-hybrid_cPa339,1_1_1,102,44
chr2-289349_289451,cPa75,1,1,289399,289399,cPa75,1,102,0
chr2-289494_289596,cPa75,1,1,289544,289544,cPa75,1,102,0
chr2-29080421_29080523,cPa62,0.888888888888889,2,29080519,29080468,cPa62_cPa62-unknown,16_2,102,51
chr2-29108749_29108863,cPa15,0.5,4,29108811,29108789,cPa118_cPa15_cPa248-unknown_cPa443,1_3_1_1,114,22
chr2-29260587_29260802,cPa223,0.570652173913043,18,29260796,29260586,cPa223_cPa327-cPa183-hybrid_cPa379_cPa419_cPa424-cPa16-hybrid_cPa424-cPa183-hybrid_cPa424-cPa223-hybrid_cPa424-cPa327-hybrid_cPa424-cPa363-hybrid_cPa424-cPa379-hybrid_cPa424-cPa452-hybrid_cPa424-cPa71-hybrid_cPa424-unknown_cPa446-cPa16-hybrid_cPa446-cPa223-hybrid_cPa446-cPa363-hybrid_cPa446-cPa71-hybrid_cPa446-unknown,105_1_1_1_9_4_9_1_15_1_4_2_23_3_1_2_1_1,215,210
chr2-29439205_29439344,cPa15,0.466666666666667,5,29439303,29439255,cPa118_cPa15_cPa248-cPa118-hybrid_cPa248-cPa419-hybrid_cPa443-cPa419-hybrid,4_7_2_1_1,139,48
chr2-29456797_29456899,cPa254_cPa425_cPa47-cPa174-hybrid,0.285714285714286,4,29456857,29456845,cPa254_cPa425_cPa47_cPa47-cPa174-hybrid,2_2_1_2,102,12
chr2-294721_294823,cPa75,1,1,294771,294771,cPa75,1,102,0
chr2-29475705_29475911,cPa15,0.45,15,29475877,29475716,cPa118_cPa118-cPa140-hybrid_cPa118-cPa15-hybrid_cPa118-cPa419-hybrid_cPa118-cPa443-hybrid_cPa118-unknown_cPa125-cPa118-hybrid_cPa125-cPa443-hybrid_cPa125-unknown_cPa15_cPa254_cPa268-cPa443-hybrid_cPa443_cPa47_cPa47-cPa174-hybrid,9_3_2_1_3_1_2_2_2_36_4_1_11_2_1,206,161
chr2-29617407_29617509,cPa419,1,1,29617457,29617457,cPa419,1,102,0
chr2-29850281_29850385,HERV-W_repbase_HERV17_LTR17,0.964912280701754,3,29850383,29850280,cPa75-HERV-W_repbase_HERV17_LTR17-hybrid_HERV-W_repbase_HERV17_LTR17_HERV-XA34_repbase_HERVFH21I_LTR21A,1_55_1,104,103
chr2-3000491_3000593,cPa285_cPa293_cPa62_cPa62-unknown,0.25,4,3000577,3000541,cPa285_cPa293_cPa62_cPa62-unknown,1_1_1_1,102,36
chr2-3000655_3000767,cPa62,0.5,3,3000761,3000662,cPa285_cPa293_cPa62,2_2_4,112,99
chr2-30335351_30335453,cPa104_cPa220,0.5,2,30335453,30335401,cPa104_cPa220,1_1,102,52
chr2-30371149_30371251,cPa273-cPa199-hybrid_cPa450,0.5,2,30371199,30371199,cPa273-cPa199-hybrid_cPa450,1_1,102,0
chr2-30440013_30440119,cPa75-unknown,1,1,30440067,30440063,cPa75-unknown,2,106,4
chr2-30440229_30440337,cPa75-unknown,1,1,30440285,30440279,cPa75-unknown,2,108,6
chr2-30440540_30440642,cPa75-CAEV_NC001463-hybrid,1,1,30440590,30440590,cPa75-CAEV_NC001463-hybrid,1,102,0
chr2-30549765_30549867,cPa62,0.91304347826087,3,30549820,30549802,cPa419_cPa62_cPa62-unknown,1_21_1,102,18
chr2-30671564_30671666,cPa62,1,1,30671614,30671570,cPa62,3,102,44
chr2-30672202_30672304,cPa62,1,1,30672252,30672252,cPa62,1,102,0
chr2-31219675_31219777,cPa62,0.5,8,31219758,31219700,cPa285_cPa402_cPa62_cPa62-cPa285-hybrid_cPa62-cPa75-hybrid_cPa62-unknown_cPa75_HML2_Pheonix,1_3_37_2_9_4_17_1,102,58
chr2-31344792_31344899,cPa456,0.4,6,31344888,31344806,cPa363_cPa456_cPa456-cPa117-hybrid_cPa587-cPa117-hybrid_cPa587-cPa363-hybrid_cPa587-cPa452-hybrid,6_8_2_2_1_1,107,82
chr2-31350630_31350732,cPa201-cPa511-hybrid,1,1,31350680,31350680,cPa201-cPa511-hybrid,1,102,0
chr2-3138926_3139028,cPa62,1,1,3138978,3138935,cPa62,19,102,43
chr2-31508959_31509071,cPa254,0.375,5,31509027,31509003,cPa174_cPa254_cPa254-cPa425-hybrid_cPa47-cPa254-hybrid_cPa47-cPa404-hybrid,2_3_1_1_1,112,24
chr2-31595213_31595315,HERV-W_repbase_HERV17_LTR17,0.444444444444444,9,31595309,31595212,cPa62-cPa75-hybrid_cPa62-HERV-W_repbase_HERV17_LTR17-hybrid_cPa62-KoRV_AF151794-hybrid_cPa62-unknown_cPa75_cPa75-HERV-W_repbase_HERV17_LTR17-hybrid_cPa75-unknown_HERV-W_repbase_HERV17_LTR17_S71_repbase_HERVS71_LTR6A,5_14_2_12_14_1_1_40_1,102,97
chr2-31615230_31615332,cPa285_cPa62,0.444444444444444,3,31615327,31615252,cPa285_cPa293_cPa62,4_1_4,102,75
chr2-31615339_31615441,cPa62,0.705882352941177,5,31615438,31615358,cPa285_cPa285-cPa62-hybrid_cPa62_cPa62-cPa285-hybrid_cPa62-cPa419-hybrid,2_1_12_1_1,102,80
chr2-31865986_31866088,HERV-W_repbase_HERV17_LTR17,1,1,31866036,31865995,HERV-W_repbase_HERV17_LTR17,3,102,41
chr2-31881443_31881586,cPa434,1,1,31881534,31881479,cPa434,3,143,55
chr2-31882348_31882450,cPa434,0.8,2,31882440,31882398,cPa142_cPa434,1_4,102,42
chr2-31882490_31882628,cPa434,0.882352941176471,2,31882579,31882493,cPa142_cPa434,2_15,138,86
chr2-31882651_31882898,cPa434,0.858208955223881,3,31882898,31882701,cPa142_cPa357_cPa434,18_1_115,247,197
chr2-31884645_31884747,cPa434,0.923076923076923,2,31884695,31884648,cPa434_cPa67-unknown,12_1,102,47
chr2-31896948_31897050,cPa434,1,1,31896998,31896998,cPa434,1,102,0
chr2-31902545_31902651,cPa434,1,1,31902606,31902592,cPa434,6,106,14
chr2-31908774_31908901,cPa434,0.8,2,31908852,31908816,cPa434_cPa434-cPa67-hybrid,4_1,127,36
chr2-31909057_31909193,cPa434,1,1,31909141,31909092,cPa434,24,136,49
chr2-31909198_31909300,cPa434,1,1,31909248,31909248,cPa434,1,102,0
chr2-31909339_31909455,cPa434,1,1,31909425,31909371,cPa434,12,116,54
chr2-31909474_31909576,cPa434,1,1,31909559,31909524,cPa434,4,102,35
chr2-31909602_31909723,cPa434,1,1,31909683,31909623,cPa434,28,121,60
chr2-31910369_31910605,cPa434,0.943181818181818,4,31910600,31910381,cPa434_cPa434-HERV-E_repbase_HERVE_LTR2-hybrid_cPa67-HERV-E_repbase_HERVE_LTR2-hybrid_cPa67-unknown,83_3_1_1,236,219
chr2-31911169_31911323,cPa434,1,1,31911271,31911219,cPa434,3,154,52
chr2-32288665_32288767,cPa15,0.666666666666667,4,32288716,32288700,cPa118_cPa118-unknown_cPa15_cPa268,1_3_12_2,102,16
chr2-32555617_32555719,cPa117-cPa587-hybrid,0.666666666666667,2,32555702,32555667,cPa117-cPa587-hybrid_cPa456,2_1,102,35
chr2-3263829_3263931,cPa62,0.95,2,3263924,3263879,cPa62_cPa62-unknown,19_1,102,45
chr2-32810606_32810708,cPa568,0.274390243902439,11,32810708,32810610,cPa333_cPa333-cPa15-hybrid_cPa333-cPa50-hybrid_cPa333-cPa568-hybrid_cPa333-unknown_cPa371-cPa50-hybrid_cPa371-cPa568-hybrid_cPa371-unknown_cPa50_cPa568_cPa568-cPa50-hybrid,35_1_31_4_6_20_2_2_16_45_2,102,98
chr2-32878186_32878288,cPa391,0.375,5,32878252,32878236,cPa287_cPa293_cPa391_cPa426_cPa426-cPa287-hybrid,1_2_3_1_1,102,16
chr2-32923824_32923926,cPa62,0.888888888888889,5,32923919,32923874,cPa254_cPa254-cPa75-hybrid_cPa254-unknown_cPa62_cPa62-unknown,1_1_1_32_1,102,45
chr2-3301472_3301574,HERV-W_repbase_HERV17_LTR17-unknown,0.5,3,3301559,3301512,cPa67-unknown_HERV-W_repbase_HERV17_LTR17_HERV-W_repbase_HERV17_LTR17-unknown,1_3_4,102,47
chr2-333699_333892,cPa75,1,1,333840,333749,cPa75,2,193,91
chr2-334274_334376,cPa75,1,1,334324,334324,cPa75,1,102,0
chr2-342494_342617,cPa177-cPa75-hybrid,1,1,342568,342544,cPa177-cPa75-hybrid,5,123,24
chr2-34267099_34267216,cPa15,0.545454545454545,4,34267164,34267132,cPa118_cPa118-cPa443-hybrid_cPa118-unknown_cPa15,3_1_1_6,117,32
chr2-342793_342987,cPa177-cPa75-hybrid,0.571428571428571,2,342935,342843,cPa177-cPa75-hybrid_cPa75,4_3,194,92
chr2-34417015_34417117,cPa118_cPa15,0.5,2,34417065,34417065,cPa118_cPa15,1_1,102,0
chr2-347340_347458,cPa75,1,1,347406,347390,cPa75,2,118,16
chr2-348025_348157,cPa75,1,1,348105,348075,cPa75,4,132,30
chr2-348246_348348,cPa75,1,1,348342,348296,cPa75,2,102,46
chr2-3492875_3492977,cPa75,0.6,2,3492925,3492904,cPa62-unknown_cPa75,2_3,102,21
chr2-34932428_34932536,cPa456,0.567567567567568,6,34932498,34932444,cPa117-cPa587-hybrid_cPa363_cPa363-cPa587-hybrid_cPa452-cPa363-hybrid_cPa452-cPa587-hybrid_cPa456,6_4_2_2_2_21,108,54
chr2-35324050_35324152,cPa363,0.75,3,35324151,35324081,cPa363_cPa450-cPa456-hybrid_cPa456,6_1_1,102,70
chr2-35676934_35677036,cPa75,0.5,3,35677027,35676951,cPa62_cPa75_cPa75-KWERV_GQ222416-hybrid,6_7_1,102,76
chr2-35677171_35677323,cPa75,0.888888888888889,2,35677315,35677218,cPa62_cPa75,2_16,152,97
chr2-35753668_35753770,cPa62,1,1,35753725,35753718,cPa62,2,102,7
chr2-35819540_35819669,cPa363_cPa452-unknown_cPa456-unknown,0.333333333333333,3,35819617,35819590,cPa363_cPa452-unknown_cPa456-unknown,1_1_1,129,27
chr2-3597976_3598215,cPa456,0.521739130434783,7,3598163,3597981,cPa363_cPa456_cPa456-cPa452-hybrid_cPa587-cPa117-hybrid_cPa587-cPa205-hybrid_cPa587-cPa452-hybrid_REV_NC006934-cPa452-hybrid,1_12_1_1_2_3_3,239,182
chr2-3612072_3612184,cPa62,0.930232558139535,2,3612157,3612103,cPa62_cPa62-unknown,40_3,112,54
chr2-3613685_3613843,cPa62,1,1,3613817,3613735,cPa62,27,158,82
chr2-36210612_36210714,cPa118,0.571428571428571,3,36210667,36210647,cPa118_cPa15_cPa15-cPa248-hybrid,4_2_1,102,20
chr2-362245_362347,cPa75,1,1,362295,362295,cPa75,1,102,0
chr2-362442_362747,cPa75,1,1,362695,362444,cPa75,21,305,251
chr2-362801_362947,cPa75,1,1,362895,362851,cPa75,4,146,44
chr2-363000_363199,cPa75,1,1,363147,363050,cPa75,5,199,97
chr2-36445577_36445703,cPa452,0.5,3,36445682,36445616,cPa363_cPa452_cPa587,5_7_2,126,66
chr2-36445765_36445957,cPa452,0.444444444444444,7,36445925,36445776,cPa363_cPa363-cPa452-hybrid_cPa419_cPa452_cPa452-unknown_cPa456-cPa452-hybrid_cPa587,4_1_1_16_1_1_12,192,149
chr2-36456564_36456677,cPa363_cPa456,0.5,2,36456625,36456614,cPa363_cPa456,1_1,113,11
chr2-36527267_36527380,cPa118_cPa15,0.375,4,36527329,36527317,cPa118_cPa15_cPa248-unknown_cPa268-unknown,3_3_1_1,113,12
chr2-367007_367126,cPa75,1,1,367074,367057,cPa75,2,119,17
chr2-367400_367522,cPa75,1,1,367470,367450,cPa75,2,122,20
chr2-36771051_36771374,cPa254,0.295454545454545,7,36771322,36771101,cPa174_cPa254_cPa425_cPa47_cPa47-cPa174-hybrid_cPa47-cPa254-hybrid_cPa47-cPa425-hybrid,1_13_3_9_10_7_1,323,221
chr2-36806519_36806621,cPa391_cPa419,0.5,2,36806606,36806569,cPa391_cPa419,1_1,102,37
chr2-3703283_3703385,cPa62,0.9,3,3703350,3703327,cPa62_cPa62-unknown_cPa75-cPa254-hybrid,18_1_1,102,23
chr2-37263248_37263375,cPa131,0.333333333333333,5,37263323,37263268,cPa131_cPa255-cPa246-hybrid_cPa255-cPa438-hybrid_cPa478_cPa479,2_1_1_1_1,127,55
chr2-372759_372861,cPa404-cPa174-hybrid,1,1,372809,372809,cPa404-cPa174-hybrid,1,102,0
chr2-3747987_3748093,cPa117-cPa587-hybrid_cPa452-cPa587-hybrid_cPa456,0.333333333333333,3,3748041,3748030,cPa117-cPa587-hybrid_cPa452-cPa587-hybrid_cPa456,1_1_1,106,11
chr2-3791506_3791608,cPa113,0.636363636363636,4,3791600,3791556,cPa113_cPa75-cPa113-hybrid_cPa75-cPa67-hybrid_cPa75-unknown,7_1_2_1,102,44
chr2-38270841_38270944,cPa452,0.4,4,38270903,38270891,cPa363_cPa363-unknown_cPa452_cPa71,1_1_2_1,103,12
chr2-38327274_38327376,HERV-W_repbase_HERV17_LTR17_HERV-W_repbase_HERV17_LTR17-cPa62-hybrid,0.5,2,38327325,38327324,HERV-W_repbase_HERV17_LTR17_HERV-W_repbase_HERV17_LTR17-cPa62-hybrid,1_1,102,1
chr2-38327434_38327536,cPa75,1,1,38327484,38327484,cPa75,1,102,0
chr2-38363884_38364100,cPa117-cPa587-hybrid_cPa363_cPa456,0.285714285714286,4,38364048,38363934,cPa117-cPa587-hybrid_cPa363_cPa452-cPa587-hybrid_cPa456,2_2_1_2,216,114
chr2-38539244_38539346,cPa75,0.5,3,38539342,38539245,cPa62-cPa75-hybrid_cPa62-unknown_cPa75,3_1_4,102,97
chr2-3857924_3858065,cPa75-cPa62-hybrid,0.465116279069767,5,3858058,3857952,cPa62_cPa75_cPa75-cPa62-hybrid_cPa75-unknown_HERV-W_repbase_HERV17_LTR17-cPa62-hybrid,3_17_20_2_1,141,106
chr2-3876256_3876372,cPa363,0.25,7,3876320,3876262,cPa176_cPa254-cPa223-hybrid_cPa254-cPa363-hybrid_cPa363_cPa419_cPa452_cPa71,1_1_1_2_1_1_1,116,58
chr2-38905690_38905792,cPa62,1,1,38905751,38905722,cPa62,6,102,29
chr2-3900799_3900901,cPa75,1,1,3900849,3900849,cPa75,1,102,0
chr2-39029941_39030043,cPa15,0.571428571428571,2,39030003,39029991,cPa118_cPa15,3_4,102,12
chr2-390998_391100,cPa75,1,1,391048,391048,cPa75,1,102,0
chr2-39126346_39126448,cPa62,0.5,5,39126444,39126349,cPa293_cPa419_cPa62_cPa75_cPa75-unknown,1_1_8_4_2,102,95
chr2-39128322_39128424,cPa62,1,1,39128378,39128354,cPa62,7,102,24
chr2-39974525_39974634,cPa363_cPa452-cPa587-hybrid_cPa456,0.333333333333333,3,39974582,39974575,cPa363_cPa452-cPa587-hybrid_cPa456,1_1_1,109,7
chr2-40011690_40011805,cPa452,0.521739130434783,3,40011794,40011715,cPa363_cPa452_cPa71,7_12_4,115,79
chr2-40017009_40017111,HERV-W_repbase_HERV17_LTR17,0.4,4,40017060,40017040,cPa62-cPa75-hybrid_cPa75_cPa75-unknown_HERV-W_repbase_HERV17_LTR17,1_1_1_2,102,20
chr2-4003348_4003450,cPa62,1,1,4003418,4003396,cPa62,28,102,22
chr2-40387346_40387461,cPa4-cPa529-hybrid,0.5,3,40387430,40387396,cPa190-cPa529-hybrid_cPa4-cPa529-hybrid_cPa541-cPa529-hybrid,1_2_1,115,34
chr2-404156_404258,cPa201,0.857142857142857,2,404220,404170,cPa109_cPa201,1_6,102,50
chr2-40540230_40540332,cPa15,0.666666666666667,3,40540297,40540280,cPa118_cPa118-cPa15-hybrid_cPa15,1_1_4,102,17
chr2-40561736_40561838,cPa241,1,1,40561786,40561775,cPa241,3,102,11
chr2-40583735_40583837,cPa75,0.444444444444444,3,40583804,40583785,cPa433_cPa521_cPa75,2_3_4,102,19
chr2-40722892_40723006,cPa104,0.4,5,40723000,40722942,cPa104_cPa104-cPa219-hybrid_cPa190_cPa190-cPa219-hybrid_cPa220,8_3_3_5_1,114,58
chr2-40753_40855,cPa75,1,1,40803,40803,cPa75,1,102,0
chr2-40877_40979,cPa75,1,1,40927,40927,cPa75,1,102,0
chr2-40895095_40895203,cPa545,0.375,4,40895151,40895095,cPa247_cPa247-cPa14-hybrid_cPa545_cPa95,2_1_3_2,108,56
chr2-409639_409863,cPa75-unknown,0.55,2,409849,409645,cPa75_cPa75-unknown,9_11,224,204
chr2-40975994_40976107,cPa450,0.571428571428571,4,40976055,40976039,cPa227-cPa345-hybrid_cPa450_cPa450-cPa482-hybrid_cPa553,1_4_1_1,113,16
chr2-40981433_40981536,cPa142,1,1,40981484,40981479,cPa142,3,103,5
chr2-40984_41229,cPa75,1,1,41177,41034,cPa75,8,245,143
chr2-41024544_41024646,cPa127,0.333333333333333,5,41024615,41024591,cPa127_cPa290_cPa290-cPa241-hybrid_cPa290-cPa530-hybrid_cPa540,2_1_1_1_1,102,24
chr2-41287_41422,cPa75,1,1,41370,41337,cPa75,2,135,33
chr2-41306514_41306616,cPa363_cPa456_cPa456-cPa117-hybrid_cPa587-cPa117-hybrid,0.1875,8,41306606,41306517,cPa363_cPa452_cPa456_cPa456-cPa117-hybrid_cPa456-cPa452-hybrid_cPa587-cPa117-hybrid_cPa587-cPa452-hybrid_cPa75-cPa117-hybrid,3_1_3_3_1_3_1_1,102,89
chr2-41539_41705,cPa75,1,1,41653,41589,cPa75,2,166,64
chr2-41562785_41562899,cPa391,0.375,4,41562848,41562834,cPa287-cPa426-hybrid_cPa293_cPa293-cPa426-hybrid_cPa391,2_2_1_3,114,14
chr2-41598349_41598451,cPa419,1,1,41598399,41598399,cPa419,1,102,0
chr2-41600974_41601092,cPa452,0.346938775510204,7,41601061,41600979,cPa327-cPa176-hybrid_cPa363_cPa363-cPa176-hybrid_cPa363-unknown_cPa452_cPa71_cPa71-cPa452-hybrid,1_14_1_1_17_13_2,118,82
chr2-42226976_42227078,cPa62,1,1,42227061,42227026,cPa62,3,102,35
chr2-42850832_42850934,cPa391,0.555555555555556,3,42850891,42850872,cPa293_cPa391_cPa391-cPa426-hybrid,3_5_1,102,19
chr2-42882801_42882920,cPa62,0.736842105263158,4,42882879,42882827,cPa285_cPa285-cPa75-hybrid_cPa62_cPa75,2_1_28_7,119,52
chr2-4306545_4306667,cPa293,0.5,11,4306655,4306560,cPa293_cPa293-unknown_cPa546_cPa75-cPa293-hybrid_cPa75-unknown_HERV-W_repbase_HERV17_LTR17_HIV2_NC001722_HIV2_NC001722-cPa293-hybrid_MER52A_repbase_MER52AI_MER52A-cPa566-hybrid_PERV_AJ293656_PERV_AJ293656-unknown,20_1_1_3_2_2_4_1_1_3_2,122,95
chr2-43159853_43159955,cPa62,0.785714285714286,3,43159927,43159885,cPa62_cPa62-cPa285-hybrid_cPa62-unknown,11_1_2,102,42
chr2-4335169_4335282,cPa183-cPa223-hybrid_cPa223_cPa363-cPa223-hybrid_cPa363-cPa424-hybrid_cPa452-cPa424-hybrid_cPa71-cPa223-hybrid,0.166666666666667,6,4335252,4335218,cPa183-cPa223-hybrid_cPa223_cPa363-cPa223-hybrid_cPa363-cPa424-hybrid_cPa452-cPa424-hybrid_cPa71-cPa223-hybrid,1_1_1_1_1_1,113,34
chr2-433779_433881,cPa75,1,1,433829,433829,cPa75,1,102,0
chr2-43407238_43407341,CAEV_NC001463,0.846153846153846,2,43407296,43407279,CAEV_NC001463_cPa62-CAEV_NC001463-hybrid,11_2,103,17
chr2-434600_434809,cPa75,1,1,434757,434650,cPa75,13,209,107
chr2-43602020_43602222,cPa75,0.377777777777778,6,43602173,43602063,cPa113_cPa113-cPa62-hybrid_cPa113-cPa75-hybrid_cPa113-unknown_cPa67-cPa75-hybrid_cPa75,12_1_11_3_1_17,202,110
chr2-43602235_43602337,cPa113_cPa75,0.5,2,43602285,43602285,cPa113_cPa75,1_1,102,0
chr2-43833537_43833639,cPa251,1,1,43833606,43833587,cPa251,3,102,19
chr2-43844324_43844426,cPa174_cPa425,0.4,3,43844378,43844370,cPa174_cPa254_cPa425,2_1_2,102,8
chr2-44408211_44408364,cPa62,0.966101694915254,3,44408336,44408252,cPa285_cPa62_cPa62-unknown,1_57_1,153,84
chr2-44425765_44425867,cPa456,0.7,3,44425838,44425778,cPa363_cPa456_cPa456-cPa452-hybrid,2_7_1,102,60
chr2-44465777_44465879,cPa392,1,1,44465861,44465827,cPa392,5,102,34
chr2-44474502_44474604,cPa392,1,1,44474579,44474506,cPa392,3,102,73
chr2-44474663_44474765,cPa392,1,1,44474713,44474713,cPa392,1,102,0
chr2-44474940_44475084,cPa392,1,1,44475032,44474969,cPa392,5,144,63
chr2-44615812_44615914,cPa456,0.442622950819672,8,44615887,44615812,cPa117-cPa308-hybrid_cPa117-cPa363-hybrid_cPa117-cPa456-hybrid_cPa117-cPa587-hybrid_cPa117-cPa75-hybrid_cPa363_cPa452_cPa456,1_9_1_2_2_16_3_27,102,75
chr2-44625081_44625183,WDSV_NC001867,0.586206896551724,5,44625145,44625109,cPa260_cPa260-unknown_cPa260-WDSV_NC001867-hybrid_WDSV_NC001867_WDSV_NC001867-unknown,8_1_2_17_1,102,36
chr2-44645675_44645777,cPa62,1,1,44645725,44645725,cPa62,1,102,0
chr2-44664203_44664317,cPa254,0.323529411764706,9,44664274,44664253,cPa174_cPa254_cPa404_cPa404-cPa174-hybrid_cPa404-cPa254-hybrid_cPa425_cPa425-cPa174-hybrid_cPa47_cPa47-cPa174-hybrid,1_22_7_5_1_10_4_12_6,114,21
chr2-44669456_44669558,cPa363_cPa456-cPa363-hybrid,0.5,2,44669513,44669506,cPa363_cPa456-cPa363-hybrid,1_1,102,7
chr2-44670191_44670364,cPa363,0.75,2,44670314,44670241,cPa363_cPa456-cPa363-hybrid,3_1,173,73
chr2-44683488_44683590,cPa150-cPa438-hybrid,0.375,6,44683555,44683517,cPa150_cPa150-cPa246-hybrid_cPa150-cPa302-hybrid_cPa150-cPa438-hybrid_cPa246_cPa246-cPa479-hybrid,1_1_1_3_1_1,102,38
chr2-44683678_44683780,cPa150_cPa246,0.333333333333333,4,44683743,44683722,cPa150_cPa246_cPa246-cPa438-hybrid_cPa302,2_2_1_1,102,21
chr2-44683864_44683966,cPa302,0.833333333333333,2,44683940,44683912,cPa246_cPa302,1_5,102,28
chr2-44747800_44747902,cPa62,1,1,44747881,44747817,cPa62,26,102,64
chr2-44786689_44786791,cPa450,0.361111111111111,12,44786751,44786689,cPa199_cPa199-cPa227-hybrid_cPa199-cPa273-hybrid_cPa199-cPa542-hybrid_cPa199-unknown_cPa227_cPa273_cPa413-cPa542-hybrid_cPa450_cPa542_cPa553_cPa553-cPa542-hybrid,6_1_1_3_2_1_1_5_13_1_1_1,102,62
chr2-44810161_44810284,cPa75,0.923076923076923,2,44810280,44810172,cPa71-cPa75-hybrid_cPa75,1_12,123,108
chr2-44810346_44810448,cPa71-cPa75-hybrid,1,1,44810396,44810396,cPa71-cPa75-hybrid,1,102,0
chr2-44810451_44810553,cPa75,0.75,2,44810520,44810488,cPa71-cPa75-hybrid_cPa75,1_3,102,32
chr2-44810573_44810740,cPa75,1,1,44810688,44810623,cPa75,3,167,65
chr2-44882594_44882696,cPa62,1,1,44882656,44882637,cPa62,19,102,19
chr2-450382_450484,cPa566-cPa75-hybrid_cPa75,0.5,2,450440,450392,cPa566-cPa75-hybrid_cPa75,2_2,102,48
chr2-450488_450590,cPa566-cPa75-hybrid,1,1,450588,450538,cPa566-cPa75-hybrid,2,102,50
chr2-451196_451298,cPa56-cPa75-hybrid_cPa566-cPa75-hybrid,0.5,2,451257,451246,cPa56-cPa75-hybrid_cPa566-cPa75-hybrid,1_1,102,11
chr2-451378_451480,cPa566-cPa75-hybrid,1,1,451428,451419,cPa566-cPa75-hybrid,2,102,9
chr2-451868_451985,cPa566-cPa75-hybrid,0.444444444444444,3,451933,451918,cPa56-cPa75-hybrid_cPa566-cPa75-hybrid_cPa75,3_4_2,117,15
chr2-452060_452162,cPa75,0.5,3,452145,452091,cPa56-cPa75-hybrid_cPa566-cPa75-hybrid_cPa75,1_3_4,102,54
chr2-45269897_45269999,cPa62,0.928571428571429,2,45269978,45269898,cPa285_cPa62,1_13,102,80
chr2-45355989_45356092,cPa62,1,1,45356053,45356039,cPa62,4,103,14
chr2-45475440_45475558,cPa273,0.5,3,45475507,45475477,cPa273_cPa413_cPa450,3_1_2,118,30
chr2-45479259_45479361,cPa62,0.980392156862745,2,45479341,45479292,cPa62_cPa62-unknown,50_1,102,49
chr2-456416_456518,cPa75,1,1,456466,456466,cPa75,1,102,0
chr2-45762245_45762347,cPa62,1,1,45762295,45762295,cPa62,1,102,0
chr2-45769445_45769547,cPa223-cPa199-hybrid_cPa273_cPa553,0.285714285714286,4,45769497,45769488,cPa223-cPa199-hybrid_cPa273_cPa345_cPa553,2_2_1_2,102,9
chr2-45778520_45778622,cPa15,0.8,2,45778609,45778562,cPa118_cPa15,1_4,102,47
chr2-46091126_46091228,cPa75,1,1,46091182,46091176,cPa75,2,102,6
chr2-46092007_46092132,cPa75,1,1,46092080,46092057,cPa75,2,125,23
chr2-46092908_46093023,cPa75,1,1,46092973,46092958,cPa75,8,115,15
chr2-46283558_46283660,cPa285-cPa75-hybrid,1,1,46283608,46283608,cPa285-cPa75-hybrid,1,102,0
chr2-46284012_46284114,cPa75,1,1,46284062,46284062,cPa75,1,102,0
chr2-46284186_46284292,cPa75,1,1,46284240,46284236,cPa75,2,106,4
chr2-46291828_46291930,cPa62,1,1,46291878,46291831,cPa62,48,102,47
chr2-4648783_4648890,cPa529,0.75,3,4648843,4648827,cPa247_cPa247-cPa545-hybrid_cPa529,2_1_9,107,16
chr2-46487905_46488007,cPa62-unknown,0.636363636363636,4,46487958,46487904,cPa62-HERV-W_repbase_HERV17_LTR17-hybrid_cPa62-unknown_cPa75-unknown_HERV-W_repbase_HERV17_LTR17,2_7_1_1,102,54
chr2-466037_466139,cPa75-cPa552-hybrid,1,1,466087,466087,cPa75-cPa552-hybrid,1,102,0
chr2-466217_466455,cPa75-cPa510-hybrid,0.62962962962963,4,466406,466249,cPa419_cPa75_cPa75-cPa101-hybrid_cPa75-cPa510-hybrid,1_8_1_17,238,157
chr2-466502_466619,cPa75,0.6,3,466616,466552,cPa145-cPa552-hybrid_cPa543-cPa510-hybrid_cPa75,1_1_3,117,64
chr2-466627_466729,cPa510,0.5,4,466712,466655,cPa362_cPa419_cPa510_cPa75-cPa510-hybrid,1_1_4_2,102,57
chr2-46696359_46696461,cPa247-cPa14-hybrid_cPa541_cPa545_cPa95,0.25,4,46696409,46696409,cPa247-cPa14-hybrid_cPa541_cPa545_cPa95,1_1_1_1,102,0
chr2-467222_467324,cPa75,0.75,2,467272,467264,cPa145-cPa75-hybrid_cPa75,1_3,102,8
chr2-46841488_46841590,cPa62,0.947368421052632,2,46841544,46841490,cPa15_cPa62,2_36,102,54
chr2-46841671_46841774,cPa118,0.5,3,46841733,46841721,cPa118_cPa15_cPa285-cPa15-hybrid,2_1_1,103,12
chr2-46844731_46844833,cPa174_cPa254_cPa404-unknown_cPa425_cPa47,0.2,5,46844787,46844781,cPa174_cPa254_cPa404-unknown_cPa425_cPa47,1_1_1_1_1,102,6
chr2-468606_468838,cPa199,1,1,468786,468656,cPa199,10,232,130
chr2-47448342_47448544,cPa75,0.833333333333333,2,47448492,47448392,cPa75_cPa75-cPa419-hybrid,5_1,202,100
chr2-47448566_47448668,cPa75,1,1,47448616,47448592,cPa75,5,102,24
chr2-48002892_48003003,cPa529,0.684210526315789,4,48002976,48002900,cPa529_cPa95_cPa95-cPa247-hybrid_cPa95-unknown,13_1_4_1,111,76
chr2-4801310_4801412,cPa62,1,1,4801380,4801334,cPa62,16,102,46
chr2-4809875_4809977,cPa539,0.909090909090909,2,4809926,4809916,cPa419_cPa539,1_10,102,10
chr2-48335115_48335217,cPa15,0.6,3,48335186,48335164,cPa118_cPa118-cPa15-hybrid_cPa15,3_1_6,102,22
chr2-48415316_48415418,cPa176,0.75,2,48415413,48415366,cPa176_cPa62-cPa176-hybrid,3_1,102,47
chr2-485007_485194,cPa293-unknown,0.428571428571429,5,485142,485017,cPa18_cPa293-cPa438-hybrid_cPa293-EqFV_NC002201-hybrid_cPa293-unknown_cPa472-cPa18-hybrid,3_3_1_6_1,187,125
chr2-48596743_48596855,cPa555,0.333333333333333,5,48596851,48596748,cPa546-cPa130-hybrid_cPa546-cPa257-hybrid_cPa546-cPa285-hybrid_cPa555_cPa555-cPa285-hybrid,1_4_4_6_3,112,103
chr2-48598090_48598192,cPa413,1,1,48598149,48598091,cPa413,6,102,58
chr2-48800994_48801103,cPa229,0.285714285714286,6,48801051,48801015,cPa157_cPa183_cPa193_cPa229_cPa500_cPa500-cPa157-hybrid,1_1_1_2_1_1,109,36
chr2-49310811_49310993,cPa75,1,1,49310941,49310848,cPa75,7,182,93
chr2-49412135_49412237,cPa363_cPa452,0.375,4,49412199,49412185,cPa363_cPa452_cPa71_cPa71-cPa16-hybrid,3_3_1_1,102,14
chr2-49683506_49683611,cPa174_cPa254_cPa425_cPa47,0.25,4,49683559,49683547,cPa174_cPa254_cPa425_cPa47,1_1_1_1,105,12
chr2-50095241_50095343,cPa450,0.5,6,50095291,50095275,cPa227_cPa273-cPa199-hybrid_cPa273-cPa223-hybrid_cPa450_cPa542-cPa223-hybrid_cPa553-cPa223-hybrid,1_1_1_7_1_3,102,16
chr2-50187919_50188021,cPa62,1,1,50187981,50187957,cPa62,9,102,24
chr2-50198890_50198992,cPa142,1,1,50198955,50198940,cPa142,4,102,15
chr2-50255818_50255946,cPa223,0.3,17,50255898,50255817,cPa16_cPa16-cPa183-hybrid_cPa16-cPa452-hybrid_cPa183_cPa223_cPa223-cPa183-hybrid_cPa223-cPa452-hybrid_cPa223-cPa71-hybrid_cPa223-unknown_cPa327_cPa327-cPa183-hybrid_cPa327-cPa452-hybrid_cPa379-cPa183-hybrid_cPa424-cPa452-hybrid_cPa446_cPa446-cPa183-hybrid_cPa446-cPa452-hybrid,2_1_1_4_15_2_12_1_2_1_1_2_1_1_1_1_2,128,81
chr2-5031101_5031203,cPa62,1,1,5031180,5031114,cPa62,26,102,66
chr2-50556467_50556569,cPa174_cPa174-cPa404-hybrid_cPa254_cPa254-cPa404-hybrid_cPa404_cPa425_cPa47,0.142857142857143,7,50556527,50556515,cPa174_cPa174-cPa404-hybrid_cPa254_cPa254-cPa404-hybrid_cPa404_cPa425_cPa47,1_1_1_1_1_1_1,102,12
chr2-50655355_50655463,cPa62,0.833333333333333,3,50655411,50655395,cPa118_cPa15-cPa125-hybrid_cPa62,1_1_10,108,16
chr2-5071747_5071849,cPa62,0.973684210526316,2,5071814,5071797,cPa62_cPa62-unknown,37_1,102,17
chr2-51132666_51132768,cPa456,0.341772151898734,11,51132729,51132713,cPa117-cPa363-hybrid_cPa117-cPa452-hybrid_cPa117-cPa62-hybrid_cPa117-unknown_cPa363_cPa452_cPa452-cPa363-hybrid_cPa452-unknown_cPa456_cPa456-cPa363-hybrid_cPa456-unknown,12_1_1_13_11_2_3_4_27_2_3,102,16
chr2-5126202_5126367,cPa75-unknown,0.888888888888889,3,5126318,5126204,cPa546-unknown_cPa75_cPa75-unknown,1_2_24,165,114
chr2-5126395_5126534,cPa75-unknown,0.8125,2,5126528,5126413,cPa75_cPa75-unknown,3_13,139,115
chr2-51289448_51289561,cPa47,0.315789473684211,7,51289515,51289496,cPa174_cPa254_cPa404-cPa174-hybrid_cPa425_cPa425-cPa174-hybrid_cPa47_cPa47-cPa174-hybrid,1_4_1_2_1_6_4,113,19
chr2-51893917_51894019,cPa16_cPa363_cPa452_cPa71,0.25,4,51893967,51893967,cPa16_cPa363_cPa452_cPa71,1_1_1_1,102,0
chr2-52529_52631,cPa75,1,1,52579,52579,cPa75,1,102,0
chr2-525715_525844,cPa138,0.8,2,525792,525760,cPa138_HERV-W_repbase_HERV17_LTR17,4_1,129,32
chr2-52578280_52578382,cPa62,1,1,52578330,52578330,cPa62,1,102,0
chr2-53369092_53369206,cPa456,0.5,3,53369154,53369142,cPa363_cPa456_cPa587-cPa117-hybrid,1_2_1,114,12
chr2-53460033_53460145,cPa456,0.722222222222222,5,53460105,53460083,cPa363_cPa452_cPa452-cPa363-hybrid_cPa456_cPa62-cPa363-hybrid,2_1_1_13_1,112,22
chr2-53460243_53460345,cPa62,0.666666666666667,2,53460293,53460263,cPa456_cPa62,1_2,102,30
chr2-53460378_53460480,cPa62,0.88,3,53460432,53460413,cPa285_cPa62_cPa62-cPa285-hybrid,2_22_1,102,19
chr2-536136_536238,cPa75,1,1,536186,536184,cPa75,2,102,2
chr2-53635668_53635770,cPa223,1,1,53635718,53635718,cPa223,2,102,0
chr2-536483_536585,cPa75,1,1,536533,536533,cPa75,1,102,0
chr2-536604_536713,cPa75,1,1,536661,536654,cPa75,3,109,7
chr2-53677388_53677501,cPa456,0.545454545454545,5,53677493,53677438,cPa363_cPa363-unknown_cPa456_cPa587-cPa456-hybrid_cPa75-unknown,2_1_6_1_1,113,55
chr2-5368813_5368928,cPa18_cPa541,0.285714285714286,5,5368876,5368816,cPa104-cPa4-hybrid_cPa14_cPa18_cPa4_cPa541,1_1_2_1_2,115,60
chr2-53822730_53822897,cPa392,0.777777777777778,3,53822845,53822739,cPa34-unknown_cPa392_cPa62-unknown,1_7_1,167,106
chr2-539220_539322,cPa75,1,1,539270,539230,cPa75,6,102,40
chr2-539718_539889,cPa75,1,1,539837,539768,cPa75,5,171,69
chr2-54001108_54001210,cPa419,1,1,54001158,54001158,cPa419,1,102,0
chr2-540185_540359,cPa75,1,1,540339,540184,cPa75,10,174,155
chr2-54544360_54544501,cPa15,0.533333333333333,6,54544472,54544380,cPa118_cPa125_cPa140-cPa125-hybrid_cPa15_cPa248-cPa118-hybrid_cPa443,3_1_1_8_1_1,141,92
chr2-54544591_54544693,cPa15,1,1,54544641,54544622,cPa15,2,102,19
chr2-54544863_54544965,cPa15,0.555555555555556,5,54544913,54544863,cPa118_cPa125-cPa118-hybrid_cPa140-cPa125-hybrid_cPa15_cPa264,1_1_1_5_1,102,50
chr2-54681518_54681624,cPa479,0.354430379746835,12,54681576,54681524,cPa131_cPa131-cPa255-hybrid_cPa131-cPa438-hybrid_cPa131-cPa479-hybrid_cPa150-cPa246-hybrid_cPa150-cPa255-hybrid_cPa150-cPa479-hybrid_cPa255_cPa255-cPa438-hybrid_cPa255-unknown_cPa302-cPa255-hybrid_cPa479,5_13_1_1_1_21_1_4_1_1_2_28,106,52
chr2-54736042_54736144,cPa446,0.51063829787234,6,54736093,54736079,cPa419_cPa446_cPa446-unknown_cPa552_cPa552-cPa446-hybrid_cPa552-unknown,2_24_2_1_7_11,102,14
chr2-54736164_54736266,cPa552-unknown,0.6,2,54736214,54736186,cPa446_cPa552-unknown,2_3,102,28
chr2-54868132_54868234,cPa75,1,1,54868218,54868162,cPa75,5,102,56
chr2-54868390_54868502,cPa75,0.6,6,54868464,54868393,cPa419_cPa62_cPa71-cPa62-hybrid_cPa75_cPa75-cPa62-hybrid_HERV-W_repbase_HERV17_LTR17,1_1_1_15_6_1,112,71
chr2-54917301_54917403,cPa260_cPa62_cPa75_cPa75-cPa62-hybrid,0.25,4,54917399,54917351,cPa260_cPa62_cPa75_cPa75-cPa62-hybrid,1_1_1_1,102,48
chr2-55070672_55070786,cPa199-unknown,0.488372093023256,8,55070777,55070681,cPa199-cPa273-hybrid_cPa199-unknown_cPa273_cPa450_cPa450-cPa482-hybrid_cPa450-unknown_cPa553_cPa553-unknown,2_21_3_4_1_9_2_1,114,96
chr2-55114623_55114725,cPa75,0.5,3,55114675,55114657,cPa62-unknown_cPa75_HERV-W_repbase_HERV17_LTR17-FeFV_NC001871-hybrid,1_2_1,102,18
chr2-55419383_55419485,cPa62,1,1,55419433,55419401,cPa62,11,102,32
chr2-556316_556418,cPa552-unknown,1,1,556369,556366,cPa552-unknown,2,102,3
chr2-55763502_55763604,cPa62,0.923076923076923,2,55763556,55763539,cPa293-cPa62-hybrid_cPa62,1_12,102,17
chr2-56067120_56067222,cPa216-cPa131-hybrid,1,1,56067173,56067159,cPa216-cPa131-hybrid,7,102,14
chr2-56207217_56207351,cPa75,0.444444444444444,6,56207342,56207223,cPa62_cPa75_cPa75-cPa62-hybrid_HERV-W_repbase_HERV17_LTR17-cPa62-hybrid_HERV-W_repbase_HERV17_LTR17-cPa75-hybrid_HERV-W_repbase_HERV17_LTR17-unknown,2_8_2_2_3_1,134,119
chr2-56207446_56207660,cPa75,0.461538461538462,6,56207658,56207480,cPa62_cPa75_cPa75-unknown_HERV-W_repbase_HERV17_LTR17-cPa62-hybrid_HERV-W_repbase_HERV17_LTR17-cPa75-hybrid_HERV-W_repbase_HERV17_LTR17-unknown,1_12_1_7_3_2,214,178
chr2-563398_563500,cPa67,1,1,563448,563425,cPa67,2,102,23
chr2-563515_563617,cPa67,1,1,563580,563520,cPa67,3,102,60
chr2-56477996_56478110,cPa363_cPa456,0.333333333333333,4,56478058,56478046,cPa117-cPa587-hybrid_cPa363_cPa452_cPa456,1_2_1_2,114,12
chr2-56610161_56610333,cPa62-cPa75-hybrid,0.461538461538462,4,56610281,56610181,cPa62_cPa62-cPa75-hybrid_cPa62-HERV-W_repbase_HERV17_LTR17-hybrid_cPa75,1_6_2_4,172,100
chr2-56837448_56837550,cPa492,0.5,3,56837546,56837498,cPa492_cPa492-cPa62-hybrid_cPa75,2_1_1,102,48
chr2-56837556_56837658,cPa492,0.75,2,56837606,56837578,cPa492_cPa492-cPa75-hybrid,3_1,102,28
chr2-56850436_56850604,cPa308,0.974683544303797,2,56850590,56850486,cPa308_cPa308-unknown,77_2,168,104
chr2-56911366_56911468,cPa75,1,1,56911416,56911416,cPa75,1,102,0
chr2-56911575_56911680,cPa62,0.818181818181818,3,56911676,56911625,cPa254_cPa62_cPa75,1_9_1,105,51
chr2-56943457_56943559,cPa419,1,1,56943507,56943507,cPa419,1,102,0
chr2-56981418_56981553,cPa62,0.769230769230769,4,56981501,56981449,cPa62_cPa62-cPa285-hybrid_cPa62-cPa75-hybrid_cPa62-unknown,40_1_2_9,135,52
chr2-57138210_57138312,cPa395,1,1,57138260,57138260,cPa395,1,102,0
chr2-57242993_57243095,cPa62-cPa419-hybrid,1,1,57243043,57243043,cPa62-cPa419-hybrid,1,102,0
chr2-57311612_57311714,cPa62,1,1,57311672,57311645,cPa62,5,102,27
chr2-57351842_57351956,cPa216,0.428571428571429,5,57351904,57351887,cPa216_cPa438_cPa523-cPa131-hybrid_cPa549-cPa131-hybrid_cPa549-cPa526-hybrid,3_1_1_1_1,114,17
chr2-57401789_57401955,cPa75-cPa260-hybrid,0.555555555555556,4,57401903,57401839,cPa260_cPa71_cPa75-cPa260-hybrid_cPa75-cPa71-hybrid,2_1_5_1,166,64
chr2-57466835_57466937,cPa62,1,1,57466885,57466853,cPa62,10,102,32
chr2-57468160_57468265,cPa62,1,1,57468222,57468195,cPa62,24,105,27
chr2-575849_575951,cPa273,1,1,575899,575899,cPa273,1,102,0
chr2-57604895_57604997,cPa450,0.435897435897436,10,57604959,57604899,cPa117-cPa223-hybrid_cPa199_cPa199-cPa223-hybrid_cPa227_cPa227-cPa223-hybrid_cPa273-cPa223-hybrid_cPa450_cPa450-cPa223-hybrid_cPa553_cPa553-cPa223-hybrid,1_1_13_4_1_3_34_6_4_11,102,60
chr2-57615936_57616038,cPa363,0.44,6,57615988,57615939,cPa216-cPa117-hybrid_cPa363_cPa456_cPa456-cPa117-hybrid_cPa456-cPa452-hybrid_cPa75-cPa117-hybrid,1_11_7_4_1_1,102,49
chr2-57634767_57634876,cPa583,0.425,5,57634858,57634812,cPa251_cPa251-cPa358-hybrid_cPa251-unknown_cPa358_cPa583,10_1_4_8_17,109,46
chr2-57989818_57989938,cPa456,0.476190476190476,5,57989925,57989824,cPa363_cPa363-cPa452-hybrid_cPa452_cPa456_cPa587-cPa452-hybrid,5_3_2_10_1,120,101
chr2-58135386_58135488,cPa62,0.875,2,58135438,58135421,cPa419_cPa62,1_7,102,17
chr2-581580_581867,cPa75,1,1,581815,581630,cPa75,8,287,185
chr2-58258581_58258710,cPa62,0.987179487179487,2,58258683,58258628,cPa285_cPa62,1_77,129,55
chr2-5838402_5838516,cPa183-cPa363-hybrid_cPa223_cPa223-cPa363-hybrid_cPa223-cPa452-hybrid,0.25,4,5838464,5838452,cPa183-cPa363-hybrid_cPa223_cPa223-cPa363-hybrid_cPa223-cPa452-hybrid,1_1_1_1,114,12
chr2-58406660_58406982,cPa75,0.75,5,58406975,58406677,cPa113-cPa106-hybrid_cPa62_cPa75_cPa75-cPa62-hybrid_cPa75-unknown,1_1_42_8_4,322,298
chr2-58573357_58573459,cPa75_cPa75-unknown_HERV-W_repbase_HERV17_LTR17_HERV-W_repbase_HERV17_LTR17-unknown,0.25,4,58573457,58573407,cPa75_cPa75-unknown_HERV-W_repbase_HERV17_LTR17_HERV-W_repbase_HERV17_LTR17-unknown,1_1_1_1,102,50
chr2-58573725_58573827,cPa75,1,1,58573775,58573775,cPa75,1,102,0
chr2-58574222_58574377,cPa75,1,1,58574325,58574272,cPa75,2,155,53
chr2-58767634_58767736,cPa492_cPa62-cPa492-hybrid,0.5,2,58767684,58767674,cPa492_cPa62-cPa492-hybrid,1_1,102,10
chr2-58934796_58934898,HML2_Pheonix,1,1,58934853,58934846,HML2_Pheonix,2,102,7
chr2-5971460_5971571,cPa62,0.975609756097561,2,5971567,5971470,cPa293_cPa62,1_40,111,97
chr2-59734121_59734228,cPa15,0.333333333333333,5,59734207,59734166,cPa118_cPa118-unknown_cPa15_cPa15-unknown_cPa443,1_1_2_1_1,107,41
chr2-60045878_60045989,cPa450,0.409836065573771,11,60045982,60045893,cPa199_cPa199-cPa227-hybrid_cPa199-cPa273-hybrid_cPa199-cPa450-hybrid_cPa199-cPa542-hybrid_cPa199-cPa75-hybrid_cPa199-unknown_cPa273_cPa450_cPa450-cPa75-hybrid_cPa542,1_1_17_2_1_5_3_4_25_1_1,111,89
chr2-6053390_6053515,cPa75-cPa113-hybrid,0.6,3,6053498,6053439,cPa113_cPa62-unknown_cPa75-cPa113-hybrid,1_1_3,125,59
chr2-6053632_6053796,cPa113_cPa75-cPa113-hybrid,0.235294117647059,8,6053768,6053682,cPa113_cPa113-HERV-W_repbase_HERV17_LTR17-hybrid_cPa62-cPa113-hybrid_cPa62-HERV-W_repbase_HERV17_LTR17-hybrid_cPa62-MoMLV_J02255-hybrid_cPa75-cPa113-hybrid_cPa75-MLV_Xmv43-hybrid_cPa75-unknown,4_1_3_1_1_4_1_2,164,86
chr2-61434041_61434143,cPa419,1,1,61434091,61434091,cPa419,1,102,0
chr2-6210745_6210856,cPa444-cPa381-hybrid,0.363636363636364,5,6210856,6210746,cPa339-cPa270-hybrid_cPa339-cPa381-hybrid_cPa444-cPa270-hybrid_cPa444-cPa381-hybrid_cPa444-cPa398-hybrid,4_7_2_8_1,111,110
chr2-62210581_62210685,cPa174_cPa404_cPa425_cPa47,0.25,4,62210658,62210631,cPa174_cPa404_cPa425_cPa47,1_1_1_1,104,27
chr2-62351226_62351338,cPa452,0.456852791878173,9,62351286,62351231,cPa176-cPa16-hybrid_cPa183-cPa16-hybrid_cPa363_cPa363-cPa16-hybrid_cPa363-cPa71-hybrid_cPa363-unknown_cPa452_cPa71_cPa71-cPa16-hybrid,3_3_73_1_1_2_90_23_1,112,55
chr2-62407261_62407363,cPa113-unknown_cPa75,0.5,2,62407353,62407311,cPa113-unknown_cPa75,1_1,102,42
chr2-6259354_6259456,cPa456,0.6,2,6259435,6259404,cPa363_cPa456,2_3,102,31
chr2-62674995_62675099,cPa14_cPa4_cPa541,0.333333333333333,3,62675047,62675044,cPa14_cPa4_cPa541,1_1_1,104,3
chr2-62852535_62852662,cPa492_cPa539,0.5,2,62852610,62852585,cPa492_cPa539,1_1,127,25
chr2-63189355_63189457,cPa62-cPa75-hybrid,0.545454545454545,5,63189456,63189405,cPa62_cPa62-cPa413-hybrid_cPa62-cPa71-hybrid_cPa62-cPa75-hybrid_cPa62-unknown,1_2_1_6_1,102,51
chr2-63189515_63189628,cPa62-cPa75-hybrid,0.428571428571429,5,63189628,63189517,cPa62_cPa62-cPa75-hybrid_cPa62-unknown_cPa71_cPa75,2_6_1_1_4,113,111
chr2-63449584_63449686,cPa75,0.730769230769231,8,63449660,63449584,cPa113_cPa113-cPa260-hybrid_cPa113-cPa75-hybrid_cPa113-unknown_cPa260_cPa293-unknown_cPa75_PERVC_HM159246-cPa75-hybrid,1_1_1_1_1_1_19_1,102,76
chr2-63449726_63449828,cPa75,0.818181818181818,3,63449826,63449776,cPa260-cPa75-hybrid_cPa67-cPa62-hybrid_cPa75,1_1_9,102,50
chr2-63542444_63542553,cPa71_cPa75,0.307692307692308,7,63542507,63542447,cPa293_cPa402_cPa419_cPa62_cPa71_cPa71-cPa75-hybrid_cPa75,1_1_1_6_8_1_8,109,60
chr2-63542843_63543131,cPa62,0.662921348314607,6,63543128,63542852,cPa62_cPa62-unknown_cPa71_cPa71-unknown_cPa75_cPa75-unknown,59_1_5_15_3_6,288,276
chr2-63553673_63553775,cPa75,0.409090909090909,9,63553772,63553692,cPa260-cPa486-hybrid_cPa260-cPa62-hybrid_cPa260-cPa75-hybrid_cPa293_cPa62_cPa75_cPa75-cPa62-hybrid_cPa75-unknown_PERVC_HM159246,1_4_1_1_3_9_1_1_1,102,80
chr2-63591000_63591151,cPa62-cPa75-hybrid,0.298245614035088,7,63591150,63591031,cPa62_cPa62-cPa293-hybrid_cPa62-cPa71-hybrid_cPa62-cPa75-hybrid_cPa62-HERV-W_repbase_HERV17_LTR17-hybrid_cPa71_cPa75,7_2_5_17_3_8_15,151,119
chr2-63591429_63591568,cPa75,0.326086956521739,9,63591568,63591479,cPa62_cPa62-cPa71-hybrid_cPa62-cPa75-hybrid_cPa62-HERV-W_repbase_HERV17_LTR17-hybrid_cPa62-unknown_cPa71_cPa71-cPa75-hybrid_cPa71-HERV-W_repbase_HERV17_LTR17-hybrid_cPa75,12_1_11_2_1_1_1_2_15,139,89
chr2-63750236_63750338,cPa62,1,1,63750292,63750286,cPa62,2,102,6
chr2-63770281_63770438,cPa62-cPa113-hybrid,0.75,2,63770386,63770331,cPa62-cPa113-hybrid_cPa75,3_1,157,55
chr2-64101812_64101914,cPa434,1,1,64101862,64101862,cPa434,1,102,0
chr2-64292601_64292718,cPa363,0.666666666666667,2,64292666,64292651,cPa363_cPa452,2_1,117,15
chr2-64355023_64355125,cPa15,0.666666666666667,2,64355073,64355059,cPa15_cPa268,2_1,102,14
chr2-64584_64686,cPa75,1,1,64644,64634,cPa75,3,102,10
chr2-649317_649423,cPa75,1,1,649379,649367,cPa75,4,106,12
chr2-64981_65083,cPa75,1,1,65031,65031,cPa75,1,102,0
chr2-649923_650025,cPa75,1,1,649973,649973,cPa75,1,102,0
chr2-65094_65288,cPa75,1,1,65237,65134,cPa75,7,194,103
chr2-651673_652003,cPa323,0.852941176470588,2,651951,651692,cPa323_cPa371,29_5,330,259
chr2-652081_652240,cPa323,0.875,2,652190,652106,cPa323_cPa371-cPa323-hybrid,7_1,159,84
chr2-652274_652741,cPa323,0.739130434782609,3,652689,652324,cPa323_cPa371_cPa371-cPa323-hybrid,17_5_1,467,365
chr2-65326081_65326184,cPa62,0.971428571428571,2,65326142,65326111,cPa62_HERV30_repbase_HERV30I_LTR30-cPa62-hybrid,34_1,103,31
chr2-65676_65778,cPa75,1,1,65740,65716,cPa75,3,102,24
chr2-65846381_65846483,cPa118,0.555555555555556,3,65846435,65846415,cPa118_cPa15_cPa248-cPa15-hybrid,5_3_1,102,20
chr2-65879443_65879549,cPa450,0.261627906976744,17,65879541,65879447,cPa199_cPa199-cPa223-hybrid_cPa223_cPa273_cPa273-cPa199-hybrid_cPa273-cPa223-hybrid_cPa273-cPa450-hybrid_cPa450_cPa450-cPa199-hybrid_cPa450-cPa223-hybrid_cPa542-cPa199-hybrid_cPa542-cPa223-hybrid_cPa542-cPa450-hybrid_cPa542-unknown_cPa553_cPa553-cPa199-hybrid_cPa553-cPa223-hybrid,13_2_6_6_14_20_1_45_3_2_9_16_1_1_18_6_9,106,94
chr2-65933248_65933392,cPa62,0.96,2,65933358,65933293,cPa62_cPa62-unknown,48_2,144,65
chr2-6599783_6599885,cPa62-unknown_cPa75_HERV-W_repbase_HERV17_LTR17,0.285714285714286,4,6599881,6599817,cPa62-HERV-W_repbase_HERV17_LTR17-hybrid_cPa62-unknown_cPa75_HERV-W_repbase_HERV17_LTR17,2_4_4_4,102,64
chr2-6599986_6600334,HERV-W_repbase_HERV17_LTR17,0.436170212765957,9,6600333,6599985,cPa419_cPa62-HERV-W_repbase_HERV17_LTR17-hybrid_cPa62-unknown_cPa75_cPa75-HERV-W_repbase_HERV17_LTR17-hybrid_cPa75-unknown_HERV-W_repbase_HERV17_LTR17_HERV-W_repbase_HERV17_LTR17-unknown_PERV_AJ293656,2_8_21_16_3_1_41_1_1,348,348
chr2-6600350_6600631,HERV-W_repbase_HERV17_LTR17,0.411764705882353,7,6600584,6600349,cPa62_cPa62-HERV-W_repbase_HERV17_LTR17-hybrid_cPa62-unknown_cPa75_cPa75-HERV-W_repbase_HERV17_LTR17-hybrid_cPa75-unknown_HERV-W_repbase_HERV17_LTR17,1_3_24_8_1_3_28,281,235
chr2-66411280_66411403,cPa339,0.375,7,66411353,66411330,cPa339_cPa353-cPa447-hybrid_cPa444-cPa339-hybrid_cPa444-cPa390-hybrid_cPa444-cPa447-hybrid_cPa444-cPa62-hybrid_cPa447,12_1_1_4_11_2_1,123,23
chr2-6641920_6642022,cPa456,0.551020408163265,9,6641985,6641948,cPa363_cPa363-cPa117-hybrid_cPa363-cPa452-hybrid_cPa363-unknown_cPa452_cPa456_cPa456-cPa363-hybrid_cPa587-cPa117-hybrid_REV_NC006934-cPa452-hybrid,8_1_7_1_2_27_1_1_1,102,37
chr2-66573854_66573997,cPa205,0.507042253521127,3,66573989,66573904,cPa205_cPa357_cPa61,36_4_31,143,85
chr2-66575796_66576372,cPa205,0.557377049180328,7,66576367,66575800,cPa205_cPa363-cPa587-hybrid_cPa363-unknown_cPa456_cPa456-cPa15-hybrid_cPa456-cPa357-hybrid_cPa61,68_1_1_5_1_1_45,576,567
chr2-66577271_66577661,cPa205,0.56,2,66577660,66577281,cPa205_cPa61,84_66,390,379
chr2-66579216_66579339,cPa205_cPa61,0.5,2,66579327,66579227,cPa205_cPa61,29_29,123,100
chr2-66579410_66579531,cPa61,0.583333333333333,3,66579504,66579415,cPa205_cPa61_cPa75-unknown,4_7_1,121,89
chr2-66579578_66579680,cPa205,0.75,2,66579633,66579593,cPa205_cPa61,3_1,102,40
chr2-6698451_6698564,cPa118_cPa15,0.4,3,6698523,6698501,cPa118_cPa15_cPa248-unknown,2_2_1,113,22
chr2-67134602_67134716,cPa363,0.5,3,67134664,67134611,cPa363_cPa452_cPa71,3_2_1,114,53
chr2-67145175_67145277,cPa358,1,1,67145227,67145225,cPa358,2,102,2
chr2-67146051_67146153,cPa251,0.463414634146341,4,67146146,67146054,cPa251_cPa251-unknown_cPa358_cPa419,19_4_17_1,102,92
chr2-67390202_67390304,cPa540,0.333333333333333,5,67390263,67390252,cPa11-cPa241-hybrid_cPa11-cPa515-hybrid_cPa127_cPa356-cPa241-hybrid_cPa540,1_1_1_1_2,102,11
chr2-67427441_67427552,cPa479_cPa479-unknown_cPa563,0.2,7,67427533,67427443,cPa478-cPa255-hybrid_cPa478-cPa438-hybrid_cPa479_cPa479-cPa526-hybrid_cPa479-unknown_cPa526_cPa563,1_1_2_1_2_1_2,111,90
chr2-67538390_67538492,cPa456,0.580645161290323,8,67538454,67538396,cPa285-cPa117-hybrid_cPa363_cPa363-cPa452-hybrid_cPa452_cPa456_cPa456-cPa117-hybrid_cPa456-unknown_cPa587-cPa452-hybrid,1_7_1_1_18_1_1_1,102,58
chr2-67562225_67562329,cPa62,0.5,6,67562311,67562264,cPa293_cPa293-cPa62-hybrid_cPa62_cPa75_cPa75-cPa62-hybrid_cPa75-unknown,1_1_8_2_3_1,104,47
chr2-67566421_67566523,cPa419,1,1,67566471,67566471,cPa419,1,102,0
chr2-67595910_67596012,cPa450,0.478260869565217,8,67595970,67595946,cPa199_cPa273-cPa199-hybrid_cPa450_cPa450-cPa199-hybrid_cPa542-cPa199-hybrid_cPa542-unknown_cPa553_cPa553-cPa199-hybrid,4_3_11_1_1_1_1_1,102,24
chr2-67692178_67692363,cPa456,0.523809523809524,9,67692331,67692209,cPa117-cPa363-hybrid_cPa117-cPa456-hybrid_cPa117-cPa587-hybrid_cPa363_cPa363-cPa456-hybrid_cPa452_cPa452-cPa456-hybrid_cPa456_cPa47-cPa174-hybrid,3_4_3_4_2_1_2_22_1,185,122
chr2-67806707_67806906,cPa75-unknown,0.45,4,67806879,67806757,cPa125-unknown_cPa391_cPa75_cPa75-unknown,1_2_8_9,199,122
chr2-67845124_67845226,cPa541,0.888888888888889,2,67845204,67845174,cPa4_cPa541,1_8,102,30
chr2-67918056_67918158,cPa419,1,1,67918106,67918106,cPa419,1,102,0
chr2-67987361_67987463,cPa75,1,1,67987411,67987411,cPa75,1,102,0
chr2-67987510_67987697,cPa75,1,1,67987645,67987560,cPa75,2,187,85
chr2-67987815_67987968,cPa75,1,1,67987931,67987865,cPa75,9,153,66
chr2-67988557_67988681,cPa75,0.888888888888889,2,67988629,67988607,cPa555-cPa75-hybrid_cPa75,1_8,124,22
chr2-68050278_68050388,cPa540,0.285714285714286,6,68050336,68050300,cPa11_cPa127_cPa127-unknown_cPa241_cPa515_cPa540,1_1_1_1_1_2,110,36
chr2-68068984_68069094,cPa229,0.958904109589041,4,68069044,68069002,cPa229_cPa229-cPa62-hybrid_cPa229-unknown_cPa419,70_1_1_1,110,42
chr2-68223983_68224085,cPa193_cPa229_cPa500,0.25,5,68224045,68224033,cPa157_cPa183_cPa193_cPa229_cPa500,1_1_2_2_2,102,12
chr2-68311760_68311862,cPa363_cPa452,0.375,3,68311845,68311804,cPa363_cPa452_cPa71,3_3_2,102,41
chr2-68355683_68355785,cPa260-KWERV_GQ222416-hybrid,0.666666666666667,2,68355768,68355703,cPa260-KWERV_GQ222416-hybrid_cPa75,2_1,102,65
chr2-68427213_68427315,cPa113_cPa387-cPa113-hybrid_cPa67_cPa75-unknown,0.25,4,68427306,68427236,cPa113_cPa387-cPa113-hybrid_cPa67_cPa75-unknown,1_1_1_1,102,70
chr2-68427371_68427480,cPa113,0.555555555555556,4,68427473,68427371,cPa113_cPa387_cPa62-cPa113-hybrid_cPa75-cPa113-hybrid,5_1_1_2,109,102
chr2-6853932_6854037,cPa456,0.5,3,6853985,6853982,cPa363_cPa452_cPa456,1_1_2,105,3
chr2-68542502_68542751,cPa62,0.916666666666667,3,68542707,68542549,cPa254_cPa62_cPa62-unknown,1_22_1,249,158
chr2-6862087_6862189,cPa293_cPa391_cPa426,0.333333333333333,3,6862137,6862137,cPa293_cPa391_cPa426,1_1_1,102,0
chr2-68645129_68645231,cPa220,1,1,68645179,68645164,cPa220,2,102,15
chr2-68708474_68708623,cPa14,0.6875,4,68708597,68708524,cPa14_cPa541_cPa541-cPa4-hybrid_cPa541-unknown,11_1_2_2,149,73
chr2-68720294_68720399,cPa220,0.3125,8,68720347,68720321,cPa104_cPa18-cPa104-hybrid_cPa18-cPa190-hybrid_cPa18-unknown_cPa219_cPa220_cPa258-cPa104-hybrid_cPa258-cPa190-hybrid,4_2_1_1_1_5_1_1,105,26
chr2-6872625_6872809,cPa60,0.42,10,6872782,6872675,cPa257_cPa285-cPa257-hybrid_cPa285-unknown_cPa546_cPa546-cPa130-hybrid_cPa546-cPa257-hybrid_cPa546-cPa555-hybrid_cPa546-unknown_cPa555_cPa60,7_3_1_9_2_4_1_1_1_21,184,107
chr2-68727977_68728079,cPa363_cPa452_cPa71,0.315789473684211,4,68728032,68727999,cPa16-cPa183-hybrid_cPa363_cPa452_cPa71,1_6_6_6,102,33
chr2-68921847_68921949,cPa363,0.428571428571429,3,68921897,68921886,cPa363_cPa456_cPa587-cPa452-hybrid,3_2_2,102,11
chr2-68940583_68940685,cPa419,1,1,68940633,68940633,cPa419,1,102,0
chr2-68986032_68986134,cPa4,0.68,5,68986116,68986036,cPa14_cPa4_cPa4-cPa14-hybrid_cPa4-unknown_cPa541,2_17_3_1_2,102,80
chr2-6916731_6916833,cPa199_cPa482-cPa260-hybrid,0.5,2,6916781,6916775,cPa199_cPa482-cPa260-hybrid,1_1,102,6
chr2-6961264_6961366,WDSV_NC001867,0.666666666666667,2,6961317,6961311,WDSV_NC001867_WDSV_NC001867-unknown,2_1,102,6
chr2-69658017_69658131,cPa95,0.5,3,69658082,69658067,cPa14-unknown_cPa545_cPa95,1_2_3,114,15
chr2-698167_698269,cPa75,1,1,698217,698217,cPa75,1,102,0
chr2-69841075_69841189,cPa14_cPa4_cPa545_cPa95,0.25,4,69841137,69841125,cPa14_cPa4_cPa545_cPa95,1_1_1_1,114,12
chr2-698430_698532,cPa75,1,1,698480,698480,cPa75,1,102,0
chr2-698583_698689,cPa75,1,1,698637,698633,cPa75,2,106,4
chr2-699091_699193,cPa75,1,1,699141,699141,cPa75,1,102,0
chr2-699226_699353,cPa75,1,1,699301,699276,cPa75,2,127,25
chr2-69984685_69984790,cPa15,0.857142857142857,2,69984788,69984735,cPa15_cPa443,6_1,105,53
chr2-69984803_69985286,cPa15,0.698863636363636,9,69985234,69984853,cPa118_cPa118-cPa268-hybrid_cPa15_cPa15-cPa268-hybrid_cPa443_cPa443-cPa118-hybrid_cPa443-cPa15-hybrid_cPa443-cPa268-hybrid_cPa62,13_2_123_1_21_6_1_7_2,483,381
chr2-7003704_7003806,cPa425,0.428571428571429,4,7003754,7003739,cPa254_cPa425_cPa47_cPa47-cPa174-hybrid,1_3_1_2,102,15
chr2-70080804_70081001,cPa62,1,1,70080949,70080833,cPa62,11,197,116
chr2-700851_700953,cPa75,1,1,700901,700901,cPa75,1,102,0
chr2-701212_701314,cPa75,1,1,701262,701262,cPa75,1,102,0
chr2-701415_701931,cPa75,1,1,701879,701465,cPa75,11,516,414
chr2-70277992_70278094,cPa285_cPa62,0.4,3,70278051,70278017,cPa285_cPa62_cPa62-unknown,2_2_1,102,34
chr2-70335537_70335639,cPa75,1,1,70335587,70335587,cPa75,1,102,0
chr2-70342617_70342719,cPa518-unknown,1,1,70342667,70342667,cPa518-unknown,1,102,0
chr2-70636867_70636969,cPa469-cPa21-hybrid,1,1,70636927,70636917,cPa469-cPa21-hybrid,9,102,10
chr2-70892039_70892148,cPa323_cPa323-cPa568-hybrid_cPa333_cPa371-cPa568-hybrid_cPa419,0.2,5,70892141,70892089,cPa323_cPa323-cPa568-hybrid_cPa333_cPa371-cPa568-hybrid_cPa419,1_1_1_1_1,109,52
chr2-71346226_71346328,cPa15,0.571428571428571,6,71346291,71346259,cPa118_cPa118-cPa183-hybrid_cPa118-cPa268-hybrid_cPa118-unknown_cPa15_cPa268,1_1_2_1_8_1,102,32
chr2-71423968_71424070,cPa62,1,1,71424018,71424018,cPa62,1,102,0
chr2-715595_715739,cPa452,1,1,715687,715645,cPa452,2,144,42
chr2-71561317_71561441,cPa223-cPa254-hybrid_cPa450_cPa482-cPa254-hybrid,0.333333333333333,3,71561414,71561367,cPa223-cPa254-hybrid_cPa450_cPa482-cPa254-hybrid,1_1_1,124,47
chr2-71561479_71561581,cPa450,0.476190476190476,16,71561542,71561487,cPa199_cPa199-cPa542-hybrid_cPa223_cPa223-cPa542-hybrid_cPa223-unknown_cPa285-cPa273-hybrid_cPa345-cPa553-hybrid_cPa450_cPa482_cPa482-cPa227-hybrid_cPa482-cPa273-hybrid_cPa482-cPa450-hybrid_cPa482-cPa542-hybrid_cPa482-cPa553-hybrid_cPa553_cPa62-cPa553-hybrid,1_1_1_3_1_1_1_20_1_1_1_4_3_1_1_1,102,55
chr2-71847192_71847294,cPa287_cPa287-cPa426-hybrid_cPa293_cPa391,0.208333333333333,8,71847277,71847238,cPa287_cPa287-cPa391-hybrid_cPa287-cPa426-hybrid_cPa287-unknown_cPa293_cPa293-cPa391-hybrid_cPa391_cPa426,5_1_5_1_5_1_5_1,102,39
chr2-72038005_72038107,cPa450,0.315789473684211,10,72038055,72038008,cPa199_cPa227_cPa273-cPa199-hybrid_cPa273-cPa223-hybrid_cPa273-cPa345-hybrid_cPa273-cPa553-hybrid_cPa273-unknown_cPa450_cPa450-cPa223-hybrid_cPa553,3_2_1_1_1_1_1_6_1_2,102,47
chr2-72083099_72083201,cPa452,0.631578947368421,6,72083155,72083140,cPa176-cPa327-hybrid_cPa363_cPa452_cPa71_cPa71-cPa452-hybrid_cPa71-unknown,1_2_12_1_1_2,102,15
chr2-72233322_72233424,cPa113_cPa113-cPa62-hybrid_cPa113-cPa75-hybrid_cPa113-PERVA_AY099323-hybrid_cPa67-cPa62-hybrid,0.2,5,72233372,72233338,cPa113_cPa113-cPa62-hybrid_cPa113-cPa75-hybrid_cPa113-PERVA_AY099323-hybrid_cPa67-cPa62-hybrid,1_1_1_1_1,102,34
chr2-72236195_72236297,cPa444-cPa447-hybrid,0.3,8,72236268,72236222,cPa339_cPa339-cPa390-hybrid_cPa444-cPa339-hybrid_cPa444-cPa390-hybrid_cPa444-cPa447-hybrid_cPa444-cPa452-hybrid_cPa447_cPa62,4_2_4_1_6_1_1_1,102,46
chr2-72250925_72251027,cPa363_cPa419-cPa452-hybrid_cPa452,0.333333333333333,3,72251015,72250975,cPa363_cPa419-cPa452-hybrid_cPa452,1_1_1,102,40
chr2-724470_724624,cPa75,1,1,724572,724520,cPa75,14,154,52
chr2-725243_725425,cPa75,1,1,725373,725293,cPa75,3,182,80
chr2-725784_725886,cPa75,1,1,725834,725834,cPa75,1,102,0
chr2-725929_726176,cPa75,1,1,726124,725979,cPa75,27,247,145
chr2-726240_726357,cPa75,1,1,726305,726252,cPa75,4,117,53
chr2-72784338_72784440,cPa308_cPa410,0.5,2,72784388,72784388,cPa308_cPa410,1_1,102,0
chr2-72900239_72900341,cPa75,1,1,72900297,72900266,cPa75,11,102,31
chr2-72901522_72901638,cPa75,1,1,72901586,72901570,cPa75,6,116,16
chr2-72953074_72953185,cPa256,0.333333333333333,5,72953147,72953096,cPa101-cPa256-hybrid_cPa101-cPa51-hybrid_cPa101-unknown_cPa256_cPa582,1_2_2_3_1,111,51
chr2-730414_730649,cPa75,1,1,730597,730464,cPa75,13,235,133
chr2-730747_730849,cPa75,1,1,730798,730797,cPa75,4,102,1
chr2-730915_731133,cPa75,1,1,731081,730965,cPa75,17,218,116
chr2-73097966_73098068,HERV-XA34_repbase_HERVFH21I_LTR21A,0.6,2,73098016,73098004,cPa315_HERV-XA34_repbase_HERVFH21I_LTR21A,2_3,102,12
chr2-7326257_7326359,cPa62,1,1,7326307,7326307,cPa62,1,102,0
chr2-7326926_7327028,cPa62,1,1,7326976,7326976,cPa62,1,102,0
chr2-73496784_73496952,cPa219-cPa104-hybrid,0.560975609756098,6,73496903,73496834,cPa104_cPa190_cPa219-cPa104-hybrid_cPa219-unknown_cPa220_cPa258-unknown,2_2_23_1_12_1,168,69
chr2-7363024_7363126,cPa555,0.307692307692308,6,7363084,7363040,cPa257-cPa546-hybrid_cPa257-cPa555-hybrid_cPa472-cPa257-hybrid_cPa546_cPa555_cPa60-cPa546-hybrid,3_2_1_2_4_1,102,44
chr2-73841386_73841488,cPa285_cPa293_cPa419_cPa62,0.25,4,73841451,73841436,cPa285_cPa293_cPa419_cPa62,1_1_1_1,102,15
chr2-73853726_73853845,cPa333-cPa450-hybrid,0.714285714285714,2,73853832,73853740,cPa333-cPa273-hybrid_cPa333-cPa450-hybrid,2_5,119,92
chr2-73853939_73854041,cPa323-cPa273-hybrid,0.666666666666667,2,73854017,73853981,cPa323-cPa273-hybrid_cPa323-cPa450-hybrid,2_1,102,36
chr2-74071723_74071832,cPa539,0.666666666666667,2,74071780,74071773,cPa419_cPa539,1_2,109,7
chr2-74310341_74310443,cPa118_cPa15_cPa248-unknown,0.333333333333333,3,74310391,74310391,cPa118_cPa15_cPa248-unknown,1_1_1,102,0
chr2-74669481_74669583,cPa62,1,1,74669538,74669512,cPa62,4,102,26
chr2-74702696_74702798,cPa62,1,1,74702751,74702735,cPa62,11,102,16
chr2-74736443_74736545,cPa358_cPa583,0.4,3,74736515,74736489,cPa251_cPa358_cPa583,2_4_4,102,26
chr2-74741648_74741750,cPa450_cPa553,0.333333333333333,5,74741710,74741698,cPa199-cPa273-hybrid_cPa345-cPa273-hybrid_cPa450_cPa482-cPa273-hybrid_cPa553,1_1_3_1_3,102,12
chr2-748740_748842,cPa75,1,1,748790,748790,cPa75,1,102,0
chr2-74879921_74880023,cPa452_cPa71,0.4,3,74879973,74879971,cPa16-cPa363-hybrid_cPa452_cPa71,1_2_2,102,2
chr2-74929766_74929878,cPa15,0.833333333333333,2,74929828,74929816,cPa15_cPa268-cPa118-hybrid,5_1,112,12
chr2-74997239_74997341,cPa47,0.5,3,74997289,74997277,cPa254_cPa47_cPa47-cPa174-hybrid,2_3_1,102,12
chr2-75064038_75064140,cPa75,0.571428571428571,2,75064131,75064064,cPa75_cPa75-cPa62-hybrid,4_3,102,67
chr2-75126319_75126421,cPa15,0.5,3,75126380,75126356,cPa118_cPa118-unknown_cPa15,2_1_3,102,24
chr2-75536826_75536928,cPa62,0.888888888888889,2,75536886,75536870,cPa254_cPa62,2_16,102,16
chr2-75605000_75605102,HERV-I_repbase_HERVI_LTR10B-unknown,1,1,75605050,75605003,HERV-I_repbase_HERVI_LTR10B-unknown,4,102,47
chr2-75720758_75720887,cPa456,0.444444444444444,6,75720867,75720761,cPa363_cPa363-cPa117-hybrid_cPa452-cPa117-hybrid_cPa456_cPa587-cPa117-hybrid_cPa75-cPa117-hybrid,21_5_1_28_5_3,129,106
chr2-75739813_75739920,cPa62,0.8,3,75739875,75739854,cPa254_cPa254-cPa62-hybrid_cPa62,3_1_16,107,21
chr2-75866773_75866875,cPa363,0.545454545454545,3,75866823,75866798,cPa363_cPa452_cPa71,6_4_1,102,25
chr2-75977032_75977134,cPa542-cPa554-hybrid_cPa542-cPa585-hybrid_cPa553-cPa444-hybrid,0.333333333333333,3,75977096,75977043,cPa542-cPa554-hybrid_cPa542-cPa585-hybrid_cPa553-cPa444-hybrid,1_1_1,102,53
chr2-75977147_75977253,cPa553,0.523809523809524,9,75977204,75977155,cPa199-cPa223-hybrid_cPa273_cPa273-cPa345-hybrid_cPa447-cPa223-hybrid_cPa450-cPa223-hybrid_cPa450-unknown_cPa542-unknown_cPa553_cPa553-cPa482-hybrid,2_2_1_1_1_1_1_11_1,106,49
chr2-7604932_7605034,cPa419,1,1,7604982,7604982,cPa419,1,102,0
chr2-76074845_76075004,cPa62,1,1,76074983,76074885,cPa62,12,159,98
chr2-76075046_76075148,cPa62,1,1,76075106,76075064,cPa62,4,102,42
chr2-76115774_76115876,cPa75,1,1,76115824,76115814,cPa75,3,102,10
chr2-76116489_76116606,cPa75,1,1,76116582,76116513,cPa75,5,117,69
chr2-76212943_76213145,cPa425,0.304878048780488,9,76213094,76212945,cPa174_cPa174-cPa404-hybrid_cPa174-unknown_cPa404_cPa404-cPa118-hybrid_cPa404-cPa174-hybrid_cPa425_cPa47_cPa47-unknown,24_1_3_4_1_1_25_22_1,202,149
chr2-76213440_76213593,cPa174,0.318181818181818,7,76213541,76213490,cPa118_cPa118-unknown_cPa174_cPa404_cPa404-cPa174-hybrid_cPa425_cPa47,2_1_7_3_1_3_5,153,51
chr2-76220813_76220915,cPa117-cPa363-hybrid,0.6,3,76220894,76220853,cPa117-cPa363-hybrid_cPa121-cPa363-hybrid_cPa456-cPa363-hybrid,3_1_1,102,41
chr2-76221710_76221812,cPa117-cPa587-hybrid,1,1,76221760,76221760,cPa117-cPa587-hybrid,1,102,0
chr2-76247343_76247445,cPa419,1,1,76247393,76247393,cPa419,1,102,0
chr2-76343665_76343767,cPa363_cPa456,0.375,4,76343727,76343715,cPa117-cPa587-hybrid_cPa363_cPa452_cPa456,1_3_1_3,102,12
chr2-76540333_76540441,cPa363_cPa452,0.333333333333333,4,76540389,76540376,cPa176-unknown_cPa363_cPa452_cPa71,1_2_2_1,108,13
chr2-7658949_7659053,cPa450,0.444444444444444,5,7659016,7658964,cPa273-cPa199-hybrid_cPa273-cPa223-hybrid_cPa450_cPa450-cPa482-hybrid_cPa553,1_8_12_1_5,104,52
chr2-76640861_76640963,cPa540,0.333333333333333,8,76640936,76640884,cPa11_cPa11-cPa127-hybrid_cPa127_cPa127-cPa241-hybrid_cPa515_cPa515-cPa127-hybrid_cPa540_cPa540-cPa241-hybrid,1_1_1_2_5_1_6_1,102,52
chr2-76718886_76718988,cPa62,0.863636363636364,3,76718970,76718900,cPa285_cPa62_cPa62-unknown,2_19_1,102,70
chr2-76847974_76848091,HERV-W_repbase_HERV17_LTR17,0.39622641509434,9,76848091,76847998,cPa293-KoRV_AF151794-hybrid_cPa62_cPa62-cPa75-hybrid_cPa62-HERV-W_repbase_HERV17_LTR17-hybrid_cPa62-unknown_cPa71_cPa75_cPa75-HERV-W_repbase_HERV17_LTR17-hybrid_HERV-W_repbase_HERV17_LTR17,1_3_3_2_2_1_18_2_21,117,93
chr2-76882736_76882838,cPa450,0.5,8,76882818,76882777,cPa273-cPa223-hybrid_cPa450_cPa450-cPa199-hybrid_cPa450-cPa223-hybrid_cPa542-cPa199-hybrid_cPa553_cPa553-cPa223-hybrid_cPa553-cPa482-hybrid,1_8_1_1_1_2_1_1,102,41
chr2-76886086_76886188,cPa61,0.977011494252874,3,76886142,76886089,cPa61_cPa61-cPa62-hybrid_cPa61-unknown,85_1_1,102,53
chr2-771364_771466,cPa183-cPa566-hybrid,1,1,771414,771414,cPa183-cPa566-hybrid,1,102,0
chr2-77144764_77144866,cPa62,1,1,77144845,77144814,cPa62,43,102,31
chr2-7733684_7733786,cPa75,1,1,7733741,7733685,cPa75,8,102,56
chr2-77476543_77476645,cPa62,0.818181818181818,3,77476600,77476563,cPa419_cPa62_cPa62-unknown,1_18_3,102,37
chr2-77566731_77566833,cPa117-cPa587-hybrid_cPa363_cPa456_cPa456-cPa587-hybrid,0.25,4,77566785,77566781,cPa117-cPa587-hybrid_cPa363_cPa456_cPa456-cPa587-hybrid,1_1_1_1,102,4
chr2-7760725_7760836,cPa62,0.666666666666667,3,7760784,7760775,cPa62_cPa62-cPa75-hybrid_cPa62-unknown,4_1_1,111,9
chr2-77693961_77694063,cPa363_cPa363-cPa452-hybrid_cPa456_cPa456-cPa452-hybrid_cPa587-cPa117-hybrid,0.2,5,77694045,77694008,cPa363_cPa363-cPa452-hybrid_cPa456_cPa456-cPa452-hybrid_cPa587-cPa117-hybrid,1_1_1_1_1,102,37
chr2-77752955_77753140,cPa345,1,1,77753088,77753005,cPa345,3,185,83
chr2-77753152_77753270,cPa345,1,1,77753263,77753202,cPa345,9,118,61
chr2-77753338_77753440,cPa345,1,1,77753390,77753379,cPa345,3,102,11
chr2-77849014_77849116,cPa118_cPa15,0.5,2,77849064,77849064,cPa118_cPa15,1_1,102,0
chr2-77855849_77855967,cPa183-cPa16-hybrid_cPa363_cPa419_cPa452_cPa71,0.2,5,77855915,77855899,cPa183-cPa16-hybrid_cPa363_cPa419_cPa452_cPa71,1_1_1_1_1,118,16
chr2-77863714_77863816,cPa392,1,1,77863764,77863764,cPa392,1,102,0
chr2-77866579_77866729,cPa62,0.833333333333333,2,77866677,77866629,cPa285_cPa62,1_5,150,48
chr2-77952479_77952583,cPa62,1,1,77952547,77952512,cPa62,7,104,35
chr2-779659_779761,cPa16,0.818181818181818,2,779757,779678,cPa16_cPa176,9_2,102,79
chr2-78062723_78062825,cPa419,1,1,78062773,78062773,cPa419,1,102,0
chr2-78554222_78554337,cPa456,0.471153846153846,17,78554331,78554254,cPa117-cPa16-hybrid_cPa117-cPa363-hybrid_cPa117-cPa587-hybrid_cPa117-unknown_cPa363_cPa363-cPa587-hybrid_cPa452-cPa363-hybrid_cPa452-cPa456-hybrid_cPa452-cPa587-hybrid_cPa452-unknown_cPa456_cPa456-cPa363-hybrid_cPa456-cPa587-hybrid_cPa456-unknown_FeLV_NC001940-cPa456-hybrid_PRIMA41_repbase_PRIMA41_MER41A-cPa456-hybrid_PRIMA41_repbase_PRIMA41_MER41A-cPa587-hybrid,1_2_17_1_13_2_5_1_3_3_49_1_1_1_1_2_1,115,77
chr2-78642551_78642653,cPa260-cPa75-hybrid,0.4,4,78642603,78642588,cPa260-cPa75-hybrid_cPa75_SMRV_NC001514_SMRV_NC001514-cPa75-hybrid,2_1_1_1,102,15
chr2-78858624_78858737,cPa15_cPa264,0.4,3,78858685,78858672,cPa15_cPa264_cPa443,2_2_1,113,13
chr2-78877514_78877616,HERV-W_repbase_HERV17_LTR17,1,1,78877564,78877564,HERV-W_repbase_HERV17_LTR17,1,102,0
chr2-79006677_79006791,cPa62,0.875,4,79006749,79006722,cPa224-cPa75-hybrid_cPa285_cPa62_cPa62-unknown,1_1_21_1,114,27
chr2-79068135_79068349,cPa75,0.516778523489933,5,79068342,79068143,cPa62_cPa62-cPa75-hybrid_cPa62-HERV-W_repbase_HERV17_LTR17-hybrid_cPa62-unknown_cPa75,7_10_1_54_77,214,199
chr2-79079401_79079569,cPa75-unknown,0.666666666666667,4,79079517,79079451,cPa546-unknown_cPa75_cPa75-cPa113-hybrid_cPa75-unknown,1_3_1_10,168,66
chr2-79178070_79178427,cPa71,0.295454545454545,14,79178404,79178077,cPa113-PERVC_HM159246-hybrid_cPa16_cPa260_cPa293-PERVC_HM159246-hybrid_cPa62-cPa260-hybrid_cPa62-cPa71-hybrid_cPa62-unknown_cPa71_cPa71-unknown_cPa75_cPa75-cPa260-hybrid_cPa75-cPa71-hybrid_cPa75-PERVC_HM159246-hybrid_HERV-W_repbase_HERV17_LTR17-cPa71-hybrid,1_1_1_1_1_9_5_13_1_5_1_2_1_2,357,327
chr2-79321798_79321903,cPa138-unknown_cPa395,0.375,4,79321862,79321846,cPa138_cPa138-cPa572-hybrid_cPa138-unknown_cPa395,1_1_3_3,105,16
chr2-79361705_79361812,cPa104-cPa18-hybrid_cPa104-cPa219-hybrid_cPa190_cPa190-cPa219-hybrid_cPa219_cPa220,0.166666666666667,6,79361760,79361755,cPa104-cPa18-hybrid_cPa104-cPa219-hybrid_cPa190_cPa190-cPa219-hybrid_cPa219_cPa220,1_1_1_1_1_1,107,5
chr2-79373588_79373690,cPa62,0.90625,4,79373656,79373635,cPa254_cPa62_cPa62-cPa254-hybrid_cPa62-unknown,1_29_1_1,102,21
chr2-79515817_79515919,cPa450_cPa553,0.333333333333333,4,79515867,79515854,cPa227-cPa199-hybrid_cPa273_cPa450_cPa553,1_1_2_2,102,13
chr2-79532549_79532651,cPa75,0.4,4,79532599,79532568,cPa285_cPa75_cPa75-cPa62-hybrid_cPa75-unknown,1_2_1_1,102,31
chr2-79572720_79572822,WDSV_NC001867,0.916666666666667,2,79572788,79572770,cPa260_WDSV_NC001867,1_11,102,18
chr2-796161_796704,cPa392,1,1,796661,796211,cPa392,22,543,450
chr2-79653606_79653723,cPa529-cPa95-hybrid,0.222222222222222,13,79653722,79653654,cPa14_cPa247_cPa247-cPa14-hybrid_cPa247-cPa541-hybrid_cPa247-cPa545-hybrid_cPa247-cPa95-hybrid_cPa529-cPa14-hybrid_cPa529-cPa545-hybrid_cPa529-cPa95-hybrid_cPa545_cPa545-cPa14-hybrid_cPa545-cPa95-hybrid_cPa95,1_1_4_1_2_1_3_1_8_7_1_1_5,117,68
chr2-79676614_79676716,cPa62,1,1,79676664,79676659,cPa62,2,102,5
chr2-797261_797363,cPa392,1,1,797352,797294,cPa392,4,102,58
chr2-7977407_7977591,cPa174-cPa254-hybrid_cPa174-cPa404-hybrid_cPa47_cPa62-cPa425-hybrid,0.25,4,7977539,7977457,cPa174-cPa254-hybrid_cPa174-cPa404-hybrid_cPa47_cPa62-cPa425-hybrid,1_1_1_1,184,82
chr2-798434_798536,cPa392,1,1,798484,798484,cPa392,1,102,0
chr2-80080408_80080510,cPa62,1,1,80080464,80080407,cPa62,22,102,57
chr2-80261179_80261281,cPa62,1,1,80261240,80261223,cPa62,11,102,17
chr2-80340493_80340605,cPa357_cPa357-cPa75-hybrid,0.5,2,80340553,80340543,cPa357_cPa357-cPa75-hybrid,3_3,112,10
chr2-80340619_80340721,cPa357,0.6,2,80340704,80340669,cPa357_cPa357-cPa75-hybrid,3_2,102,35
chr2-803814_803991,cPa75,1,1,803950,803864,cPa75,5,177,86
chr2-80398195_80398297,cPa62,1,1,80398270,80398236,cPa62,17,102,34
chr2-80482201_80482303,cPa62,0.857142857142857,3,80482252,80482234,cPa285-unknown_cPa345-cPa62-hybrid_cPa62,1_1_12,102,18
chr2-80551817_80551921,cPa363_cPa452,0.4,3,80551876,80551867,cPa363_cPa452_cPa71,2_2_1,104,9
chr2-80624462_80624564,cPa15,0.548387096774194,6,80624522,80624504,cPa118_cPa118-cPa268-hybrid_cPa118-cPa443-hybrid_cPa118-unknown_cPa15_cPa268,8_1_2_2_17_1,102,18
chr2-80887061_80887163,cPa62,1,1,80887157,80887102,cPa62,31,102,55
chr2-80915304_80915427,cPa62,0.897435897435897,2,80915409,80915352,cPa62_cPa75,35_4,123,57
chr2-81253955_81254057,cPa391,0.5,3,81254056,81254005,cPa293_cPa293-unknown_cPa391,2_1_3,102,51
chr2-81373626_81373728,cPa47,0.333333333333333,5,81373677,81373666,cPa174_cPa174-cPa254-hybrid_cPa254-cPa404-hybrid_cPa425_cPa47,1_1_1_1_2,102,11
chr2-8138160_8138293,cPa75-unknown,1,1,8138241,8138204,cPa75-unknown,5,133,37
chr2-81655515_81655617,cPa62,1,1,81655565,81655537,cPa62,2,102,28
chr2-81982869_81983043,cPa71,0.5,3,81983000,81982907,cPa62_cPa71_cPa75,1_3_2,174,93
chr2-81983221_81983323,cPa71_cPa75,0.5,2,81983271,81983250,cPa71_cPa75,1_1,102,21
chr2-82583037_82583177,cPa173-cPa182-hybrid_cPa357-cPa182-hybrid,0.333333333333333,4,82583177,82583087,cPa173-cPa182-hybrid_cPa173-unknown_cPa205_cPa357-cPa182-hybrid,4_3_1_4,140,90
chr2-82804631_82804733,cPa62,0.923076923076923,4,82804703,82804676,cPa402-cPa62-hybrid_cPa419_cPa62_cPa62-unknown,1_1_36_1,102,27
chr2-83192374_83192476,cPa62,1,1,83192424,83192424,cPa62,1,102,0
chr2-83369947_83370070,HERV-W_repbase_HERV17_LTR17,0.964912280701754,3,83370038,83369953,cPa587_HERV-W_repbase_HERV17_LTR17_HERV-XA34_repbase_HERVFH21I_LTR21A,1_55_1,123,85
chr2-83456930_83457032,cPa62,0.857142857142857,2,83457001,83456935,cPa62_cPa62-cPa75-hybrid,6_1,102,66
chr2-83467832_83467939,cPa62,0.96969696969697,2,83467900,83467879,cPa285-unknown_cPa62,1_32,107,21
chr2-83581333_83581435,cPa456,0.4,6,83581420,83581362,cPa363_cPa363-cPa117-hybrid_cPa456_cPa456-cPa117-hybrid_cPa587-cPa117-hybrid_cPa587-cPa456-hybrid,1_1_4_1_2_1,102,58
chr2-83581755_83581857,cPa456,0.6,2,83581805,83581767,cPa363-cPa117-hybrid_cPa456,2_3,102,38
chr2-84548622_84548724,cPa363_cPa456,0.384615384615385,4,84548702,84548649,cPa363_cPa456_cPa456-cPa117-hybrid_cPa587-cPa117-hybrid,5_5_1_2,102,53
chr2-84635445_84635605,cPa152_cPa201,0.5,2,84635553,84635495,cPa152_cPa201,1_1,160,58
chr2-84682080_84682195,cPa15,0.826086956521739,2,84682145,84682127,cPa118_cPa15,4_19,115,18
chr2-8516933_8517035,cPa75-unknown,0.888888888888889,2,8517034,8516968,cPa62-unknown_cPa75-unknown,1_8,102,66
chr2-85191119_85191231,cPa62,1,1,85191187,85191169,cPa62,16,112,18
chr2-85218765_85219112,cPa62,0.962962962962963,2,85219060,85218815,cPa62_cPa62-unknown,26_1,347,245
chr2-85251428_85251530,cPa62,1,1,85251478,85251478,cPa62,1,102,0
chr2-85547049_85547151,cPa75,1,1,85547099,85547099,cPa75,1,102,0
chr2-85547781_85547899,cPa75,1,1,85547847,85547831,cPa75,13,118,16
chr2-86043582_86043684,cPa248-cPa118-hybrid,1,1,86043632,86043632,cPa248-cPa118-hybrid,1,102,0
chr2-8658291_8658393,cPa339,0.444444444444444,4,8658341,8658299,cPa339_cPa390-cPa444-hybrid_cPa447_cPa62-cPa444-hybrid,4_1_3_1,102,42
chr2-86736925_86737027,cPa545,0.333333333333333,12,86736985,86736924,cPa14-cPa4-hybrid_cPa14-cPa545-hybrid_cPa14-cPa95-hybrid_cPa14-unknown_cPa247-cPa4-hybrid_cPa247-cPa95-hybrid_cPa4_cPa541-cPa95-hybrid_cPa541-unknown_cPa545_cPa545-cPa95-hybrid_cPa95,3_4_5_3_1_1_1_1_2_16_1_10,102,61
chr2-8697529_8697637,cPa15,0.486486486486487,8,8697633,8697547,cPa118_cPa118-unknown_cPa15_cPa15-cPa248-hybrid_cPa443_cPa443-cPa125-hybrid_cPa443-cPa268-hybrid_cPa516-cPa125-hybrid,3_1_18_1_10_1_1_2,108,86
chr2-86980887_86980989,cPa62-unknown,0.416666666666667,9,86980975,86980899,cPa254_cPa285-cPa199-hybrid_cPa293_cPa62_cPa62-cPa425-hybrid_cPa62-cPa505-hybrid_cPa62-cPa75-hybrid_cPa62-unknown_cPa75,1_1_1_3_2_1_3_10_2,102,76
chr2-87019119_87019229,cPa62,0.611111111111111,4,87019177,87019155,cPa62_cPa62-cPa75-hybrid_cPa75_cPa75-cPa62-hybrid,11_2_4_1,110,22
chr2-87019264_87019366,cPa75,1,1,87019314,87019314,cPa75,1,102,0
chr2-87039699_87039801,cPa75-cPa62-hybrid,1,1,87039749,87039708,cPa75-cPa62-hybrid,5,102,41
chr2-87040093_87040195,cPa75-cPa62-hybrid,1,1,87040143,87040143,cPa75-cPa62-hybrid,1,102,0
chr2-87040889_87041001,cPa75-cPa62-hybrid,1,1,87040949,87040928,cPa75-cPa62-hybrid,6,112,21
chr2-87041422_87041697,cPa75-cPa62-hybrid,0.851851851851852,2,87041645,87041472,cPa62_cPa75-cPa62-hybrid,4_23,275,173
chr2-87045285_87045399,cPa62,1,1,87045364,87045334,cPa62,9,114,30
chr2-87232571_87232673,cPa15,0.516129032258065,7,87232661,87232603,cPa118_cPa15_cPa248-cPa118-hybrid_cPa248-unknown_cPa268-cPa118-hybrid_cPa443-cPa118-hybrid_cPa452-cPa118-hybrid,8_16_2_1_2_1_1,102,58
chr2-8727613_8727781,HERV-W_repbase_HERV17_LTR17,0.875,2,8727732,8727663,cPa75_HERV-W_repbase_HERV17_LTR17,1_7,168,69
chr2-8727811_8727913,HERV-W_repbase_HERV17_LTR17,1,1,8727861,8727815,HERV-W_repbase_HERV17_LTR17,8,102,46
chr2-8728022_8728124,HERV-W_repbase_HERV17_LTR17,1,1,8728072,8728027,HERV-W_repbase_HERV17_LTR17,3,102,45
chr2-8728152_8728326,HERV-W_repbase_HERV17_LTR17,0.96,2,8728296,8728201,cPa62_HERV-W_repbase_HERV17_LTR17,1_24,174,95
chr2-87378756_87378865,cPa75,0.36,5,87378853,87378766,cPa62_cPa62-cPa75-hybrid_cPa62-HERV-W_repbase_HERV17_LTR17-hybrid_cPa62-unknown_cPa75,1_4_6_5_9,109,87
chr2-87378876_87379051,cPa75,0.32258064516129,5,87379042,87378906,cPa62_cPa62-cPa75-hybrid_cPa62-HERV-W_repbase_HERV17_LTR17-hybrid_cPa62-unknown_cPa75,1_7_5_8_10,175,136
chr2-87395986_87396094,cPa71,0.5,5,87396094,87396036,cPa16_cPa379_cPa505-cPa16-hybrid_cPa71_cPa71-cPa16-hybrid,1_1_1_4_1,108,58
chr2-8743668_8743770,cPa75,1,1,8743718,8743718,cPa75,1,102,0
chr2-8756653_8756755,cPa251,1,1,8756703,8756703,cPa251,1,102,0
chr2-87682874_87682976,cPa62,0.870967741935484,2,87682924,87682909,cPa285_cPa62,4_27,102,15
chr2-87791389_87791491,cPa62,1,1,87791474,87791439,cPa62,3,102,35
chr2-87791540_87791642,cPa62,1,1,87791590,87791590,cPa62,1,102,0
chr2-87978395_87978497,cPa62,1,1,87978454,87978415,cPa62,9,102,39
chr2-88019087_88019189,cPa15,0.428571428571429,5,88019149,88019108,cPa118_cPa15_cPa248-cPa118-hybrid_cPa248-cPa443-hybrid_cPa443,7_12_1_3_5,102,41
chr2-8837037_8837217,cPa75,0.555555555555556,3,8837165,8837082,cPa75_HERV-W_repbase_HERV17_LTR17-cPa62-hybrid_KWERV_GQ222416-cPa62-hybrid,5_3_1,180,83
chr2-8837971_8838080,cPa75,0.666666666666667,2,8838028,8837999,cPa75_HERV-W_repbase_HERV17_LTR17-cPa75-hybrid,2_1,109,29
chr2-8838865_8838967,cPa75,1,1,8838915,8838915,cPa75,1,102,0
chr2-88397151_88397253,cPa62-cPa587-hybrid_cPa62-unknown,0.5,2,88397201,88397174,cPa62-cPa587-hybrid_cPa62-unknown,1_1,102,27
chr2-88630113_88630232,cPa75,1,1,88630180,88630163,cPa75,19,119,17
chr2-88630720_88630822,cPa75,1,1,88630770,88630744,cPa75,2,102,26
chr2-88630825_88630938,cPa75,1,1,88630899,88630837,cPa75,7,113,62
chr2-88667173_88667275,cPa62,1,1,88667223,88667223,cPa62,1,102,0
chr2-88680574_88680682,cPa456,0.483443708609272,16,88680679,88680584,cPa117-cPa315-hybrid_cPa117-cPa363-hybrid_cPa117-cPa456-hybrid_cPa117-cPa587-hybrid_cPa117-unknown_cPa363_cPa363-cPa587-hybrid_cPa452_cPa452-cPa315-hybrid_cPa452-cPa363-hybrid_cPa452-cPa456-hybrid_cPa452-cPa587-hybrid_cPa452-unknown_cPa456_FeLV_NC001940-unknown_MLV_Pmv4-cPa587-hybrid,1_3_4_7_1_29_2_1_1_10_5_9_3_73_1_1,108,95
chr2-88896298_88896451,cPa62,0.961538461538462,2,88896433,88896320,cPa285_cPa62,1_25,153,113
chr2-89250890_89250992,cPa188-unknown,1,1,89250940,89250940,cPa188-unknown,1,102,0
chr2-89327526_89327683,cPa75-unknown,1,1,89327631,89327556,cPa75-unknown,9,157,75
chr2-89401888_89401991,HERV-W_repbase_HERV17_LTR17,0.8,3,89401976,89401926,cPa419_cPa75_HERV-W_repbase_HERV17_LTR17,1_1_8,103,50
chr2-89402006_89402178,HERV-W_repbase_HERV17_LTR17,0.8125,5,89402177,89402017,cPa62-cPa75-hybrid_cPa75_HERV-W_repbase_HERV17_LTR17_HERV-W_repbase_HERV17_LTR17-cPa75-hybrid_HERV-W_repbase_HERV17_LTR17-unknown,2_4_39_2_1,172,160
chr2-89790006_89790108,cPa15,0.472222222222222,7,89790068,89790045,cPa118_cPa118-cPa443-hybrid_cPa15_cPa248-cPa443-hybrid_cPa248-unknown_cPa268_cPa443,7_1_17_2_1_2_6,102,23
chr2-89890149_89890251,cPa62,0.941176470588235,3,89890217,89890192,cPa254-unknown_cPa293-cPa62-hybrid_cPa62,2_1_48,102,25
chr2-90076154_90076256,cPa75-unknown,1,1,90076204,90076204,cPa75-unknown,1,102,0
chr2-90809107_90809209,cPa113-cPa434-hybrid_HERV-W_repbase_HERV17_LTR17-S71_repbase_HERVS71_LTR6A-hybrid,0.5,2,90809177,90809157,cPa113-cPa434-hybrid_HERV-W_repbase_HERV17_LTR17-S71_repbase_HERVS71_LTR6A-hybrid,1_1,102,20
chr2-90822236_90822338,cPa62,0.75,2,90822286,90822237,cPa62_cPa62-unknown,3_1,102,49
chr2-9112545_9112657,cPa220,0.580645161290323,6,9112632,9112594,cPa104_cPa18-cPa190-hybrid_cPa18-unknown_cPa190_cPa190-cPa220-hybrid_cPa220,4_1_4_3_1_18,112,38
chr2-91173099_91173201,cPa15,0.444444444444444,4,91173167,91173139,cPa118_cPa15_cPa248-cPa118-hybrid_cPa248-unknown,2_4_2_1,102,28
chr2-91258696_91258799,cPa456,0.5,3,91258748,91258717,cPa363_cPa456_cPa456-cPa117-hybrid,1_2_1,103,31
chr2-9129814_9129916,cPa293,0.277777777777778,6,9129880,9129831,cPa287_cPa293_cPa391_cPa391-cPa287-hybrid_cPa426_cPa426-cPa287-hybrid,1_5_4_4_1_3,102,49
chr2-91898478_91898580,cPa287-cPa426-hybrid,0.25,11,91898537,91898512,cPa287_cPa287-cPa293-hybrid_cPa287-cPa391-hybrid_cPa287-cPa426-hybrid_cPa287-unknown_cPa293_cPa293-cPa391-hybrid_cPa293-cPa426-hybrid_cPa391_cPa62_cPa62-cPa391-hybrid,2_1_5_11_1_8_2_4_8_1_1,102,25
chr2-92114116_92114218,cPa62,0.875,2,92114217,92114160,cPa293_cPa62,1_7,102,57
chr2-92122019_92122121,cPa62,1,1,92122069,92122069,cPa62,1,102,0
chr2-92164313_92164415,cPa62-unknown,1,1,92164363,92164354,cPa62-unknown,2,102,9
chr2-92362791_92362893,cPa62,1,1,92362872,92362809,cPa62,13,102,63
chr2-92592174_92592276,cPa541,0.5,4,92592227,92592212,cPa4_cPa4-cPa14-hybrid_cPa4-cPa18-hybrid_cPa541,1_1_1_3,102,15
chr2-92601671_92601822,cPa75,0.55,4,92601805,92601708,cPa419_cPa75_cPa75-cPa62-hybrid_PRIMA41_repbase_PRIMA41_MER41A-cPa62-hybrid,1_11_5_3,151,97
chr2-92602759_92602871,PRIMA41_repbase_PRIMA41_MER41A,0.897959183673469,2,92602838,92602806,cPa75-PRIMA41_repbase_PRIMA41_MER41A-hybrid_PRIMA41_repbase_PRIMA41_MER41A,5_44,112,32
chr2-92614696_92614861,cPa452,1,1,92614809,92614746,cPa452,2,165,63
chr2-92845794_92846339,cPa75,0.6,7,92846287,92845843,cPa260_cPa71-cPa62-hybrid_cPa75_cPa75-cPa62-hybrid_HERV-W_repbase_HERV17_LTR17_HERV-W_repbase_HERV17_LTR17-cPa62-hybrid_SMRV_NC001514-cPa75-hybrid,1_3_36_15_2_2_1,545,444
chr2-92920980_92921082,cPa254,0.357142857142857,6,92921060,92921030,cPa174-cPa404-hybrid_cPa254_cPa254-cPa404-hybrid_cPa404_cPa425_cPa47,3_5_1_1_2_2,102,30
chr2-93007217_93007319,cPa75,1,1,93007267,93007267,cPa75,1,102,0
chr2-93107800_93107902,cPa419,1,1,93107850,93107850,cPa419,1,102,0
chr2-93250798_93250900,cPa450,0.444444444444444,4,93250859,93250832,cPa450_cPa542-cPa223-hybrid_cPa553_cPa553-cPa223-hybrid,4_2_2_1,102,27
chr2-93291159_93291433,cPa75-cPa62-hybrid,0.363636363636364,5,93291428,93291209,cPa62_cPa75_cPa75-cPa546-hybrid_cPa75-cPa62-hybrid_cPa75-unknown,1_3_2_4_1,274,219
chr2-93353365_93353467,cPa75,1,1,93353415,93353415,cPa75,1,102,0
chr2-93476574_93476966,HERV-W_repbase_HERV17_LTR17,0.833333333333333,6,93476944,93476611,cPa419_cPa75_HERV-W_repbase_HERV17_LTR17_KoRV_AF151794_KoRV_AF151794-unknown_PERV_AJ293656,1_1_30_2_1_1,392,333
chr2-93477154_93477258,HERV-W_repbase_HERV17_LTR17,1,1,93477228,93477201,HERV-W_repbase_HERV17_LTR17,4,104,27
chr2-93477409_93477511,HERV-W_repbase_HERV17_LTR17,1,1,93477488,93477459,HERV-W_repbase_HERV17_LTR17,3,102,29
chr2-93477902_93478004,HERV-W_repbase_HERV17_LTR17,1,1,93477952,93477952,HERV-W_repbase_HERV17_LTR17,1,102,0
chr2-93478336_93478438,HERV-W_repbase_HERV17_LTR17,1,1,93478434,93478352,HERV-W_repbase_HERV17_LTR17,4,102,82
chr2-93478461_93478655,HERV-W_repbase_HERV17_LTR17,1,1,93478635,93478508,HERV-W_repbase_HERV17_LTR17,9,194,127
chr2-93479316_93479418,HERV-W_repbase_HERV17_LTR17,0.8,2,93479394,93479364,cPa75-HERV-W_repbase_HERV17_LTR17-hybrid_HERV-W_repbase_HERV17_LTR17,1_4,102,30
chr2-93479462_93479564,HERV-W_repbase_HERV17_LTR17,0.833333333333333,2,93479517,93479473,HERV-W_repbase_HERV17_LTR17_KoRV_AF151794,5_1,102,44
chr2-93479783_93479885,HERV-W_repbase_HERV17_LTR17,1,1,93479833,93479833,HERV-W_repbase_HERV17_LTR17,1,102,0
chr2-93480116_93480276,HERV-W_repbase_HERV17_LTR17,0.666666666666667,4,93480262,93480145,cPa75_cPa75-KoRV_AF151794-hybrid_HERV-W_repbase_HERV17_LTR17_KoRV_AF151794,1_1_6_1,160,117
chr2-93480343_93480445,HERV-W_repbase_HERV17_LTR17,1,1,93480428,93480393,HERV-W_repbase_HERV17_LTR17,4,102,35
chr2-93480853_93480955,HERV-W_repbase_HERV17_LTR17,1,1,93480945,93480865,HERV-W_repbase_HERV17_LTR17,8,102,80
chr2-93581739_93581841,cPa75,0.833333333333333,2,93581794,93581741,cPa75_cPa75-unknown,5_1,102,53
chr2-93581944_93582250,cPa75,0.888888888888889,2,93582198,93581980,cPa75_cPa75-unknown,8_1,306,218
chr2-94084514_94084616,cPa140-cPa118-hybrid,1,1,94084564,94084564,cPa140-cPa118-hybrid,1,102,0
chr2-94085755_94086089,cPa15,0.49618320610687,22,94086089,94085770,cPa118_cPa118-cPa140-hybrid_cPa118-cPa264-hybrid_cPa118-cPa268-hybrid_cPa118-unknown_cPa119-cPa268-hybrid_cPa140_cPa140-cPa268-hybrid_cPa15_cPa15-unknown_cPa248-cPa268-hybrid_cPa248-cPa443-hybrid_cPa264_cPa264-cPa268-hybrid_cPa264-cPa443-hybrid_cPa268_cPa419_cPa443_cPa443-cPa118-hybrid_cPa443-cPa264-hybrid_cPa443-cPa268-hybrid_cPa443-unknown,70_1_1_2_3_1_1_2_130_1_2_1_5_1_1_6_1_15_7_1_7_3,334,319
chr2-94129748_94129866,cPa62_cPa62-unknown,0.272727272727273,6,94129830,94129791,cPa62_cPa62-HERV-W_repbase_HERV17_LTR17-hybrid_cPa62-unknown_cPa75_cPa75-HERV-W_repbase_HERV17_LTR17-hybrid_HERV-W_repbase_HERV17_LTR17,3_1_3_1_1_2,118,39
chr2-94697874_94697976,cPa419,1,1,94697927,94697924,cPa419,2,102,3
chr2-94745944_94746046,cPa419,1,1,94745994,94745994,cPa419,1,102,0
chr2-94777301_94777407,cPa452,0.333333333333333,5,94777362,94777303,cPa363_cPa363-unknown_cPa452_cPa71_cPa71-cPa16-hybrid,4_1_5_4_1,106,59
chr2-94869808_94869910,cPa75,1,1,94869858,94869858,cPa75,1,102,0
chr2-94870454_94870645,cPa75,1,1,94870593,94870504,cPa75,5,191,89
chr2-95051326_95051436,cPa62-unknown,0.375,4,95051430,95051332,cPa293_cPa62-cPa75-hybrid_cPa62-unknown_cPa75,1_4_6_5,110,98
chr2-95054837_95054940,cPa541,0.333333333333333,9,95054902,95054876,cPa104_cPa104-unknown_cPa14_cPa14-cPa220-hybrid_cPa14-cPa541-hybrid_cPa14-unknown_cPa4_cPa4-cPa220-hybrid_cPa541,1_1_3_1_1_2_6_1_8,103,26
chr2-95063513_95063615,cPa419,1,1,95063563,95063563,cPa419,1,102,0
chr2-95140542_95140906,cPa62-unknown,0.769230769230769,8,95140874,95140578,cPa109_cPa201_cPa62_cPa62-cPa71-hybrid_cPa62-unknown_cPa75_cPa75-cPa201-hybrid_cPa75-unknown,1_1_2_3_40_3_1_1,364,296
chr2-9514502_9514612,cPa257_cPa555-cPa130-hybrid,0.5,2,9514560,9514552,cPa257_cPa555-cPa130-hybrid,1_1,110,8
chr2-95176266_95176393,cPa75,1,1,95176342,95176316,cPa75,8,127,26
chr2-95247960_95248062,cPa75,1,1,95248010,95248010,cPa75,1,102,0
chr2-9527735_9527837,cPa62,0.95,2,9527826,9527785,cPa62_cPa62-unknown,19_1,102,41
chr2-95281224_95281326,cPa229-cPa174-hybrid,1,1,95281274,95281274,cPa229-cPa174-hybrid,1,102,0
chr2-95281691_95281874,cPa229-cPa174-hybrid,0.888888888888889,2,95281861,95281725,cPa229-cPa174-hybrid_cPa229-cPa404-hybrid,8_1,183,136
chr2-95281926_95282028,cPa118-cPa229-hybrid_cPa229-cPa174-hybrid,0.5,2,95281976,95281932,cPa118-cPa229-hybrid_cPa229-cPa174-hybrid,1_1,102,44
chr2-95364998_95365100,cPa419,1,1,95365048,95365048,cPa419,1,102,0
chr2-95404933_95405035,cPa15,0.5,3,95405019,95404968,cPa118_cPa15_cPa419,2_3_1,102,51
chr2-95453624_95453726,cPa62,1,1,95453712,95453674,cPa62,2,102,38
chr2-95480574_95480676,cPa363,0.833333333333333,2,95480665,95480609,cPa363_cPa456,5_1,102,56
chr2-95505320_95505422,cPa75,1,1,95505395,95505360,cPa75,4,102,35
chr2-95505753_95506355,cPa62,0.349537037037037,11,95506303,95505759,cPa109_cPa293_cPa293-unknown_cPa62_cPa62-unknown_cPa71-unknown_cPa75_cPa75-unknown_HERV-W_repbase_HERV17_LTR17-unknown_KoRV_AF151794-unknown_KWERV_GQ222416,1_2_2_151_10_34_79_72_79_1_1,602,544
chr2-95575818_95575920,cPa174_cPa254_cPa392_cPa404_cPa425_cPa47,0.166666666666667,6,95575868,95575868,cPa174_cPa254_cPa392_cPa404_cPa425_cPa47,1_1_1_1_1_1,102,0
chr2-95606735_95606906,cPa62_cPa75,0.387096774193548,6,95606880,95606749,cPa62_cPa62-cPa293-hybrid_cPa62-cPa75-hybrid_cPa62-unknown_cPa75_cPa75-unknown,12_3_2_1_12_1,171,131
chr2-95606966_95607220,cPa75,0.625,4,95607214,95606989,cPa62_cPa62-cPa75-hybrid_cPa62-unknown_cPa75,5_2_2_15,254,225
chr2-95625225_95625327,cPa75-cPa419-hybrid,1,1,95625275,95625275,cPa75-cPa419-hybrid,1,102,0
chr2-95626954_95627062,cPa419,1,1,95627015,95626964,cPa419,5,108,51
chr2-95627078_95627396,cPa419,0.96551724137931,2,95627360,95627095,cPa419_cPa419-unknown,28_1,318,265
chr2-95675739_95675841,cPa419,1,1,95675789,95675789,cPa419,1,102,0
chr2-95691125_95691227,cPa176,0.75,4,95691198,95691131,cPa176_cPa371-cPa176-hybrid_cPa371-cPa273-hybrid_cPa587-cPa176-hybrid,9_1_1_1,102,67
chr2-95707221_95707323,cPa15,0.833333333333333,2,95707291,95707271,cPa15_cPa268-cPa118-hybrid,5_1,102,20
chr2-95846324_95846426,cPa62,0.947368421052632,2,95846392,95846362,cPa62_cPa62-unknown,18_1,102,30
chr2-9593199_9593301,cPa62,0.964285714285714,2,9593270,9593242,cPa254-cPa62-hybrid_cPa62,1_27,102,28
chr2-95954352_95954454,cPa223,0.75,2,95954402,95954351,cPa223_cPa392,3_1,102,51
chr2-95980854_95980969,cPa452,0.375,4,95980917,95980904,cPa363_cPa363-unknown_cPa452_cPa71,2_1_3_2,115,13
chr2-96051693_96051910,cPa62-unknown_cPa75,0.32,5,96051903,96051709,cPa62-cPa75-hybrid_cPa62-HERV-W_repbase_HERV17_LTR17-hybrid_cPa62-unknown_cPa75_HERV-W_repbase_HERV17_LTR17,5_2_8_8_2,217,194
chr2-96051921_96052360,cPa75,0.593023255813954,6,96052340,96051920,cPa62_cPa62-cPa75-hybrid_cPa62-HERV-W_repbase_HERV17_LTR17-hybrid_cPa62-unknown_cPa75_HERV-W_repbase_HERV17_LTR17,1_11_8_13_51_2,439,420
chr2-96052423_96052543,cPa75,0.857142857142857,2,96052520,96052464,cPa62-cPa75-hybrid_cPa75,1_6,120,56
chr2-96052698_96052800,cPa62-cPa75-hybrid_cPa75,0.5,2,96052748,96052725,cPa62-cPa75-hybrid_cPa75,2_2,102,23
chr2-96107990_96108092,cPa345,1,1,96108040,96108040,cPa345,1,102,0
chr2-96108847_96108949,cPa345,1,1,96108917,96108870,cPa345,7,102,47
chr2-96109166_96109268,cPa345,1,1,96109259,96109187,cPa345,19,102,72
chr2-96110521_96110623,cPa419,1,1,96110571,96110571,cPa419,1,102,0
chr2-96219211_96219313,cPa75,1,1,96219266,96219261,cPa75,2,102,5
chr2-96221158_96221260,cPa205-cPa16-hybrid,1,1,96221208,96221208,cPa205-cPa16-hybrid,1,102,0
chr2-96224892_96224994,cPa345,1,1,96224942,96224942,cPa345,1,102,0
chr2-96225477_96225631,cPa345,1,1,96225613,96225519,cPa345,12,154,94
chr2-96312655_96312757,cPa419,1,1,96312705,96312705,cPa419,1,102,0
chr2-96313599_96313701,cPa67,1,1,96313685,96313634,cPa67,5,102,51
chr2-96313805_96313950,cPa67,1,1,96313950,96313823,cPa67,25,145,127
chr2-96323755_96323857,cPa357,0.8,2,96323813,96323767,cPa357_cPa419,4_1,102,46
chr2-96459879_96459982,cPa183-cPa176-hybrid_cPa363_cPa452_cPa71,0.25,4,96459930,96459929,cPa183-cPa176-hybrid_cPa363_cPa452_cPa71,1_1_1_1,103,1
chr2-96555540_96555753,cPa260,0.75,2,96555701,96555590,cPa260_cPa260-cPa75-hybrid,3_1,213,111
chr2-96963194_96963296,cPa452-cPa363-hybrid_cPa456,0.5,2,96963244,96963244,cPa452-cPa363-hybrid_cPa456,1_1,102,0
chr2-97040143_97040253,cPa452,0.5,7,97040244,97040154,cPa363_cPa363-cPa71-hybrid_cPa363-unknown_cPa452_cPa452-cPa363-hybrid_cPa71_cPa71-cPa176-hybrid,29_2_1_43_1_9_1,110,90
chr2-97044557_97044777,cPa75,0.862068965517241,3,97044739,97044603,cPa75_cPa75-cPa260-hybrid_cPa75-cPa293-hybrid,25_3_1,220,136
chr2-97045306_97045485,cPa75,0.947368421052632,2,97045481,97045344,cPa62_cPa75,1_18,179,137
chr2-97045873_97046093,cPa75,0.909090909090909,2,97046041,97045908,cPa62_cPa75,1_10,220,133
chr2-97177659_97177784,cPa205,0.380952380952381,5,97177739,97177709,cPa205_cPa205-cPa75-hybrid_cPa61-cPa205-hybrid_cPa61-cPa75-hybrid_HERV-ADP_repbase_HERVP71A_I_LTR71A-cPa75-hybrid,8_5_1_6_1,125,30
chr2-97304852_97305041,cPa62,1,1,97305025,97304854,cPa62,43,189,171
chr2-97382642_97382744,cPa419,1,1,97382692,97382692,cPa419,1,102,0
chr2-97399486_97399591,cPa75,0.666666666666667,2,97399539,97399490,cPa542-cPa75-hybrid_cPa75,1_2,105,49
chr2-97446887_97447005,cPa456,0.294339622641509,15,97447001,97446895,cPa308-cPa117-hybrid_cPa308-cPa363-hybrid_cPa308-cPa452-hybrid_cPa308-cPa456-hybrid_cPa308-unknown_cPa363_cPa363-cPa117-hybrid_cPa363-cPa452-hybrid_cPa363-cPa456-hybrid_cPa452_cPa456_cPa456-cPa117-hybrid_cPa456-cPa363-hybrid_cPa456-unknown_cPa587-cPa117-hybrid,46_5_24_2_4_41_3_2_1_52_78_3_1_1_2,118,106
chr2-97473100_97473202,cPa315-cPa168-hybrid,1,1,97473150,97473150,cPa315-cPa168-hybrid,1,102,0
chr2-97515987_97516152,cPa512,0.954545454545455,2,97516100,97516037,cPa419_cPa512,1_21,165,63
chr2-97520000_97520102,cPa223,0.565217391304348,5,97520088,97520020,cPa223_cPa419-cPa450-hybrid_cPa443-cPa109-hybrid_cPa443-cPa223-hybrid_cPa505-cPa450-hybrid,13_1_4_4_1,102,68
chr2-97520251_97520353,cPa223,1,1,97520301,97520276,cPa223,2,102,25
chr2-97521153_97521282,cPa443-cPa109-hybrid,0.555555555555556,4,97521231,97521176,cPa443-cPa109-hybrid_cPa443-cPa387-hybrid_cPa505-cPa109-hybrid_cPa505-cPa387-hybrid,5_2_1_1,129,55
chr2-97521688_97521790,cPa443-cPa387-hybrid,1,1,97521738,97521738,cPa443-cPa387-hybrid,1,102,0
chr2-97634411_97634513,cPa15,0.428571428571429,4,97634469,97634458,cPa118_cPa118-cPa248-hybrid_cPa15_cPa264-cPa248-hybrid,2_1_3_1,102,11
chr2-97654026_97654139,cPa67,0.975,2,97654130,97654051,cPa15-cPa223-hybrid_cPa67,1_39,113,79
chr2-97654150_97654252,cPa67,1,1,97654245,97654166,cPa67,6,102,79
chr2-97654518_97654620,cPa67,1,1,97654604,97654522,cPa67,7,102,82
chr2-97812774_97812876,cPa273-unknown_cPa450_cPa553,0.333333333333333,3,97812837,97812811,cPa273-unknown_cPa450_cPa553,1_1_1,102,26
chr2-98199673_98199787,cPa529,0.602409638554217,8,98199743,98199678,cPa14-cPa247-hybrid_cPa14-unknown_cPa247_cPa529_cPa545-unknown_cPa95-cPa247-hybrid_cPa95-cPa529-hybrid_cPa95-unknown,1_1_2_50_2_7_2_18,114,65
chr2-982523_982625,cPa75,1,1,982573,982573,cPa75,1,102,0
chr2-98350235_98350337,cPa456-unknown,1,1,98350285,98350285,cPa456-unknown,1,102,0
chr2-98405418_98405520,cPa62,0.941176470588235,3,98405483,98405464,cPa254-unknown_cPa62_cPa62-cPa75-hybrid,1_32_1,102,19
chr2-98550676_98550910,cPa587,0.780487804878049,6,98550909,98550679,cPa363_cPa363-cPa587-hybrid_cPa452_cPa456_cPa587_cPa75,3_3_1_1_32_1,234,230
chr2-98550911_98551013,cPa587,0.80952380952381,4,98551011,98550912,cPa363-cPa117-hybrid_cPa363-cPa456-hybrid_cPa456_cPa587,2_1_1_17,102,99
chr2-98649941_98650043,cPa419,1,1,98649991,98649991,cPa419,1,102,0
chr2-99729498_99729600,cPa425-WDSV_NC001867-hybrid,1,1,99729548,99729548,cPa425-WDSV_NC001867-hybrid,1,102,0
chr2-99741088_99741202,cPa101_cPa142,0.5,2,99741150,99741138,cPa101_cPa142,3_3,114,12
chr2-999592_999706,cPa174,0.32,14,999704,999591,cPa118-cPa254-hybrid_cPa140-cPa254-hybrid_cPa15-cPa47-hybrid_cPa174_cPa174-cPa125-hybrid_cPa174-cPa15-hybrid_cPa174-cPa268-hybrid_cPa248-cPa254-hybrid_cPa254_cPa404_cPa419_cPa425_cPa47_cPa47-cPa15-hybrid,4_1_1_48_1_2_1_1_6_5_2_47_30_1,114,113
chr20-10074834_10074946,cPa15,0.5,3,10074894,10074852,cPa15_cPa248-unknown_cPa268,2_1_1,112,42
chr20-10132702_10132804,cPa62,1,1,10132792,10132715,cPa62,22,102,77
chr20-10195816_10195918,cPa163,0.666666666666667,2,10195878,10195866,cPa163_cPa224,2_1,102,12
chr20-10332986_10333088,cPa75-cPa260-hybrid_cPa75-unknown,0.363636363636364,4,10333071,10332996,cPa62_cPa62-unknown_cPa75-cPa260-hybrid_cPa75-unknown,1_2_4_4,102,75
chr20-10396945_10397047,cPa285_cPa75,0.5,2,10396995,10396969,cPa285_cPa75,1_1,102,26
chr20-1045851_1045953,cPa75_cPa75-unknown,0.5,2,1045901,1045890,cPa75_cPa75-unknown,1_1,102,11
chr20-1048614_1048716,cPa391,1,1,1048664,1048664,cPa391,1,102,0
chr20-10586623_10586725,cPa75,1,1,10586673,10586638,cPa75,9,102,35
chr20-10715144_10715246,cPa118-cPa15-hybrid_cPa248,0.5,2,10715195,10715194,cPa118-cPa15-hybrid_cPa248,1_1,102,1
chr20-10822226_10822359,cPa62,1,1,10822326,10822276,cPa62,3,133,50
chr20-10823140_10823242,cPa62,1,1,10823190,10823190,cPa62,1,102,0
chr20-10869926_10870145,cPa356,0.5,5,10870130,10869944,cPa356_cPa356-cPa428-hybrid_cPa356-unknown_cPa428_cPa428-unknown,96_1_4_90_1,219,186
chr20-10870160_10870363,cPa428,0.52,2,10870318,10870210,cPa356_cPa428,12_13,203,108
chr20-10870376_10870478,cPa356,0.636363636363636,2,10870468,10870394,cPa356_cPa428,7_4,102,74
chr20-10873276_10873475,cPa356,0.516483516483517,3,10873460,10873307,cPa356_cPa428_cPa428-cPa356-hybrid,47_43_1,199,153
chr20-10916509_10916611,cPa363_cPa71,0.333333333333333,4,10916559,10916547,cPa16-cPa223-hybrid_cPa363_cPa452_cPa71,1_2_1_2,102,12
chr20-1094158_1094547,cPa194,0.511111111111111,4,1094537,1094162,cPa194_cPa194-cPa345-hybrid_cPa67_cPa67-cPa345-hybrid,23_2_18_2,389,375
chr20-1094550_1094985,cPa67,0.428571428571429,8,1094933,1094561,cPa194_cPa194-cPa345-hybrid_cPa194-unknown_cPa345_cPa345-cPa194-hybrid_cPa345-cPa67-hybrid_cPa360_cPa67,16_1_1_3_1_1_1_18,435,372
chr20-10988067_10988169,cPa113-unknown_HERV-W_repbase_HERV17_LTR17,0.5,2,10988126,10988117,cPa113-unknown_HERV-W_repbase_HERV17_LTR17,1_1,102,9
chr20-1102803_1102905,cPa75,1,1,1102875,1102853,cPa75,2,102,22
chr20-1103047_1103612,cPa75,1,1,1103560,1103097,cPa75,24,565,463
chr20-1103632_1104042,cPa75,1,1,1104033,1103682,cPa75,30,410,351
chr20-1104045_1104147,cPa75,1,1,1104095,1104095,cPa75,1,102,0
chr20-11244763_11244865,cPa176-cPa363-hybrid,1,1,11244813,11244813,cPa176-cPa363-hybrid,1,102,0
chr20-11469030_11469136,cPa583,0.563492063492063,6,11469134,11469030,cPa358_cPa358-cPa251-hybrid_cPa358-unknown_cPa583_cPa583-cPa254-hybrid_cPa583-cPa260-hybrid,47_3_3_71_1_1,106,104
chr20-11476239_11476365,cPa492,1,1,11476349,11476242,cPa492,88,126,107
chr20-11531896_11532002,cPa308,0.75,2,11531959,11531946,cPa308_cPa308-unknown,6_2,106,13
chr20-11553964_11554066,cPa308-cPa62-hybrid,0.666666666666667,2,11554014,11554001,cPa308-cPa62-hybrid_cPa62,2_1,102,13
chr20-11687615_11687717,cPa583,1,1,11687672,11687651,cPa583,13,102,21
chr20-11812727_11812829,cPa118-cPa248-hybrid_cPa15,0.428571428571429,3,11812782,11812766,cPa118_cPa118-cPa248-hybrid_cPa15,1_3_3,102,16
chr20-11913742_11913844,cPa62,1,1,11913799,11913792,cPa62,2,102,7
chr20-11914693_11914902,cPa16_cPa379,0.222222222222222,7,11914857,11914743,cPa16_cPa16-cPa62-hybrid_cPa16-unknown_cPa183_cPa183-cPa452-hybrid_cPa223_cPa379,2_1_1_1_1_1_2,209,114
chr20-11971079_11971181,cPa194-cPa345-hybrid_cPa67,0.5,2,11971129,11971129,cPa194-cPa345-hybrid_cPa67,1_1,102,0
chr20-11974834_11974936,cPa75,0.5,3,11974884,11974843,cPa62_cPa75_cPa75-cPa62-hybrid,1_2_1,102,41
chr20-12132391_12132493,HFV_NC001736,1,1,12132441,12132409,HFV_NC001736,4,102,32
chr20-12245589_12245691,cPa345,1,1,12245639,12245639,cPa345,1,102,0
chr20-12275197_12275299,cPa543,0.857142857142857,2,12275297,12275247,cPa543_cPa543-cPa327-hybrid,6_1,102,50
chr20-12404126_12404253,cPa75,1,1,12404201,12404168,cPa75,3,127,33
chr20-12435698_12435822,S71_repbase_HERVS71_LTR6A-cPa345-hybrid,0.384615384615385,7,12435799,12435726,cPa67_HERV-F_repbase_HERVFH19I_LTR19A-cPa345-hybrid_HERV-F_repbase_HERVFH19I_LTR19A-cPa67-hybrid_S71_repbase_HERVS71_LTR6A_S71_repbase_HERVS71_LTR6A-cPa327-hybrid_S71_repbase_HERVS71_LTR6A-cPa345-hybrid_S71_repbase_HERVS71_LTR6A-unknown,1_1_2_2_1_5_1,124,73
chr20-12437285_12437478,cPa553,0.290697674418605,24,12437476,12437308,cPa199_cPa199-cPa345-hybrid_cPa199-cPa450-hybrid_cPa199-unknown_cPa223_cPa223-cPa199-hybrid_cPa223-unknown_cPa227_cPa273_cPa273-cPa542-hybrid_cPa273-cPa75-hybrid_cPa273-unknown_cPa345_cPa345-cPa273-hybrid_cPa345-cPa542-hybrid_cPa345-cPa75-hybrid_cPa450_cPa450-unknown_cPa542_cPa542-cPa67-hybrid_cPa542-cPa75-hybrid_cPa542-unknown_cPa553_S71_repbase_HERVS71_LTR6A-cPa199-hybrid,34_1_1_1_5_3_1_1_24_1_1_1_6_2_1_1_17_1_16_1_1_1_50_1,193,168
chr20-12437499_12437662,cPa553,0.356164383561644,16,12437660,12437498,cPa199_cPa199-unknown_cPa223_cPa223-cPa273-hybrid_cPa273_cPa273-unknown_cPa345_cPa345-cPa273-hybrid_cPa345-cPa553-hybrid_cPa345-cPa75-hybrid_cPa450_cPa542_cPa542-cPa199-hybrid_cPa542-cPa75-hybrid_cPa553_cPa67-cPa273-hybrid,19_1_2_2_5_1_2_1_1_1_2_6_1_2_26_1,163,162
chr20-12537536_12537707,cPa333-unknown,0.352941176470588,6,12537705,12537553,cPa260-cPa566-hybrid_cPa260-unknown_cPa333-cPa434-hybrid_cPa333-unknown_cPa419_cPa449-cPa566-hybrid,1_5_3_6_1_1,171,152
chr20-12648964_12649282,cPa323,0.558139534883721,5,12649268,12648971,cPa323_cPa371_cPa371-cPa323-hybrid_cPa371-cPa482-hybrid_cPa50-cPa323-hybrid,24_14_3_1_1,318,297
chr20-12659770_12659924,cPa434-cPa75-hybrid,0.428571428571429,5,12659920,12659774,cPa260_cPa434-cPa75-hybrid_cPa434-unknown_cPa566-cPa75-hybrid_cPa566-unknown,1_3_1_1_1,154,146
chr20-12660014_12660116,cPa434-cPa75-hybrid,0.666666666666667,4,12660113,12660025,cPa260_cPa434_cPa434-cPa75-hybrid_cPa566-cPa75-hybrid,1_1_6_1,102,88
chr20-12660120_12660222,cPa434-cPa75-hybrid,0.571428571428571,2,12660203,12660134,cPa434-cPa75-hybrid_cPa566-cPa75-hybrid,4_3,102,69
chr20-12713645_12713747,cPa75_cPa75-cPa62-hybrid,0.5,2,12713707,12713683,cPa75_cPa75-cPa62-hybrid,2_2,102,24
chr20-12714024_12714126,cPa75,0.8,3,12714110,12714052,cPa260-cPa62-hybrid_cPa260-cPa67-hybrid_cPa75,2_1_12,102,58
chr20-12750041_12750240,cPa323,0.444444444444444,4,12750198,12750091,cPa323_cPa323-cPa371-hybrid_cPa371_cPa482-cPa371-hybrid,4_1_3_1,199,107
chr20-12791277_12791466,cPa452,0.6,3,12791414,12791283,cPa425-unknown_cPa446_cPa452,1_1_3,189,131
chr20-1305663_1305791,cPa75-unknown,1,1,1305776,1305675,cPa75-unknown,9,128,101
chr20-13115233_13115335,cPa75,1,1,13115283,13115283,cPa75,1,102,0
chr20-13154459_13154561,cPa75,0.7,4,13154515,13154466,cPa315_cPa75_HERV-XA34_repbase_HERVFH21I_LTR21A_HERV-XA34_repbase_HERVFH21I_LTR21A-cPa75-hybrid,1_7_1_1,102,49
chr20-13194153_13194255,cPa176,1,1,13194203,13194179,cPa176,5,102,24
chr20-13236156_13236409,cPa208-unknown,1,1,13236357,13236162,cPa208-unknown,36,253,195
chr20-13237394_13237557,cPa381-cPa315-hybrid,0.285714285714286,12,13237505,13237398,CAEV_NC001463_CAEV_NC001463-cPa190-hybrid_CAEV_NC001463-cPa227-hybrid_CAEV_NC001463-cPa315-hybrid_CAEV_NC001463-cPa434-hybrid_cPa260-cPa434-hybrid_cPa381-cPa227-hybrid_cPa381-cPa315-hybrid_cPa381-cPa419-hybrid_cPa381-cPa434-hybrid_cPa434_cPa541-cPa434-hybrid,1_1_1_3_7_1_1_8_1_1_2_1,163,107
chr20-13237753_13238059,cPa541-cPa315-hybrid,0.263888888888889,28,13238057,13237795,CAEV_NC001463_CAEV_NC001463-cPa190-hybrid_CAEV_NC001463-cPa227-hybrid_CAEV_NC001463-cPa315-hybrid_CAEV_NC001463-cPa434-hybrid_cPa167-cPa315-hybrid_cPa167-cPa469-hybrid_cPa208-cPa227-hybrid_cPa208-cPa434-hybrid_cPa260-cPa227-hybrid_cPa260-cPa315-hybrid_cPa260-cPa469-hybrid_cPa315_cPa323-cPa315-hybrid_cPa333-cPa190-hybrid_cPa333-cPa315-hybrid_cPa381-cPa190-hybrid_cPa381-cPa315-hybrid_cPa381-cPa434-hybrid_cPa381-cPa435-hybrid_cPa381-unknown_cPa419_cPa419-cPa113-hybrid_cPa435-cPa315-hybrid_cPa435-cPa434-hybrid_cPa541-cPa227-hybrid_cPa541-cPa315-hybrid_cPa541-cPa434-hybrid,1_3_1_11_1_2_1_1_7_1_18_1_2_1_1_1_5_26_1_1_3_1_1_6_3_1_38_5,306,262
chr20-13238551_13238867,cPa541-cPa113-hybrid,0.357142857142857,8,13238815,13238601,cPa260-cPa113-hybrid_cPa260-cPa553-hybrid_cPa435-cPa113-hybrid_cPa435-cPa553-hybrid_cPa541_cPa541-cPa113-hybrid_cPa541-cPa190-hybrid_cPa541-cPa199-hybrid,1_1_1_1_1_5_3_1,316,214
chr20-13239366_13239508,cPa541-cPa113-hybrid,0.552941176470588,8,13239456,13239416,cPa199_cPa260-cPa113-hybrid_cPa260-cPa345-hybrid_cPa260-cPa553-hybrid_cPa435-cPa113-hybrid_cPa435-cPa199-hybrid_cPa541-cPa113-hybrid_cPa541-cPa553-hybrid,1_23_1_1_9_1_47_2,142,40
chr20-13239528_13239630,cPa541-cPa113-hybrid,1,1,13239578,13239578,cPa541-cPa113-hybrid,3,102,0
chr20-13241319_13241421,HTLV1_NC001436-cPa121-hybrid,1,1,13241369,13241369,HTLV1_NC001436-cPa121-hybrid,1,102,0
chr20-13280707_13280904,cPa140_cPa140-cPa248-hybrid_cPa140-unknown_cPa15_cPa15-cPa248-hybrid_cPa223-unknown_cPa443,0.142857142857143,7,13280871,13280740,cPa140_cPa140-cPa248-hybrid_cPa140-unknown_cPa15_cPa15-cPa248-hybrid_cPa223-unknown_cPa443,1_1_1_1_1_1_1,197,131
chr20-13376996_13377098,cPa75-HERV-W_repbase_HERV17_LTR17-hybrid_HERV-W_repbase_HERV17_LTR17,0.5,2,13377056,13377046,cPa75-HERV-W_repbase_HERV17_LTR17-hybrid_HERV-W_repbase_HERV17_LTR17,1_1,102,10
chr20-13430658_13430760,cPa419-cPa333-hybrid,1,1,13430708,13430708,cPa419-cPa333-hybrid,1,102,0
chr20-13442776_13442994,cPa223,1,1,13442942,13442826,cPa223,12,218,116
chr20-13443395_13443497,cPa223-cPa118-hybrid,1,1,13443445,13443398,cPa223-cPa118-hybrid,4,102,47
chr20-13446502_13446657,cPa254,0.564102564102564,7,13446623,13446539,cPa254_cPa254-cPa392-hybrid_cPa392-cPa254-hybrid_cPa404_cPa47_cPa47-cPa254-hybrid_cPa47-cPa404-hybrid,22_1_2_6_5_2_1,155,84
chr20-13456629_13457031,cPa434,0.989051094890511,3,13456990,13456679,cPa119-unknown_cPa434_cPa434-cPa419-hybrid,2_271_1,402,311
chr20-13471397_13471604,cPa75-unknown,0.826086956521739,4,13471552,13471447,cPa339_cPa75_cPa75-cPa339-hybrid_cPa75-unknown,1_1_2_19,207,105
chr20-13487532_13487634,cPa176_cPa176-cPa452-hybrid,0.5,2,13487605,13487582,cPa176_cPa176-cPa452-hybrid,1_1,102,23
chr20-13626025_13626127,cPa118_cPa15_cPa419,0.333333333333333,3,13626078,13626029,cPa118_cPa15_cPa419,1_1_1,102,49
chr20-13638354_13638483,cPa75,1,1,13638431,13638404,cPa75,18,129,27
chr20-13642792_13642894,cPa587-unknown,0.9,3,13642842,13642842,cPa410-unknown_cPa587-cPa526-hybrid_cPa587-unknown,1_1_18,102,0
chr20-13678818_13678920,cPa482,0.714285714285714,2,13678912,13678854,cPa419_cPa482,2_5,102,58
chr20-13709449_13709551,cPa194-cPa260-hybrid,0.333333333333333,5,13709534,13709469,cPa194_cPa194-cPa260-hybrid_cPa194-cPa67-hybrid_cPa67_cPa67-cPa566-hybrid,1_2_1_1_1,102,65
chr20-13821884_13821986,cPa199,0.842105263157895,3,13821986,13821922,cPa199_cPa199-unknown_cPa482,16_1_2,102,64
chr20-13856500_13856602,cPa363,0.5,4,13856597,13856504,cPa176_cPa363_cPa452_cPa71-cPa174-hybrid,1_3_1_1,102,93
chr20-13930421_13930523,cPa228_cPa75,0.5,2,13930471,13930460,cPa228_cPa75,1_1,102,11
chr20-13930617_13930759,cPa75,1,1,13930707,13930667,cPa75,2,142,40
chr20-14056750_14056852,cPa75,1,1,14056800,14056751,cPa75,4,102,49
chr20-14477873_14477975,cPa542,0.875,2,14477969,14477913,cPa542_cPa542-cPa62-hybrid,7_1,102,56
chr20-14477987_14478089,cPa542,0.875,2,14478038,14478005,cPa542_cPa542-unknown,7_1,102,33
chr20-14478090_14478227,cPa542,1,1,14478176,14478093,cPa542,32,137,83
chr20-14594909_14595011,cPa339,1,1,14594959,14594959,cPa339,1,102,0
chr20-14646940_14647042,cPa363,1,1,14646990,14646990,cPa363,1,102,0
chr20-14819691_14819829,cPa339-cPa62-hybrid,0.0970588235294118,49,14819828,14819740,cPa205-cPa140-hybrid_cPa205-cPa285-hybrid_cPa205-cPa293-hybrid_cPa205-cPa75-hybrid_cPa205-HERV-E_repbase_HERVE_LTR2-hybrid_cPa339-cPa119-hybrid_cPa339-cPa130-hybrid_cPa339-cPa140-hybrid_cPa339-cPa285-hybrid_cPa339-cPa293-hybrid_cPa339-cPa456-hybrid_cPa339-cPa492-hybrid_cPa339-cPa62-hybrid_cPa339-cPa75-hybrid_cPa339-HERV-E_repbase_HERVE_LTR2-hybrid_cPa339-PRIMA41_repbase_PRIMA41_MER41A-hybrid_cPa353-cPa130-hybrid_cPa353-cPa140-hybrid_cPa353-cPa285-hybrid_cPa353-cPa293-hybrid_cPa353-cPa75-hybrid_cPa353-HERV-E_repbase_HERVE_LTR2-hybrid_cPa363-cPa140-hybrid_cPa363-cPa285-hybrid_cPa363-cPa293-hybrid_cPa363-cPa75-hybrid_cPa390-cPa119-hybrid_cPa390-cPa130-hybrid_cPa390-cPa140-hybrid_cPa390-cPa285-hybrid_cPa390-cPa293-hybrid_cPa390-cPa572-hybrid_cPa390-cPa62-hybrid_cPa390-cPa75-hybrid_cPa390-HERV-E_repbase_HERVE_LTR2-hybrid_cPa400-HERV-E_repbase_HERVE_LTR2-hybrid_cPa400-PRIMA41_repbase_PRIMA41_MER41A-hybrid_cPa419_cPa444-cPa140-hybrid_cPa444-cPa285-hybrid_cPa444-cPa293-hybrid_cPa444-cPa456-hybrid_cPa444-cPa62-hybrid_cPa444-cPa74-hybrid_cPa444-cPa75-hybrid_cPa444-HERV-E_repbase_HERVE_LTR2-hybrid_cPa447-cPa285-hybrid_cPa447-HERV-E_repbase_HERVE_LTR2-hybrid_cPa75,1_1_1_1_2_2_1_17_25_30_6_1_33_31_20_2_1_1_2_1_4_3_2_1_2_1_2_2_13_10_14_1_17_17_11_1_1_3_4_12_5_1_7_1_13_7_1_1_4,138,88
chr20-14822014_14822116,cPa339-cPa140-hybrid_cPa339-cPa257-hybrid,0.12,29,14822082,14822013,cPa285-cPa363-hybrid_cPa339-cPa130-hybrid_cPa339-cPa140-hybrid_cPa339-cPa16-hybrid_cPa339-cPa199-hybrid_cPa339-cPa257-hybrid_cPa339-cPa285-hybrid_cPa339-cPa293-hybrid_cPa339-cPa363-hybrid_cPa339-cPa456-hybrid_cPa339-cPa546-hybrid_cPa339-HERV-E_repbase_HERVE_LTR2-hybrid_cPa353-cPa546-hybrid_cPa390-cPa140-hybrid_cPa390-cPa293-hybrid_cPa390-cPa456-hybrid_cPa419_cPa444-cPa109-hybrid_cPa444-cPa119-hybrid_cPa444-cPa140-hybrid_cPa444-cPa285-hybrid_cPa444-cPa546-hybrid_cPa444-cPa572-hybrid_cPa444-HERV-E_repbase_HERVE_LTR2-hybrid_cPa444-MSEV_CT990572-hybrid_cPa447-cPa140-hybrid_cPa447-cPa16-hybrid_cPa447-cPa293-hybrid_cPa447-cPa555-hybrid,3_1_6_1_1_6_1_5_1_1_3_1_1_1_1_1_2_1_1_1_1_1_1_1_1_3_1_1_1,102,69
chr20-14823025_14823178,cPa555,0.4,8,14823177,14823028,cPa130-cPa257-hybrid_cPa285-cPa257-hybrid_cPa285-cPa419-hybrid_cPa285-cPa546-hybrid_cPa285-cPa555-hybrid_cPa419_cPa555_cPa60-cPa257-hybrid,1_7_1_1_1_2_12_5,153,149
chr20-14823629_14823882,cPa482-unknown,0.352380952380952,23,14823830,14823631,cPa285_cPa285-cPa257-hybrid_cPa285-cPa419-hybrid_cPa285-cPa555-hybrid_cPa339-cPa257-hybrid_cPa390-cPa257-hybrid_cPa390-cPa555-hybrid_cPa419_cPa444-MSEV_CT990572-hybrid_cPa456-cPa555-hybrid_cPa482-cPa16-hybrid_cPa482-cPa168-hybrid_cPa482-cPa199-hybrid_cPa482-cPa227-hybrid_cPa482-cPa257-hybrid_cPa482-cPa357-hybrid_cPa482-cPa363-hybrid_cPa482-cPa546-hybrid_cPa482-cPa555-hybrid_cPa482-unknown_cPa555_cPa60-unknown_MSEV_CT990572,1_3_1_1_2_1_1_6_1_1_1_1_1_2_49_10_5_29_13_74_5_1_1,253,199
chr20-14825972_14826074,cPa168-unknown,1,1,14826022,14826022,cPa168-unknown,1,102,0
chr20-14929716_14929818,cPa339_cPa444-cPa447-hybrid_cPa447,0.333333333333333,3,14929796,14929766,cPa339_cPa444-cPa447-hybrid_cPa447,1_1_1,102,30
chr20-154328_154430,cPa62,0.341463414634146,12,154400,154338,cPa410-cPa75-hybrid_cPa419_cPa62_cPa62-cPa410-hybrid_cPa62-cPa71-hybrid_cPa62-HERV-W_repbase_HERV17_LTR17-hybrid_cPa62-unknown_cPa75_cPa75-unknown_HERV-W_repbase_HERV17_LTR17_HERV-W_repbase_HERV17_LTR17-unknown_WDSV_NC001867,1_1_14_1_1_1_3_8_1_1_2_7,102,62
chr20-1860448_1860550,cPa75,1,1,1860498,1860498,cPa75,1,102,0
chr20-1860562_1860664,cPa75,1,1,1860612,1860612,cPa75,1,102,0
chr20-1893727_1893829,cPa62,1,1,1893807,1893777,cPa62,2,102,30
chr20-1928475_1928609,cPa62,1,1,1928557,1928525,cPa62,14,134,32
chr20-2095548_2095650,cPa572-cPa285-hybrid_cPa572-unknown,0.5,2,2095639,2095598,cPa572-cPa285-hybrid_cPa572-unknown,1_1,102,41
chr20-2135813_2135926,cPa404_cPa47,0.5,2,2135874,2135863,cPa404_cPa47,1_1,113,11
chr20-2140347_2140449,cPa199,1,1,2140432,2140386,cPa199,19,102,46
chr20-2367886_2367988,cPa404_cPa47,0.4,3,2367936,2367915,cPa404_cPa47_cPa47-cPa404-hybrid,4_4_2,102,21
chr20-2773658_2773818,cPa75,1,1,2773766,2773708,cPa75,6,160,58
chr20-2773877_2774149,cPa75,1,1,2774097,2773927,cPa75,7,272,170
chr20-2774509_2774611,cPa75,1,1,2774559,2774559,cPa75,1,102,0
chr20-303538_303664,cPa75,1,1,303612,303588,cPa75,2,126,24
chr20-3340227_3340342,cPa75,0.666666666666667,2,3340290,3340277,cPa308-cPa75-hybrid_cPa75,1_2,115,13
chr20-4218072_4218187,cPa452,0.392857142857143,8,4218156,4218074,cPa223-cPa16-hybrid_cPa363_cPa363-cPa16-hybrid_cPa363-cPa452-hybrid_cPa363-unknown_cPa452_cPa71_cPa71-cPa16-hybrid,2_19_2_1_1_22_8_1,115,82
chr20-4480808_4480910,cPa62,1,1,4480887,4480858,cPa62,4,102,29
chr20-5163221_5163323,cPa15,1,1,5163292,5163271,cPa15,3,102,21
chr20-5234985_5235087,cPa168-cPa450-hybrid_cPa450,0.5,2,5235046,5235006,cPa168-cPa450-hybrid_cPa450,2_2,102,40
chr20-5416960_5417259,cPa62,0.55,3,5417247,5417010,cPa62_cPa62-cPa75-hybrid_cPa75,11_8_1,299,237
chr20-5417458_5417560,cPa62-cPa75-hybrid,1,1,5417508,5417508,cPa62-cPa75-hybrid,1,102,0
chr20-5417574_5417832,cPa62-cPa75-hybrid,0.888888888888889,2,5417780,5417609,cPa285-cPa75-hybrid_cPa62-cPa75-hybrid,1_8,258,171
chr20-5857034_5857210,cPa62,0.851851851851852,5,5857199,5857033,cPa285_cPa285-unknown_cPa293_cPa62_HERV30_repbase_HERV30I_LTR30,2_1_8_69_1,176,166
chr20-6004334_6004436,cPa75,1,1,6004384,6004384,cPa75,1,102,0
chr20-6105573_6105675,HML8_repbase_HERVK11I_MER11A-cPa419-hybrid,1,1,6105623,6105623,HML8_repbase_HERVK11I_MER11A-cPa419-hybrid,1,102,0
chr20-6456436_6456595,cPa62-cPa75-hybrid,0.363636363636364,6,6456584,6456454,cPa62_cPa62-cPa75-hybrid_cPa62-HERV-W_repbase_HERV17_LTR17-hybrid_cPa62-unknown_cPa75_cPa75-unknown,1_8_5_1_6_1,159,130
chr20-6456818_6456920,cPa62-cPa75-hybrid,1,1,6456868,6456868,cPa62-cPa75-hybrid,1,102,0
chr20-6634395_6634497,cPa118_cPa248-unknown_cPa443,0.285714285714286,4,6634449,6634445,cPa118_cPa15_cPa248-unknown_cPa443,2_1_2_2,102,4
chr20-6648478_6648580,cPa118_cPa15,0.5,2,6648528,6648519,cPa118_cPa15,1_1,102,9
chr20-6860534_6860636,cPa75,1,1,6860584,6860584,cPa75,1,102,0
chr20-6860827_6860929,cPa75,1,1,6860877,6860877,cPa75,1,102,0
chr20-6861341_6861443,cPa75,1,1,6861391,6861391,cPa75,1,102,0
chr20-7425746_7425848,cPa62,1,1,7425823,7425790,cPa62,8,102,33
chr20-7563944_7564046,cPa419,1,1,7563994,7563994,cPa419,1,102,0
chr20-7649698_7649868,cPa75-unknown,0.75,2,7649816,7649710,cPa75_cPa75-unknown,1_3,170,106
chr20-7915427_7915529,cPa452,0.483870967741935,3,7915513,7915440,cPa363_cPa452_cPa71,8_15_8,102,73
chr20-7915674_7915776,cPa452,0.448275862068966,4,7915776,7915713,cPa363_cPa452_cPa452-cPa363-hybrid_cPa71,8_13_1_7,102,63
chr20-847819_847921,cPa260_cPa62_WDSV_NC001867,0.333333333333333,3,847890,847869,cPa260_cPa62_WDSV_NC001867,1_1_1,102,21
chr20-849157_849282,cPa117,1,1,849245,849183,cPa117,70,125,62
chr20-8955827_8955929,cPa75,1,1,8955877,8955877,cPa75,1,102,0
chr20-9588674_9588822,HERV-W_repbase_HERV17_LTR17,1,1,9588770,9588681,HERV-W_repbase_HERV17_LTR17,16,148,89
chr20-9588853_9589069,HERV-W_repbase_HERV17_LTR17,0.928571428571429,2,9589056,9588887,HERV-W_repbase_HERV17_LTR17_KoRV_AF151794,13_1,216,169
chr20-9589170_9589709,HERV-W_repbase_HERV17_LTR17,0.967741935483871,3,9589677,9589192,cPa75-HERV-W_repbase_HERV17_LTR17-hybrid_HERV-W_repbase_HERV17_LTR17_HERV-W_repbase_HERV17_LTR17-cPa75-hybrid,1_60_1,539,485
chr20-9604789_9604891,cPa62,1,1,9604840,9604822,cPa62,9,102,18
chr20-9751215_9751459,HERV-W_repbase_HERV17_LTR17,0.806451612903226,7,9751420,9751232,cPa62_cPa75_cPa75-cPa62-hybrid_HERV-W_repbase_HERV17_LTR17_HERV-W_repbase_HERV17_LTR17-cPa62-hybrid_HERV-W_repbase_HERV17_LTR17-unknown_KoRV_AF151794,1_1_1_25_1_1_1,244,188
chr20-9751480_9751582,cPa75-cPa62-hybrid_HERV-W_repbase_HERV17_LTR17,0.5,2,9751556,9751530,cPa75-cPa62-hybrid_HERV-W_repbase_HERV17_LTR17,1_1,102,26
chr20-9751628_9751762,HERV-W_repbase_HERV17_LTR17,0.636363636363636,3,9751747,9751639,cPa75-cPa62-hybrid_HERV-W_repbase_HERV17_LTR17_HERV-W_repbase_HERV17_LTR17-cPa62-hybrid,1_7_3,134,108
chr20-9751945_9752096,HERV-W_repbase_HERV17_LTR17,0.714285714285714,2,9752044,9751971,HERV-W_repbase_HERV17_LTR17_HERV-W_repbase_HERV17_LTR17-cPa62-hybrid,5_2,151,73
chr20-9752228_9752330,HERV-W_repbase_HERV17_LTR17,0.8,2,9752278,9752237,HERV-W_repbase_HERV17_LTR17_HERV-W_repbase_HERV17_LTR17-cPa62-hybrid,4_1,102,41
chr21-108674_109108,cPa75-unknown,0.294117647058824,6,109056,108724,cPa117_cPa452_cPa452-unknown_cPa75-cPa117-hybrid_cPa75-cPa452-hybrid_cPa75-unknown,4_2_1_3_2_5,434,332
chr21-1092930_1093032,cPa75,1,1,1092980,1092980,cPa75,1,102,0
chr21-110334_110436,cPa75,1,1,110384,110384,cPa75,1,102,0
chr21-110705_110807,cPa75,1,1,110755,110755,cPa75,1,102,0
chr21-110844_111046,cPa75,1,1,110994,110855,cPa75,5,202,139
chr21-111199_111531,cPa75,1,1,111514,111249,cPa75,7,332,265
chr21-111871_112155,cPa75,1,1,112103,111921,cPa75,9,284,182
chr21-1159556_1159658,cPa75-unknown,1,1,1159606,1159606,cPa75-unknown,1,102,0
chr21-1167183_1167285,cPa75,1,1,1167233,1167233,cPa75,1,102,0
chr21-1174574_1174676,cPa62,1,1,1174624,1174624,cPa62,1,102,0
chr21-1175420_1175522,cPa62,1,1,1175470,1175470,cPa62,1,102,0
chr21-1175611_1175713,cPa62,1,1,1175661,1175614,cPa62,3,102,47
chr21-1175792_1175915,cPa62,0.666666666666667,2,1175863,1175804,cPa62_cPa75-cPa62-hybrid,4_2,123,59
chr21-1251446_1251548,cPa118_cPa268-cPa15-hybrid,0.5,2,1251513,1251496,cPa118_cPa268-cPa15-hybrid,1_1,102,17
chr21-1265303_1265498,cPa75,1,1,1265471,1265353,cPa75,5,195,118
chr21-1283306_1283408,cPa75,1,1,1283375,1283355,cPa75,9,102,20
chr21-1283478_1283586,cPa75,1,1,1283551,1283485,cPa75,8,108,66
chr21-1337054_1337161,cPa75,1,1,1337109,1337104,cPa75,4,107,5
chr21-1337226_1337336,cPa75,1,1,1337284,1337276,cPa75,5,110,8
chr21-1340930_1341032,HERV-W_repbase_HERV17_LTR17,0.75,2,1341001,1340962,HERV-W_repbase_HERV17_LTR17_HERV-W_repbase_HERV17_LTR17-unknown,3_1,102,39
chr21-1348013_1348115,cPa75-cPa62-hybrid,1,1,1348063,1348063,cPa75-cPa62-hybrid,1,102,0
chr21-1348764_1348867,cPa75-cPa62-hybrid,1,1,1348815,1348814,cPa75-cPa62-hybrid,2,103,1
chr21-1349002_1349278,cPa62,0.7,3,1349229,1349052,Cer1_U15406_cPa62_cPa75-Cer1_U15406-hybrid,2_7_1,276,177
chr21-1349896_1350150,cPa75,1,1,1350098,1349946,cPa75,5,254,152
chr21-1354256_1354358,FeFV_NC001871-cPa75-hybrid,1,1,1354306,1354306,FeFV_NC001871-cPa75-hybrid,1,102,0
chr21-1357599_1357752,cPa75-cPa260-hybrid,0.8,2,1357700,1357649,cPa75_cPa75-cPa260-hybrid,1_4,153,51
chr21-1357767_1357869,cPa75-cPa260-hybrid,1,1,1357817,1357817,cPa75-cPa260-hybrid,1,102,0
chr21-1357922_1358029,cPa75-cPa260-hybrid,1,1,1357977,1357972,cPa75-cPa260-hybrid,2,107,5
chr21-1362933_1363035,cPa293_cPa293-unknown,0.5,2,1362983,1362962,cPa293_cPa293-unknown,1_1,102,21
chr21-1372422_1372524,cPa75-cPa199-hybrid,1,1,1372472,1372472,cPa75-cPa199-hybrid,1,102,0
chr21-1372716_1372818,cPa199,1,1,1372767,1372720,cPa199,6,102,47
chr21-1373074_1373270,cPa199,0.958333333333333,2,1373264,1373078,cPa199_cPa413-cPa199-hybrid,23_1,196,186
chr21-1373374_1373478,cPa199,1,1,1373469,1373404,cPa199,7,104,65
chr21-1373592_1373694,cPa199,1,1,1373642,1373642,cPa199,1,102,0
chr21-1373717_1373819,cPa199,1,1,1373767,1373767,cPa199,1,102,0
chr21-1374031_1374133,cPa199,1,1,1374081,1374062,cPa199,3,102,19
chr21-155109_155211,cPa254_cPa62,0.5,2,155159,155156,cPa254_cPa62,2_2,102,3
chr21-1574491_1574593,cPa15,0.5,3,1574541,1574530,cPa118_cPa118-cPa268-hybrid_cPa15,2_1_3,102,11
chr21-158678_158780,cPa75,1,1,158728,158728,cPa75,1,102,0
chr21-160664_160766,cPa75,1,1,160717,160714,cPa75,3,102,3
chr21-161513_161615,cPa75,1,1,161563,161563,cPa75,1,102,0
chr21-184995_185097,cPa75,1,1,185062,185045,cPa75,3,102,17
chr21-185356_186010,cPa75,1,1,185958,185406,cPa75,14,654,552
chr21-186293_186411,cPa75,1,1,186366,186343,cPa75,10,118,23
chr21-186467_186686,cPa75,1,1,186634,186516,cPa75,13,219,118
chr21-186741_186843,cPa75,1,1,186827,186791,cPa75,2,102,36
chr21-1884556_1884658,cPa163,0.75,2,1884609,1884593,cPa163_cPa224-unknown,6_2,102,16
chr21-1898155_1898257,cPa182-unknown,1,1,1898205,1898205,cPa182-unknown,1,102,0
chr21-1898805_1898907,cPa182-cPa475-hybrid,1,1,1898855,1898855,cPa182-cPa475-hybrid,1,102,0
chr21-1917252_1917354,cPa118-cPa475-hybrid,1,1,1917302,1917302,cPa118-cPa475-hybrid,1,102,0
chr21-1919550_1919658,cPa345,0.545454545454545,4,1919658,1919590,cPa140-cPa345-hybrid_cPa140-cPa527-hybrid_cPa15_cPa345,1_1_3_6,108,68
chr21-1919845_1919947,cPa15,0.6,3,1919898,1919845,cPa15_cPa15-cPa118-hybrid_cPa345,3_1_1,102,53
chr21-1921729_1921833,cPa15,0.833333333333333,2,1921804,1921771,cPa125-cPa167-hybrid_cPa15,1_5,104,33
chr21-192352_192465,cPa75,1,1,192413,192402,cPa75,2,113,11
chr21-1949058_1949188,cPa75,0.583333333333333,3,1949156,1949108,cPa107_cPa75_cPa75-unknown,1_7_4,130,48
chr21-1949249_1949351,cPa75-unknown,0.923076923076923,2,1949346,1949286,cPa75_cPa75-unknown,1_12,102,60
chr21-195478_195654,cPa75,1,1,195602,195528,cPa75,3,176,74
chr21-195791_195948,cPa75,1,1,195896,195841,cPa75,4,157,55
chr21-195982_196084,cPa75,1,1,196032,196032,cPa75,1,102,0
chr21-19650_19821,cPa308_cPa353,0.5,2,19769,19700,cPa308_cPa353,1_1,171,69
chr21-2061837_2061981,cPa75-unknown,0.8,2,2061929,2061887,cPa75_cPa75-unknown,1_4,144,42
chr21-2067922_2068024,cPa62,1,1,2067987,2067942,cPa62,5,102,45
chr21-214096_214198,cPa75,1,1,214146,214146,cPa75,1,102,0
chr21-214202_214304,cPa75,1,1,214252,214208,cPa75,3,102,44
chr21-2170858_2170960,cPa75,1,1,2170908,2170908,cPa75,1,102,0
chr21-2171071_2171225,cPa75,1,1,2171173,2171121,cPa75,2,154,52
chr21-226119_226375,cPa75,1,1,226323,226169,cPa75,5,256,154
chr21-226932_227034,cPa75,1,1,226982,226982,cPa75,1,102,0
chr21-232194_232383,cPa75,1,1,232331,232244,cPa75,7,189,87
chr21-232907_233030,cPa75,1,1,232978,232957,cPa75,3,123,21
chr21-233542_233680,cPa75,1,1,233628,233592,cPa75,3,138,36
chr21-234103_234226,cPa75,1,1,234174,234153,cPa75,2,123,21
chr21-2403295_2403409,cPa293_cPa391_cPa426,0.285714285714286,4,2403357,2403345,cPa293_cPa391_cPa419_cPa426,2_2_1_2,114,12
chr21-2476949_2477063,Cer1_U15406-unknown_cPa449-unknown,0.5,2,2477011,2476999,Cer1_U15406-unknown_cPa449-unknown,1_1,114,12
chr21-2510274_2510384,cPa62,0.666666666666667,2,2510332,2510324,cPa62_HERV-XA34_repbase_HERVFH21I_LTR21A-cPa62-hybrid,2_1,110,8
chr21-2783718_2783830,cPa419-cPa356-hybrid,0.666666666666667,3,2783780,2783720,cPa419_cPa419-cPa356-hybrid_cPa419-cPa428-hybrid,1_30_14,112,60
chr21-2784069_2784195,cPa419-cPa356-hybrid,0.923076923076923,2,2784146,2784075,cPa419-cPa356-hybrid_cPa419-cPa428-hybrid,12_1,126,71
chr21-2938177_2938307,cPa106,1,1,2938265,2938227,cPa106,4,130,38
chr21-295336_295451,cPa75,1,1,295402,295386,cPa75,3,115,16
chr21-295510_295739,cPa75,1,1,295688,295560,cPa75,16,229,128
chr21-295755_296141,cPa75,1,1,296089,295805,cPa75,10,386,284
chr21-296221_296343,cPa75,1,1,296291,296271,cPa75,5,122,20
chr21-2962281_2962383,cPa118-cPa248-hybrid,1,1,2962331,2962331,cPa118-cPa248-hybrid,1,102,0
chr21-2962422_2962524,cPa118,1,1,2962472,2962472,cPa118,1,102,0
chr21-296428_296531,cPa75,1,1,296479,296478,cPa75,2,103,1
chr21-301863_301965,cPa75,1,1,301913,301913,cPa75,1,102,0
chr21-302055_302213,cPa75,1,1,302161,302080,cPa75,18,158,81
chr21-305217_305319,cPa75,1,1,305267,305267,cPa75,1,102,0
chr21-3208973_3209075,cPa62,1,1,3209065,3208975,cPa62,8,102,90
chr21-3227927_3228029,cPa363,0.5,3,3227977,3227976,cPa363_cPa452_cPa71,3_2_1,102,1
chr21-3249243_3249345,cPa371,0.474576271186441,8,3249333,3249256,cPa323_cPa323-cPa333-hybrid_cPa323-cPa50-hybrid_cPa371_cPa371-cPa323-hybrid_cPa371-cPa50-hybrid_cPa371-cPa568-hybrid_cPa371-unknown,17_1_2_28_6_1_1_3,102,77
chr21-3249606_3249714,cPa323,0.555555555555556,2,3249693,3249624,cPa323_cPa371,5_4,108,69
chr21-3492486_3492588,cPa308-unknown,1,1,3492536,3492536,cPa308-unknown,1,102,0
chr21-3654963_3655065,cPa413,0.634146341463415,7,3655025,3654999,cPa260-cPa273-hybrid_cPa260-cPa75-hybrid_cPa273_cPa413_cPa413-cPa273-hybrid_cPa542_cPa542-cPa273-hybrid,3_1_5_26_3_1_2,102,26
chr21-3832759_3832861,cPa62,1,1,3832809,3832788,cPa62,2,102,21
chr21-4175860_4176059,cPa323,0.5,4,4176041,4175881,cPa323_cPa371_cPa50_cPa568,20_16_1_3,199,160
chr21-4176175_4176359,cPa371,0.557692307692308,6,4176345,4176211,cPa323_cPa323-unknown_cPa371_cPa50-unknown_cPa568_cPa568-cPa371-hybrid,18_1_29_1_2_1,184,134
chr21-4176376_4176554,cPa371,0.716981132075472,5,4176548,4176381,cPa323_cPa323-unknown_cPa371_cPa50-cPa323-hybrid_cPa50-cPa371-hybrid,11_1_38_2_1,178,167
chr21-4585212_4585321,cPa199_cPa553,0.2,10,4585321,4585211,cPa199_cPa199-cPa542-hybrid_cPa199-unknown_cPa223_cPa223-unknown_cPa273_cPa345-unknown_cPa482_cPa542_cPa553,4_1_1_1_1_2_1_2_3_4,109,110
chr21-4585328_4585430,cPa273,0.5,3,4585418,4585347,cPa199_cPa273_cPa553,1_2_1,102,71
chr21-4585468_4585572,cPa199_cPa199-unknown_cPa273_cPa542,0.2,6,4585548,4585518,cPa199_cPa199-unknown_cPa273_cPa482_cPa542_cPa553,2_2_2_1_2_1,104,30
chr21-4653660_4653763,cPa163,0.75,3,4653739,4653704,cPa163_cPa224_cPa360,6_1_1,103,35
chr21-4739925_4740027,HFV_NC001736,1,1,4739975,4739975,HFV_NC001736,1,102,0
chr21-4808491_4808593,cPa223,1,1,4808541,4808541,cPa223,1,102,0
chr21-4819235_4819426,WDSV_NC001867,0.714285714285714,3,4819403,4819285,WDSV_NC001867_WDSV_NC001867-cPa273-hybrid_WDSV_NC001867-cPa345-hybrid,5_1_1,191,118
chr21-4875558_4875660,cPa371,0.428571428571429,4,4875657,4875563,cPa323_cPa323-cPa371-hybrid_cPa323-cPa542-hybrid_cPa371,4_2_2_6,102,94
chr21-4875674_4875776,cPa371,0.777777777777778,2,4875775,4875718,cPa323_cPa371,2_7,102,57
chr21-4899724_4899908,cPa75,0.591836734693878,5,4899895,4899766,cPa62_cPa62-cPa75-hybrid_cPa62-unknown_cPa75_HERV-W_repbase_HERV17_LTR17,7_8_2_29_3,184,129
chr21-4899978_4900350,cPa75,0.65625,6,4900323,4899998,cPa62_cPa62-cPa75-hybrid_cPa62-HERV-W_repbase_HERV17_LTR17-hybrid_cPa62-unknown_cPa75_HERV-W_repbase_HERV17_LTR17,13_3_1_2_42_3,372,325
chr21-4935149_4935251,cPa62_cPa62-WDSV_NC001867-hybrid,0.5,2,4935247,4935199,cPa62_cPa62-WDSV_NC001867-hybrid,2_2,102,48
chr21-4939234_4939336,cPa62,0.375,9,4939316,4939246,cPa413_cPa62_cPa62-cPa293-hybrid_cPa62-cPa413-hybrid_cPa62-cPa75-hybrid_cPa62-unknown_cPa62-WDSV_NC001867-hybrid_cPa75_WDSV_NC001867,1_9_1_1_1_4_4_1_2,102,70
chr21-4975864_4975966,cPa75-cPa260-hybrid,1,1,4975914,4975914,cPa75-cPa260-hybrid,1,102,0
chr21-4977928_4978150,cPa62,0.666666666666667,3,4978098,4977978,cPa254_cPa62_WDSV_NC001867-cPa254-hybrid,1_4_1,222,120
chr21-5014980_5015082,cPa16,0.714285714285714,3,5015065,5014981,cPa16_cPa183-cPa379-hybrid_cPa379,15_1_5,102,84
chr21-5023841_5023943,HERV-W_repbase_HERV17_LTR17,0.8,2,5023931,5023890,HERV-W_repbase_HERV17_LTR17_HERV-W_repbase_HERV17_LTR17-unknown,4_1,102,41
chr21-5050386_5050488,cPa75,1,1,5050436,5050436,cPa75,1,102,0
chr21-5137350_5137452,cPa62,1,1,5137417,5137400,cPa62,2,102,17
chr21-5195246_5195348,cPa62,1,1,5195296,5195283,cPa62,3,102,13
chr21-5228373_5228479,cPa544,0.76,4,5228427,5228412,cPa255-unknown_cPa419_cPa544_cPa551,1_2_19_3,106,15
chr21-5399609_5399711,cPa505,1,1,5399659,5399659,cPa505,1,102,0
chr21-5602678_5602780,cPa452,0.636363636363636,5,5602775,5602687,cPa176-cPa379-hybrid_cPa176-cPa419-hybrid_cPa363_cPa446_cPa452,1_1_1_1_7,102,88
chr21-5945363_5945465,cPa450,0.4,4,5945415,5945369,cPa273_cPa273-cPa482-hybrid_cPa450_cPa482,2_1_4_3,102,46
chr21-5953913_5954050,cPa539,0.5,5,5954024,5953963,cPa199_cPa381_cPa381-cPa539-hybrid_cPa381-unknown_cPa539,1_1_1_1_4,137,61
chr21-5954100_5954202,cPa539,0.571428571428571,7,5954195,5954140,cPa199_cPa381_cPa381-cPa539-hybrid_cPa381-unknown_cPa482-cPa539-hybrid_cPa505-unknown_cPa539,1_1_1_1_1_1_8,102,55
chr21-6035525_6035641,cPa199,0.909090909090909,2,6035638,6035570,cPa199_cPa199-unknown,20_2,116,68
chr21-6103306_6103799,cPa75-unknown,0.517241379310345,6,6103747,6103307,cPa260_cPa293_cPa482-cPa260-hybrid_cPa553_cPa62-unknown_cPa75-unknown,3_1_1_1_8_15,493,440
chr21-6218058_6218160,cPa539,1,1,6218108,6218108,cPa539,1,102,0
chr21-6219786_6219888,cPa62,1,1,6219836,6219836,cPa62,1,102,0
chr21-6220451_6220553,cPa62,1,1,6220549,6220501,cPa62,2,102,48
chr21-6221255_6221357,cPa62,1,1,6221305,6221305,cPa62,1,102,0
chr21-6253725_6253914,cPa260,0.727272727272727,4,6253898,6253775,cPa260_cPa285-cPa260-hybrid_cPa293-cPa260-hybrid_cPa572-cPa62-hybrid,8_1_1_1,189,123
chr21-6281276_6281389,cPa260,0.925925925925926,3,6281376,6281277,cPa260_cPa62-cPa260-hybrid_cPa75-cPa260-hybrid,25_1_1,113,99
chr21-6934240_6934342,cPa419_cPa62,0.5,2,6934326,6934290,cPa419_cPa62,1_1,102,36
chr21-6993568_6993670,cPa199-cPa62-hybrid_cPa75-cPa117-hybrid,0.5,2,6993665,6993618,cPa199-cPa62-hybrid_cPa75-cPa117-hybrid,1_1,102,47
chr21-6993693_6993795,cPa117,1,1,6993743,6993743,cPa117,1,102,0
chr21-7340264_7340448,cPa75,1,1,7340396,7340282,cPa75,7,184,114
chr21-7467421_7467589,cPa75-unknown,0.6,3,7467537,7467465,cPa75_cPa75-cPa585-hybrid_cPa75-unknown,3_1_6,168,72
chr21-7467627_7467863,cPa75,0.636363636363636,3,7467811,7467639,cPa75_cPa75-cPa552-hybrid_cPa75-unknown,14_1_7,236,172
chr21-7484214_7484404,cPa539,0.333333333333333,5,7484402,7484264,cPa199_cPa345-cPa553-hybrid_cPa539_cPa539-cPa553-hybrid_cPa539-unknown,1_1_2_1_1,190,138
chr21-7570327_7570429,cPa419,1,1,7570377,7570377,cPa419,1,102,0
chr21-759807_759909,cPa67,1,1,759857,759857,cPa67,1,102,0
chr21-7706852_7706954,cPa75,1,1,7706902,7706902,cPa75,1,102,0
chr21-7806475_7806577,cPa75,1,1,7806525,7806525,cPa75,1,102,0
chr21-805897_806572,cPa428,0.613636363636364,3,806520,805947,cPa356_cPa356-cPa428-hybrid_cPa428,16_1_27,675,573
chr21-816675_816811,cPa75_cPa75-unknown,0.5,2,816808,816725,cPa75_cPa75-unknown,3_3,136,83
chr21-831748_831850,cPa75,1,1,831798,831798,cPa75,1,102,0
chr21-831897_832006,cPa75,1,1,831954,831947,cPa75,2,109,7
chr21-832020_832434,cPa75,1,1,832382,832070,cPa75,12,414,312
chr21-832481_832630,cPa75,1,1,832578,832531,cPa75,2,149,47
chr21-832656_832758,cPa75,1,1,832706,832706,cPa75,1,102,0
chr21-832865_833000,cPa75,1,1,832948,832915,cPa75,2,135,33
chr21-833146_833311,cPa75,1,1,833259,833196,cPa75,4,165,63
chr21-846652_846754,cPa75,1,1,846702,846702,cPa75,1,102,0
chr21-847242_847344,cPa75,1,1,847292,847292,cPa75,1,102,0
chr21-937391_937493,cPa75,1,1,937441,937441,cPa75,1,102,0
chr21-943961_944095,cPa75,1,1,944060,944010,cPa75,18,134,50
chr21-960842_960944,cPa75,1,1,960922,960892,cPa75,2,102,30
chr21-987965_988067,cPa75,1,1,988015,988015,cPa75,1,102,0
chr21-988085_988455,cPa75,0.777777777777778,3,988403,988135,cPa75_cPa75-cPa285-hybrid_cPa75-cPa62-hybrid,14_1_3,370,268
chr21-988501_988668,cPa75,1,1,988616,988551,cPa75,2,167,65
chr21-988708_989064,cPa75,0.789473684210526,3,989012,988758,cPa75_cPa75-cPa285-hybrid_cPa75-cPa62-hybrid,15_1_3,356,254
chr22-1058401_1058503,cPa75,1,1,1058451,1058451,cPa75,1,102,0
chr22-1058596_1058716,cPa75,1,1,1058664,1058646,cPa75,2,120,18
chr22-1092394_1092509,cPa75,1,1,1092457,1092429,cPa75,3,115,28
chr22-110708_110810,cPa75,1,1,110758,110758,cPa75,1,102,0
chr22-110831_111048,cPa75,1,1,110996,110881,cPa75,4,217,115
chr22-111368_111637,cPa75,0.928571428571429,2,111585,111418,cPa107-cPa75-hybrid_cPa75,1_13,269,167
chr22-111691_111793,cPa75,1,1,111754,111741,cPa75,2,102,13
chr22-1124749_1124851,cPa75,1,1,1124799,1124799,cPa75,1,102,0
chr22-1135304_1135406,cPa75,1,1,1135354,1135354,cPa75,1,102,0
chr22-1135652_1135768,cPa75,1,1,1135716,1135702,cPa75,2,116,14
chr22-1135784_1135920,cPa75,1,1,1135868,1135834,cPa75,2,136,34
chr22-1158848_1158950,cPa75,1,1,1158898,1158898,cPa75,1,102,0
chr22-1158961_1159063,cPa75,1,1,1159011,1159011,cPa75,1,102,0
chr22-1159573_1160190,cPa75,1,1,1160150,1159623,cPa75,37,617,527
chr22-1185130_1185341,WDSV_NC001867,1,1,1185289,1185180,WDSV_NC001867,13,211,109
chr22-1266685_1266787,cPa539-cPa446-hybrid,1,1,1266735,1266718,cPa539-cPa446-hybrid,4,102,17
chr22-128588_128690,cPa75,1,1,128638,128638,cPa75,1,102,0
chr22-129689_129797,cPa75,1,1,129745,129739,cPa75,2,108,6
chr22-1300388_1300490,cPa486-cPa75-hybrid_cPa62-cPa75-hybrid,0.5,2,1300438,1300428,cPa486-cPa75-hybrid_cPa62-cPa75-hybrid,1_1,102,10
chr22-130170_130272,cPa75,1,1,130224,130217,cPa75,4,102,7
chr22-1301947_1302049,cPa62-cPa75-hybrid,1,1,1301997,1301997,cPa62-cPa75-hybrid,1,102,0
chr22-1377659_1377761,cPa434,1,1,1377724,1377671,cPa434,8,102,53
chr22-1446787_1446925,cPa327_cPa472-cPa387-hybrid_cPa472-cPa75-hybrid,0.333333333333333,3,1446880,1446837,cPa327_cPa472-cPa387-hybrid_cPa472-cPa75-hybrid,1_1_1,138,43
chr22-1486320_1486422,cPa75-cPa62-hybrid,1,1,1486370,1486370,cPa75-cPa62-hybrid,1,102,0
chr22-1486572_1486785,cPa75,0.5,5,1486754,1486588,cPa62_cPa75_cPa75-cPa62-hybrid_cPa75-HERV-W_repbase_HERV17_LTR17-hybrid_cPa75-unknown,4_7_1_1_1,213,166
chr22-1486890_1486992,cPa113-HERV-W_repbase_HERV17_LTR17-hybrid_cPa62_cPa75-cPa62-hybrid,0.333333333333333,3,1486981,1486940,cPa113-HERV-W_repbase_HERV17_LTR17-hybrid_cPa62_cPa75-cPa62-hybrid,1_1_1,102,41
chr22-1510222_1510405,cPa62,0.5,6,1510353,1510233,cPa62_cPa62-cPa177-hybrid_cPa62-cPa260-hybrid_cPa62-cPa486-hybrid_cPa62-PyERV_AF500296-hybrid_cPa62-unknown,8_1_3_1_1_2,183,120
chr22-1559592_1559694,cPa539,1,1,1559692,1559642,cPa539,4,102,50
chr22-156139_156278,cPa121,0.5,3,156226,156189,cPa121_cPa75_cPa75-cPa121-hybrid,4_2_2,139,37
chr22-1591294_1591417,cPa16,0.733333333333333,3,1591411,1591312,cPa16_cPa379_cPa425,11_2_2,123,99
chr22-1611030_1611132,cPa539,0.666666666666667,2,1611080,1611073,cPa199_cPa539,1_2,102,7
chr22-1635967_1636069,cPa434,1,1,1636017,1636017,cPa434,1,102,0
chr22-1636090_1636281,cPa434,1,1,1636279,1636140,cPa434,4,191,139
chr22-1636305_1636407,cPa199-cPa434-hybrid_cPa434-cPa199-hybrid,0.5,2,1636401,1636355,cPa199-cPa434-hybrid_cPa434-cPa199-hybrid,1_1,102,46
chr22-171811_171981,cPa75,1,1,171929,171861,cPa75,4,170,68
chr22-172281_172409,cPa75,1,1,172357,172331,cPa75,2,128,26
chr22-172748_172850,cPa75,1,1,172798,172798,cPa75,1,102,0
chr22-173011_173113,cPa75,1,1,173061,173061,cPa75,1,102,0
chr22-173242_173344,cPa75,1,1,173292,173292,cPa75,1,102,0
chr22-1764915_1765017,cPa16,0.428571428571429,7,1764965,1764921,cPa16_cPa16-cPa71-hybrid_cPa16-unknown_cPa363_cPa379_cPa71_cPa75,9_2_2_1_2_1_4,102,44
chr22-1824502_1824604,cPa75,1,1,1824552,1824552,cPa75,1,102,0
chr22-1824773_1824875,cPa75,1,1,1824823,1824823,cPa75,1,102,0
chr22-1824994_1825126,cPa75,1,1,1825074,1825044,cPa75,2,132,30
chr22-1928316_1928418,cPa118,0.486486486486487,12,1928366,1928318,cPa118_cPa118-cPa15-hybrid_cPa118-cPa434-hybrid_cPa118-cPa566-hybrid_cPa118-unknown_cPa248_cPa248-cPa434-hybrid_cPa434_cPa443_cPa443-cPa434-hybrid_cPa443-unknown_cPa566,18_1_3_1_2_1_2_1_1_1_2_4,102,48
chr22-1954978_1955080,cPa323,0.6,3,1955074,1955028,cPa323_cPa323-unknown_cPa333-cPa512-hybrid,3_1_1,102,46
chr22-1955394_1955582,cPa323,0.666666666666667,7,1955580,1955416,cPa323_cPa323-cPa371-hybrid_cPa323-cPa512-hybrid_cPa323-unknown_cPa333-cPa323-hybrid_cPa371_cPa371-cPa323-hybrid,18_1_1_1_2_2_2,188,164
chr22-2016843_2016945,cPa381-cPa413-hybrid_MDEV_AF053745-unknown,0.5,2,2016896,2016893,cPa381-cPa413-hybrid_MDEV_AF053745-unknown,1_1,102,3
chr22-2124471_2124573,cPa75-unknown,1,1,2124521,2124521,cPa75-unknown,1,102,0
chr22-2125645_2125747,cPa62-cPa176-hybrid_cPa62-cPa199-hybrid,0.5,2,2125695,2125671,cPa62-cPa176-hybrid_cPa62-cPa199-hybrid,1_1,102,24
chr22-2214196_2214305,cPa505,0.571428571428571,6,2214272,2214195,cPa109_cPa450_cPa482_cPa482-cPa450-hybrid_cPa505_cPa505-unknown,2_1_1_1_8_1,109,77
chr22-2215145_2215247,cPa183-cPa345-hybrid_cPa199-cPa424-hybrid_cPa452-cPa482-hybrid_cPa482_cPa505_cPa539,0.166666666666667,6,2215195,2215149,cPa183-cPa345-hybrid_cPa199-cPa424-hybrid_cPa452-cPa482-hybrid_cPa482_cPa505_cPa539,1_1_1_1_1_1,102,46
chr22-221887_222041,cPa75,0.882352941176471,2,221989,221937,cPa138_cPa75,2_15,154,52
chr22-222648_222750,cPa75,1,1,222698,222698,cPa75,1,102,0
chr22-223351_223453,cPa75,1,1,223406,223383,cPa75,6,102,23
chr22-2258725_2258827,cPa62-cPa75-hybrid,0.75,2,2258824,2258760,cPa62_cPa62-cPa75-hybrid,1_3,102,64
chr22-2258833_2258935,cPa62_cPa62-cPa75-hybrid,0.5,2,2258927,2258883,cPa62_cPa62-cPa75-hybrid,1_1,102,44
chr22-2258950_2259091,cPa62_cPa62-cPa75-hybrid,0.5,2,2259086,2259000,cPa62_cPa62-cPa75-hybrid,2_2,141,86
chr22-226273_226375,cPa75,1,1,226323,226323,cPa75,1,102,0
chr22-226487_226589,cPa75,1,1,226537,226537,cPa75,1,102,0
chr22-228713_228830,cPa75,0.666666666666667,2,228778,228763,cPa345-cPa75-hybrid_cPa75,1_2,117,15
chr22-229318_229430,cPa75,1,1,229378,229368,cPa75,2,112,10
chr22-2302017_2302119,cPa75,1,1,2302073,2302067,cPa75,3,102,6
chr22-2302212_2302314,cPa75,1,1,2302262,2302258,cPa75,2,102,4
chr22-2302467_2302569,cPa75,1,1,2302517,2302517,cPa75,1,102,0
chr22-2316243_2316345,cPa75,1,1,2316293,2316293,cPa75,1,102,0
chr22-2317659_2317761,cPa194-WDSV_NC001867-hybrid_cPa199-cPa183-hybrid_cPa446-cPa75-hybrid_cPa450-cPa327-hybrid_cPa542-cPa223-hybrid,0.2,5,2317719,2317674,cPa194-WDSV_NC001867-hybrid_cPa199-cPa183-hybrid_cPa446-cPa75-hybrid_cPa450-cPa327-hybrid_cPa542-cPa223-hybrid,1_1_1_1_1,102,45
chr22-2318960_2319062,cPa446,0.318181818181818,11,2319052,2318979,cPa183-cPa223-hybrid_cPa194-cPa446-hybrid_cPa223_cPa327_cPa379_cPa379-cPa223-hybrid_cPa424_cPa424-cPa446-hybrid_cPa446_cPa446-cPa223-hybrid_cPa452-unknown,2_1_3_2_2_1_1_1_7_1_1,102,73
chr22-2367466_2367696,cPa345-cPa75-hybrid,0.545454545454545,2,2367648,2367516,cPa345-cPa75-hybrid_cPa67-cPa75-hybrid,6_5,230,132
chr22-2453619_2453746,cPa75,1,1,2453694,2453669,cPa75,2,127,25
chr22-246493_246653,cPa75,1,1,246601,246543,cPa75,2,160,58
chr22-246759_246861,cPa75,1,1,246809,246809,cPa75,1,102,0
chr22-246952_247054,cPa75,1,1,247002,247002,cPa75,1,102,0
chr22-247311_247610,cPa75,1,1,247558,247361,cPa75,5,299,197
chr22-2479470_2479572,cPa273-cPa75-hybrid,1,1,2479520,2479520,cPa273-cPa75-hybrid,1,102,0
chr22-248255_248385,cPa75,1,1,248333,248305,cPa75,5,130,28
chr22-249271_249373,cPa75,1,1,249321,249321,cPa75,1,102,0
chr22-250160_250262,cPa75,1,1,250210,250210,cPa75,1,102,0
chr22-2519339_2519441,cPa67-cPa273-hybrid,1,1,2519389,2519389,cPa67-cPa273-hybrid,1,102,0
chr22-2519572_2519674,cPa273,1,1,2519622,2519622,cPa273,1,102,0
chr22-2540190_2540292,cPa67-cPa75-hybrid,0.75,2,2540273,2540240,cPa194-cPa75-hybrid_cPa67-cPa75-hybrid,1_3,102,33
chr22-2540393_2540516,cPa194-cPa75-hybrid,0.666666666666667,2,2540501,2540443,cPa194-cPa75-hybrid_GaLV_M26927-cPa75-hybrid,2_1,123,58
chr22-2546895_2546997,cPa323_cPa323-cPa371-hybrid_cPa323-cPa50-hybrid_cPa371_cPa50-cPa371-hybrid,0.2,5,2546975,2546933,cPa323_cPa323-cPa371-hybrid_cPa323-cPa50-hybrid_cPa371_cPa50-cPa371-hybrid,1_1_1_1_1,102,42
chr22-2579595_2579697,cPa75,1,1,2579645,2579645,cPa75,1,102,0
chr22-2639546_2639656,cPa75,1,1,2639604,2639596,cPa75,2,110,8
chr22-2639744_2640006,cPa75,0.8,2,2639954,2639794,cPa413_cPa75,1_4,262,160
chr22-264660_264762,cPa75,1,1,264710,264710,cPa75,1,102,0
chr22-268034_268136,cPa75,1,1,268084,268084,cPa75,1,102,0
chr22-2681537_2681683,cPa62,0.939393939393939,2,2681631,2681541,cPa62_cPa62-unknown,31_2,146,90
chr22-2683799_2683901,cPa356_cPa428,0.5,2,2683887,2683805,cPa356_cPa428,7_7,102,82
chr22-2684076_2684280,cPa356,0.529411764705882,2,2684276,2684126,cPa356_cPa428,9_8,204,150
chr22-2685619_2685721,cPa428,0.625,2,2685699,2685669,cPa356_cPa428,3_5,102,30
chr22-2685820_2685922,cPa428,1,1,2685870,2685870,cPa428,1,102,0
chr22-2686273_2686416,cPa356,0.6,2,2686403,2686309,cPa356_cPa428,9_6,143,94
chr22-2688114_2688437,cPa428,0.538461538461538,2,2688425,2688164,cPa356_cPa428,12_14,323,261
chr22-2688540_2688642,cPa428,1,1,2688590,2688590,cPa428,1,102,0
chr22-2737000_2737102,cPa15,1,1,2737050,2737050,cPa15,1,102,0
chr22-2817367_2817469,cPa62,0.5,3,2817417,2817375,cPa285-cPa62-hybrid_cPa285-cPa75-hybrid_cPa62,1_1_2,102,42
chr22-2818943_2819045,cPa75,0.666666666666667,2,2819011,2818993,cPa285-cPa75-hybrid_cPa75,1_2,102,18
chr22-2836995_2837097,cPa75,1,1,2837045,2837045,cPa75,1,102,0
chr22-2837254_2837487,cPa75,1,1,2837435,2837304,cPa75,5,233,131
chr22-2837620_2837722,cPa75,1,1,2837670,2837670,cPa75,1,102,0
chr22-2838411_2838513,cPa75,0.75,2,2838480,2838461,cPa260_cPa75,1_3,102,19
chr22-2848283_2848385,cPa62,1,1,2848337,2848317,cPa62,24,102,20
chr22-2850281_2850383,cPa113_cPa113-cPa75-hybrid_cPa113-unknown_cPa62,0.25,4,2850369,2850331,cPa113_cPa113-cPa75-hybrid_cPa113-unknown_cPa62,1_1_1_1,102,38
chr22-290899_291065,cPa75,1,1,291013,290949,cPa75,2,166,64
chr22-2955560_2955662,cPa356,0.5,3,2955610,2955562,cPa356_cPa356-unknown_cPa428,2_1_1,102,48
chr22-2955700_2955922,cPa428,0.6,3,2955870,2955750,cPa356_cPa428_cPa428-cPa356-hybrid,1_3_1,222,120
chr22-2956125_2956227,cPa356_cPa428,0.5,2,2956175,2956127,cPa356_cPa428,3_3,102,48
chr22-2956375_2956477,cPa356_cPa428,0.5,2,2956452,2956425,cPa356_cPa428,1_1,102,27
chr22-2956646_2956748,cPa356,0.6,2,2956703,2956674,cPa356_cPa428,3_2,102,29
chr22-2956941_2957043,cPa428,1,1,2956991,2956991,cPa428,1,102,0
chr22-2957347_2957449,cPa428,1,1,2957420,2957397,cPa428,2,102,23
chr22-2957678_2957974,cPa428,0.555555555555556,2,2957969,2957678,cPa356_cPa428,40_50,296,291
chr22-2958127_2958526,cPa428,0.551724137931034,5,2958526,2958126,cPa356_cPa356-cPa428-hybrid_cPa356-unknown_cPa419_cPa428,75_1_1_1_96,399,400
chr22-2958696_2958892,cPa428,0.55,3,2958884,2958695,cPa356_cPa419_cPa428,8_1_11,196,189
chr22-2959384_2959486,cPa428,0.461538461538462,3,2959447,2959391,cPa356_cPa419_cPa428,5_2_6,102,56
chr22-2962328_2962896,cPa356,0.505102040816326,5,2962877,2962378,cPa356_cPa419_cPa419-unknown_cPa428_cPa428-unknown,99_2_1_93_1,568,499
chr22-2963250_2963352,cPa356,0.666666666666667,2,2963348,2963279,cPa356_cPa428,4_2,102,69
chr22-2963381_2963590,cPa356,0.617647058823529,2,2963580,2963381,cPa356_cPa428,42_26,209,199
chr22-2963656_2963769,cPa356,0.611111111111111,2,2963745,2963655,cPa356_cPa428,11_7,113,90
chr22-2963842_2964190,cPa356,0.549019607843137,2,2964148,2963854,cPa356_cPa428,28_23,348,294
chr22-3020404_3020506,cPa450,0.4,6,3020486,3020454,cPa199_cPa199-unknown_cPa227_cPa273_cPa450_cPa553,2_1_1_1_4_1,102,32
chr22-302785_302887,cPa75,1,1,302835,302835,cPa75,1,102,0
chr22-3040091_3040193,cPa62,1,1,3040191,3040141,cPa62,3,102,50
chr22-3048470_3048572,cPa75,1,1,3048520,3048520,cPa75,1,102,0
chr22-3054929_3055170,cPa260,0.8,2,3055118,3054935,cPa260_cPa260-unknown,4_1,241,183
chr22-3058386_3058527,cPa268,0.571428571428571,5,3058475,3058436,cPa268_cPa268-cPa308-hybrid_cPa308_cPa353_cPa486,16_1_6_4_1,141,39
chr22-3058651_3058753,cPa268,0.5,4,3058731,3058682,cPa268_cPa308_cPa308-cPa268-hybrid_cPa353,5_3_1_1,102,49
chr22-306506_306608,cPa62,0.857142857142857,3,306590,306526,cPa62_cPa62-cPa75-hybrid_cPa62-unknown,12_1_1,102,64
chr22-306619_306721,cPa62,1,1,306670,306642,cPa62,8,102,28
chr22-307212_307347,cPa62,1,1,307329,307262,cPa62,4,135,67
chr22-3083556_3083889,cPa323,0.620689655172414,5,3083837,3083606,cPa323_cPa323-cPa371-hybrid_cPa323-cPa452-hybrid_cPa323-cPa62-hybrid_cPa371,18_5_1_1_4,333,231
chr22-3084001_3084183,cPa323,0.6,3,3084155,3084051,cPa323_cPa371_cPa50,3_1_1,182,104
chr22-3124442_3124589,cPa62-cPa75-hybrid,1,1,3124537,3124492,cPa62-cPa75-hybrid,3,147,45
chr22-3144999_3145101,cPa323,1,1,3145049,3145049,cPa323,1,102,0
chr22-3176979_3177085,cPa293,0.5,3,3177033,3176998,cPa293_cPa572_cPa75,2_1_1,106,35
chr22-3189281_3189479,cPa446,0.428571428571429,6,3189471,3189304,cPa223_cPa379_cPa424_cPa446_cPa452_cPa452-cPa379-hybrid,1_1_2_6_3_1,198,167
chr22-3189501_3189603,cPa446,0.352941176470588,7,3189572,3189548,cPa223_cPa223-cPa363-hybrid_cPa379_cPa424_cPa424-cPa379-hybrid_cPa446_cPa452,2_1_3_1_1_6_3,102,24
chr22-3210613_3210715,cPa62,1,1,3210663,3210663,cPa62,1,102,0
chr22-3210734_3210914,cPa62,0.857142857142857,2,3210862,3210739,cPa356-cPa62-hybrid_cPa62,1_6,180,123
chr22-3210942_3211044,cPa62,1,1,3211012,3210959,cPa62,3,102,53
chr22-3213278_3213380,cPa75-unknown,1,1,3213328,3213328,cPa75-unknown,1,102,0
chr22-3213448_3213628,cPa75_cPa75-unknown,0.375,4,3213576,3213488,cPa546_cPa75_cPa75-cPa400-hybrid_cPa75-unknown,1_3_1_3,180,88
chr22-3264529_3264631,WDSV_NC001867,1,1,3264579,3264579,WDSV_NC001867,1,102,0
chr22-326982_327084,STLV2_NC001815,1,1,327032,327032,STLV2_NC001815,1,102,0
chr22-3279693_3280042,cPa62,1,1,3279990,3279692,cPa62,64,349,298
chr22-3280166_3280373,cPa62,1,1,3280371,3280184,cPa62,11,207,187
chr22-3280393_3280495,cPa62,1,1,3280443,3280443,cPa62,1,102,0
chr22-3293917_3294019,cPa75,1,1,3293967,3293967,cPa75,1,102,0
chr22-3308086_3308188,cPa75-cPa542-hybrid,1,1,3308136,3308136,cPa75-cPa542-hybrid,1,102,0
chr22-3311824_3311926,cPa505,1,1,3311874,3311874,cPa505,1,102,0
chr22-3327009_3327300,cPa75-cPa67-hybrid,0.5,3,3327248,3327059,cPa75_cPa75-cPa345-hybrid_cPa75-cPa67-hybrid,3_1_4,291,189
chr22-3327347_3327449,cPa75,1,1,3327397,3327397,cPa75,1,102,0
chr22-3327766_3327896,cPa75,1,1,3327844,3327816,cPa75,2,130,28
chr22-3327936_3328040,cPa75,1,1,3327988,3327986,cPa75,2,104,2
chr22-3328070_3328172,cPa75,1,1,3328120,3328120,cPa75,1,102,0
chr22-3331240_3331342,cPa75,1,1,3331290,3331280,cPa75,3,102,10
chr22-3332523_3332625,cPa75,1,1,3332573,3332569,cPa75,2,102,4
chr22-3333438_3333568,cPa15,0.555555555555556,7,3333564,3333441,cPa118_cPa118-cPa15-hybrid_cPa118-cPa443-hybrid_cPa118-cPa75-hybrid_cPa15_cPa268_cPa443,3_1_1_1_10_1_1,130,123
chr22-3336065_3336167,cPa118_cPa140-cPa118-hybrid,0.5,2,3336115,3336095,cPa118_cPa140-cPa118-hybrid,1_1,102,20
chr22-3341939_3342041,cPa486_cPa486-cPa62-hybrid,0.428571428571429,3,3342004,3341979,cPa486_cPa486-cPa62-hybrid_cPa75,3_3_1,102,25
chr22-3404292_3404394,cPa75,1,1,3404393,3404295,cPa75,4,102,98
chr22-3405100_3405202,cPa75,1,1,3405150,3405150,cPa75,1,102,0
chr22-3442709_3443328,cPa75,0.966666666666667,2,3443276,3442759,cPa75_cPa75-cPa109-hybrid,29_1,619,517
chr22-3443592_3443694,cPa75-cPa199-hybrid,1,1,3443642,3443642,cPa75-cPa199-hybrid,1,102,0
chr22-3450660_3450762,cPa75,1,1,3450710,3450710,cPa75,1,102,0
chr22-3511860_3511962,cPa118,0.666666666666667,2,3511936,3511890,cPa118_cPa15-cPa434-hybrid,2_1,102,46
chr22-3512030_3512230,cPa566,0.318181818181818,9,3512186,3512051,cPa118_cPa118-cPa15-hybrid_cPa118-cPa434-hybrid_cPa118-cPa566-hybrid_cPa118-unknown_cPa248-cPa434-hybrid_cPa434_cPa443_cPa566,4_1_1_1_1_1_5_1_7,200,135
chr22-3576965_3577067,cPa117,1,1,3577015,3577015,cPa117,1,102,0
chr22-3608867_3609063,cPa75,1,1,3609011,3608870,cPa75,7,196,141
chr22-3610546_3610648,cPa75,1,1,3610596,3610592,cPa75,4,102,4
chr22-3610709_3610851,cPa75,1,1,3610799,3610739,cPa75,17,142,60
chr22-3610890_3611100,cPa75,1,1,3611048,3610914,cPa75,8,210,134
chr22-3620017_3620158,cPa75,1,1,3620106,3620067,cPa75,3,141,39
chr22-3620247_3620349,cPa75,1,1,3620297,3620297,cPa75,1,102,0
chr22-3620391_3620493,cPa75,1,1,3620441,3620422,cPa75,2,102,19
chr22-3638_3906,cPa75,1,1,3877,3688,cPa75,20,268,189
chr22-3639099_3639419,cPa62,1,1,3639367,3639123,cPa62,14,320,244
chr22-3676563_3676665,cPa539,1,1,3676613,3676613,cPa539,1,102,0
chr22-3755023_3755176,cPa505,0.8,2,3755124,3755024,cPa482_cPa505,1_4,153,100
chr22-3791212_3791314,WDSV_NC001867_WDSV_NC001867-cPa62-hybrid,0.5,2,3791282,3791216,WDSV_NC001867_WDSV_NC001867-cPa62-hybrid,4_4,102,66
chr22-3792059_3792161,cPa62,1,1,3792109,3792109,cPa62,4,102,0
chr22-3812692_3812794,cPa323,1,1,3812742,3812742,cPa323,1,102,0
chr22-3812826_3813004,cPa323,0.916666666666667,2,3812977,3812864,cPa323_cPa371,11_1,178,113
chr22-3813158_3813301,cPa323,1,1,3813249,3813208,cPa323,4,143,41
chr22-3813438_3813644,cPa323,1,1,3813636,3813488,cPa323,16,206,148
chr22-3814677_3814779,cPa323-cPa75-hybrid,1,1,3814727,3814704,cPa323-cPa75-hybrid,3,102,23
chr22-3818015_3818123,cPa323,0.75,2,3818071,3818054,cPa323_cPa50,3_1,108,17
chr22-3818124_3818323,cPa371,0.666666666666667,2,3818271,3818174,cPa323_cPa371,1_2,199,97
chr22-3818335_3818470,cPa323,0.5,4,3818430,3818377,cPa323_cPa434-cPa323-hybrid_cPa434-cPa50-hybrid_cPa434-cPa527-hybrid,4_2_1_1,135,53
chr22-3867557_3867659,cPa75,1,1,3867607,3867607,cPa75,1,102,0
chr22-3906000_3906102,cPa75,1,1,3906052,3906050,cPa75,2,102,2
chr22-3909602_3909704,cPa71,0.67741935483871,8,3909697,3909614,cPa16_cPa379_cPa379-cPa446-hybrid_cPa452_cPa71_cPa71-cPa199-hybrid_cPa71-cPa482-hybrid_cPa71-unknown,2_1_1_3_21_1_1_1,102,83
chr22-3950170_3950288,cPa268-cPa62-hybrid,0.222222222222222,8,3950254,3950186,cPa118_cPa118-cPa62-hybrid_cPa125-cPa566-hybrid_cPa140-cPa434-hybrid_cPa264-cPa566-hybrid_cPa268-cPa434-hybrid_cPa268-cPa62-hybrid_cPa443-cPa566-hybrid,1_1_1_1_1_1_2_1,118,68
chr22-3950851_3950953,cPa264-cPa62-hybrid_cPa268-cPa62-hybrid,0.333333333333333,4,3950923,3950883,cPa264-cPa62-hybrid_cPa268-cPa260-hybrid_cPa268-cPa62-hybrid_cPa268-WDSV_NC001867-hybrid,2_1_2_1,102,40
chr22-3977919_3978158,cPa62,0.428571428571429,6,3978118,3977946,cPa293-cPa75-hybrid_cPa293-unknown_cPa62_cPa75_cPa75-cPa62-hybrid_cPa75-unknown,1_2_12_9_1_3,239,172
chr22-3982028_3982130,cPa434,1,1,3982078,3982060,cPa434,2,102,18
chr22-3982247_3982404,cPa434,0.5,3,3982352,3982274,cPa434_cPa434-cPa75-hybrid_cPa75,2_1_1,157,78
chr22-4029720_4029880,cPa118,1,1,4029828,4029738,cPa118,8,160,90
chr22-4029929_4030031,cPa118,1,1,4029979,4029979,cPa118,1,102,0
chr22-4030284_4030386,cPa118-cPa450-hybrid,1,1,4030334,4030334,cPa118-cPa450-hybrid,1,102,0
chr22-4061660_4061762,cPa75,0.75,2,4061711,4061677,cPa260-cPa62-hybrid_cPa75,1_3,102,34
chr22-4061795_4062003,HERV-W_repbase_HERV17_LTR17,0.363636363636364,7,4062003,4061845,cPa260-cPa62-hybrid_cPa419_cPa75_cPa75-cPa62-hybrid_cPa75-HERV-W_repbase_HERV17_LTR17-hybrid_HERV-W_repbase_HERV17_LTR17_PERVC_HM159246-cPa75-hybrid,1_1_1_1_2_4_1,208,158
chr22-4062024_4062126,HERV-W_repbase_HERV17_LTR17,0.545454545454545,5,4062106,4062023,cPa260_cPa75_HERV-W_repbase_HERV17_LTR17_HERV-W_repbase_HERV17_LTR17-cPa62-hybrid_HERV-W_repbase_HERV17_LTR17-unknown,1_1_6_1_2,102,83
chr22-4138227_4138329,cPa542,1,1,4138299,4138250,cPa542,7,102,49
chr22-4155572_4155674,cPa75-unknown,0.777777777777778,2,4155632,4155582,cPa75-cPa260-hybrid_cPa75-unknown,2_7,102,50
chr22-4155750_4155852,cPa75-unknown,0.807692307692308,4,4155838,4155769,cPa75-cPa15-hybrid_cPa75-cPa260-hybrid_cPa75-unknown_HML5_repbase_HERVK22I_LTR22-cPa260-hybrid,1_3_21_1,102,69
chr22-4177682_4177784,cPa323-HTLV1_NC001436-hybrid,0.6,2,4177777,4177698,cPa323-HTLV1_NC001436-hybrid_cPa371-unknown,3_2,102,79
chr22-4213660_4213796,cPa118,0.833333333333333,2,4213748,4213694,cPa118_cPa118-cPa248-hybrid,5_1,136,54
chr22-4213856_4213992,cPa118,1,1,4213940,4213906,cPa118,3,136,34
chr22-4214811_4214913,cPa118_cPa443-cPa15-hybrid_cPa566,0.333333333333333,3,4214891,4214820,cPa118_cPa443-cPa15-hybrid_cPa566,1_1_1,102,71
chr22-4241736_4241838,cPa223,1,1,4241786,4241786,cPa223,1,102,0
chr22-4241963_4242065,cPa223,1,1,4242047,4242012,cPa223,4,102,35
chr22-4264730_4264832,cPa75-unknown,0.6,2,4264788,4264754,cPa75_cPa75-unknown,2_3,102,34
chr22-4264835_4264937,cPa75-unknown,0.833333333333333,2,4264888,4264855,cPa75_cPa75-unknown,1_5,102,33
chr22-4272291_4272393,cPa434_cPa566,0.230769230769231,7,4272393,4272290,cPa15_cPa15-cPa434-hybrid_cPa15-cPa566-hybrid_cPa434_cPa434-unknown_cPa566_cPa566-cPa118-hybrid,2_1_1_3_2_3_1,102,103
chr22-4273161_4273263,cPa62,0.75,2,4273218,4273201,cPa15-cPa62-hybrid_cPa62,1_3,102,17
chr22-4277241_4277343,cPa539,0.666666666666667,2,4277296,4277287,cPa492_cPa539,1_2,102,9
chr22-4324365_4324484,cPa118-cPa15-hybrid,0.384615384615385,6,4324481,4324365,cPa118-cPa15-hybrid_cPa15_cPa248-cPa15-hybrid_cPa434_cPa443-cPa15-hybrid_cPa566,5_3_1_2_1_1,119,116
chr22-4329465_4329579,cPa62,1,1,4329527,4329500,cPa62,30,114,27
chr22-4435983_4436085,cPa260,1,1,4436079,4436032,cPa260,9,102,47
chr22-4575_4677,cPa75,1,1,4625,4625,cPa75,1,102,0
chr22-4680_4782,cPa75,1,1,4730,4730,cPa75,1,102,0
chr22-473267_473445,cPa75,0.928571428571429,2,473413,473281,cPa75_cPa75-unknown,13_1,178,132
chr22-473452_473749,cPa75,0.954545454545455,4,473697,473470,cPa285_cPa285-cPa75-hybrid_cPa75_cPa75-unknown,1_1_63_1,297,227
chr22-4848286_4848388,cPa61,0.68,2,4848381,4848289,cPa205_cPa61,8_17,102,92
chr22-4848390_4848572,cPa61,0.571428571428571,2,4848539,4848401,cPa205_cPa61,3_4,182,138
chr22-4849174_4849276,cPa205_cPa61,0.5,2,4849253,4849181,cPa205_cPa61,2_2,102,72
chr22-4849363_4849465,cPa61,0.8,2,4849449,4849413,cPa205_cPa61,1_4,102,36
chr22-4849960_4850062,cPa61,0.8125,2,4850057,4849966,cPa205_cPa61,3_13,102,91
chr22-486184_486600,cPa75,0.787234042553192,6,486570,486185,cPa113_cPa285_cPa62-cPa75-hybrid_cPa62-unknown_cPa75_cPa75-unknown,1_2_2_4_37_1,416,385
chr22-505625_505727,cPa62,0.722222222222222,3,505688,505671,cPa254-cPa62-hybrid_cPa62_cPa62-unknown,1_13_4,102,17
chr22-5363_5550,cPa75,1,1,5498,5413,cPa75,32,187,85
chr22-702195_702741,cPa62,0.710144927536232,11,702724,702222,cPa254-cPa62-hybrid_cPa254-unknown_cPa293-HML2_Pheonix-hybrid_cPa293-WDSV_NC001867-hybrid_cPa486_cPa486-cPa62-hybrid_cPa486-HML2_Pheonix-hybrid_cPa62_HML2_repbase_HERVK_LTR5-HML2_Pheonix-hybrid_WDSV_NC001867_WDSV_NC001867-cPa62-hybrid,1_1_1_1_1_5_2_49_1_3_4,546,502
chr22-732582_732684,cPa486,1,1,732649,732632,cPa486,2,102,17
chr22-732857_733325,cPa62-cPa486-hybrid,0.611111111111111,4,733273,732907,cPa486_cPa62_cPa62-cPa486-hybrid_cPa62-unknown,5_1_11_1,468,366
chr22-733357_733459,cPa199-cPa486-hybrid_cPa199-WDSV_NC001867-hybrid,0.5,2,733407,733407,cPa199-cPa486-hybrid_cPa199-WDSV_NC001867-hybrid,1_1,102,0
chr22-735264_735366,cPa199,0.846153846153846,3,735350,735265,cPa199_cPa199-cPa482-hybrid_cPa482,11_1_1,102,85
chr22-768042_768578,cPa75,0.96,2,768527,768073,cPa75_cPa75-unknown,96_4,536,454
chr22-775900_776002,cPa75-unknown,0.818181818181818,2,776001,775919,cPa75_cPa75-unknown,2_9,102,82
chr22-795247_795349,cPa75,1,1,795297,795297,cPa75,1,102,0
chr22-795412_796304,cPa75,1,1,796252,795433,cPa75,60,892,819
chr22-827527_827629,WDSV_NC001867-cPa62-hybrid,1,1,827603,827577,WDSV_NC001867-cPa62-hybrid,2,102,26
chr22-827683_827863,WDSV_NC001867-cPa62-hybrid,0.5,4,827812,827733,cPa62_cPa75-cPa62-hybrid_WDSV_NC001867_WDSV_NC001867-cPa62-hybrid,1_1_1_3,180,79
chr22-841567_841916,cPa75,1,1,841864,841617,cPa75,16,349,247
chr22-842621_842723,cPa75,1,1,842705,842625,cPa75,4,102,80
chr223-11135_11252,cPa505-cPa425-hybrid_cPa505-cPa75-hybrid_PyERV_AF500296-cPa425-hybrid,0.333333333333333,3,11200,11185,cPa505-cPa425-hybrid_cPa505-cPa75-hybrid_PyERV_AF500296-cPa425-hybrid,1_1_1,117,15
chr223-11481_11751,cPa505,0.615384615384615,6,11738,11524,cPa293_cPa425_cPa505_cPa75_PyERV_AF500296-cPa425-hybrid_PyERV_AF500296-cPa505-hybrid,1_1_8_1_1_1,270,214
chr223-12495_12597,cPa505,1,1,12545,12504,cPa505,4,102,41
chr223-19568_19670,cPa247-unknown,1,1,19618,19618,cPa247-unknown,1,102,0
chr223-2030_2304,cPa260,0.125,30,2252,2033,cPa15_cPa196-cPa308-hybrid_cPa205_cPa205-cPa15-hybrid_cPa205-unknown_cPa260_cPa260-cPa381-hybrid_cPa260-unknown_cPa308_cPa381_cPa419_cPa419-cPa205-hybrid_cPa419-cPa260-hybrid_cPa425-cPa205-hybrid_cPa425-cPa260-hybrid_cPa425-unknown_cPa75_ENTV_NC004994_ENTV_NC004994-cPa118-hybrid_ENTV_NC004994-cPa15-hybrid_ENTV_NC004994-cPa205-hybrid_ENTV_NC004994-cPa260-hybrid_ENTV_NC004994-cPa308-hybrid_ENTV_NC004994-cPa419-hybrid_ENTV_NC004994-cPa447-hybrid_ENTV_NC004994-cPa75-hybrid_ENTV_NC004994-unknown_HERV-I_repbase_HERVI_LTR10B-cPa308-hybrid_HTLV1_NC001436-cPa75-hybrid_HTLV1_NC001436-unknown,1_1_4_1_1_8_1_1_1_1_6_1_1_1_5_2_1_2_2_2_3_2_4_1_1_2_2_2_1_3,274,219
chr223-21541_21643,cPa391,1,1,21610,21591,cPa391,2,102,19
chr223-21691_22151,cPa391,0.982758620689655,2,22146,21696,cPa163-cPa390-hybrid_cPa391,1_57,460,450
chr223-2307_2834,cPa205,0.19811320754717,32,2782,2357,cPa15_cPa15-cPa247-hybrid_cPa15-cPa260-hybrid_cPa168-cPa205-hybrid_cPa168-cPa260-hybrid_cPa205_cPa205-cPa15-hybrid_cPa205-cPa260-hybrid_cPa205-cPa268-hybrid_cPa205-unknown_cPa247_cPa260_cPa260-HERVHcons-hybrid_cPa260-unknown_cPa419_cPa419-cPa205-hybrid_cPa425-cPa118-hybrid_cPa425-cPa205-hybrid_cPa425-cPa260-hybrid_cPa425-HERVHcons-hybrid_cPa75-cPa205-hybrid_ENTV_NC004994_ENTV_NC004994-cPa205-hybrid_ENTV_NC004994-cPa260-hybrid_ENTV_NC004994-cPa268-hybrid_ENTV_NC004994-cPa34-hybrid_ENTV_NC004994-MoMLV_J02255-hybrid_ENTV_NC004994-unknown_HERVHcons_HTLV1_NC001436-cPa260-hybrid_HTLV1_NC001436-unknown_MoMLV_J02255-cPa260-hybrid,1_1_5_1_1_21_2_5_1_1_1_19_1_1_3_1_3_7_3_1_1_7_5_1_1_1_1_4_1_2_2_1,527,425
chr223-3645_3994,cPa15,0.739130434782609,6,3942,3695,cPa15_cPa15-cPa118-hybrid_cPa15-cPa223-hybrid_cPa15-unknown_cPa379-cPa205-hybrid_MoMLV_J02255,17_1_1_2_1_1,349,247
chr223-5222_5324,cPa223_cPa419,0.222222222222222,7,5324,5231,cPa168-unknown_cPa223_cPa223-cPa358-hybrid_cPa227-FeFV_NC001871-hybrid_cPa391_cPa419_cPa450-cPa358-hybrid,1_2_1_1_1_2_1,102,93
chr223-5329_5431,cPa168-unknown_cPa205_cPa223_cPa227-cPa254-hybrid_cPa583-cPa34-hybrid,0.2,5,5386,5369,cPa168-unknown_cPa205_cPa223_cPa227-cPa254-hybrid_cPa583-cPa34-hybrid,1_1_1_1_1,102,17
chr223-5492_5594,cPa168-unknown_cPa273-unknown_cPa419,0.333333333333333,3,5542,5519,cPa168-unknown_cPa273-unknown_cPa419,1_1_1,102,23
chr223-9539_9766,cPa247-unknown,0.727272727272727,2,9714,9586,cPa247_cPa247-unknown,3_8,227,128
chr224-13109_13308,HML5_repbase_HERVK22I_LTR22-cPa75-hybrid,0.405405405405405,14,13289,13148,cPa107-cPa75-hybrid_cPa142-cPa177-hybrid_cPa216-HML5_repbase_HERVK22I_LTR22-hybrid_cPa339-cPa363-hybrid_cPa402-cPa177-hybrid_cPa419_cPa447-cPa75-hybrid_cPa542-cPa177-hybrid_cPa542-cPa75-hybrid_cPa542-HTLV1_NC001436-hybrid_cPa75_HML5_repbase_HERVK22I_LTR22-cPa75-hybrid_HTLV1_NC001436_MDEV_AF053745-cPa75-hybrid,3_1_1_1_1_2_1_1_1_1_4_15_1_4,199,141
chr224-13819_13944,MDEV_AF053745-cPa75-hybrid,0.481481481481481,6,13898,13832,cPa193-cPa216-hybrid_cPa216-cPa75-hybrid_cPa419_MDEV_AF053745-cPa75-hybrid_MDEV_AF053745-HTLV1_NC001436-hybrid_SIV_NC001870-cPa75-hybrid,1_4_2_13_4_3,125,66
chr224-15007_15229,MDEV_AF053745-cPa526-hybrid_MDEV_AF053745-unknown,0.444444444444444,3,15177,15057,MDEV_AF053745-cPa526-hybrid_MDEV_AF053745-unknown_SIV_NC001870-cPa526-hybrid,4_4_1,222,120
chr224-15488_15590,SIV_NC001870-unknown,0.666666666666667,2,15575,15523,cPa419_SIV_NC001870-unknown,1_2,102,52
chr224-18482_18584,cPa419_cPa75-unknown,0.5,2,18532,18484,cPa419_cPa75-unknown,1_1,102,48
chr224-21317_21822,cPa15,0.489051094890511,37,21807,21350,cPa118_cPa118-cPa125-hybrid_cPa118-cPa248-hybrid_cPa118-cPa264-hybrid_cPa118-cPa443-hybrid_cPa125_cPa125-cPa118-hybrid_cPa125-cPa248-hybrid_cPa125-cPa264-hybrid_cPa125-cPa443-hybrid_cPa140-cPa125-hybrid_cPa15_cPa15-cPa118-hybrid_cPa15-cPa125-hybrid_cPa15-cPa248-hybrid_cPa15-cPa402-hybrid_cPa15-unknown_cPa248_cPa264_cPa264-cPa248-hybrid_cPa264-unknown_cPa268_cPa268-cPa118-hybrid_cPa268-cPa125-hybrid_cPa268-cPa248-hybrid_cPa268-cPa264-hybrid_cPa268-unknown_cPa402-cPa118-hybrid_cPa419_cPa438-cPa118-hybrid_cPa438-cPa248-hybrid_cPa438-cPa264-hybrid_cPa438-cPa443-hybrid_cPa443_cPa61_cPa74-cPa264-hybrid_cPa75-cPa125-hybrid,65_1_8_3_2_21_1_1_1_1_1_268_1_2_1_1_8_1_54_1_1_30_3_2_12_4_2_1_8_1_6_1_1_31_1_1_1,505,457
chr224-2222_2345,cPa447,0.456310679611651,26,2294,2258,cPa145-cPa193-hybrid_cPa145-cPa42-hybrid_cPa145-cPa529-hybrid_cPa260-cPa205-hybrid_cPa323-cPa205-hybrid_cPa339_cPa353_cPa390_cPa434-cPa529-hybrid_cPa447_cPa447-BIV_NC001413-hybrid_cPa447-cPa205-hybrid_cPa447-cPa339-hybrid_cPa447-cPa353-hybrid_cPa447-cPa387-hybrid_cPa447-cPa390-hybrid_cPa447-cPa42-hybrid_cPa447-cPa444-hybrid_cPa447-cPa452-hybrid_cPa447-cPa456-hybrid_cPa447-cPa529-hybrid_cPa47-BIV_NC001413-hybrid_cPa47-cPa353-hybrid_cPa47-cPa529-hybrid_cPa62-BIV_NC001413-hybrid_cPa62-cPa353-hybrid,1_1_1_1_1_5_1_6_1_47_5_6_1_4_1_1_1_4_3_1_1_2_1_2_4_1,123,36
chr224-2424_2528,cPa447,0.6,6,2476,2473,cPa339_cPa353_cPa419_cPa447_cPa447-cPa205-hybrid_cPa447-cPa353-hybrid,7_1_1_18_1_2,104,3
chr224-2598_2822,cPa447,0.35195530726257,43,2808,2647,cPa145_cPa145-BIV_NC001413-hybrid_cPa145-cPa353-hybrid_cPa145-cPa529-hybrid_cPa16-cPa339-hybrid_cPa16-cPa353-hybrid_cPa16-cPa444-hybrid_cPa176-cPa353-hybrid_cPa323-cPa444-hybrid_cPa339_cPa339-BIV_NC001413-hybrid_cPa339-cPa205-hybrid_cPa339-cPa353-hybrid_cPa353_cPa387_cPa387-BIV_NC001413-hybrid_cPa387-cPa205-hybrid_cPa387-cPa339-hybrid_cPa387-cPa353-hybrid_cPa390_cPa390-BIV_NC001413-hybrid_cPa402-BIV_NC001413-hybrid_cPa419-cPa216-hybrid_cPa447_cPa447-BIV_NC001413-hybrid_cPa447-cPa145-hybrid_cPa447-cPa205-hybrid_cPa447-cPa216-hybrid_cPa447-cPa339-hybrid_cPa447-cPa353-hybrid_cPa447-cPa387-hybrid_cPa447-cPa390-hybrid_cPa447-cPa444-hybrid_cPa47-BIV_NC001413-hybrid_cPa551-BIV_NC001413-hybrid_cPa551-cPa339-hybrid_cPa551-cPa353-hybrid_cPa551-cPa444-hybrid_cPa551-cPa447-hybrid_cPa62-BIV_NC001413-hybrid_cPa62-cPa205-hybrid_cPa62-cPa353-hybrid_cPa62-cPa387-hybrid,3_4_3_3_2_2_1_1_1_12_1_1_1_3_9_1_1_1_2_12_1_2_1_63_13_1_2_1_2_3_2_2_3_3_5_2_1_2_1_2_1_1_1,224,161
chr224-26590_26692,cPa199-unknown,1,1,26676,26607,cPa199-unknown,8,102,69
chr224-26979_27090,cPa199-unknown,1,1,27090,27029,cPa199-unknown,10,111,61
chr224-27197_27299,cPa199-unknown,0.785714285714286,4,27290,27210,cPa199-cPa11-hybrid_cPa199-cPa446-hybrid_cPa199-cPa75-hybrid_cPa199-unknown,4_7_1_44,102,80
chr224-5802_5912,cPa75-cPa450-hybrid,0.4,4,5860,5843,cPa16-cPa273-hybrid_cPa419-cPa273-hybrid_cPa75-cPa273-hybrid_cPa75-cPa450-hybrid,1_1_1_2,110,17
chr224-5945_6111,cPa75-cPa553-hybrid,0.4,5,6109,5995,cPa360-cPa273-hybrid_cPa450_cPa75-cPa138-hybrid_cPa75-cPa450-hybrid_cPa75-cPa553-hybrid,1_1_1_3_4,166,114
chr224-7650_7894,cPa75-cPa223-hybrid,0.6,8,7881,7649,cPa75-cPa119-hybrid_cPa75-cPa223-hybrid_cPa75-cPa438-hybrid_cPa75-cPa450-hybrid_cPa75-cPa463-hybrid_cPa75-cPa542-hybrid_cPa75-unknown_STLV2_NC001815-S71_repbase_HERVS71_LTR6A-hybrid,1_12_1_1_1_2_1_1,244,232
chr224-8240_8342,cPa75-cPa223-hybrid,1,1,8290,8290,cPa75-cPa223-hybrid,1,102,0
chr224-8428_8533,cPa75-cPa223-hybrid,0.631578947368421,6,8531,8467,cPa219-cPa438-hybrid_cPa419_cPa463-cPa583-hybrid_cPa529-cPa223-hybrid_cPa75-cPa223-hybrid_STLV2_NC001815-cPa223-hybrid,1_1_1_2_12_2,105,64
chr224-9546_9648,PERV_AJ293656-cPa223-hybrid,1,1,9604,9596,PERV_AJ293656-cPa223-hybrid,2,102,8
chr224-9723_9825,cPa419_cPa42-cPa223-hybrid_cPa549-cPa223-hybrid_cPa75_HML5_repbase_HERVK22I_LTR22-cPa75-hybrid_PERV_AJ293656-cPa177-hybrid,0.166666666666667,6,9817,9773,cPa419_cPa42-cPa223-hybrid_cPa549-cPa223-hybrid_cPa75_HML5_repbase_HERVK22I_LTR22-cPa75-hybrid_PERV_AJ293656-cPa177-hybrid,1_1_1_1_1_1,102,44
chr224-9992_10094,cPa419_PERV_AJ293656-cPa177-hybrid_PERV_AJ293656-cPa308-hybrid,0.333333333333333,3,10042,10022,cPa419_PERV_AJ293656-cPa177-hybrid_PERV_AJ293656-cPa308-hybrid,1_1_1,102,20
chr225-27046_27148,cPa75,1,1,27096,27096,cPa75,1,102,0
chr226-2746_2981,cPa356,0.5,4,2929,2796,cPa356_cPa546-cPa356-hybrid_cPa546-cPa434-hybrid_cPa546-unknown,3_1_1_1,235,133
chr226-3749_3851,cPa566,0.333333333333333,12,3845,3799,cPa109-cPa434-hybrid_cPa140-cPa434-hybrid_cPa15-cPa434-hybrid_cPa248-cPa434-hybrid_cPa248-cPa566-hybrid_cPa264-cPa356-hybrid_cPa434_cPa443_cPa443-cPa434-hybrid_cPa443-cPa566-hybrid_cPa546-cPa434-hybrid_cPa566,1_1_3_2_1_1_1_1_1_2_2_8,102,46
chr226-5417_5528,cPa428,0.75,2,5513,5467,cPa356_cPa428,1_3,111,46
chr226-5950_6052,cPa428,0.567567567567568,3,6050,5957,cPa356_cPa428_cPa61-cPa419-hybrid,15_21_1,102,93
chr226-6386_6524,cPa356,0.535714285714286,2,6523,6390,cPa356_cPa428,15_13,138,133
chr226-6648_6750,cPa356_cPa428,0.5,2,6698,6648,cPa356_cPa428,1_1,102,50
chr228-22118_22314,cPa428,0.666666666666667,2,22270,22168,cPa356_cPa428,1_2,196,102
chr228-22383_22485,cPa428,1,1,22433,22433,cPa428,1,102,0
chr228-28363_28465,cPa356_cPa428,0.5,2,28413,28391,cPa356_cPa428,1_1,102,22
chr229-26995_27135,cPa356,0.588235294117647,2,27083,27017,cPa356_cPa428,10_7,140,66
chr229-27492_27602,cPa428,0.507692307692308,2,27592,27503,cPa356_cPa428,32_33,110,89
chr229-27744_27880,cPa428,0.512820512820513,2,27843,27784,cPa356_cPa428,19_20,136,59
chr229-28012_28189,cPa428,0.50354609929078,3,28187,28028,cPa356_cPa428_cPa428-cPa356-hybrid,69_71_1,177,159
chr229-28370_28485,cPa428,0.580645161290323,2,28482,28386,cPa356_cPa428,13_18,115,96
chr23-1002431_1002574,cPa15-cPa140-hybrid,0.428571428571429,5,1002554,1002474,cPa15_cPa15-cPa140-hybrid_cPa15-cPa248-hybrid_cPa15-cPa268-hybrid_cPa248,1_3_1_1_1,143,80
chr23-1022174_1022380,GaLV_M26927-cPa176-hybrid,0.391304347826087,5,1022371,1022219,cPa176_cPa176-GaLV_M26927-hybrid_GaLV_M26927_GaLV_M26927-cPa176-hybrid_GaLV_M26927-unknown,2_1_8_9_3,206,152
chr23-1040540_1040771,cPa15,0.563829787234043,11,1040737,1040585,cPa118_cPa118-cPa443-hybrid_cPa15_cPa248-cPa15-hybrid_cPa248-cPa434-hybrid_cPa248-cPa443-hybrid_cPa248-unknown_cPa268_cPa419_cPa443_cPa443-cPa118-hybrid,10_4_53_2_1_5_3_1_1_13_1,231,152
chr23-1080209_1080311,cPa75-cPa176-hybrid_cPa75-cPa438-hybrid,0.5,2,1080259,1080258,cPa75-cPa176-hybrid_cPa75-cPa438-hybrid,1_1,102,1
chr23-1080390_1080492,cPa438_cPa75-cPa438-hybrid,0.5,2,1080446,1080440,cPa438_cPa75-cPa438-hybrid,1_1,102,6
chr23-1100671_1100886,cPa75,1,1,1100834,1100721,cPa75,5,215,113
chr23-1101656_1101758,cPa75,1,1,1101722,1101700,cPa75,3,102,22
chr23-1167962_1168099,cPa75,0.666666666666667,2,1168047,1168012,cPa75_cPa75-unknown,2_1,137,35
chr23-1172466_1172568,cPa323,0.666666666666667,2,1172516,1172468,cPa323_cPa371,2_1,102,48
chr23-1172578_1172680,cPa323_cPa381-cPa371-hybrid,0.5,2,1172628,1172628,cPa323_cPa381-cPa371-hybrid,1_1,102,0
chr23-1172776_1172887,cPa323,0.333333333333333,5,1172858,1172805,cPa323_cPa371_cPa381-cPa323-hybrid_cPa50_cPa542-cPa323-hybrid,4_2_2_1_3,111,53
chr23-1213242_1213344,cPa117,1,1,1213292,1213291,cPa117,2,102,1
chr23-1244834_1244936,cPa539-unknown_ENTV_NC004994,0.5,2,1244884,1244869,cPa539-unknown_ENTV_NC004994,1_1,102,15
chr23-1260201_1260390,cPa71,0.466666666666667,5,1260338,1260244,cPa62-cPa75-hybrid_cPa71_cPa71-cPa75-hybrid_cPa71-unknown_cPa75,1_7_3_1_3,189,94
chr23-1261768_1261870,cPa75,1,1,1261837,1261789,cPa75,3,102,48
chr23-1353387_1353489,cPa75-unknown,1,1,1353458,1353387,cPa75-unknown,8,102,71
chr23-1359973_1360075,cPa199,0.285714285714286,8,1360069,1360004,cPa199_cPa223_cPa227_cPa273_cPa273-cPa345-hybrid_cPa345_cPa542_cPa553,4_1_1_2_1_3_1_1,102,65
chr23-1360083_1360185,cPa542,0.4,4,1360166,1360130,cPa199_cPa223_cPa542_cPa553,1_1_2_1,102,36
chr23-1408322_1408424,cPa62,1,1,1408372,1408372,cPa62,1,102,0
chr23-1486849_1486951,cPa67-cPa546-hybrid,1,1,1486899,1486899,cPa67-cPa546-hybrid,1,102,0
chr23-1486989_1487091,cPa113-cPa75-hybrid_cPa75,0.5,2,1487084,1487039,cPa113-cPa75-hybrid_cPa75,1_1,102,45
chr23-1523870_1524068,cPa62,0.695652173913043,4,1524032,1523885,cPa285_cPa62_cPa62-cPa285-hybrid_cPa62-unknown,2_16_1_4,198,147
chr23-1547027_1547301,cPa176,0.736842105263158,4,1547249,1547077,cPa176_cPa176-cPa260-hybrid_cPa176-unknown_cPa438-cPa127-hybrid,14_3_1_1,274,172
chr23-1577839_1577941,cPa71,1,1,1577941,1577863,cPa71,7,102,78
chr23-1578088_1578190,cPa71,0.916666666666667,2,1578179,1578097,cPa71_cPa71-cPa176-hybrid,11_1,102,82
chr23-1579485_1579610,cPa176_cPa71-cPa176-hybrid,0.428571428571429,3,1579558,1579535,cPa176_cPa260_cPa71-cPa176-hybrid,3_1_3,125,23
chr23-1581206_1581342,cPa425-cPa75-hybrid,1,1,1581290,1581256,cPa425-cPa75-hybrid,2,136,34
chr23-1591021_1591156,cPa75-unknown,0.75,2,1591104,1591068,cPa293_cPa75-unknown,1_3,135,36
chr23-1591461_1591597,cPa75-unknown,1,1,1591557,1591511,cPa75-unknown,6,136,46
chr23-1605682_1605789,cPa62,0.8,3,1605743,1605727,cPa285_cPa62_cPa62-unknown,1_8_1,107,16
chr23-1684247_1684351,cPa75-SMRV_NC001514-hybrid,0.4,4,1684350,1684259,cPa75_cPa75-cPa260-hybrid_cPa75-SMRV_NC001514-hybrid_SMRV_NC001514,1_1_2_1,104,91
chr23-1691168_1691270,cPa176,1,1,1691218,1691175,cPa176,2,102,43
chr23-1691392_1691494,cPa176-cPa62-hybrid,1,1,1691442,1691442,cPa176-cPa62-hybrid,1,102,0
chr23-1711540_1711735,cPa260,0.24390243902439,9,1711731,1711571,cPa127-unknown_cPa176_cPa176-cPa62-hybrid_cPa176-unknown_cPa260_cPa260-cPa176-hybrid_cPa260-cPa438-hybrid_cPa260-unknown_cPa438,1_8_1_4_10_5_1_8_3,195,160
chr23-1724762_1724956,cPa67,0.309090909090909,12,1724942,1724762,cPa119_cPa119-cPa67-hybrid_cPa119-cPa75-hybrid_cPa119-unknown_cPa194_cPa194-cPa67-hybrid_cPa254-cPa67-hybrid_cPa254-cPa75-hybrid_cPa539_cPa539-cPa194-hybrid_cPa539-cPa67-hybrid_cPa67,8_3_1_2_12_2_2_1_5_1_1_17,194,180
chr23-1733276_1733378,cPa260-cPa75-hybrid,1,1,1733326,1733326,cPa260-cPa75-hybrid,1,102,0
chr23-1787454_1787592,cPa75-unknown,0.866666666666667,3,1787542,1787500,cPa75_cPa75-HERV-W_repbase_HERV17_LTR17-hybrid_cPa75-unknown,1_1_13,138,42
chr23-1787649_1787751,cPa75-unknown,1,1,1787714,1787682,cPa75-unknown,3,102,32
chr23-1824948_1825050,cPa542,1,1,1824998,1824998,cPa542,1,102,0
chr23-1834340_1834442,cPa62,0.875,2,1834442,1834376,cPa62_cPa62-cPa75-hybrid,7_1,102,66
chr23-1843260_1843362,cPa75,1,1,1843310,1843310,cPa75,1,102,0
chr23-1843376_1843478,cPa75,1,1,1843426,1843426,cPa75,1,102,0
chr23-1848004_1848264,cPa71,0.550724637681159,5,1848222,1848006,cPa16_cPa379_cPa71_cPa71-unknown_cPa75-cPa16-hybrid,27_1_38_2_1,260,216
chr23-1862916_1863018,cPa62,1,1,1862966,1862966,cPa62,1,102,0
chr23-1931664_1931766,cPa75-unknown,1,1,1931714,1931714,cPa75-unknown,1,102,0
chr23-1931812_1932013,cPa75-unknown,1,1,1931961,1931862,cPa75-unknown,3,201,99
chr23-1966987_1967089,cPa419,1,1,1967037,1967037,cPa419,1,102,0
chr23-1988509_1988611,cPa75-unknown,0.8,3,1988599,1988508,cPa113_cPa75_cPa75-unknown,1_1_8,102,91
chr23-1990903_1991005,cPa75-cPa260-hybrid,0.285714285714286,6,1990996,1990939,cPa260_cPa62-unknown_cPa75_cPa75-cPa260-hybrid_cPa75-cPa293-hybrid_cPa75-unknown,1_1_1_2_1_1,102,57
chr23-1995150_1995347,cPa363,0.428571428571429,4,1995322,1995170,cPa176_cPa363_cPa363-cPa67-hybrid_cPa424,2_3_1_1,197,152
chr23-2041315_2041417,cPa75-cPa118-hybrid,0.75,2,2041413,2041365,cPa546-cPa118-hybrid_cPa75-cPa118-hybrid,1_3,102,48
chr23-2057053_2057155,cPa75-cPa176-hybrid,1,1,2057137,2057103,cPa75-cPa176-hybrid,2,102,34
chr23-2073773_2073875,cPa62,1,1,2073831,2073817,cPa62,6,102,14
chr23-2074411_2074513,cPa62-cPa75-hybrid,1,1,2074461,2074461,cPa62-cPa75-hybrid,1,102,0
chr23-2074817_2074962,cPa62-cPa75-hybrid,1,1,2074910,2074867,cPa62-cPa75-hybrid,2,145,43
chr23-2074991_2075093,cPa62-cPa75-hybrid,1,1,2075041,2075041,cPa62-cPa75-hybrid,1,102,0
chr23-2109918_2110020,cPa339,1,1,2110017,2109951,cPa339,7,102,66
chr23-2121582_2121818,cPa323,0.536585365853659,5,2121782,2121593,cPa323_cPa333-unknown_cPa371_cPa371-cPa323-hybrid_cPa371-unknown,22_1_14_2_2,236,189
chr23-2126693_2126855,cPa75,0.875,2,2126854,2126705,cPa75_cPa75-unknown,14_2,162,149
chr23-2126891_2127055,cPa75,1,1,2127014,2126890,cPa75,7,164,124
chr23-2165265_2165367,cPa260,1,1,2165315,2165315,cPa260,1,102,0
chr23-2213182_2213284,cPa543,1,1,2213232,2213232,cPa543,1,102,0
chr23-2241631_2241733,cPa75,1,1,2241681,2241681,cPa75,1,102,0
chr23-2241737_2241851,cPa75,1,1,2241799,2241787,cPa75,2,114,12
chr23-2242755_2242857,cPa75,1,1,2242805,2242805,cPa75,1,102,0
chr23-2261041_2261278,cPa118-cPa75-hybrid_cPa516-cPa75-hybrid,0.5,2,2261226,2261091,cPa118-cPa75-hybrid_cPa516-cPa75-hybrid,3_3,237,135
chr23-2289543_2289715,cPa539,1,1,2289663,2289575,cPa539,3,172,88
chr23-2317980_2318082,cPa183-cPa323-hybrid_cPa327-cPa323-hybrid,0.5,2,2318030,2318006,cPa183-cPa323-hybrid_cPa327-cPa323-hybrid,1_1,102,24
chr23-2318143_2318245,cPa183-cPa323-hybrid_cPa327-cPa323-hybrid_cPa327-cPa371-hybrid,0.333333333333333,3,2318223,2318193,cPa183-cPa323-hybrid_cPa327-cPa323-hybrid_cPa327-cPa371-hybrid,1_1_1,102,30
chr23-2319043_2319216,cPa183-cPa323-hybrid_cPa371,0.227272727272727,9,2319172,2319093,cPa183-cPa323-hybrid_cPa183-cPa333-hybrid_cPa323_cPa327-cPa323-hybrid_cPa371_cPa371-cPa323-hybrid_cPa371-unknown_cPa424-cPa323-hybrid_cPa50-cPa371-hybrid,5_1_2_2_5_4_1_1_1,173,79
chr23-2319363_2319465,cPa183-cPa323-hybrid,0.4,4,2319413,2319375,cPa183-cPa323-hybrid_cPa323_cPa327-cPa323-hybrid_cPa371,2_1_1_1,102,38
chr23-2348887_2348989,cPa446,0.476190476190476,6,2348989,2348915,cPa183_cPa327_cPa379_cPa446_cPa452_cPa75-cPa183-hybrid,3_4_1_10_2_1,102,74
chr23-2490727_2490829,cPa452,0.5625,4,2490809,2490736,cPa176_cPa176-cPa363-hybrid_cPa363_cPa452,1_1_5_9,102,73
chr23-2497417_2497519,cPa199_cPa482,0.5,2,2497467,2497467,cPa199_cPa482,1_1,102,0
chr23-2585518_2585620,cPa75,1,1,2585568,2585549,cPa75,3,102,19
chr23-272259_272361,cPa117,0.8,2,272343,272264,cPa117_cPa452,8_2,102,79
chr23-272525_272760,cPa117,0.787878787878788,2,272754,272565,cPa117_cPa452,26_7,235,189
chr23-272817_272939,cPa117,0.608695652173913,3,272936,272851,cPa117_cPa452_cPa452-cPa117-hybrid,14_8_1,122,85
chr23-2894734_2894917,cPa472,0.986666666666667,2,2894880,2894759,cPa419_cPa472,1_74,183,121
chr23-2927730_2927893,cPa75,1,1,2927850,2927780,cPa75,3,163,70
chr23-3085463_3085565,cPa285_cPa75,0.5,2,3085515,3085513,cPa285_cPa75,1_1,102,2
chr23-3152822_3153235,cPa323,0.5,3,3153183,3152872,cPa323_cPa371_cPa371-cPa323-hybrid,7_6_1,413,311
chr23-3153275_3153596,cPa323,0.48,4,3153544,3153325,cPa313-cPa323-hybrid_cPa323_cPa371_cPa371-cPa323-hybrid,1_12_11_1,321,219
chr23-3155020_3155122,cPa183,0.461538461538462,6,3155121,3155027,cPa183_cPa223_cPa223-cPa183-hybrid_cPa379_cPa452-cPa183-hybrid_cPa452-cPa223-hybrid,6_2_1_2_1_1,102,94
chr23-3308150_3308275,cPa371,1,1,3308247,3308200,cPa371,3,125,47
chr23-3309636_3309960,cPa323,0.4,6,3309945,3309686,cPa323_cPa323-cPa371-hybrid_cPa323-unknown_cPa371_cPa371-cPa323-hybrid_cPa371-unknown,10_3_3_7_1_1,324,259
chr23-3338621_3338723,cPa541_cPa541-unknown,0.5,2,3338671,3338671,cPa541_cPa541-unknown,1_1,102,0
chr23-3350625_3350747,cPa75,0.666666666666667,2,3350696,3350675,cPa75_cPa75-unknown,2_1,122,21
chr23-3352479_3352824,cPa323,0.549019607843137,8,3352777,3352515,cPa323_cPa323-cPa371-hybrid_cPa323-unknown_cPa371_cPa371-cPa50-hybrid_cPa479-cPa371-hybrid_cPa50_cPa582-cPa323-hybrid,28_4_1_14_1_1_1_1,345,262
chr23-3352884_3353237,cPa323,0.709677419354839,4,3353185,3352934,cPa323_cPa323-cPa50-hybrid_cPa371_cPa512-cPa371-hybrid,22_1_7_1,353,251
chr23-3421973_3422075,cPa323,1,1,3422023,3422023,cPa323,1,102,0
chr23-3422170_3422272,cPa371,1,1,3422220,3422220,cPa371,1,102,0
chr23-3485819_3485921,cPa308,1,1,3485903,3485869,cPa308,3,102,34
chr23-3545556_3545679,cPa51-unknown,0.903225806451613,2,3545658,3545604,cPa51_cPa51-unknown,3_28,123,54
chr23-3631618_3631720,cPa323,0.909090909090909,2,3631668,3631628,cPa323_cPa323-cPa371-hybrid,10_1,102,40
chr23-3842005_3842151,cPa428,0.5,3,3842144,3842020,cPa356_cPa428_cPa428-cPa356-hybrid,7_9_2,146,124
chr23-3842429_3842620,cPa356,0.5625,2,3842620,3842428,cPa356_cPa428,18_14,191,192
chr23-3842708_3842810,cPa428,0.51063829787234,2,3842780,3842707,cPa356_cPa428,23_24,102,73
chr23-3842868_3843074,cPa428,0.534090909090909,2,3843069,3842873,cPa356_cPa428,41_47,206,196
chr23-3843109_3843252,cPa356,0.714285714285714,2,3843234,3843127,cPa356_cPa428,15_6,143,107
chr23-3843453_3843555,cPa356,0.551724137931034,2,3843555,3843454,cPa356_cPa428,16_13,102,101
chr23-3843722_3843839,cPa356_cPa428,0.5,2,3843808,3843728,cPa356_cPa428,21_21,117,80
chr23-4006943_4007045,cPa75,1,1,4007044,4006993,cPa75,8,102,51
chr23-4108820_4108922,cPa75,1,1,4108887,4108870,cPa75,2,102,17
chr23-4138797_4138910,cPa107,0.942857142857143,2,4138866,4138844,cPa107_cPa107-unknown,33_2,113,22
chr23-4441482_4441776,cPa371,0.52,6,4441730,4441532,cPa323_cPa323-cPa371-hybrid_cPa323-unknown_cPa371_cPa371-cPa323-hybrid_cPa371-unknown,6_1_2_13_1_2,294,198
chr23-4441784_4442099,cPa371,0.5625,4,4442090,4441834,cPa323_cPa323-unknown_cPa371_cPa371-cPa50-hybrid,5_1_9_1,315,256
chr23-4442124_4442236,cPa371,0.5,3,4442184,4442174,cPa323-cPa371-hybrid_cPa371_cPa371-cPa323-hybrid,1_2_1,112,10
chr23-4445830_4445932,cPa450,1,1,4445880,4445880,cPa450,1,102,0
chr23-4460055_4460157,cPa428-cPa402-hybrid,1,1,4460105,4460105,cPa428-cPa402-hybrid,1,102,0
chr23-4460468_4460570,cPa428-cPa402-hybrid,1,1,4460518,4460518,cPa428-cPa402-hybrid,1,102,0
chr23-4545268_4545557,cPa113,0.6,6,4545505,4545285,cPa113_cPa113-cPa67-hybrid_cPa67_cPa67-unknown_cPa75-cPa67-hybrid_cPa75-unknown,12_1_4_1_1_1,289,220
chr23-4553842_4554027,cPa308,0.333333333333333,6,4553975,4553842,cPa260_cPa260-cPa308-hybrid_cPa308_cPa413_cPa572_cPa75-cPa260-hybrid,2_1_3_1_1_1,185,133
chr23-4744350_4744452,cPa75-unknown,1,1,4744400,4744400,cPa75-unknown,1,102,0
chr23-480698_480857,cPa260,0.75,2,480805,480734,cPa260_cPa551-cPa75-hybrid,3_1,159,71
chr23-481029_481131,cPa260-cPa75-hybrid,1,1,481079,481079,cPa260-cPa75-hybrid,1,102,0
chr23-481626_481728,cPa260-cPa75-hybrid,1,1,481676,481674,cPa260-cPa75-hybrid,2,102,2
chr23-4821737_4821839,cPa200,1,1,4821787,4821787,cPa200,1,102,0
chr23-4828977_4829294,cPa75-cPa223-hybrid,0.714285714285714,3,4829242,4829027,cPa75-cPa223-hybrid_cPa75-cPa553-hybrid_cPa75-HML1a_repbase_HERV-K14CI_LTR14C-hybrid,20_6_2,317,215
chr23-4901291_4901393,cPa75,1,1,4901341,4901341,cPa75,1,102,0
chr23-4901698_4901873,cPa75,1,1,4901821,4901748,cPa75,3,175,73
chr23-4901994_4902096,cPa75,1,1,4902044,4902044,cPa75,1,102,0
chr23-4902106_4902420,cPa75,1,1,4902368,4902156,cPa75,9,314,212
chr23-4902629_4902755,cPa75,1,1,4902703,4902679,cPa75,2,126,24
chr23-5003750_5004026,cPa323,0.428571428571429,4,5003982,5003767,cPa323_cPa323-unknown_cPa371_cPa371-unknown,9_3_8_1,276,215
chr23-5042670_5042772,cPa199-cPa443-hybrid_cPa345_cPa553_cPa553-cPa443-hybrid,0.25,4,5042736,5042677,cPa199-cPa443-hybrid_cPa345_cPa553_cPa553-cPa443-hybrid,1_1_1_1,102,59
chr23-5051471_5051573,cPa75,0.571428571428571,2,5051560,5051492,cPa75_cPa75-unknown,4_3,102,68
chr23-5112462_5112568,cPa425,1,1,5112516,5112512,cPa425,2,106,4
chr23-5112586_5112688,cPa75,1,1,5112636,5112636,cPa75,1,102,0
chr23-5116732_5116834,cPa62-cPa75-hybrid,1,1,5116782,5116782,cPa62-cPa75-hybrid,1,102,0
chr23-5116843_5116945,cPa62-cPa75-hybrid,1,1,5116893,5116893,cPa62-cPa75-hybrid,1,102,0
chr23-5135897_5136014,cPa75,1,1,5135962,5135917,cPa75,4,117,45
chr23-5136090_5136192,cPa75,1,1,5136140,5136140,cPa75,1,102,0
chr23-5136311_5136413,cPa75,1,1,5136361,5136361,cPa75,1,102,0
chr23-5136522_5136632,cPa75,1,1,5136580,5136572,cPa75,3,110,8
chr23-5136721_5136823,cPa75,1,1,5136771,5136771,cPa75,1,102,0
chr23-514229_514382,cPa75,1,1,514361,514279,cPa75,12,153,82
chr23-514504_514606,cPa75,1,1,514554,514554,cPa75,1,102,0
chr23-514887_515056,cPa75,1,1,515021,514898,cPa75,13,169,123
chr23-515489_515666,cPa75,1,1,515614,515539,cPa75,36,177,75
chr23-5180067_5180169,cPa75,1,1,5180117,5180102,cPa75,2,102,15
chr23-520998_521100,cPa75,1,1,521048,521048,cPa75,1,102,0
chr23-521325_521503,cPa75,1,1,521451,521375,cPa75,2,178,76
chr23-5223873_5224062,cPa75,1,1,5224010,5223923,cPa75,4,189,87
chr23-5224651_5224753,cPa75,1,1,5224701,5224686,cPa75,2,102,15
chr23-5245185_5245287,cPa62-cPa75-hybrid,1,1,5245235,5245235,cPa62-cPa75-hybrid,1,102,0
chr23-5260252_5260354,cPa75,1,1,5260302,5260302,cPa75,1,102,0
chr23-5276130_5276232,cPa482,1,1,5276180,5276180,cPa482,1,102,0
chr23-5276265_5276405,cPa505,0.5,7,5276397,5276273,cPa106_cPa109_cPa199_cPa201_cPa482_cPa482-cPa109-hybrid_cPa505,1_2_1_1_1_1_7,140,124
chr23-5343266_5343368,cPa371,0.5,3,5343365,5343270,cPa323_cPa323-cPa371-hybrid_cPa371,5_1_6,102,95
chr23-5352458_5352628,cPa505,1,1,5352576,5352484,cPa505,5,170,92
chr23-5352636_5352934,cPa505,0.583333333333333,6,5352882,5352686,cPa109-EIAV_NC001450-hybrid_cPa199_cPa446-cPa109-hybrid_cPa482_cPa482-cPa109-hybrid_cPa505,1_1_1_1_1_7,298,196
chr23-5556959_5557061,cPa199,0.769230769230769,3,5557051,5557009,cPa199_cPa199-unknown_cPa539,10_2_1,102,42
chr23-5706121_5706257,cPa16,0.464285714285714,13,5706224,5706135,cPa16_cPa16-cPa246-hybrid_cPa16-cPa363-hybrid_cPa16-unknown_cPa183-cPa379-hybrid_cPa327-unknown_cPa363_cPa363-PERVE_NC003059-hybrid_cPa379_cPa379-cPa16-hybrid_cPa379-cPa446-hybrid_cPa452_cPa452-cPa246-hybrid,13_1_1_3_1_1_1_1_2_1_1_1_1,136,89
chr23-613495_613691,cPa176,0.414634146341463,8,613665,613499,cPa176_cPa176-cPa177-hybrid_cPa176-cPa438-hybrid_cPa176-unknown_cPa177_cPa260_cPa438_cPa438-unknown,17_2_3_8_5_2_3_1,196,166
chr23-6147241_6147343,cPa75,1,1,6147291,6147275,cPa75,2,102,16
chr23-6149893_6150316,cPa62,0.814814814814815,5,6150264,6149893,cPa293_cPa293-cPa62-hybrid_cPa62_cPa62-unknown_cPa75,1_1_22_1_2,423,371
chr23-6225765_6225889,HERV-W_repbase_HERV17_LTR17,0.666666666666667,2,6225837,6225815,cPa75_HERV-W_repbase_HERV17_LTR17,1_2,124,22
chr23-6226017_6226140,HERV-W_repbase_HERV17_LTR17-cPa75-hybrid,0.4,4,6226088,6226067,cPa113_cPa67-cPa75-hybrid_HERV-W_repbase_HERV17_LTR17_HERV-W_repbase_HERV17_LTR17-cPa75-hybrid,1_1_1_2,123,21
chr23-6269221_6269323,cPa75-unknown,1,1,6269271,6269271,cPa75-unknown,1,102,0
chr23-6652563_6652665,cPa75-unknown,0.6,2,6652638,6652585,cPa75_cPa75-unknown,8_12,102,53
chr23-671299_671401,cPa452-cPa75-hybrid,1,1,671349,671349,cPa452-cPa75-hybrid,1,102,0
chr23-672323_672425,cPa452-cPa75-hybrid,1,1,672373,672373,cPa452-cPa75-hybrid,1,102,0
chr23-673920_674022,cPa75,1,1,673970,673970,cPa75,1,102,0
chr23-7057122_7057224,cPa356,0.625,2,7057217,7057146,cPa356_cPa428,5_3,102,71
chr23-7057294_7057507,cPa356,0.518518518518518,5,7057496,7057298,cPa356_cPa356-cPa428-hybrid_cPa428_cPa428-cPa356-hybrid_cPa428-unknown,14_1_10_1_1,213,198
chr23-7057509_7057744,cPa356_cPa428,0.5,2,7057739,7057511,cPa356_cPa428,17_17,235,228
chr23-706637_706739,cPa71,1,1,706738,706672,cPa71,13,102,66
chr23-706787_706977,cPa71,1,1,706927,706837,cPa71,8,190,90
chr23-707017_707119,cPa71,1,1,707100,707066,cPa71,4,102,34
chr23-789439_789541,cPa371_cPa371-cPa323-hybrid,0.5,2,789489,789462,cPa371_cPa371-cPa323-hybrid,1_1,102,27
chr23-789612_789943,cPa323,0.32,5,789891,789662,cPa323_cPa371_cPa371-cPa323-hybrid_cPa371-cPa438-hybrid_cPa434-cPa323-hybrid,8_6_6_4_1,331,229
chr23-801661_802005,cPa75-unknown,0.777777777777778,2,801953,801711,cPa75_cPa75-unknown,2_7,344,242
chr23-854092_854231,cPa456,0.43859649122807,14,854207,854095,cPa363_cPa363-cPa223-hybrid_cPa363-cPa345-hybrid_cPa363-cPa452-hybrid_cPa363-cPa553-hybrid_cPa452_cPa456_cPa456-cPa553-hybrid_cPa456-MLV_Xmv43-hybrid_cPa456-unknown_cPa553_cPa587-cPa452-hybrid_cPa587-cPa553-hybrid_cPa75-cPa363-hybrid,14_1_1_1_2_1_25_1_2_1_2_3_2_1,139,112
chr23-889326_889428,cPa323,0.5,4,889426,889348,cPa323_cPa323-unknown_cPa371_cPa371-unknown,4_1_2_1,102,78
chr23-922063_922165,cPa323,1,1,922126,922082,cPa323,6,102,44
chr23-936887_936989,cPa62,1,1,936937,936937,cPa62,1,102,0
chr23-941790_941892,cPa75,0.583333333333333,2,941887,941812,cPa75_cPa75-unknown,7_5,102,75
chr23-948937_949067,cPa71,0.380952380952381,5,949057,948941,cPa62_cPa71_cPa71-cPa62-hybrid_cPa75_cPa75-cPa62-hybrid,1_16_11_13_1,130,116
chr23-949069_949273,cPa71,0.452380952380952,4,949272,949085,cPa62_cPa71_cPa71-cPa62-hybrid_cPa75,2_19_9_12,204,187
chr23-957234_957336,cPa333_cPa333-cPa568-hybrid_cPa568,0.333333333333333,3,957300,957284,cPa333_cPa333-cPa568-hybrid_cPa568,1_1_1,102,16
chr23-971382_971484,cPa62,0.916666666666667,2,971456,971415,cPa62_cPa62-unknown,11_1,102,41
chr23-986377_986479,cPa539,1,1,986427,986427,cPa539,1,102,0
chr24-1025199_1025348,cPa363_cPa452,0.227272727272727,17,1025299,1025199,cPa183_cPa223_cPa327_cPa327-cPa379-hybrid_cPa363_cPa379_cPa379-cPa452-hybrid_cPa379-unknown_cPa446_cPa446-cPa183-hybrid_cPa446-cPa223-hybrid_cPa446-cPa327-hybrid_cPa446-unknown_cPa452_cPa452-cPa223-hybrid_cPa452-cPa363-hybrid_cPa452-unknown,7_1_1_1_15_9_1_2_7_1_1_1_1_15_1_1_1,149,100
chr24-1058238_1058426,cPa75,1,1,1058374,1058262,cPa75,4,188,112
chr24-1058496_1059055,cPa75,1,1,1059043,1058546,cPa75,42,559,497
chr24-1159366_1159468,cPa323,1,1,1159416,1159416,cPa323,1,102,0
chr24-1159542_1159689,cPa323,0.4,4,1159637,1159592,cPa323_cPa371_cPa371-cPa323-hybrid_cPa50,2_1_1_1,147,45
chr24-1169285_1169387,cPa379-cPa62-hybrid,1,1,1169335,1169335,cPa379-cPa62-hybrid,1,102,0
chr24-1284896_1285056,cPa356,0.5,3,1285004,1284946,cPa356_cPa356-cPa428-hybrid_cPa428,3_1_2,160,58
chr24-1285171_1285349,cPa356,1,1,1285297,1285221,cPa356,3,178,76
chr24-1285813_1285915,cPa356-cPa428-hybrid,1,1,1285863,1285863,cPa356-cPa428-hybrid,1,102,0
chr24-1323679_1323781,cPa543-cPa75-hybrid,1,1,1323729,1323729,cPa543-cPa75-hybrid,1,102,0
chr24-1323923_1324097,cPa75,1,1,1324045,1323948,cPa75,3,174,97
chr24-1331806_1331976,cPa434,0.954545454545455,2,1331965,1331810,cPa434_cPa434-unknown,21_1,170,155
chr24-133346_133530,cPa371,0.428571428571429,5,133519,133396,cPa323_cPa323-cPa443-hybrid_cPa371_cPa371-cPa118-hybrid_cPa371-cPa50-hybrid,1_1_3_1_1,184,123
chr24-133587_133927,cPa371,0.357142857142857,12,133878,133637,cPa323_cPa323-cPa118-hybrid_cPa323-cPa140-hybrid_cPa323-cPa371-hybrid_cPa323-cPa434-hybrid_cPa323-cPa50-hybrid_cPa323-cPa566-hybrid_cPa371_cPa371-cPa118-hybrid_cPa371-cPa323-hybrid_cPa371-cPa434-hybrid_cPa371-cPa566-hybrid,17_1_1_2_3_3_3_20_2_1_1_2,340,241
chr24-1336243_1336345,cPa371,0.590909090909091,3,1336318,1336246,cPa323_cPa371_cPa50-cPa323-hybrid,8_13_1,102,72
chr24-134170_134272,cPa371,0.4,4,134258,134220,cPa323_cPa323-cPa118-hybrid_cPa371_cPa371-cPa268-hybrid,1_1_2_1,102,38
chr24-1344914_1345016,cPa113,0.555555555555556,3,1345007,1344930,cPa113_cPa75-cPa113-hybrid_cPa75-unknown,5_2_2,102,77
chr24-134894_134996,cPa323-cPa566-hybrid_cPa371-cPa566-hybrid,0.5,2,134944,134934,cPa323-cPa566-hybrid_cPa371-cPa566-hybrid,1_1,102,10
chr24-1396194_1396296,WDSV_NC001867,0.666666666666667,2,1396254,1396213,cPa260_WDSV_NC001867,2_4,102,41
chr24-1414719_1414821,cPa371,0.944444444444444,2,1414799,1414730,cPa323_cPa371,1_17,102,69
chr24-1414850_1414954,cPa371,0.791666666666667,4,1414943,1414898,cPa323_cPa333-cPa50-hybrid_cPa371_cPa50,2_1_19_2,104,45
chr24-1415121_1415223,cPa371,0.727272727272727,2,1415204,1415122,cPa323_cPa371,3_8,102,82
chr24-1431619_1431721,cPa75,1,1,1431669,1431669,cPa75,1,102,0
chr24-1431830_1431955,cPa75,1,1,1431903,1431880,cPa75,2,125,23
chr24-146383_146485,cPa118,0.588235294117647,11,146443,146411,cPa118_cPa118-cPa268-hybrid_cPa118-unknown_cPa15-cPa118-hybrid_cPa15-cPa223-hybrid_cPa15-cPa298-hybrid_cPa15-cPa566-hybrid_cPa15-unknown_cPa268_cPa443_cPa443-unknown,20_1_2_1_1_1_1_2_1_3_1,102,32
chr24-1520428_1520530,cPa75,1,1,1520498,1520476,cPa75,3,102,22
chr24-1520727_1520829,cPa75,1,1,1520814,1520777,cPa75,2,102,37
chr24-1533986_1534088,cPa75_cPa75-unknown,0.5,2,1534036,1533985,cPa75_cPa75-unknown,1_1,102,51
chr24-1631819_1631921,cPa75-WDSV_NC001867-hybrid,1,1,1631869,1631869,cPa75-WDSV_NC001867-hybrid,1,102,0
chr24-172770_172872,cPa475,1,1,172820,172820,cPa475,1,102,0
chr24-1882704_1882806,cPa75,1,1,1882796,1882754,cPa75,3,102,42
chr24-1968036_1968183,cPa125,1,1,1968140,1968086,cPa125,12,147,54
chr24-1987105_1987363,cPa323,0.564516129032258,3,1987311,1987155,cPa323_cPa323-cPa371-hybrid_cPa371,35_1_26,258,156
chr24-1987482_1987664,cPa323_cPa371,0.428571428571429,4,1987656,1987522,cPa323_cPa371_cPa371-cPa323-hybrid_cPa371-cPa50-hybrid,6_6_1_1,182,134
chr24-1987775_1987877,cPa371,0.6,2,1987863,1987825,cPa323_cPa371,2_3,102,38
chr24-2086292_2086677,cPa371,0.479166666666667,7,2086625,2086342,cPa199-cPa371-hybrid_cPa323_cPa323-cPa260-hybrid_cPa323-cPa333-hybrid_cPa323-cPa371-hybrid_cPa323-cPa50-hybrid_cPa371,1_16_1_1_5_1_23,385,283
chr24-2086774_2086949,cPa371,0.470588235294118,3,2086938,2086817,cPa323_cPa323-cPa371-hybrid_cPa371,7_2_8,175,121
chr24-2163113_2163215,cPa223_cPa446,0.23943661971831,15,2163200,2163114,cPa183_cPa223_cPa223-cPa183-hybrid_cPa327_cPa327-cPa183-hybrid_cPa327-cPa223-hybrid_cPa327-cPa452-hybrid_cPa379_cPa424-cPa183-hybrid_cPa446_cPa446-cPa183-hybrid_cPa452_cPa482-cPa183-hybrid_cPa482-cPa223-hybrid_cPa482-cPa452-hybrid,2_17_2_6_9_3_3_1_1_17_3_1_4_1_1,102,86
chr24-2471201_2471318,cPa15-S71_repbase_HERVS71_LTR6A-hybrid,1,1,2471273,2471251,cPa15-S71_repbase_HERVS71_LTR6A-hybrid,3,117,22
chr24-2473566_2473670,cPa118_cPa15_cPa443-cPa268-hybrid,0.333333333333333,3,2473618,2473616,cPa118_cPa15_cPa443-cPa268-hybrid,1_1_1,104,2
chr24-2561777_2561879,cPa260,0.829787234042553,3,2561874,2561782,cPa228_cPa260_cPa260-cPa228-hybrid,7_39_1,102,92
chr24-2749219_2749321,cPa75,0.6,2,2749314,2749227,cPa75_HERV-W_repbase_HERV17_LTR17,3_2,102,87
chr24-2749380_2749482,cPa75,0.7,3,2749439,2749383,cPa75_HERV-W_repbase_HERV17_LTR17_HERV-W_repbase_HERV17_LTR17-unknown,7_2_1,102,56
chr24-2788160_2788282,cPa62,0.5,3,2788244,2788205,cPa285_cPa62_cPa75,1_3_2,122,39
chr24-293661_293763,cPa285_cPa62-cPa260-hybrid_cPa75,0.333333333333333,3,293711,293707,cPa285_cPa62-cPa260-hybrid_cPa75,1_1_1,102,4
chr24-297289_297391,cPa75,1,1,297339,297339,cPa75,1,102,0
chr24-3343456_3343558,cPa456,0.5,4,3343507,3343497,cPa363-cPa452-hybrid_cPa363-cPa587-hybrid_cPa363-unknown_cPa456,1_1_1_3,102,10
chr24-3434547_3434649,cPa200,0.954545454545455,2,3434647,3434572,cPa200_cPa200-unknown,21_1,102,75
chr24-3438245_3438347,cPa142,0.666666666666667,2,3438295,3438277,cPa101-unknown_cPa142,1_2,102,18
chr24-3560165_3560368,cPa15,0.555555555555556,5,3560318,3560215,cPa118_cPa15_cPa443_cPa443-cPa118-hybrid_cPa443-cPa140-hybrid,1_5_1_1_1,203,103
chr24-3562062_3562164,cPa227-unknown_cPa273,0.25,7,3562122,3562063,cPa168_cPa168-FrMuLV_NC001362-hybrid_cPa227_cPa227-FrMuLV_NC001362-hybrid_cPa227-unknown_cPa273_cPa273-FrMuLV_NC001362-hybrid,1_1_1_2_3_3_1,102,59
chr24-359512_359636,cPa62,0.875,2,359635,359562,cPa254_cPa62,1_7,124,73
chr24-3618289_3618471,cPa75,0.625,2,3618423,3618339,cPa75_cPa75-unknown,5_3,182,84
chr24-3717164_3717266,cPa356_cPa428,0.5,2,3717214,3717214,cPa356_cPa428,1_1,102,0
chr24-3755668_3755770,cPa75,1,1,3755718,3755718,cPa75,1,102,0
chr24-3769701_3769824,cPa62-cPa75-hybrid_cPa75,0.333333333333333,6,3769823,3769709,cPa62_cPa62-cPa71-hybrid_cPa62-cPa75-hybrid_cPa62-unknown_cPa75_HERV-W_repbase_HERV17_LTR17,1_3_11_6_11_1,123,114
chr24-3858116_3858218,cPa177-cPa75-hybrid,1,1,3858166,3858166,cPa177-cPa75-hybrid,1,102,0
chr24-3858961_3859063,cPa482,1,1,3859017,3859011,cPa482,2,102,6
chr24-3878813_3878915,cPa62,1,1,3878871,3878857,cPa62,20,102,14
chr24-3880287_3880389,cPa194,0.444444444444444,6,3880374,3880289,cPa194_cPa345_cPa345-cPa194-hybrid_cPa345-cPa67-hybrid_cPa345-unknown_cPa67,12_1_1_1_2_10,102,85
chr24-3883024_3883126,cPa15,1,1,3883074,3883074,cPa15,1,102,0
chr24-3883180_3883282,cPa118-cPa140-hybrid_cPa15,0.5,2,3883232,3883230,cPa118-cPa140-hybrid_cPa15,1_1,102,2
chr24-3939916_3940018,cPa323,0.540540540540541,4,3939973,3939926,cPa323_cPa371_cPa371-cPa568-hybrid_cPa371-unknown,20_13_2_2,102,47
chr24-3940046_3940202,cPa323,0.55,5,3940180,3940081,cPa323_cPa371_cPa371-cPa50-hybrid_cPa371-cPa512-hybrid_cPa371-unknown,44_29_1_1_5,156,99
chr24-3990121_3990223,cPa62_cPa62-cPa539-hybrid,0.5,2,3990176,3990171,cPa62_cPa62-cPa539-hybrid,1_1,102,5
chr24-3990238_3990437,cPa62,0.8,3,3990407,3990239,cPa285_cPa62_cPa62-unknown,1_12_2,199,168
chr24-4032590_4032692,cPa313,0.666666666666667,2,4032680,4032640,cPa183-cPa313-hybrid_cPa313,1_2,102,40
chr24-4036203_4036305,cPa62,1,1,4036281,4036253,cPa62,13,102,28
chr24-4054832_4054934,cPa492,1,1,4054882,4054859,cPa492,2,102,23
chr24-4176301_4176403,cPa62,1,1,4176351,4176351,cPa62,1,102,0
chr24-4184890_4184992,cPa62,1,1,4184940,4184940,cPa62,1,102,0
chr24-4240783_4240885,HERV-R_repbase_HERV3_LTR4,0.4,4,4240833,4240794,cPa223-HERV-R_repbase_HERV3_LTR4-hybrid_cPa371_cPa371-HERV-R_repbase_HERV3_LTR4-hybrid_HERV-R_repbase_HERV3_LTR4,1_1_1_2,102,39
chr24-4305117_4305219,cPa176_cPa176-cPa379-hybrid_cPa363_cPa452,0.25,4,4305199,4305167,cPa176_cPa176-cPa379-hybrid_cPa363_cPa452,1_1_1_1,102,32
chr24-4313425_4313527,cPa75,1,1,4313475,4313446,cPa75,2,102,29
chr24-4349500_4349630,cPa75,0.434782608695652,6,4349587,4349499,cPa62_cPa71-cPa62-hybrid_cPa71-unknown_cPa75_cPa75-cPa62-hybrid_cPa75-unknown,2_1_2_10_4_4,130,88
chr24-4356320_4356422,cPa75_HERV-W_repbase_HERV17_LTR17-unknown,0.25,7,4356383,4356336,cPa62-unknown_cPa75_HERV-W_repbase_HERV17_LTR17_HERV-W_repbase_HERV17_LTR17-cPa113-hybrid_HERV-W_repbase_HERV17_LTR17-cPa62-hybrid_HERV-W_repbase_HERV17_LTR17-cPa75-hybrid_HERV-W_repbase_HERV17_LTR17-unknown,1_3_1_1_1_2_3,102,47
chr24-4395548_4395736,CAEV_NC001463,0.875,2,4395710,4395598,CAEV_NC001463_WDSV_NC001867-unknown,7_1,188,112
chr24-4477709_4477811,cPa118_cPa434-cPa443-hybrid,0.225806451612903,13,4477806,4477711,cPa118_cPa15-cPa118-hybrid_cPa15-cPa443-hybrid_cPa434_cPa434-cPa118-hybrid_cPa434-cPa248-hybrid_cPa434-cPa268-hybrid_cPa434-cPa443-hybrid_cPa434-unknown_cPa566_cPa566-cPa15-hybrid_cPa566-cPa443-hybrid_cPa566-unknown,7_1_2_1_3_2_1_7_2_1_1_1_2,102,95
chr24-4492408_4492643,cPa75,0.666666666666667,4,4492616,4492420,cPa75_cPa75-unknown_HERV-F_repbase_HERVFH19I_LTR19A-cPa62-hybrid_HERV-W_repbase_HERV17_LTR17-cPa62-hybrid,8_2_1_1,235,196
chr24-4637785_4637887,cPa118_cPa118-cPa566-hybrid,0.5,2,4637850,4637835,cPa118_cPa118-cPa566-hybrid,1_1,102,15
chr24-4642256_4642358,cPa62,0.869565217391304,3,4642324,4642272,cPa293_cPa62_cPa62-unknown,1_20_2,102,52
chr24-4646806_4646908,cPa62,1,1,4646874,4646827,cPa62,10,102,47
chr24-4681188_4681343,cPa75,1,1,4681291,4681238,cPa75,9,155,53
chr24-4730279_4730381,cPa492,1,1,4730329,4730288,cPa492,3,102,41
chr24-4738098_4738200,cPa62,1,1,4738149,4738142,cPa62,4,102,7
chr24-475433_475535,cPa67,0.538461538461538,3,475488,475454,cPa194_cPa67_cPa75-cPa194-hybrid,5_7_1,102,34
chr24-4756661_4756763,cPa62,1,1,4756715,4756680,cPa62,7,102,35
chr24-4787748_4787850,cPa75,1,1,4787798,4787798,cPa75,1,102,0
chr24-4788051_4788324,HERV-W_repbase_HERV17_LTR17,0.8,4,4788299,4788098,cPa75-HERV-W_repbase_HERV17_LTR17-hybrid_cPa75-KoRV_AF151794-hybrid_HERV-W_repbase_HERV17_LTR17_KWERV_GQ222416,1_1_12_1,273,201
chr24-4834421_4834523,cPa62,1,1,4834514,4834471,cPa62,3,102,43
chr24-5088106_5088208,cPa62,0.75,2,5088158,5088154,cPa62_HML7_repbase_HERVK11DI_MER11D-cPa62-hybrid,3_1,102,4
chr24-5114539_5114641,WDSV_NC001867,0.4,6,5114595,5114589,cPa199-WDSV_NC001867-hybrid_cPa486_cPa62_cPa62-cPa486-hybrid_cPa75_WDSV_NC001867,1_1_1_1_2_4,102,6
chr24-5145381_5145517,cPa223-cPa273-hybrid_cPa223-cPa542-hybrid_cPa223-cPa62-hybrid_cPa345-cPa62-hybrid_cPa450_cPa542_cPa553,0.142857142857143,7,5145465,5145431,cPa223-cPa273-hybrid_cPa223-cPa542-hybrid_cPa223-cPa62-hybrid_cPa345-cPa62-hybrid_cPa450_cPa542_cPa553,1_1_1_1_1_1_1,136,34
chr24-5159043_5159145,cPa285,1,1,5159093,5159093,cPa285,1,102,0
chr24-5194168_5194375,cPa62,1,1,5194323,5194218,cPa62,11,207,105
chr24-5244765_5244867,cPa539,1,1,5244815,5244815,cPa539,1,102,0
chr24-5316393_5316599,cPa62,1,1,5316547,5316413,cPa62,4,206,134
chr24-5361679_5361824,cPa273,0.411764705882353,6,5361791,5361729,cPa273_cPa273-cPa553-hybrid_cPa542_cPa542-cPa553-hybrid_cPa553_SIV_NC001870,7_1_2_1_5_1,145,62
chr24-5361913_5362015,cPa553,0.553191489361702,5,5361981,5361938,cPa273_cPa273-cPa553-hybrid_cPa542_cPa553_cPa553-unknown,17_1_2_26_1,102,43
chr24-5362111_5362213,cPa273_cPa553,0.5,2,5362161,5362154,cPa273_cPa553,1_1,102,7
chr24-5367579_5367681,cPa62,1,1,5367629,5367629,cPa62,1,102,0
chr24-5371367_5371469,HML5_repbase_HERVK22I_LTR22-cPa75-hybrid,1,1,5371417,5371417,HML5_repbase_HERVK22I_LTR22-cPa75-hybrid,1,102,0
chr24-5409486_5409614,cPa539,1,1,5409562,5409536,cPa539,3,128,26
chr24-5446913_5447024,cPa199,0.384615384615385,7,5447002,5446959,cPa109_cPa199_cPa201_cPa201-unknown_cPa482_cPa482-cPa152-hybrid_cPa482-unknown,2_5_1_1_2_1_1,111,43
chr24-571121_571273,cPa67,0.5,4,571272,571146,cPa194_cPa194-unknown_cPa67_cPa67-unknown,33_1_35_1,152,126
chr24-5713657_5713767,cPa15,0.4,4,5713715,5713705,cPa118_cPa15_cPa268_cPa268-cPa140-hybrid,1_2_1_1,110,10
chr24-5823260_5823362,cPa450,1,1,5823310,5823310,cPa450,1,102,0
chr24-5829030_5829194,cPa199,0.368421052631579,11,5829189,5829080,cPa199_cPa199-cPa345-hybrid_cPa199-unknown_cPa223-cPa450-hybrid_cPa223-unknown_cPa273_cPa273-cPa553-hybrid_cPa345_cPa345-unknown_cPa542_cPa553,21_1_1_1_1_2_1_6_1_2_20,164,109
chr24-5854191_5854429,cPa199,1,1,5854385,5854241,cPa199,29,238,144
chr24-5854518_5854759,cPa199,0.972222222222222,2,5854756,5854518,cPa199_HERV-XA34_repbase_HERVFH21I_LTR21A-cPa199-hybrid,35_1,241,238
chr24-5854766_5854868,cPa199,1,1,5854828,5854780,cPa199,7,102,48
chr24-5885686_5885788,cPa391,1,1,5885736,5885736,cPa391,1,102,0
chr24-5885798_5885900,cPa293,1,1,5885848,5885848,cPa293,1,102,0
chr24-5965866_5965968,cPa51,1,1,5965916,5965916,cPa51,1,102,0
chr24-5967937_5968143,cPa285,0.428571428571429,4,5968091,5967947,cPa285_cPa62_cPa62-cPa285-hybrid_cPa75,3_2_1_1,206,144
chr24-6031134_6031236,cPa75,1,1,6031211,6031135,cPa75,4,102,76
chr24-6093351_6093453,cPa75,1,1,6093401,6093395,cPa75,2,102,6
chr24-6179503_6179638,cPa75,1,1,6179617,6179540,cPa75,24,135,77
chr24-6369858_6369960,cPa450,1,1,6369908,6369908,cPa450,1,102,0
chr24-6426892_6426994,cPa539-cPa381-hybrid,1,1,6426942,6426942,cPa539-cPa381-hybrid,1,102,0
chr24-6427101_6427218,cPa505_cPa505-cPa109-hybrid,0.5,2,6427166,6427151,cPa505_cPa505-cPa109-hybrid,1_1,117,15
chr24-6765369_6765471,cPa75,0.285714285714286,6,6765420,6765392,cPa113_cPa293_cPa392_cPa75_cPa75-cPa113-hybrid_cPa75-unknown,1_1_1_2_1_1,102,28
chr24-7072268_7072449,cPa425,1,1,7072397,7072277,cPa425,34,181,120
chr24-7072890_7072992,cPa425,1,1,7072940,7072940,cPa425,1,102,0
chr24-7076469_7076596,cPa75,0.666666666666667,2,7076544,7076483,cPa75_cPa75-cPa62-hybrid,2_1,127,61
chr24-7077029_7077131,cPa75,1,1,7077079,7077079,cPa75,1,102,0
chr24-7077545_7077647,cPa62,0.740740740740741,5,7077600,7077552,cPa254_cPa62_cPa62-unknown_cPa75-cPa254-hybrid_cPa75-cPa62-hybrid,2_20_1_1_3,102,48
chr24-7145768_7145942,cPa75-unknown,1,1,7145890,7145818,cPa75-unknown,3,174,72
chr24-7277321_7277423,cPa75,1,1,7277371,7277371,cPa75,1,102,0
chr24-885148_885250,cPa260,0.454545454545455,4,885235,885177,cPa228_cPa260_cPa260-cPa228-hybrid_MER52A_repbase_MER52AI_MER52A,4_5_1_1,102,58
chr25-1048135_1048237,cPa111,1,1,1048185,1048185,cPa111,1,102,0
chr25-1064686_1064822,cPa260,0.4,4,1064808,1064698,cPa260_cPa566_cPa566-cPa125-hybrid_cPa566-cPa410-hybrid,2_1_1_1,136,110
chr25-1180796_1180923,cPa62,1,1,1180886,1180846,cPa62,9,127,40
chr25-1180939_1181120,cPa62,1,1,1181074,1180989,cPa62,8,181,85
chr25-1188632_1188734,cPa363,1,1,1188682,1188682,cPa363,1,102,0
chr25-1218033_1218198,cPa452,0.5,3,1218146,1218083,cPa452_cPa75-cPa163-hybrid_cPa75-cPa452-hybrid,2_1_1,165,63
chr25-1219667_1219769,cPa583-cPa75-hybrid,1,1,1219717,1219717,cPa583-cPa75-hybrid,1,102,0
chr25-1222868_1222970,cPa111,1,1,1222948,1222903,cPa111,10,102,45
chr25-1232982_1233084,cPa482,1,1,1233032,1233032,cPa482,1,102,0
chr25-1233278_1233380,cPa482,0.75,2,1233328,1233302,cPa199_cPa482,1_3,102,26
chr25-1243950_1244052,cPa323,0.769230769230769,2,1244049,1243960,cPa323_cPa371,10_3,102,89
chr25-1260983_1261086,EIAV_NC001450-cPa260-hybrid,0.75,2,1261034,1260988,EIAV_NC001450-cPa260-hybrid_EIAV_NC001450-unknown,3_1,103,46
chr25-1268311_1268413,cPa486-cPa285-hybrid,1,1,1268361,1268361,cPa486-cPa285-hybrid,1,102,0
chr25-1269025_1269299,cPa285,0.4,5,1269247,1269075,cPa285_cPa486-cPa285-hybrid_cPa512_cPa75_cPa75-cPa285-hybrid,4_1_1_2_2,274,172
chr25-1290315_1290505,cPa75,1,1,1290496,1290365,cPa75,4,190,131
chr25-1290510_1290669,cPa75,1,1,1290617,1290560,cPa75,5,159,57
chr25-1290807_1290909,cPa75,1,1,1290857,1290857,cPa75,1,102,0
chr25-1290985_1291270,cPa75,1,1,1291218,1291035,cPa75,7,285,183
chr25-1291279_1291381,cPa75,1,1,1291329,1291329,cPa75,1,102,0
chr25-1291450_1291581,cPa75,1,1,1291529,1291500,cPa75,2,131,29
chr25-1291676_1291778,cPa75,1,1,1291726,1291726,cPa75,1,102,0
chr25-1291838_1291971,cPa75,1,1,1291919,1291888,cPa75,3,133,31
chr25-1300930_1301032,cPa356,0.7,2,1301021,1300929,cPa356_cPa428,7_3,102,92
chr25-1302035_1302137,cPa428-cPa75-hybrid,1,1,1302085,1302085,cPa428-cPa75-hybrid,1,102,0
chr25-1303814_1303916,cPa75,1,1,1303864,1303864,cPa75,1,102,0
chr25-1308706_1308930,cPa75,1,1,1308878,1308756,cPa75,7,224,122
chr25-1308949_1309132,cPa75,1,1,1309080,1308999,cPa75,3,183,81
chr25-1309209_1309319,cPa75,1,1,1309267,1309259,cPa75,2,110,8
chr25-1331221_1331349,cPa75,1,1,1331297,1331271,cPa75,11,128,26
chr25-1331419_1331669,cPa75,1,1,1331617,1331450,cPa75,7,250,167
chr25-1332342_1332444,cPa75,1,1,1332392,1332392,cPa75,1,102,0
chr25-1333808_1333948,cPa75,1,1,1333896,1333858,cPa75,3,140,38
chr25-1334846_1335065,cPa75,1,1,1335013,1334896,cPa75,3,219,117
chr25-1335615_1335880,cPa75,1,1,1335828,1335665,cPa75,3,265,163
chr25-1335978_1336080,cPa75,1,1,1336028,1336028,cPa75,1,102,0
chr25-1343877_1343979,cPa75,1,1,1343927,1343927,cPa75,1,102,0
chr25-1344133_1344614,cPa75,1,1,1344562,1344183,cPa75,9,481,379
chr25-1344729_1344900,cPa75,1,1,1344848,1344779,cPa75,2,171,69
chr25-1344918_1345020,cPa75-cPa360-hybrid,1,1,1344968,1344968,cPa75-cPa360-hybrid,1,102,0
chr25-1357967_1358519,cPa75,1,1,1358467,1358017,cPa75,14,552,450
chr25-1358564_1358680,cPa75,1,1,1358628,1358614,cPa75,2,116,14
chr25-1358703_1359333,cPa75,1,1,1359281,1358753,cPa75,40,630,528
chr25-1359378_1359480,cPa75,1,1,1359428,1359428,cPa75,1,102,0
chr25-1362948_1363050,cPa75,1,1,1363000,1362998,cPa75,2,102,2
chr25-1364963_1365065,cPa285-cPa75-hybrid,1,1,1365013,1365013,cPa285-cPa75-hybrid,1,102,0
chr25-1365457_1365622,cPa285-cPa75-hybrid_cPa75,0.5,2,1365570,1365507,cPa285-cPa75-hybrid_cPa75,1_1,165,63
chr25-1371734_1371836,cPa75,1,1,1371784,1371784,cPa75,1,102,0
chr25-1372007_1372861,cPa75,1,1,1372809,1372057,cPa75,52,854,752
chr25-1372995_1373097,cPa75,1,1,1373053,1373045,cPa75,2,102,8
chr25-1377862_1378223,cPa75,1,1,1378171,1377912,cPa75,5,361,259
chr25-1378411_1378513,cPa75,1,1,1378461,1378461,cPa75,1,102,0
chr25-1378674_1378969,cPa75,1,1,1378917,1378724,cPa75,7,295,193
chr25-1378992_1379122,cPa75,1,1,1379107,1379042,cPa75,5,130,65
chr25-1379167_1379325,cPa75,1,1,1379273,1379217,cPa75,2,158,56
chr25-1392192_1392555,cPa75,1,1,1392503,1392242,cPa75,8,363,261
chr25-1392560_1392662,cPa75,1,1,1392610,1392610,cPa75,1,102,0
chr25-1392783_1393022,cPa75,1,1,1392970,1392833,cPa75,10,239,137
chr25-1393091_1393298,cPa75,1,1,1393246,1393141,cPa75,17,207,105
chr25-1395671_1395773,cPa75,1,1,1395721,1395721,cPa75,1,102,0
chr25-1405536_1405676,cPa75,1,1,1405668,1405586,cPa75,3,140,82
chr25-1405703_1405805,cPa75-unknown,1,1,1405753,1405753,cPa75-unknown,2,102,0
chr25-1409566_1409696,cPa75,1,1,1409644,1409616,cPa75,2,130,28
chr25-1415869_1416247,cPa75,0.76,2,1416241,1415901,cPa308-cPa75-hybrid_cPa75,6_19,378,340
chr25-1425665_1425767,cPa75,1,1,1425715,1425715,cPa75,1,102,0
chr25-1425989_1426091,cPa75,1,1,1426039,1426039,cPa75,1,102,0
chr25-1430746_1431250,cPa75,1,1,1431198,1430796,cPa75,15,504,402
chr25-1431952_1433256,cPa75,1,1,1433204,1432002,cPa75,63,1304,1202
chr25-1435816_1435918,cPa75,1,1,1435866,1435866,cPa75,1,102,0
chr25-1435924_1436058,cPa75,1,1,1436006,1435974,cPa75,3,134,32
chr25-1436159_1436261,cPa75,1,1,1436209,1436209,cPa75,1,102,0
chr25-1436456_1437205,cPa75,1,1,1437205,1436506,cPa75,35,749,699
chr25-1440215_1440317,cPa75,1,1,1440265,1440265,cPa75,1,102,0
chr25-1448684_1448789,cPa75,1,1,1448737,1448734,cPa75,2,105,3
chr25-1448873_1449024,cPa75,1,1,1448972,1448923,cPa75,4,151,49
chr25-1449062_1449231,cPa75,1,1,1449179,1449112,cPa75,4,169,67
chr25-1449271_1449391,cPa75,1,1,1449348,1449321,cPa75,3,120,27
chr25-1449427_1449571,cPa75,1,1,1449566,1449477,cPa75,5,144,89
chr25-1480869_1480971,cPa75,1,1,1480919,1480876,cPa75,2,102,43
chr25-1499297_1499399,cPa75,1,1,1499356,1499339,cPa75,3,102,17
chr25-1515243_1515515,cPa75,1,1,1515473,1515285,cPa75,25,272,188
chr25-1518632_1518734,cPa75,1,1,1518682,1518682,cPa75,1,102,0
chr25-1519929_1520031,cPa75,1,1,1519979,1519979,cPa75,1,102,0
chr25-1520098_1520258,cPa75,1,1,1520206,1520148,cPa75,2,160,58
chr25-1520341_1520569,cPa75,1,1,1520517,1520391,cPa75,6,228,126
chr25-1520705_1521038,cPa75,1,1,1520986,1520755,cPa75,10,333,231
chr25-1523593_1523973,cPa75,1,1,1523921,1523643,cPa75,18,380,278
chr25-1524093_1524219,cPa75,1,1,1524167,1524143,cPa75,6,126,24
chr25-1524395_1524560,cPa75,1,1,1524508,1524445,cPa75,2,165,63
chr25-1524626_1524728,cPa75,1,1,1524676,1524676,cPa75,1,102,0
chr25-1524914_1525047,cPa75,1,1,1524995,1524964,cPa75,3,133,31
chr25-1525388_1525540,cPa75,1,1,1525488,1525438,cPa75,5,152,50
chr25-1588748_1588850,cPa75-unknown,1,1,1588798,1588798,cPa75-unknown,1,102,0
chr25-1588894_1589042,cPa75_cPa75-unknown,0.5,2,1588990,1588903,cPa75_cPa75-unknown,2_2,148,87
chr25-1589044_1589146,cPa75,1,1,1589094,1589094,cPa75,1,102,0
chr25-1596683_1596785,cPa505-cPa75-hybrid,1,1,1596733,1596733,cPa505-cPa75-hybrid,1,102,0
chr25-1606466_1606578,cPa323,0.692307692307692,2,1606548,1606467,cPa323_cPa371,9_4,112,81
chr25-1618715_1618852,cPa75-unknown,0.857142857142857,2,1618816,1618733,cPa75-cPa572-hybrid_cPa75-unknown,1_6,137,83
chr25-1643871_1644037,cPa199,0.888888888888889,4,1644014,1643920,cPa199_cPa505-unknown_cPa539-cPa199-hybrid_cPa539-unknown,24_1_1_1,166,94
chr25-1663014_1663175,cPa356_cPa428,0.5,2,1663123,1663064,cPa356_cPa428,2_2,161,59
chr25-1669873_1670083,cPa428,0.583333333333333,3,1670034,1669881,cPa356_cPa428_cPa428-cPa356-hybrid,4_7_1,210,153
chr25-1670837_1671155,cPa428,0.513513513513513,2,1671152,1670845,cPa356_cPa428,54_57,318,307
chr25-1671165_1671370,cPa356,0.520325203252033,3,1671330,1671180,cPa356_cPa428_cPa428-cPa356-hybrid,64_58_1,205,150
chr25-1677846_1677948,cPa356,1,1,1677896,1677891,cPa356,2,102,5
chr25-1679577_1679726,cPa356,0.5,3,1679674,1679612,cPa356_cPa356-unknown_cPa428,7_1_6,149,62
chr25-1679804_1679906,cPa356_cPa428,0.5,2,1679905,1679854,cPa356_cPa428,1_1,102,51
chr25-1682763_1682879,cPa75,1,1,1682840,1682813,cPa75,3,116,27
chr25-1683349_1683464,cPa75,1,1,1683414,1683398,cPa75,13,115,16
chr25-1703002_1703125,cPa75,1,1,1703074,1703052,cPa75,9,123,22
chr25-1703275_1703377,cPa75,1,1,1703325,1703319,cPa75,2,102,6
chr25-1703386_1703619,cPa75,1,1,1703579,1703393,cPa75,11,233,186
chr25-1703624_1703775,cPa75,1,1,1703764,1703631,cPa75,10,151,133
chr25-1704952_1705170,cPa75,1,1,1705118,1705002,cPa75,9,218,116
chr25-1705206_1705326,cPa75,1,1,1705274,1705256,cPa75,3,120,18
chr25-1705336_1705793,cPa75,1,1,1705741,1705386,cPa75,51,457,355
chr25-1731620_1731722,cPa75,1,1,1731670,1731670,cPa75,1,102,0
chr25-1731738_1731964,cPa75,1,1,1731941,1731757,cPa75,9,226,184
chr25-1732564_1732666,cPa75,1,1,1732652,1732614,cPa75,2,102,38
chr25-1733075_1733329,cPa75,1,1,1733277,1733125,cPa75,13,254,152
chr25-1733905_1734467,cPa75,1,1,1734415,1733955,cPa75,47,562,460
chr25-1734561_1734767,cPa75,1,1,1734715,1734575,cPa75,8,206,140
chr25-1734826_1734935,cPa75,1,1,1734883,1734876,cPa75,3,109,7
chr25-1735021_1735182,cPa75,1,1,1735130,1735071,cPa75,13,161,59
chr25-1735283_1735385,cPa75,1,1,1735333,1735333,cPa75,1,102,0
chr25-1747250_1747352,cPa75,1,1,1747300,1747300,cPa75,1,102,0
chr25-1747365_1747467,cPa75,1,1,1747415,1747415,cPa75,1,102,0
chr25-1747774_1747876,cPa75,1,1,1747824,1747824,cPa75,1,102,0
chr25-1748168_1748477,cPa75,1,1,1748425,1748218,cPa75,17,309,207
chr25-1748531_1748807,cPa75,1,1,1748768,1748581,cPa75,11,276,187
chr25-1753354_1753458,cPa75,1,1,1753406,1753404,cPa75,2,104,2
chr25-1757710_1757812,cPa75,1,1,1757760,1757747,cPa75,2,102,13
chr25-1757833_1757935,cPa75,1,1,1757883,1757872,cPa75,2,102,11
chr25-1757974_1758087,cPa75,1,1,1758035,1758024,cPa75,2,113,11
chr25-1768656_1768758,cPa75,1,1,1768706,1768706,cPa75,1,102,0
chr25-1769584_1769686,cPa75,1,1,1769634,1769634,cPa75,1,102,0
chr25-1769702_1769806,cPa75,1,1,1769758,1769752,cPa75,8,104,6
chr25-1769826_1769972,cPa75,1,1,1769920,1769876,cPa75,3,146,44
chr25-1770004_1770398,cPa75,1,1,1770346,1770054,cPa75,25,394,292
chr25-1771124_1771226,cPa75,1,1,1771174,1771174,cPa75,1,102,0
chr25-1771240_1771342,cPa75,1,1,1771290,1771270,cPa75,3,102,20
chr25-1771485_1771682,cPa75,1,1,1771630,1771535,cPa75,4,197,95
chr25-1771709_1771811,cPa75,1,1,1771759,1771759,cPa75,1,102,0
chr25-1771835_1771937,cPa75,1,1,1771885,1771885,cPa75,1,102,0
chr25-1771990_1772092,cPa75,1,1,1772040,1772040,cPa75,1,102,0
chr25-1829922_1830024,cPa75,1,1,1829972,1829972,cPa75,1,102,0
chr25-1830163_1830265,cPa75,1,1,1830213,1830213,cPa75,1,102,0
chr25-1830412_1830514,cPa75,1,1,1830462,1830462,cPa75,1,102,0
chr25-1836497_1836733,cPa75,0.864864864864865,2,1836695,1836547,cPa75_cPa75-unknown,32_5,236,148
chr25-1836838_1836940,cPa75,1,1,1836893,1836888,cPa75,2,102,5
chr25-1844216_1844347,cPa75,1,1,1844295,1844266,cPa75,2,131,29
chr25-1847573_1847675,cPa75,1,1,1847623,1847623,cPa75,1,102,0
chr25-1865240_1865342,WDSV_NC001867-cPa62-hybrid,0.541666666666667,3,1865337,1865239,cPa62_WDSV_NC001867_WDSV_NC001867-cPa62-hybrid,1_10_13,102,98
chr25-1865407_1865516,WDSV_NC001867-cPa62-hybrid,0.411764705882353,4,1865512,1865415,cPa62_WDSV_NC001867_WDSV_NC001867-cPa62-hybrid_WDSV_NC001867-unknown,4_5_7_1,109,97
chr25-1878360_1878462,cPa75,1,1,1878410,1878410,cPa75,1,102,0
chr25-1879473_1879575,WDSV_NC001867,1,1,1879523,1879523,WDSV_NC001867,1,102,0
chr25-1881648_1881750,cPa75-unknown,0.5625,2,1881716,1881668,cPa75_cPa75-unknown,7_9,102,48
chr25-1881770_1881940,cPa75,0.75,2,1881888,1881820,cPa75_cPa75-unknown,3_1,170,68
chr25-1883734_1883891,cPa505,0.529411764705882,3,1883874,1883775,cPa199_cPa199-cPa106-hybrid_cPa505,7_1_9,157,99
chr25-1884524_1884626,cPa539,0.333333333333333,5,1884597,1884541,cPa199_cPa273_cPa505-cPa539-hybrid_cPa539_ENTV_NC004994-cPa106-hybrid,1_1_1_2_1,102,56
chr25-1910994_1911096,cPa75,1,1,1911044,1911044,cPa75,1,102,0
chr25-1980023_1980247,cPa75,1,1,1980213,1980073,cPa75,19,224,140
chr25-1980258_1980360,cPa75,1,1,1980335,1980258,cPa75,16,102,77
chr25-1980415_1980604,cPa75,1,1,1980552,1980414,cPa75,15,189,138
chr25-2081303_2081405,cPa75,1,1,2081353,2081353,cPa75,1,102,0
chr25-2114699_2114801,cPa75,1,1,2114749,2114736,cPa75,3,102,13
chr25-2119048_2119150,cPa75,1,1,2119098,2119098,cPa75,1,102,0
chr25-2119196_2119298,cPa75,1,1,2119246,2119246,cPa75,3,102,0
chr25-2119410_2119573,cPa293-cPa75-hybrid_cPa75,0.5,2,2119521,2119460,cPa293-cPa75-hybrid_cPa75,1_1,163,61
chr25-2119807_2119909,cPa75,1,1,2119857,2119857,cPa75,1,102,0
chr25-2161094_2161250,cPa75,1,1,2161198,2161132,cPa75,6,156,66
chr25-2195934_2196036,cPa539,1,1,2195984,2195984,cPa539,1,102,0
chr25-2196097_2196199,cPa539,1,1,2196164,2196147,cPa539,3,102,17
chr25-2206365_2206565,cPa62,1,1,2206556,2206365,cPa62,5,200,191
chr25-2206639_2206782,cPa62,1,1,2206730,2206663,cPa62,3,143,67
chr25-2210572_2210674,cPa75,1,1,2210622,2210622,cPa75,1,102,0
chr25-2213987_2214089,rRVRV_JQ303225,1,1,2214037,2214037,rRVRV_JQ303225,1,102,0
chr25-2239504_2239671,cPa75,1,1,2239619,2239554,cPa75,4,167,65
chr25-2241315_2241417,cPa75,1,1,2241379,2241365,cPa75,3,102,14
chr25-2244927_2245057,cPa75,1,1,2245005,2244977,cPa75,3,130,28
chr25-2245123_2246121,cPa75,1,1,2246069,2245173,cPa75,51,998,896
chr25-2246146_2246248,cPa75,1,1,2246196,2246196,cPa75,1,102,0
chr25-2254563_2254665,cPa75,0.6,2,2254663,2254593,cPa75_cPa75-unknown,3_2,102,70
chr25-2254670_2254820,cPa75,0.833333333333333,2,2254775,2254670,cPa75_cPa75-unknown,5_1,150,105
chr25-2255263_2255365,cPa75,1,1,2255313,2255313,cPa75,1,102,0
chr25-2255413_2255515,cPa75,1,1,2255463,2255463,cPa75,1,102,0
chr25-2255652_2255754,cPa75,1,1,2255702,2255702,cPa75,1,102,0
chr25-2258115_2258248,cPa75,0.666666666666667,2,2258198,2258165,cPa75_cPa75-unknown,2_1,133,33
chr25-2259205_2259366,cPa75,1,1,2259314,2259255,cPa75,2,161,59
chr25-2260708_2260810,cPa75,1,1,2260758,2260758,cPa75,1,102,0
chr25-2260929_2261031,cPa75,1,1,2260979,2260979,cPa75,1,102,0
chr25-2271649_2271751,cPa75,1,1,2271699,2271661,cPa75,5,102,38
chr25-2271929_2272031,cPa75,1,1,2271979,2271979,cPa75,1,102,0
chr25-2282996_2283162,cPa75,1,1,2283110,2283046,cPa75,2,166,64
chr25-2283256_2283452,cPa75,1,1,2283400,2283306,cPa75,3,196,94
chr25-2284229_2284331,cPa75,1,1,2284279,2284279,cPa75,1,102,0
chr25-23182_23315,cPa75,1,1,23263,23232,cPa75,2,133,31
chr25-2348844_2348946,cPa75,1,1,2348894,2348894,cPa75,1,102,0
chr25-2348956_2349058,cPa75,1,1,2349008,2348977,cPa75,4,102,31
chr25-2349168_2349723,cPa75,1,1,2349671,2349218,cPa75,31,555,453
chr25-2349725_2349827,cPa75,1,1,2349775,2349775,cPa75,1,102,0
chr25-2385366_2385549,cPa434,1,1,2385497,2385416,cPa434,2,183,81
chr25-2485334_2485436,cPa62,0.95,2,2485427,2485382,cPa539-cPa62-hybrid_cPa62,1_19,102,45
chr25-2630478_2630880,EqFV_NC002201,0.5625,8,2630828,2630528,cPa424_cPa566_cPa566-cPa117-hybrid_EqFV_NC002201_EqFV_NC002201-unknown_PyERV_AF500296-cPa419-hybrid_SFV_U04327_SFV_U04327-EqFV_NC002201-hybrid,1_1_1_9_1_1_1_1,402,300
chr25-2747661_2747763,cPa62-cPa75-hybrid,1,1,2747711,2747696,cPa62-cPa75-hybrid,2,102,15
chr25-2747792_2748180,cPa62-cPa75-hybrid,0.714285714285714,5,2748170,2747842,cPa62_cPa62-cPa75-hybrid_cPa62-unknown_cPa62-WDSV_NC001867-hybrid_WDSV_NC001867,2_25_1_3_4,388,328
chr25-2804216_2804325,cPa224_cPa285,0.5,2,2804273,2804266,cPa224_cPa285,1_1,109,7
chr25-2840140_2840242,cPa75,1,1,2840190,2840190,cPa75,1,102,0
chr25-2840266_2840368,cPa75,1,1,2840316,2840273,cPa75,3,102,43
chr25-2840428_2840612,cPa75,1,1,2840560,2840478,cPa75,17,184,82
chr25-2840689_2840834,cPa75,1,1,2840782,2840739,cPa75,2,145,43
chr25-2863822_2863924,cPa62-WDSV_NC001867-hybrid,0.571428571428571,2,2863920,2863872,cPa62-WDSV_NC001867-hybrid_WDSV_NC001867,4_3,102,48
chr25-2890910_2891012,cPa62,1,1,2890960,2890960,cPa62,1,102,0
chr25-2891055_2891157,cPa62-unknown,1,1,2891105,2891105,cPa62-unknown,1,102,0
chr25-2891185_2891353,WDSV_NC001867,0.6,3,2891347,2891186,cPa62_cPa62-WDSV_NC001867-hybrid_WDSV_NC001867,2_2_6,168,161
chr25-2902042_2902199,cPa75,0.75,2,2902147,2902060,cPa75_cPa75-cPa111-hybrid,3_1,157,87
chr25-2902797_2902899,cPa75,1,1,2902847,2902847,cPa75,1,102,0
chr25-2911509_2911611,cPa75,1,1,2911559,2911559,cPa75,1,102,0
chr25-2920842_2920955,cPa75,1,1,2920903,2920892,cPa75,2,113,11
chr25-292405_292507,cPa75,1,1,292455,292455,cPa75,1,102,0
chr25-2928778_2928880,cPa75,1,1,2928865,2928808,cPa75,3,102,57
chr25-2930478_2930580,cPa526-cPa75-hybrid,1,1,2930528,2930528,cPa526-cPa75-hybrid,1,102,0
chr25-293082_293301,cPa75,1,1,293249,293132,cPa75,16,219,117
chr25-293321_293522,cPa75,1,1,293470,293371,cPa75,6,201,99
chr25-2956707_2956852,cPa75,1,1,2956800,2956757,cPa75,2,145,43
chr25-2963267_2963369,cPa75,1,1,2963317,2963317,cPa75,1,102,0
chr25-2963626_2963728,cPa75,1,1,2963676,2963676,cPa75,1,102,0
chr25-2963778_2963880,cPa75,1,1,2963828,2963828,cPa75,1,102,0
chr25-3011637_3011739,cPa75,1,1,3011687,3011687,cPa75,1,102,0
chr25-3011921_3012023,cPa75,1,1,3011971,3011971,cPa75,1,102,0
chr25-3016070_3016172,cPa75,1,1,3016120,3016120,cPa75,1,102,0
chr25-3031103_3031205,cPa75,1,1,3031153,3031153,cPa75,1,102,0
chr25-3049810_3049912,cPa75,1,1,3049860,3049860,cPa75,1,102,0
chr25-3064687_3064789,cPa75,1,1,3064757,3064737,cPa75,2,102,20
chr25-3064852_3064954,cPa75,1,1,3064905,3064901,cPa75,4,102,4
chr25-3070808_3070910,cPa75,1,1,3070858,3070858,cPa75,1,102,0
chr25-3070935_3071037,cPa75,1,1,3070985,3070985,cPa75,1,102,0
chr25-3071484_3071594,cPa75,1,1,3071579,3071534,cPa75,4,110,45
chr25-3071661_3071777,cPa75,1,1,3071725,3071711,cPa75,4,116,14
chr25-3111163_3111265,cPa75-cPa62-hybrid,0.75,3,3111264,3111213,CAEV_NC001463-cPa62-hybrid_cPa75-cPa62-hybrid_cPa75-unknown,1_6_1,102,51
chr25-3112898_3113000,cPa75,1,1,3112948,3112948,cPa75,1,102,0
chr25-3166164_3166266,cPa75-unknown,1,1,3166214,3166214,cPa75-unknown,1,102,0
chr25-4336_4506,cPa542,0.22568093385214,35,4506,4336,cPa199_cPa199-cPa227-hybrid_cPa199-cPa273-hybrid_cPa199-cPa450-hybrid_cPa199-cPa542-hybrid_cPa199-cPa553-hybrid_cPa199-unknown_cPa223-cPa227-hybrid_cPa223-cPa273-hybrid_cPa223-cPa390-hybrid_cPa223-cPa450-hybrid_cPa223-cPa542-hybrid_cPa223-cPa553-hybrid_cPa223-unknown_cPa273_cPa273-cPa542-hybrid_cPa273-cPa553-hybrid_cPa273-unknown_cPa345_cPa345-cPa227-hybrid_cPa345-cPa273-hybrid_cPa345-cPa553-hybrid_cPa345-unknown_cPa450_cPa450-cPa227-hybrid_cPa450-cPa542-hybrid_cPa450-unknown_cPa542_cPa542-cPa553-hybrid_cPa542-unknown_cPa553_cPa553-cPa227-hybrid_cPa553-cPa273-hybrid_cPa553-cPa450-hybrid_cPa553-unknown,37_1_12_6_6_6_3_1_6_1_1_1_4_1_12_1_1_1_4_1_4_1_1_31_1_1_2_58_1_1_44_1_2_1_2,170,170
chr25-4771_4873,cPa223-cPa390-hybrid_cPa553,0.5,2,4821,4821,cPa223-cPa390-hybrid_cPa553,1_1,102,0
chr25-492051_492270,cPa285-cPa62-hybrid,0.413793103448276,10,492267,492052,cPa254-cPa75-hybrid_cPa285_cPa285-cPa62-hybrid_cPa285-unknown_cPa293_cPa62_cPa71-cPa62-hybrid_cPa75_cPa75-cPa62-hybrid_cPa75-unknown,1_4_24_2_2_14_1_4_3_3,219,215
chr25-4925_5027,cPa199-cPa390-hybrid,1,1,4981,4974,cPa199-cPa390-hybrid,3,102,7
chr25-6354_6456,cPa163,0.666666666666667,2,6404,6381,cPa163_cPa360-cPa452-hybrid,2_1,102,23
chr25-639252_639354,cPa75-unknown,1,1,639302,639302,cPa75-unknown,1,102,0
chr25-675179_675325,cPa446,0.321428571428571,18,675279,675182,cPa138_cPa138-cPa363-hybrid_cPa194-cPa363-hybrid_cPa223_cPa327_cPa327-cPa379-hybrid_cPa363_cPa363-cPa446-hybrid_cPa363-cPa452-hybrid_cPa379_cPa379-cPa363-hybrid_cPa446_cPa446-cPa363-hybrid_cPa446-cPa379-hybrid_cPa452_cPa452-cPa446-hybrid_cPa452-cPa67-hybrid_cPa67-cPa379-hybrid,1_1_1_3_2_1_7_1_1_5_1_18_2_1_8_1_1_1,146,97
chr25-734082_734208,cPa118_cPa118-cPa268-hybrid_cPa15,0.333333333333333,3,734156,734132,cPa118_cPa118-cPa268-hybrid_cPa15,1_1_1,126,24
chr25-752019_752121,cPa75,1,1,752069,752069,cPa75,1,102,0
chr25-752647_752749,cPa75,1,1,752697,752697,cPa75,1,102,0
chr25-753353_753455,cPa75,1,1,753403,753403,cPa75,1,102,0
chr25-753489_753683,cPa75,1,1,753655,753539,cPa75,6,194,116
chr25-754839_754973,cPa75,1,1,754961,754889,cPa75,3,134,72
chr25-755459_755593,cPa75,1,1,755542,755509,cPa75,4,134,33
chr25-757186_757288,cPa117,1,1,757236,757230,cPa117,2,102,6
chr25-767984_768086,cPa75,1,1,768034,768034,cPa75,1,102,0
chr25-775606_775708,cPa308-cPa75-hybrid,1,1,775656,775656,cPa308-cPa75-hybrid,1,102,0
chr25-802095_802197,cPa371-cPa75-hybrid,1,1,802145,802145,cPa371-cPa75-hybrid,1,102,0
chr25-803241_803343,cPa371-cPa75-hybrid,1,1,803291,803284,cPa371-cPa75-hybrid,2,102,7
chr25-823981_824083,cPa75,1,1,824062,824029,cPa75,3,102,33
chr25-824269_824371,cPa75,1,1,824319,824319,cPa75,1,102,0
chr25-853104_853257,cPa75,0.6,3,853205,853114,cPa413_cPa75_cPa75-unknown,1_3_1,153,91
chr25-853919_854021,cPa75,1,1,853969,853949,cPa75,3,102,20
chr25-854076_854471,cPa75,1,1,854419,854123,cPa75,17,395,296
chr25-854747_854864,cPa75,1,1,854812,854797,cPa75,2,117,15
chr25-854874_855408,cPa75,1,1,855356,854924,cPa75,51,534,432
chr25-860715_861108,cPa75,0.65,2,861056,860765,cPa75_cPa75-unknown,13_7,393,291
chr25-861219_861321,cPa75,1,1,861269,861269,cPa75,1,102,0
chr25-861378_861595,cPa75,1,1,861543,861428,cPa75,6,217,115
chr25-861771_861963,cPa75,1,1,861911,861821,cPa75,2,192,90
chr25-865224_865326,cPa75,0.6,2,865288,865243,cPa75_cPa75-cPa62-hybrid,3_2,102,45
chr25-871689_872060,cPa492,0.971698113207547,4,872043,871695,cPa339-ENTV_NC004994-hybrid_cPa492_cPa492-unknown_SFV_U04327-cPa268-hybrid,1_103_1_1,371,348
chr25-927648_928293,cPa75,1,1,928241,927647,cPa75,27,645,594
chr25-928407_928777,cPa75,1,1,928725,928457,cPa75,15,370,268
chr25-929283_929500,cPa75,1,1,929450,929333,cPa75,19,217,117
chr25-936217_936319,cPa75,1,1,936267,936267,cPa75,1,102,0
chr25-936363_936465,cPa75,1,1,936413,936413,cPa75,1,102,0
chr25-936504_936963,cPa75,1,1,936911,936554,cPa75,16,459,357
chr25-937214_937411,cPa75,1,1,937359,937264,cPa75,7,197,95
chr26-10000_10162,cPa428,0.625,2,10110,10042,cPa356_cPa428,3_5,162,68
chr26-1039908_1040127,cPa539,0.894736842105263,2,1040112,1039955,cPa539_cPa539-cPa75-hybrid,17_2,219,157
chr26-1053_1155,cPa428,0.857142857142857,2,1153,1072,cPa356_cPa428,1_6,102,81
chr26-10636_10738,cPa428,1,1,10686,10686,cPa428,1,102,0
chr26-116192_116294,cPa75,1,1,116242,116242,cPa75,1,102,0
chr26-1162690_1162792,cPa118,0.571428571428571,3,1162750,1162731,cPa118_cPa118-cPa15-hybrid_cPa15,4_1_2,102,19
chr26-116707_116809,cPa75,1,1,116757,116757,cPa75,1,102,0
chr26-119379_119575,cPa117,0.833333333333333,2,119523,119414,cPa117_cPa117-cPa452-hybrid,5_1,196,109
chr26-1217499_1217601,cPa117,1,1,1217583,1217523,cPa117,3,102,60
chr26-1217643_1218061,cPa117,0.904761904761905,5,1218054,1217646,cPa117_cPa117-cPa452-hybrid_cPa117-unknown_cPa452_cPa452-cPa75-hybrid,38_1_1_1_1,418,408
chr26-13477_13579,cPa428,0.833333333333333,2,13530,13507,cPa356_cPa428,1_5,102,23
chr26-1357915_1358017,cPa452,0.428571428571429,4,1357965,1357941,cPa363_cPa363-cPa424-hybrid_cPa446_cPa452,2_1_1_3,102,24
chr26-13784_13935,cPa428,0.576470588235294,4,13934,13785,cPa356_cPa356-unknown_cPa428_cPa428-unknown,33_2_49_1,151,149
chr26-1410525_1410627,cPa450,0.338709677419355,20,1410586,1410529,cPa199_cPa199-cPa345-hybrid_cPa223_cPa227_cPa227-cPa345-hybrid_cPa273-cPa199-hybrid_cPa273-cPa223-hybrid_cPa273-cPa345-hybrid_cPa273-cPa450-hybrid_cPa273-cPa553-hybrid_cPa273-unknown_cPa450_cPa450-cPa199-hybrid_cPa450-cPa223-hybrid_cPa450-unknown_cPa542-cPa223-hybrid_cPa553_cPa553-cPa199-hybrid_cPa553-cPa223-hybrid_cPa553-cPa450-hybrid,7_1_1_2_1_6_3_1_1_1_1_21_2_1_1_2_6_1_2_1,102,57
chr26-14451_14575,cPa428,0.666666666666667,2,14523,14484,cPa356_cPa428,2_4,124,39
chr26-14601_14703,cPa356,0.6,2,14658,14646,cPa356_cPa428,3_2,102,12
chr26-15012_15116,cPa356,0.545454545454545,2,15076,15025,cPa356_cPa428,12_10,104,51
chr26-15250_15397,cPa428,0.684210526315789,2,15380,15283,cPa356_cPa428,6_13,147,97
chr26-15492_15627,cPa428,0.65,2,15617,15497,cPa356_cPa428,7_13,135,120
chr26-15755_15908,cPa428,0.633333333333333,2,15908,15796,cPa356_cPa428,11_19,153,112
chr26-1638403_1638505,cPa323,0.666666666666667,2,1638482,1638403,cPa323_cPa371,2_1,102,79
chr26-1684118_1684220,cPa371_cPa566-cPa323-hybrid,0.272727272727273,5,1684211,1684131,cPa323_cPa371_cPa434-cPa371-hybrid_cPa566-cPa323-hybrid_cPa566-cPa371-hybrid,2_3_1_3_2,102,80
chr26-1701626_1701728,cPa434-cPa62-hybrid_cPa62,0.5,2,1701677,1701676,cPa434-cPa62-hybrid_cPa62,1_1,102,1
chr26-1705521_1705623,cPa542,1,1,1705571,1705571,cPa542,1,102,0
chr26-1745379_1745481,cPa199-cPa505-hybrid_cPa505_cPa505-cPa482-hybrid_MSEV_CT990572,0.25,4,1745470,1745385,cPa199-cPa505-hybrid_cPa505_cPa505-cPa482-hybrid_MSEV_CT990572,1_1_1_1,102,85
chr26-1747701_1747803,cPa450,0.5,3,1747781,1747751,cPa199_cPa199-cPa67-hybrid_cPa450,1_1_2,102,30
chr26-1748879_1749085,cPa67,0.785714285714286,6,1749083,1748884,cPa194_cPa194-SnRV_NC001724-hybrid_cPa199-SnRV_NC001724-hybrid_cPa345_cPa67_cPa67-cPa345-hybrid,1_1_1_2_22_1,206,199
chr26-1749088_1749190,cPa67,1,1,1749186,1749112,cPa67,7,102,74
chr26-1804920_1805022,cPa117-cPa75-hybrid,1,1,1804970,1804970,cPa117-cPa75-hybrid,1,102,0
chr26-1818_1920,cPa428,0.552631578947368,2,1920,1827,cPa356_cPa428,17_21,102,93
chr26-1853194_1853349,cPa75,1,1,1853307,1853244,cPa75,18,155,63
chr26-1854570_1854672,cPa75,1,1,1854627,1854582,cPa75,7,102,45
chr26-1868266_1868464,cPa75,1,1,1868412,1868316,cPa75,3,198,96
chr26-1871596_1871860,cPa75,1,1,1871808,1871646,cPa75,10,264,162
chr26-1871909_1872013,cPa75,1,1,1871961,1871959,cPa75,2,104,2
chr26-1873345_1873599,cPa75,1,1,1873573,1873395,cPa75,16,254,178
chr26-1880884_1880986,cPa323_cPa371,0.444444444444444,3,1880967,1880889,cPa323_cPa323-unknown_cPa371,4_1_4,102,78
chr26-1954202_1954304,cPa223,1,1,1954279,1954210,cPa223,24,102,69
chr26-1957219_1957321,cPa199_cPa273_cPa542_cPa542-cPa227-hybrid_cPa75-cPa542-hybrid,0.2,5,1957277,1957262,cPa199_cPa273_cPa542_cPa542-cPa227-hybrid_cPa75-cPa542-hybrid,1_1_1_1_1,102,15
chr26-1978497_1978784,cPa111_cPa75_cPa75-unknown,0.333333333333333,3,1978732,1978539,cPa111_cPa75_cPa75-unknown,4_4_4,287,193
chr26-1988650_1988752,MoMLV_J02255-cPa450-hybrid_MoMLV_J02255-unknown,0.5,2,1988748,1988700,MoMLV_J02255-cPa450-hybrid_MoMLV_J02255-unknown,1_1,102,48
chr26-2002989_2003161,WDSV_NC001867-cPa345-hybrid,0.5,3,2003109,2003015,cPa67-cPa62-hybrid_WDSV_NC001867-cPa345-hybrid_WDSV_NC001867-cPa62-hybrid,1_2_1,172,94
chr26-2028299_2028526,cPa199_cPa553,0.333333333333333,5,2028513,2028349,cPa199_cPa199-cPa273-hybrid_cPa273_cPa542_cPa553,5_1_3_1_5,227,164
chr26-2028549_2028651,cPa273,0.5,3,2028600,2028566,cPa199_cPa273_cPa553,2_3_1,102,34
chr26-2037238_2037340,cPa452,0.4,4,2037298,2037267,cPa183-cPa158-hybrid_cPa379_cPa379-cPa363-hybrid_cPa452,1_1_1_2,102,31
chr26-2037992_2038585,cPa323,0.68695652173913,9,2038584,2038042,cPa183-cPa371-hybrid_cPa323_cPa363-cPa512-hybrid_cPa371_cPa371-unknown_cPa379-cPa371-hybrid_cPa447-cPa223-hybrid_cPa452-cPa323-hybrid_cPa512-cPa323-hybrid,1_79_1_28_2_1_1_1_1,593,542
chr26-2081125_2081227,cPa228-cPa75-hybrid,1,1,2081220,2081175,cPa228-cPa75-hybrid,2,102,45
chr26-2093517_2093619,cPa260_MER52A_repbase_MER52AI_MER52A,0.368421052631579,4,2093616,2093527,cPa228_cPa260_cPa260-cPa228-hybrid_MER52A_repbase_MER52AI_MER52A,4_7_1_7,102,89
chr26-2096050_2096211,cPa452,0.324324324324324,11,2096172,2096080,cPa345-cPa379-hybrid_cPa363_cPa363-cPa379-hybrid_cPa363-cPa446-hybrid_cPa363-cPa75-hybrid_cPa379_cPa446_cPa446-cPa363-hybrid_cPa452_cPa67-cPa379-hybrid_cPa67-cPa452-hybrid,1_7_1_1_1_2_8_1_12_2_1,161,92
chr26-2127146_2127248,cPa260,0.666666666666667,2,2127196,2127191,cPa260_WDSV_NC001867,4_2,102,5
chr26-2182943_2183160,cPa62,0.764705882352941,5,2183160,2182993,cPa285_cPa293_cPa402-cPa285-hybrid_cPa62_cPa62-unknown,4_2_1_39_5,217,167
chr26-2189960_2190062,HIV2_NC001722,1,1,2190010,2190010,HIV2_NC001722,1,102,0
chr26-2192919_2193083,cPa345,0.461538461538462,5,2193037,2192969,cPa199_cPa273_cPa345_cPa450_cPa553,3_1_6_2_1,164,68
chr26-2206964_2207066,cPa199_cPa450,0.235294117647059,10,2207023,2206977,cPa199_cPa199-unknown_cPa223_cPa273_cPa345_cPa345-unknown_cPa450_cPa542_cPa542-unknown_cPa553,4_1_1_1_2_1_4_1_1_1,102,46
chr26-2401967_2402102,cPa75,1,1,2402050,2402010,cPa75,3,135,40
chr26-2524945_2525047,cPa62_cPa62-cPa75-hybrid,0.5,2,2524995,2524988,cPa62_cPa62-cPa75-hybrid,1_1,102,7
chr26-2610804_2610906,cPa539,1,1,2610854,2610854,cPa539,1,102,0
chr26-2843290_2843392,cPa75,1,1,2843340,2843340,cPa75,1,102,0
chr26-29822_29962,cPa456-cPa199-hybrid,0.5,3,29910,29872,cPa452_cPa452-cPa199-hybrid_cPa456-cPa199-hybrid,1_1_2,140,38
chr26-2982495_2982597,cPa223,0.5,3,2982564,2982502,cPa199-cPa379-hybrid_cPa223_cPa419,1_2_1,102,62
chr26-2983940_2984042,cPa199,0.928571428571429,2,2984038,2983941,cPa199_cPa308-cPa199-hybrid,13_1,102,97
chr26-2984577_2984719,cPa199,1,1,2984667,2984627,cPa199,2,142,40
chr26-2984931_2985244,cPa199,0.966666666666667,2,2985204,2984981,cPa199_cPa199-unknown,29_1,313,223
chr26-2998389_2998592,WDSV_NC001867,0.461538461538462,5,2998540,2998406,cPa254_cPa62-cPa486-hybrid_cPa62-unknown_cPa62-WDSV_NC001867-hybrid_WDSV_NC001867,2_1_1_3_6,203,134
chr26-2998639_2998881,WDSV_NC001867,0.577777777777778,8,2998829,2998689,cPa254_cPa381-cPa486-hybrid_cPa381-unknown_cPa62_cPa62-cPa254-hybrid_cPa62-unknown_cPa62-WDSV_NC001867-hybrid_WDSV_NC001867,2_1_1_1_1_8_5_26,242,140
chr26-3101600_3101702,cPa542-cPa75-hybrid,1,1,3101650,3101650,cPa542-cPa75-hybrid,1,102,0
chr26-3180820_3180922,cPa75,1,1,3180870,3180870,cPa75,1,102,0
chr26-3181292_3181405,cPa75,1,1,3181353,3181330,cPa75,6,113,23
chr26-3213022_3213124,WDSV_NC001867,0.75,2,3213093,3213034,WDSV_NC001867_WDSV_NC001867-cPa62-hybrid,6_2,102,59
chr26-3222206_3222308,cPa118-cPa113-hybrid_cPa75-cPa113-hybrid,0.5,2,3222275,3222256,cPa118-cPa113-hybrid_cPa75-cPa113-hybrid,1_1,102,19
chr26-3222343_3222445,cPa118-cPa113-hybrid_cPa516-cPa113-hybrid,0.5,2,3222427,3222393,cPa118-cPa113-hybrid_cPa516-cPa113-hybrid,1_1,102,34
chr26-3252728_3252830,HERV-W_repbase_HERV17_LTR17,1,1,3252778,3252778,HERV-W_repbase_HERV17_LTR17,1,102,0
chr26-3272861_3272963,cPa539-cPa260-hybrid,1,1,3272911,3272911,cPa539-cPa260-hybrid,1,102,0
chr26-3293141_3293267,cPa75,0.5,3,3293241,3293165,cPa75_cPa75-cPa140-hybrid_cPa75-unknown,2_1_1,126,76
chr26-3309798_3309926,cPa62-WDSV_NC001867-hybrid,0.714285714285714,2,3309925,3309828,cPa62-unknown_cPa62-WDSV_NC001867-hybrid,2_5,128,97
chr26-3311637_3311739,cPa260,0.5,3,3311687,3311644,cPa260_cPa62-cPa260-hybrid_cPa62-unknown,2_1_1,102,43
chr26-3360837_3360939,cPa199,0.933333333333333,2,3360934,3360844,cPa199_cPa505,14_1,102,90
chr26-3375955_3376057,cPa199,1,1,3376005,3376005,cPa199,1,102,0
chr26-3376196_3376325,cPa199,1,1,3376322,3376212,cPa199,9,129,110
chr26-3412962_3413064,cPa75-unknown,1,1,3413012,3413012,cPa75-unknown,1,102,0
chr26-3525862_3525964,WDSV_NC001867,1,1,3525912,3525912,WDSV_NC001867,1,102,0
chr26-3526878_3526980,cPa75,0.727272727272727,3,3526978,3526905,cPa75_cPa75-cPa199-hybrid_cPa75-unknown,8_1_2,102,73
chr26-3569316_3569424,cPa118_cPa15,0.5,2,3569372,3569366,cPa118_cPa15,1_1,108,6
chr26-3623842_3623944,cPa119-WDSV_NC001867-hybrid,1,1,3623892,3623892,cPa119-WDSV_NC001867-hybrid,1,102,0
chr26-3656348_3656468,cPa402,1,1,3656435,3656386,cPa402,23,120,49
chr26-3688145_3688247,cPa118,1,1,3688195,3688195,cPa118,1,102,0
chr26-3701227_3701720,cPa75,1,1,3701668,3701228,cPa75,21,493,440
chr26-3749099_3749201,cPa75,0.666666666666667,2,3749149,3749108,cPa62-unknown_cPa75,1_2,102,41
chr26-3781743_3781922,cPa223,0.448275862068966,5,3781882,3781793,cPa199_cPa223_cPa223-unknown_cPa273_cPa379,8_13_1_5_2,179,89
chr26-3833967_3834089,cPa492,1,1,3834089,3833972,cPa492,5,122,117
chr26-3846074_3846176,WDSV_NC001867-cPa62-hybrid,1,1,3846126,3846124,WDSV_NC001867-cPa62-hybrid,2,102,2
chr26-3847482_3847584,cPa75,1,1,3847532,3847532,cPa75,1,102,0
chr26-3852813_3852915,cPa75-cPa60-hybrid,1,1,3852863,3852863,cPa75-cPa60-hybrid,1,102,0
chr26-3995663_3995915,cPa75,1,1,3995863,3995713,cPa75,16,252,150
chr26-3996082_3996207,cPa75,1,1,3996155,3996132,cPa75,2,125,23
chr26-3996553_3996655,cPa75,1,1,3996603,3996603,cPa75,1,102,0
chr26-3997384_3997486,cPa75,1,1,3997434,3997434,cPa75,1,102,0
chr26-406229_406331,HERV-W_repbase_HERV17_LTR17,0.777777777777778,2,406312,406240,cPa75-HERV-W_repbase_HERV17_LTR17-hybrid_HERV-W_repbase_HERV17_LTR17,2_7,102,72
chr26-4084262_4084364,CAEV_NC001463-cPa75-hybrid_cPa75,0.5,2,4084312,4084284,CAEV_NC001463-cPa75-hybrid_cPa75,1_1,102,28
chr26-4168820_4168936,cPa452,0.4,4,4168884,4168870,cPa363_cPa452_cPa452-cPa16-hybrid_cPa71-cPa16-hybrid,1_2_1_1,116,14
chr26-41981_42083,cPa75,1,1,42031,42031,cPa75,1,102,0
chr26-4212967_4213069,cPa308,1,1,4213017,4213017,cPa308,1,102,0
chr26-4287939_4288041,cPa62,0.863636363636364,4,4288002,4287976,cPa285-cPa75-hybrid_cPa285-unknown_cPa62_HERV30_repbase_HERV30I_LTR30-cPa62-hybrid,1_1_19_1,102,26
chr26-4333936_4334038,cPa428,1,1,4334005,4333955,cPa428,3,102,50
chr26-4334043_4334366,cPa428,0.613207547169811,3,4334355,4334051,cPa356_cPa356-unknown_cPa428,40_1_65,323,304
chr26-4334383_4335017,cPa428,0.536764705882353,5,4335016,4334391,cPa356_cPa356-cPa428-hybrid_cPa356-unknown_cPa428_cPa428-unknown,59_1_1_73_2,634,625
chr26-4341433_4341671,cPa356,0.53125,2,4341654,4341435,cPa356_cPa428,17_15,238,219
chr26-4341707_4341828,cPa428,0.488372093023256,4,4341814,4341708,cPa356_cPa356-cPa308-hybrid_cPa428_cPa428-cPa308-hybrid,19_2_21_1,121,106
chr26-4342245_4342392,cPa356-cPa308-hybrid,0.8,2,4342354,4342295,cPa356-cPa308-hybrid_cPa428-cPa308-hybrid,8_2,147,59
chr26-4342427_4342560,cPa428-cPa308-hybrid,0.538461538461538,3,4342518,4342477,cPa356-cPa308-hybrid_cPa428-cPa308-hybrid_cPa75-cPa356-hybrid,5_7_1,133,41
chr26-4371476_4371578,cPa285-unknown_cPa62,0.5,2,4371526,4371491,cPa285-unknown_cPa62,1_1,102,35
chr26-4409271_4409373,cPa323,0.5,3,4409327,4409276,cPa323_cPa323-unknown_cPa371,6_1_5,102,51
chr26-4409582_4409711,cPa323,0.777777777777778,2,4409687,4409608,cPa323_cPa371-cPa323-hybrid,7_2,129,79
chr26-4428866_4428968,cPa199,0.928571428571429,2,4428962,4428885,cPa199_cPa199-cPa345-hybrid,13_1,102,77
chr26-4453314_4453416,WDSV_NC001867,1,1,4453364,4453364,WDSV_NC001867,1,102,0
chr26-4455256_4455358,cPa539,1,1,4455306,4455306,cPa539,1,102,0
chr26-4493206_4493366,cPa428,1,1,4493314,4493229,cPa428,21,160,85
chr26-4493476_4493681,cPa428,0.954545454545455,2,4493629,4493494,cPa428_cPa428-unknown,21_1,205,135
chr26-4493693_4493795,cPa428,0.75,2,4493759,4493722,cPa428_cPa428-cPa392-hybrid,3_1,102,37
chr26-4493796_4493908,cPa428,1,1,4493856,4493846,cPa428,3,112,10
chr26-4509290_4509392,cPa75,1,1,4509340,4509340,cPa75,1,102,0
chr26-4605112_4605214,cPa62-WDSV_NC001867-hybrid_WDSV_NC001867,0.5,2,4605165,4605161,cPa62-WDSV_NC001867-hybrid_WDSV_NC001867,2_2,102,4
chr26-4605315_4605593,WDSV_NC001867,0.40625,6,4605585,4605359,cPa119_cPa119-WDSV_NC001867-hybrid_cPa62_cPa62-cPa119-hybrid_cPa62-WDSV_NC001867-hybrid_WDSV_NC001867,1_1_3_3_11_13,278,226
chr26-4624384_4624486,cPa62,1,1,4624484,4624416,cPa62,5,102,68
chr26-4624569_4624671,cPa62,0.894736842105263,2,4624667,4624571,cPa62_cPa62-unknown,17_2,102,96
chr26-4634052_4634154,WDSV_NC001867,0.666666666666667,2,4634102,4634076,cPa62_WDSV_NC001867,1_2,102,26
chr26-4634288_4634439,WDSV_NC001867,1,1,4634387,4634331,WDSV_NC001867,4,151,56
chr26-4664906_4665008,cPa75,1,1,4664956,4664956,cPa75,1,102,0
chr26-4665017_4665147,cPa75,1,1,4665095,4665067,cPa75,3,130,28
chr26-4723025_4723127,cPa452,1,1,4723106,4723075,cPa452,2,102,31
chr26-4732474_4732576,cPa75,0.916666666666667,2,4732574,4732495,cPa75_cPa75-HERV-W_repbase_HERV17_LTR17-hybrid,11_1,102,79
chr26-4732977_4733131,cPa75,0.555555555555556,3,4733099,4733021,cPa293-HERV-W_repbase_HERV17_LTR17-hybrid_cPa75_cPa75-HERV-W_repbase_HERV17_LTR17-hybrid,1_5_3,154,78
chr26-4733143_4733245,cPa75,1,1,4733210,4733148,cPa75,6,102,62
chr26-4733444_4733546,cPa75_cPa75-HERV-W_repbase_HERV17_LTR17-hybrid,0.5,2,4733530,4733490,cPa75_cPa75-HERV-W_repbase_HERV17_LTR17-hybrid,3_3,102,40
chr26-4773128_4773273,cPa62,1,1,4773221,4773178,cPa62,3,145,43
chr26-4773389_4773520,cPa62,0.75,2,4773468,4773437,cPa62_cPa62-unknown,3_1,131,31
chr26-4798724_4798894,cPa371,0.723404255319149,7,4798880,4798729,cPa323_cPa323-cPa113-hybrid_cPa323-unknown_cPa371_cPa371-cPa323-hybrid_cPa568_cPa568-cPa113-hybrid,17_1_1_68_1_5_1,170,151
chr26-4842325_4842427,cPa75-cPa62-hybrid,1,1,4842375,4842375,cPa75-cPa62-hybrid,1,102,0
chr26-4842723_4842825,cPa75-cPa62-hybrid,0.666666666666667,2,4842776,4842747,cPa75-cPa260-hybrid_cPa75-cPa62-hybrid,1_2,102,29
chr26-5017310_5017412,cPa75,1,1,5017360,5017360,cPa75,1,102,0
chr26-52825_52927,cPa75,1,1,52875,52875,cPa75,1,102,0
chr26-53624_54020,cPa75,1,1,53968,53674,cPa75,7,396,294
chr26-5400121_5400223,cPa75,1,1,5400176,5400171,cPa75,2,102,5
chr26-5863872_5864037,cPa75,0.848484848484849,3,5864005,5863898,cPa223-cPa75-hybrid_cPa273-cPa75-hybrid_cPa75,1_4_28,165,107
chr26-5914872_5914974,cPa75,1,1,5914922,5914922,cPa75,1,102,0
chr26-5915007_5915143,cPa75,1,1,5915091,5915057,cPa75,8,136,34
chr26-5949335_5949440,cPa75,1,1,5949388,5949385,cPa75,4,105,3
chr26-5949911_5950046,cPa75,1,1,5949994,5949961,cPa75,2,135,33
chr26-5950282_5950576,cPa75,1,1,5950524,5950317,cPa75,17,294,207
chr26-5952226_5952328,cPa539,1,1,5952276,5952276,cPa539,1,102,0
chr26-5960315_5960417,WDSV_NC001867,1,1,5960365,5960338,WDSV_NC001867,2,102,27
chr26-6044245_6044426,HERV-W_repbase_HERV17_LTR17,1,1,6044394,6044247,HERV-W_repbase_HERV17_LTR17,19,181,147
chr26-6044427_6044529,HERV-W_repbase_HERV17_LTR17,0.857142857142857,3,6044529,6044443,cPa75_HERV-W_repbase_HERV17_LTR17_KoRV_AF151794,1_12_1,102,86
chr26-6044611_6044833,HERV-W_repbase_HERV17_LTR17,0.875,6,6044815,6044622,cPa419_cPa62-HERV-W_repbase_HERV17_LTR17-hybrid_cPa75_HERV-W_repbase_HERV17_LTR17_HERV-W_repbase_HERV17_LTR17-unknown_KoRV_AF151794,1_2_2_49_1_1,222,193
chr26-6044866_6045090,HERV-W_repbase_HERV17_LTR17,0.928571428571429,3,6045088,6044868,cPa62-cPa75-hybrid_cPa75-S71_repbase_HERVS71_LTR6A-hybrid_HERV-W_repbase_HERV17_LTR17,1_1_26,224,220
chr26-6048328_6048430,cPa223_cPa223-cPa75-hybrid,0.5,2,6048378,6048349,cPa223_cPa223-cPa75-hybrid,1_1,102,29
chr26-6048726_6048843,cPa199-cPa75-hybrid_cPa223-cPa75-hybrid,0.285714285714286,5,6048792,6048768,cPa199-cPa75-hybrid_cPa223-cPa75-hybrid_cPa273-cPa75-hybrid_cPa542-cPa75-hybrid_cPa553-cPa75-hybrid,4_4_3_2_1,117,24
chr26-6053854_6053956,cPa273_cPa553,0.5,2,6053904,6053904,cPa273_cPa553,1_1,102,0
chr26-6055302_6055404,cPa75,1,1,6055352,6055306,cPa75,3,102,46
chr26-6056449_6056611,cPa75,1,1,6056605,6056451,cPa75,35,162,154
chr26-6059409_6059511,cPa434,1,1,6059459,6059459,cPa434,1,102,0
chr26-6065803_6065905,cPa223-cPa75-hybrid_cPa260_cPa419,0.333333333333333,3,6065905,6065853,cPa223-cPa75-hybrid_cPa260_cPa419,1_1_1,102,52
chr26-6248108_6248210,cPa75-cPa413-hybrid,1,1,6248158,6248158,cPa75-cPa413-hybrid,1,102,0
chr26-6260470_6260572,cPa75,1,1,6260520,6260520,cPa75,1,102,0
chr26-6384848_6384950,cPa158,1,1,6384898,6384898,cPa158,1,102,0
chr26-6424269_6424371,cPa75,1,1,6424319,6424319,cPa75,1,102,0
chr26-643757_643883,cPa117,0.738095238095238,4,643872,643759,cPa117_cPa117-cPa75-hybrid_cPa452_cPa452-cPa75-hybrid,31_1_7_3,126,113
chr26-643933_644050,cPa117,0.8,2,644050,643936,cPa117_cPa452,16_4,117,114
chr26-648351_648453,cPa75,1,1,648401,648401,cPa75,1,102,0
chr26-657951_658141,cPa308,0.6,2,658089,658001,cPa107_cPa308,2_3,190,88
chr26-753813_753915,cPa205-unknown,1,1,753884,753863,cPa205-unknown,20,102,21
chr26-774479_774581,cPa15,0.384615384615385,8,774577,774509,cPa118_cPa118-cPa75-hybrid_cPa15_cPa248-cPa15-hybrid_cPa248-cPa268-hybrid_cPa248-cPa75-hybrid_cPa268_cPa443,7_1_10_2_1_1_2_2,102,68
chr26-775369_775471,cPa248-cPa75-hybrid,0.5,3,775447,775419,cPa118-cPa75-hybrid_cPa248-cPa75-hybrid_cPa268-cPa75-hybrid,1_2_1,102,28
chr26-904_1006,cPa428,0.75,2,954,910,cPa356_cPa428,2_6,102,44
chr26-9889_9999,cPa428,0.545454545454545,2,9987,9892,cPa356_cPa428,5_6,110,95
chr27-1000498_1000600,cPa74-cPa138-hybrid,0.5,3,1000548,1000548,cPa74-cPa131-hybrid_cPa74-cPa138-hybrid_cPa74-cPa463-hybrid,1_2_1,102,0
chr27-1052808_1052910,cPa75-MSEV_CT990572-hybrid_HIV1_NC001802-MSEV_CT990572-hybrid,0.5,2,1052875,1052858,cPa75-MSEV_CT990572-hybrid_HIV1_NC001802-MSEV_CT990572-hybrid,1_1,102,17
chr27-1053075_1053240,cPa75-MSEV_CT990572-hybrid,0.470588235294118,3,1053236,1053125,cPa419_cPa75-MSEV_CT990572-hybrid_HIV1_NC001802-MSEV_CT990572-hybrid,4_8_5,165,111
chr27-1054481_1054583,cPa419,1,1,1054538,1054480,cPa419,5,102,58
chr27-1055915_1056017,cPa419,0.8,2,1055995,1055916,cPa419_cPa75,4_1,102,79
chr27-1061895_1062207,cPa223,0.490384615384615,16,1062157,1061918,cPa183-cPa424-hybrid_cPa223_cPa223-cPa424-hybrid_cPa272-cPa327-hybrid_cPa323-cPa424-hybrid_cPa327-cPa424-hybrid_cPa363-cPa424-hybrid_cPa379-cPa223-hybrid_cPa391-cPa424-hybrid_cPa391-cPa446-hybrid_cPa391-unknown_cPa424_cPa452-cPa223-hybrid_cPa452-cPa424-hybrid_cPa71-cPa424-hybrid_MLV_Mpmv5-cPa424-hybrid,1_51_6_1_1_2_6_1_22_1_3_3_1_2_1_2,312,239
chr27-1186354_1186456,cPa75,1,1,1186404,1186354,cPa75,2,102,50
chr27-1214634_1214783,cPa323,0.435897435897436,12,1214739,1214637,cPa323_cPa323-cPa449-hybrid_cPa333-cPa323-hybrid_cPa333-cPa371-hybrid_cPa371_cPa50_cPa50-cPa323-hybrid_cPa50-cPa371-hybrid_cPa50-cPa449-hybrid_cPa50-cPa512-hybrid_cPa50-unknown_cPa568,17_1_1_2_8_1_1_4_1_1_1_1,149,102
chr27-1214786_1214888,cPa323,0.75,2,1214836,1214817,cPa323_cPa371,3_1,102,19
chr27-1214928_1215057,cPa323,0.546875,12,1215053,1214946,cPa323_cPa323-cPa512-hybrid_cPa333_cPa371_cPa449_cPa50_cPa50-cPa16-hybrid_cPa50-cPa333-hybrid_cPa50-cPa449-hybrid_cPa50-cPa512-hybrid_cPa50-cPa568-hybrid_cPa50-unknown,35_1_1_19_1_1_1_1_1_1_1_1,129,107
chr27-1215235_1215337,cPa323,0.470588235294118,6,1215322,1215242,cPa323_cPa323-cPa568-hybrid_cPa371_cPa50-cPa323-hybrid_cPa50-cPa371-hybrid_cPa50-cPa449-hybrid,8_1_4_1_2_1,102,80
chr27-1220546_1220748,cPa482,0.85,4,1220723,1220572,cPa199_cPa199-cPa482-hybrid_cPa482_cPa482-unknown,1_1_17_1,202,151
chr27-1227363_1227465,cPa62,1,1,1227414,1227407,cPa62,4,102,7
chr27-1282888_1282990,cPa260,1,1,1282938,1282938,cPa260,1,102,0
chr27-1321307_1321411,cPa539,0.6,3,1321404,1321357,cPa450-cPa199-hybrid_cPa539_cPa539-unknown,1_3_1,104,47
chr27-1390692_1390794,cPa75,1,1,1390745,1390742,cPa75,2,102,3
chr27-1390810_1390912,cPa75,1,1,1390860,1390860,cPa75,1,102,0
chr27-1391139_1391241,cPa75,1,1,1391189,1391189,cPa75,1,102,0
chr27-1391358_1391460,cPa75,1,1,1391458,1391408,cPa75,2,102,50
chr27-1391472_1391706,cPa75,1,1,1391654,1391522,cPa75,18,234,132
chr27-1429157_1429259,cPa75,1,1,1429207,1429175,cPa75,3,102,32
chr27-1429311_1429494,cPa75,0.6,8,1429442,1429327,cPa293_cPa62_cPa62-cPa293-hybrid_cPa62-cPa413-hybrid_cPa62-cPa75-hybrid_cPa75_cPa75-PERVC_HM159246-hybrid_cPa75-unknown,2_3_3_2_2_24_1_3,183,115
chr27-1454890_1454992,cPa450,0.521739130434783,7,1454962,1454928,cPa199_cPa223-cPa199-hybrid_cPa345-cPa199-hybrid_cPa345-cPa450-hybrid_cPa450_cPa553_cPa553-cPa273-hybrid,3_1_1_1_12_4_1,102,34
chr27-1470751_1470853,cPa199_cPa199-cPa75-hybrid,0.5,2,1470801,1470764,cPa199_cPa199-cPa75-hybrid,1_1,102,37
chr27-1472170_1472272,cPa199-cPa75-hybrid,1,1,1472220,1472220,cPa199-cPa75-hybrid,1,102,0
chr27-1489990_1490092,cPa118,0.571428571428571,3,1490040,1490037,cPa118_cPa118-cPa15-hybrid_cPa15,4_1_2,102,3
chr27-1530205_1530307,cPa67,0.333333333333333,9,1530294,1530210,cPa194_cPa345_cPa345-cPa194-hybrid_cPa363-cPa194-hybrid_cPa446-cPa194-hybrid_cPa452-cPa194-hybrid_cPa67_cPa67-cPa194-hybrid_cPa67-WDSV_NC001867-hybrid,8_4_11_2_2_1_15_1_1,102,84
chr27-1546903_1547133,cPa75,0.666666666666667,2,1547081,1546916,cPa75_cPa75-unknown,8_4,230,165
chr27-1550157_1550299,cPa15,0.358490566037736,13,1550298,1550165,cPa118_cPa118-cPa248-hybrid_cPa118-cPa264-hybrid_cPa118-cPa443-hybrid_cPa15_cPa15-cPa118-hybrid_cPa15-cPa264-hybrid_cPa15-cPa345-hybrid_cPa15-cPa67-hybrid_cPa264_cPa264-cPa125-hybrid_cPa443_cPa516-cPa264-hybrid,16_2_2_1_19_1_1_1_1_5_2_1_1,142,133
chr27-1551769_1551950,cPa67,0.450980392156863,8,1551935,1551770,cPa118-cPa345-hybrid_cPa118-cPa67-hybrid_cPa15-cPa67-hybrid_cPa194_cPa264-cPa194-hybrid_cPa345_cPa67_HML3_repbase_HERVK9I_MER9,1_1_1_8_1_15_23_1,181,165
chr27-1762419_1762521,cPa199,1,1,1762469,1762469,cPa199,1,102,0
chr27-1762524_1762686,cPa199,0.916666666666667,4,1762682,1762561,cPa199_cPa199-unknown_cPa413-unknown_cPa505-unknown,44_2_1_1,162,121
chr27-1792871_1792973,cPa62-cPa345-hybrid,1,1,1792921,1792921,cPa62-cPa345-hybrid,1,102,0
chr27-1824489_1824591,cPa117,1,1,1824539,1824539,cPa117,1,102,0
chr27-1841998_1842280,cPa75,1,1,1842228,1842048,cPa75,12,282,180
chr27-1842770_1842964,cPa75,1,1,1842912,1842820,cPa75,7,194,92
chr27-1945335_1945437,cPa75,1,1,1945385,1945370,cPa75,2,102,15
chr27-1946814_1947127,cPa75,1,1,1947109,1946864,cPa75,15,313,245
chr27-1973103_1973205,cPa75,1,1,1973153,1973153,cPa75,1,102,0
chr27-1973720_1973822,cPa75,1,1,1973770,1973768,cPa75,4,102,2
chr27-1973921_1974023,cPa75,1,1,1973989,1973971,cPa75,2,102,18
chr27-2003805_2003907,cPa15,0.470588235294118,6,2003859,2003841,cPa118_cPa15_cPa15-unknown_cPa199-cPa268-hybrid_cPa268_cPa308-cPa118-hybrid,2_8_1_1_3_2,102,18
chr27-2005610_2005712,cPa308-MER52A_repbase_MER52AI_MER52A-hybrid_cPa419_cPa542-MER52A_repbase_MER52AI_MER52A-hybrid,0.333333333333333,3,2005660,2005660,cPa308-MER52A_repbase_MER52AI_MER52A-hybrid_cPa419_cPa542-MER52A_repbase_MER52AI_MER52A-hybrid,1_1_1,102,0
chr27-2063693_2063795,cPa482,0.615384615384615,8,2063759,2063704,cPa199_cPa273_cPa345_cPa413_cPa482_cPa482-unknown_cPa505_cPa505-cPa482-hybrid,1_1_1_4_24_2_4_2,102,55
chr27-2073685_2073871,cPa227,0.416666666666667,5,2073819,2073735,cPa227_cPa273_cPa273-cPa542-hybrid_cPa542_cPa542-cPa273-hybrid,5_2_1_3_1,186,84
chr27-2073889_2074050,cPa542,0.384615384615385,8,2073999,2073936,cPa157_cPa157-cPa482-hybrid_cPa227_cPa273-cPa227-hybrid_cPa345_cPa419_cPa542_cPa542-cPa345-hybrid,1_1_2_1_1_1_5_1,161,63
chr27-2074096_2074198,cPa345,0.25,7,2074191,2074141,cPa157-cPa482-hybrid_cPa227_cPa273_cPa345_cPa419_cPa542_HFV_NC001736-cPa482-hybrid,1_1_1_2_1_1_1,102,50
chr27-2092925_2093027,cPa75,0.458333333333333,6,2093017,2092925,cPa62_cPa62-cPa75-hybrid_cPa62-HERV-W_repbase_HERV17_LTR17-hybrid_cPa62-unknown_cPa75_HERV-W_repbase_HERV17_LTR17,1_5_2_4_11_1,102,92
chr27-2128616_2128718,cPa539,0.75,3,2128666,2128630,cPa539_HFV_NC001736_HFV_NC001736-cPa539-hybrid,6_1_1,102,36
chr27-2133128_2133230,cPa482,0.628571428571429,11,2133194,2133129,cPa109_cPa199_cPa199-cPa109-hybrid_cPa227-cPa482-hybrid_cPa345_cPa345-cPa109-hybrid_cPa345-cPa199-hybrid_cPa345-cPa450-hybrid_cPa482_cPa482-cPa450-hybrid_cPa505,4_1_1_1_1_1_1_1_22_1_1,102,65
chr27-2140160_2140262,cPa62-unknown,0.409090909090909,6,2140259,2140210,cPa62_cPa62-cPa109-hybrid_cPa62-cPa285-hybrid_cPa62-cPa75-hybrid_cPa62-unknown_cPa75,3_1_1_2_9_6,102,49
chr27-2149172_2149274,cPa482,1,1,2149264,2149222,cPa482,3,102,42
chr27-2162338_2162540,cPa323,0.605263157894737,8,2162535,2162337,cPa323_cPa323-unknown_cPa371_cPa371-cPa50-hybrid_cPa371-cPa568-hybrid_cPa371-unknown_cPa50_cPa568,23_1_8_1_1_2_1_1,202,198
chr27-2172812_2173009,cPa482,0.85,3,2172968,2172862,cPa273_cPa482_cPa482-unknown,1_17_2,197,106
chr27-2210536_2210638,cPa75,1,1,2210586,2210586,cPa75,1,102,0
chr27-225055_225190,cPa47,0.225563909774436,11,225143,225072,cPa174_cPa208-cPa425-hybrid_cPa254_cPa404-cPa174-hybrid_cPa404-cPa254-hybrid_cPa404-cPa47-hybrid_cPa404-unknown_cPa425_cPa425-cPa174-hybrid_cPa47_cPa47-cPa174-hybrid,10_1_28_27_8_1_5_20_1_30_2,135,71
chr27-2310412_2310514,cPa419_cPa75-unknown,0.5,2,2310462,2310448,cPa419_cPa75-unknown,1_1,102,14
chr27-2675427_2675781,cPa323,0.357142857142857,8,2675748,2675459,cPa323_cPa323-cPa333-hybrid_cPa371_cPa371-cPa333-hybrid_cPa371-cPa50-hybrid_cPa371-unknown_cPa50_cPa510-cPa333-hybrid,15_3_13_3_1_4_2_1,354,289
chr27-2675944_2676056,cPa323,0.461538461538462,5,2676049,2675955,cPa323_cPa323-cPa333-hybrid_cPa371_cPa50_cPa568,6_2_1_1_3,112,94
chr27-2727777_2727879,cPa75,1,1,2727827,2727827,cPa75,1,102,0
chr27-2740308_2740418,WDSV_NC001867,0.694444444444444,5,2740405,2740315,cPa62_cPa75-WDSV_NC001867-hybrid_WDSV_NC001867_WDSV_NC001867-cPa62-hybrid_WDSV_NC001867-unknown,7_1_25_1_2,110,90
chr27-2976746_2976848,cPa62-cPa75-hybrid,0.8,2,2976829,2976769,cPa62-cPa75-hybrid_cPa62-unknown,4_1,102,60
chr27-2976892_2976994,cPa62-HERV-W_repbase_HERV17_LTR17-hybrid,0.266666666666667,6,2976989,2976894,cPa62_cPa62-cPa75-hybrid_cPa62-HERV-W_repbase_HERV17_LTR17-hybrid_cPa62-unknown_cPa75_HERV-W_repbase_HERV17_LTR17,1_3_4_3_1_3,102,95
chr27-31400_31502,cPa118_cPa268,0.5,2,31465,31450,cPa118_cPa268,1_1,102,15
chr27-3143880_3144007,cPa15,0.5,3,3143955,3143930,cPa118_cPa118-cPa140-hybrid_cPa15,1_1_2,127,25
chr27-3148699_3149023,cPa75,0.9375,2,3148971,3148749,cPa260_cPa75,1_15,324,222
chr27-3260300_3260417,cPa75,0.75,2,3260365,3260350,cPa447-cPa75-hybrid_cPa75,1_3,117,15
chr27-3260425_3260582,cPa75,0.666666666666667,2,3260530,3260475,cPa447-cPa75-hybrid_cPa75,1_2,157,55
chr27-3260726_3260832,cPa75,1,1,3260780,3260776,cPa75,2,106,4
chr27-3261050_3261152,cPa75,1,1,3261100,3261100,cPa75,1,102,0
chr27-3291855_3291957,cPa75,1,1,3291934,3291873,cPa75,12,102,61
chr27-3306581_3306683,cPa75,1,1,3306631,3306631,cPa75,1,102,0
chr27-3322853_3323050,cPa75,1,1,3322998,3322866,cPa75,6,197,132
chr27-3339715_3339817,cPa363_cPa363-cPa379-hybrid_cPa452-cPa363-hybrid,0.333333333333333,3,3339777,3339763,cPa363_cPa363-cPa379-hybrid_cPa452-cPa363-hybrid,1_1_1,102,14
chr27-3449684_3449786,cPa75,1,1,3449734,3449695,cPa75,3,102,39
chr27-3474025_3474144,cPa75,1,1,3474092,3474075,cPa75,2,119,17
chr27-3474346_3474471,cPa75,1,1,3474419,3474396,cPa75,4,125,23
chr27-3498429_3498531,cPa75,1,1,3498479,3498479,cPa75,1,102,0
chr27-3498533_3498706,cPa75,1,1,3498706,3498562,cPa75,6,173,144
chr27-3498737_3498979,cPa75,1,1,3498927,3498787,cPa75,4,242,140
chr27-3499031_3499138,cPa75,1,1,3499086,3499081,cPa75,2,107,5
chr27-3499145_3499440,cPa75,1,1,3499388,3499195,cPa75,12,295,193
chr27-3499541_3499722,cPa75,1,1,3499675,3499550,cPa75,12,181,125
chr27-3499765_3500037,cPa75,1,1,3499985,3499815,cPa75,10,272,170
chr27-3507684_3507786,cPa75,1,1,3507734,3507734,cPa75,1,102,0
chr27-3508460_3508562,cPa75,1,1,3508510,3508510,cPa75,1,102,0
chr27-3515832_3515934,cPa75,1,1,3515882,3515882,cPa75,1,102,0
chr27-3516843_3516991,cPa75,1,1,3516939,3516893,cPa75,4,148,46
chr27-3524802_3525000,cPa75,1,1,3524948,3524852,cPa75,5,198,96
chr27-3525027_3525129,cPa75,1,1,3525077,3525077,cPa75,1,102,0
chr27-3525189_3525403,cPa75,1,1,3525351,3525190,cPa75,13,214,161
chr27-3534291_3534393,cPa62,0.75,2,3534360,3534341,cPa391_cPa62,1_3,102,19
chr27-3580496_3580651,cPa75,0.8,2,3580599,3580546,cPa308-cPa75-hybrid_cPa75,1_4,155,53
chr27-3580923_3581025,cPa75,1,1,3580973,3580952,cPa75,2,102,21
chr27-3617505_3617607,cPa75,1,1,3617555,3617528,cPa75,2,102,27
chr27-3625225_3625447,cPa75,1,1,3625433,3625275,cPa75,7,222,158
chr27-3625675_3625777,cPa75,1,1,3625739,3625725,cPa75,3,102,14
chr27-3625972_3626074,cPa75,1,1,3626050,3626001,cPa75,4,102,49
chr27-3627095_3627258,cPa75,1,1,3627206,3627145,cPa75,2,163,61
chr27-3627263_3627428,cPa75,1,1,3627376,3627313,cPa75,2,165,63
chr27-3627501_3627603,cPa75,1,1,3627551,3627532,cPa75,2,102,19
chr27-3638166_3638268,cPa75,1,1,3638216,3638216,cPa75,1,102,0
chr27-3639324_3639464,cPa75,1,1,3639420,3639374,cPa75,4,140,46
chr27-3644659_3644761,cPa75,1,1,3644709,3644709,cPa75,1,102,0
chr27-3645022_3645242,cPa75,1,1,3645190,3645072,cPa75,4,220,118
chr27-3724246_3724348,cPa356,0.571428571428571,2,3724342,3724274,cPa356_cPa428,12_9,102,68
chr27-3724429_3724632,cPa356,0.548022598870056,2,3724608,3724445,cPa356_cPa428,97_80,203,163
chr27-3731051_3731153,cPa428,0.666666666666667,2,3731101,3731101,cPa356_cPa428,1_2,102,0
chr27-3731922_3732024,cPa356,0.571428571428571,2,3732001,3731953,cPa356_cPa428,8_6,102,48
chr27-3732032_3732134,cPa428,0.625,2,3732097,3732081,cPa356_cPa428,3_5,102,16
chr27-3748374_3748476,cPa428,0.8,2,3748471,3748423,cPa356_cPa428,1_4,102,48
chr27-3749072_3749378,cPa356,0.523584905660377,2,3749326,3749071,cPa356_cPa428,111_101,306,255
chr27-3750086_3750361,cPa356,0.525,2,3750323,3750136,cPa356_cPa428,21_19,275,187
chr27-3750903_3751016,cPa356,0.666666666666667,2,3750964,3750953,cPa356_cPa428,2_1,113,11
chr27-3751063_3751165,cPa356,0.666666666666667,2,3751113,3751113,cPa356_cPa428,2_1,102,0
chr27-426283_426390,cPa254,0.4,4,426338,426333,cPa174_cPa254_cPa425_cPa47,1_2_1_1,107,5
chr27-4283454_4283562,cPa75,1,1,4283510,4283504,cPa75,2,108,6
chr27-4284838_4285050,cPa75,1,1,4284998,4284888,cPa75,32,212,110
chr27-4285104_4285209,cPa75,1,1,4285157,4285154,cPa75,2,105,3
chr27-4323499_4323601,cPa75,1,1,4323549,4323549,cPa75,1,102,0
chr27-4325252_4325354,cPa62-cPa75-hybrid,1,1,4325302,4325302,cPa62-cPa75-hybrid,1,102,0
chr27-4345978_4346080,cPa75,1,1,4346028,4346028,cPa75,1,102,0
chr27-4362171_4362273,cPa75,1,1,4362221,4362221,cPa75,1,102,0
chr27-4370211_4370313,cPa75,1,1,4370261,4370261,cPa75,1,102,0
chr27-4370593_4370695,cPa75,1,1,4370677,4370643,cPa75,2,102,34
chr27-4375953_4376055,cPa62,1,1,4376024,4376003,cPa62,2,102,21
chr27-4376109_4376248,cPa62,0.954545454545455,2,4376196,4376150,cPa285_cPa62,1_21,139,46
chr27-4384173_4384275,cPa75,1,1,4384274,4384223,cPa75,2,102,51
chr27-4384543_4384645,cPa75,1,1,4384593,4384593,cPa75,1,102,0
chr27-4389594_4389696,cPa75,1,1,4389646,4389644,cPa75,2,102,2
chr27-4389974_4390076,cPa75,1,1,4390024,4390024,cPa75,1,102,0
chr27-4390259_4390361,cPa75,1,1,4390309,4390309,cPa75,1,102,0
chr27-4404500_4404944,cPa75,1,1,4404892,4404550,cPa75,14,444,342
chr27-4405419_4405541,cPa75,1,1,4405489,4405469,cPa75,3,122,20
chr27-4406134_4406341,cPa75,1,1,4406289,4406184,cPa75,5,207,105
chr27-4412224_4412326,cPa75,1,1,4412274,4412274,cPa75,1,102,0
chr27-4418090_4418192,cPa75,1,1,4418140,4418140,cPa75,1,102,0
chr27-4424066_4424168,cPa75,1,1,4424116,4424116,cPa75,1,102,0
chr27-4435321_4435423,cPa75,1,1,4435395,4435371,cPa75,2,102,24
chr27-4435583_4436006,cPa75,1,1,4435954,4435633,cPa75,14,423,321
chr27-4436327_4436429,cPa75,1,1,4436377,4436377,cPa75,1,102,0
chr27-4453340_4453495,cPa75,1,1,4453443,4453390,cPa75,3,155,53
chr27-4453733_4453870,cPa75,1,1,4453818,4453783,cPa75,2,137,35
chr27-4454037_4454139,cPa75,1,1,4454087,4454087,cPa75,1,102,0
chr27-4455342_4455637,cPa75,1,1,4455633,4455392,cPa75,11,295,241
chr27-4457637_4457739,cPa75,1,1,4457687,4457687,cPa75,1,102,0
chr27-4459216_4459394,cPa75,1,1,4459342,4459266,cPa75,2,178,76
chr27-4461750_4461858,cPa75,1,1,4461806,4461751,cPa75,7,108,55
chr27-4474799_4474901,cPa75,1,1,4474849,4474849,cPa75,1,102,0
chr27-4484525_4484627,cPa308-cPa75-hybrid,1,1,4484575,4484575,cPa308-cPa75-hybrid,1,102,0
chr27-4503540_4503642,cPa75,1,1,4503590,4503590,cPa75,1,102,0
chr27-4503813_4503915,cPa75,1,1,4503863,4503863,cPa75,1,102,0
chr27-4503948_4504099,cPa75,1,1,4504047,4503998,cPa75,14,151,49
chr27-4504152_4504485,cPa75,1,1,4504433,4504202,cPa75,24,333,231
chr27-4504545_4504647,cPa75,1,1,4504595,4504595,cPa75,1,102,0
chr27-4540527_4540629,cPa75-unknown,0.8,2,4540615,4540541,cPa75_cPa75-unknown,3_12,102,74
chr27-4542853_4542955,cPa75,0.666666666666667,2,4542903,4542875,cPa75_cPa75-unknown,2_1,102,28
chr27-4543192_4543312,cPa75-unknown,1,1,4543260,4543222,cPa75-unknown,6,120,38
chr27-4543703_4543829,cPa75,1,1,4543777,4543753,cPa75,3,126,24
chr27-4543850_4543952,cPa75,1,1,4543900,4543900,cPa75,1,102,0
chr27-4544353_4544466,cPa75,1,1,4544414,4544403,cPa75,2,113,11
chr27-4544514_4544756,cPa75,1,1,4544704,4544564,cPa75,9,242,140
chr27-4592143_4592245,cPa75,0.6,3,4592202,4592179,cPa285_cPa285-cPa62-hybrid_cPa75,1_1_3,102,23
chr27-4593324_4593426,cPa75,1,1,4593374,4593374,cPa75,1,102,0
chr27-4593551_4593653,cPa75,1,1,4593601,4593601,cPa75,1,102,0
chr27-4593974_4594076,cPa75,1,1,4594024,4594024,cPa75,1,102,0
chr27-4594131_4594950,cPa75,1,1,4594898,4594181,cPa75,34,819,717
chr27-4597935_4598053,cPa75,1,1,4598001,4597978,cPa75,4,118,23
chr27-4613664_4613766,cPa62-cPa293-hybrid,1,1,4613714,4613714,cPa62-cPa293-hybrid,1,102,0
chr27-4623224_4623478,cPa75,1,1,4623426,4623274,cPa75,5,254,152
chr27-4623731_4623889,cPa75,1,1,4623855,4623769,cPa75,4,158,86
chr27-4632643_4632745,cPa75,1,1,4632693,4632693,cPa75,1,102,0
chr27-4646543_4646645,cPa75,1,1,4646593,4646593,cPa75,1,102,0
chr27-4646800_4646902,cPa75,1,1,4646850,4646824,cPa75,2,102,26
chr27-4646955_4647057,cPa75,1,1,4647005,4647005,cPa75,1,102,0
chr27-4655527_4655629,cPa75,1,1,4655577,4655577,cPa75,1,102,0
chr27-4679448_4679564,cPa199,0.5,4,4679512,4679479,cPa199_cPa199-cPa109-hybrid_cPa482_cPa505-unknown,3_1_1_1,116,33
chr27-4679610_4679752,cPa199,0.5,5,4679720,4679620,cPa109_cPa199_cPa199-cPa109-hybrid_cPa199-cPa201-hybrid_cPa482,1_5_1_1_2,142,100
chr27-4679785_4679892,cPa199,0.285714285714286,6,4679887,4679800,cPa199_cPa201_cPa482_cPa482-cPa199-hybrid_cPa482-cPa201-hybrid_cPa505-cPa199-hybrid,2_1_1_1_1_1,107,87
chr27-472267_472369,cPa62-unknown,0.833333333333333,2,472343,472291,cPa62_cPa62-unknown,1_5,102,52
chr27-4754465_4754654,cPa75,1,1,4754602,4754515,cPa75,6,189,87
chr27-4754728_4754954,cPa75,1,1,4754902,4754778,cPa75,7,226,124
chr27-4754979_4755109,cPa75,1,1,4755057,4755029,cPa75,2,130,28
chr27-4762722_4762824,cPa75,1,1,4762778,4762772,cPa75,2,102,6
chr27-4762892_4762994,cPa75,1,1,4762961,4762913,cPa75,3,102,48
chr27-4762999_4763128,cPa75,1,1,4763076,4763049,cPa75,4,129,27
chr27-4763251_4763432,cPa75,1,1,4763380,4763301,cPa75,4,181,79
chr27-4766304_4766604,WDSV_NC001867,0.615384615384615,3,4766552,4766354,cPa62_WDSV_NC001867_WDSV_NC001867-cPa62-hybrid,1_8_4,300,198
chr27-4766615_4766721,WDSV_NC001867,1,1,4766669,4766665,WDSV_NC001867,2,106,4
chr27-4766854_4767256,WDSV_NC001867,0.781818181818182,5,4767229,4766870,cPa254_cPa254-cPa62-hybrid_cPa62_WDSV_NC001867_WDSV_NC001867-cPa62-hybrid,2_3_2_43_5,402,359
chr27-4767317_4767586,WDSV_NC001867,0.666666666666667,2,4767534,4767367,WDSV_NC001867_WDSV_NC001867-cPa62-hybrid,4_2,269,167
chr27-4776956_4777058,cPa75,1,1,4777006,4777006,cPa75,1,102,0
chr27-4787459_4787561,cPa75,1,1,4787509,4787509,cPa75,1,102,0
chr27-4803898_4804035,cPa75-cPa62-hybrid,0.571428571428571,2,4803983,4803935,cPa62_cPa75-cPa62-hybrid,3_4,137,48
chr27-4811641_4811805,cPa62-cPa75-hybrid,1,1,4811753,4811691,cPa62-cPa75-hybrid,2,164,62
chr27-4811941_4812043,cPa62-cPa75-hybrid,1,1,4811991,4811991,cPa62-cPa75-hybrid,1,102,0
chr27-4812112_4812214,cPa62-cPa75-hybrid,1,1,4812162,4812162,cPa62-cPa75-hybrid,1,102,0
chr27-4812253_4812455,cPa62-cPa75-hybrid,0.666666666666667,2,4812403,4812303,cPa285-cPa75-hybrid_cPa62-cPa75-hybrid,1_2,202,100
chr27-4827639_4827792,cPa75,1,1,4827740,4827689,cPa75,2,153,51
chr27-4827876_4827978,cPa75,1,1,4827926,4827926,cPa75,1,102,0
chr27-4829394_4829496,cPa75-cPa62-hybrid,1,1,4829444,4829444,cPa75-cPa62-hybrid,1,102,0
chr27-4829915_4830062,cPa62,0.75,2,4830010,4829917,cPa62_cPa62-cPa75-hybrid,3_1,147,93
chr27-4833568_4833733,cPa75,0.714285714285714,3,4833681,4833618,cPa308_cPa308-cPa75-hybrid_cPa75,1_1_5,165,63
chr27-4833775_4833877,cPa75,1,1,4833825,4833825,cPa75,1,102,0
chr27-4833903_4834077,cPa75,1,1,4834029,4833914,cPa75,8,174,115
chr27-4840989_4841254,cPa486-cPa62-hybrid,0.380952380952381,6,4841237,4841039,cPa285_cPa486_cPa486-cPa62-hybrid_cPa486-unknown_cPa62_WDSV_NC001867,2_1_8_4_5_1,265,198
chr27-4854135_4854671,WDSV_NC001867,0.68,7,4854667,4854172,cPa119-cPa62-hybrid_cPa125_cPa62_WDSV_NC001867_WDSV_NC001867-cPa62-hybrid_WDSV_NC001867-cPa75-hybrid_WDSV_NC001867-unknown,2_1_8_51_9_3_1,536,495
chr27-4854705_4854896,WDSV_NC001867,0.7,5,4854891,4854705,cPa293-cPa62-hybrid_cPa62_WDSV_NC001867_WDSV_NC001867-cPa285-hybrid_WDSV_NC001867-cPa62-hybrid,2_1_14_1_2,191,186
chr27-4861196_4861298,cPa62,1,1,4861246,4861246,cPa62,1,102,0
chr27-4861329_4861431,cPa254_cPa486,0.285714285714286,5,4861379,4861335,cPa254_cPa381-cPa486-hybrid_cPa486_cPa62-cPa285-hybrid_cPa62-cPa75-hybrid,2_1_2_1_1,102,44
chr27-4884310_4884695,cPa75,0.8,4,4884643,4884360,cPa285_cPa285-cPa75-hybrid_cPa75_cPa75-unknown,1_1_12_1,385,283
chr27-4886440_4886562,cPa62,1,1,4886510,4886490,cPa62,2,122,20
chr27-4886695_4886950,cPa62,1,1,4886898,4886745,cPa62,7,255,153
chr27-4906716_4906818,cPa62,1,1,4906778,4906718,cPa62,4,102,60
chr27-4908889_4908991,cPa75,1,1,4908963,4908939,cPa75,8,102,24
chr27-4925284_4925386,cPa75-cPa62-hybrid,0.666666666666667,2,4925341,4925334,cPa62_cPa75-cPa62-hybrid,1_2,102,7
chr27-4925707_4925824,cPa62,0.941176470588235,2,4925772,4925719,cPa62_cPa75-cPa62-hybrid,16_1,117,53
chr27-4927216_4927318,cPa62-cPa75-hybrid,1,1,4927266,4927266,cPa62-cPa75-hybrid,1,102,0
chr27-4927366_4927468,cPa62-cPa75-hybrid,1,1,4927416,4927416,cPa62-cPa75-hybrid,1,102,0
chr27-4929604_4929706,cPa62,1,1,4929654,4929654,cPa62,1,102,0
chr27-4929842_4930213,cPa62,1,1,4930209,4929892,cPa62,39,371,317
chr27-4930231_4930397,cPa62,1,1,4930348,4930234,cPa62,6,166,114
chr27-4930422_4930536,cPa62,1,1,4930525,4930453,cPa62,12,114,72
chr27-4930609_4930711,cPa62,1,1,4930679,4930659,cPa62,4,102,20
chr27-4930730_4930832,cPa62,1,1,4930780,4930751,cPa62,16,102,29
chr27-4934813_4934915,cPa62,0.666666666666667,2,4934863,4934821,cPa62_cPa62-unknown,2_1,102,42
chr27-4935057_4935168,cPa62,1,1,4935142,4935107,cPa62,7,111,35
chr27-4936505_4936607,cPa62,1,1,4936555,4936555,cPa62,1,102,0
chr27-4936662_4936863,cPa62,1,1,4936811,4936712,cPa62,2,201,99
chr27-4936928_4937366,cPa62,0.92,3,4937314,4936978,cPa285_cPa62_cPa75,1_23_1,438,336
chr27-4938596_4938698,cPa75,1,1,4938646,4938646,cPa75,1,102,0
chr27-4939198_4939386,cPa75,1,1,4939334,4939248,cPa75,2,188,86
chr27-4939544_4939662,cPa75,1,1,4939610,4939594,cPa75,2,118,16
chr27-4943072_4943174,cPa62,1,1,4943122,4943122,cPa62,1,102,0
chr27-4955487_4955621,cPa62,1,1,4955569,4955537,cPa62,2,134,32
chr27-4957373_4957516,cPa75-cPa62-hybrid,1,1,4957464,4957423,cPa75-cPa62-hybrid,3,143,41
chr27-4957555_4957657,cPa75-cPa62-hybrid,1,1,4957605,4957605,cPa75-cPa62-hybrid,1,102,0
chr27-4957907_4958010,cPa75-cPa62-hybrid,1,1,4957958,4957957,cPa75-cPa62-hybrid,7,103,1
chr27-4958097_4958199,cPa75-cPa62-hybrid,1,1,4958147,4958147,cPa75-cPa62-hybrid,1,102,0
chr27-4958303_4958405,cPa75-cPa62-hybrid,1,1,4958353,4958353,cPa75-cPa62-hybrid,1,102,0
chr27-4958512_4958648,cPa75-cPa62-hybrid,0.833333333333333,2,4958596,4958562,cPa62_cPa75-cPa62-hybrid,1_5,136,34
chr27-4966786_4966965,cPa62,0.736842105263158,4,4966940,4966811,cPa62_cPa62-unknown_WDSV_NC001867_WDSV_NC001867-unknown,14_1_3_1,179,129
chr27-4966995_4967153,cPa486_cPa62_WDSV_NC001867,0.333333333333333,3,4967101,4967045,cPa486_cPa62_WDSV_NC001867,1_1_1,158,56
chr27-4973254_4973356,cPa62,1,1,4973304,4973301,cPa62,2,102,3
chr27-4979268_4979542,cPa75,0.95,2,4979490,4979318,cPa75_cPa75-unknown,19_1,274,172
chr27-4988270_4988438,WDSV_NC001867,0.7,4,4988414,4988269,WDSV_NC001867_WDSV_NC001867-cPa260-hybrid_WDSV_NC001867-cPa62-hybrid_WDSV_NC001867-unknown,7_1_1_1,168,145
chr27-4995490_4995592,cPa62,1,1,4995540,4995540,cPa62,1,102,0
chr27-5009154_5009256,cPa62,1,1,5009204,5009204,cPa62,1,102,0
chr27-5040079_5040216,cPa62-HERV-W_repbase_HERV17_LTR17-hybrid,1,1,5040164,5040129,cPa62-HERV-W_repbase_HERV17_LTR17-hybrid,2,137,35
chr27-5040251_5040455,cPa62-HERV-W_repbase_HERV17_LTR17-hybrid,0.5,3,5040433,5040301,cPa62-HERV-W_repbase_HERV17_LTR17-hybrid_cPa62-unknown_HERV-W_repbase_HERV17_LTR17,3_2_1,204,132
chr27-5045392_5045698,WDSV_NC001867,0.782608695652174,4,5045661,5045442,cPa62_cPa75-WDSV_NC001867-hybrid_WDSV_NC001867_WDSV_NC001867-unknown,2_1_18_2,306,219
chr27-5048257_5048359,WDSV_NC001867,0.947368421052632,2,5048328,5048271,WDSV_NC001867_WDSV_NC001867-cPa62-hybrid,18_1,102,57
chr27-5071722_5071826,cPa75-unknown,1,1,5071774,5071772,cPa75-unknown,2,104,2
chr27-5079705_5079822,cPa62,1,1,5079770,5079755,cPa62,2,117,15
chr27-5097325_5097428,cPa75-unknown,0.666666666666667,2,5097402,5097375,cPa75_cPa75-unknown,1_2,103,27
chr27-5109992_5110094,cPa260,1,1,5110042,5110042,cPa260,1,102,0
chr27-5152231_5152333,cPa75,1,1,5152281,5152281,cPa75,1,102,0
chr27-5152343_5152538,cPa75,1,1,5152486,5152393,cPa75,2,195,93
chr27-5168320_5168422,cPa75,1,1,5168370,5168370,cPa75,1,102,0
chr27-5217485_5217587,cPa75-unknown,1,1,5217535,5217535,cPa75-unknown,1,102,0
chr27-5224281_5224545,cPa75,1,1,5224493,5224331,cPa75,7,264,162
chr27-5224883_5225100,cPa75,1,1,5225048,5224933,cPa75,6,217,115
chr27-5225190_5225392,cPa75,1,1,5225340,5225240,cPa75,2,202,100
chr27-5229729_5229831,cPa75,1,1,5229779,5229779,cPa75,1,102,0
chr27-5230208_5230315,cPa75,1,1,5230263,5230253,cPa75,3,107,10
chr27-5239369_5239602,cPa75,1,1,5239550,5239419,cPa75,5,233,131
chr27-5242533_5242635,cPa75,1,1,5242583,5242583,cPa75,1,102,0
chr27-5242789_5242891,cPa75,1,1,5242839,5242839,cPa75,1,102,0
chr27-5247208_5247310,cPa75,1,1,5247258,5247258,cPa75,1,102,0
chr27-5259578_5259944,cPa75,1,1,5259892,5259628,cPa75,6,366,264
chr27-5259988_5260090,cPa75,1,1,5260044,5260038,cPa75,2,102,6
chr27-5260237_5260339,cPa75,1,1,5260287,5260287,cPa75,1,102,0
chr27-5260423_5260525,cPa75,1,1,5260473,5260473,cPa75,1,102,0
chr27-5299389_5299491,cPa75,1,1,5299439,5299439,cPa75,1,102,0
chr27-5337947_5338049,cPa75,1,1,5337997,5337997,cPa75,1,102,0
chr27-5338357_5338459,cPa75,1,1,5338407,5338407,cPa75,4,102,0
chr27-5370637_5370743,cPa75,1,1,5370693,5370656,cPa75,10,106,37
chr27-5370803_5370921,cPa75,1,1,5370869,5370848,cPa75,7,118,21
chr27-5370967_5371150,cPa75,1,1,5371098,5371017,cPa75,4,183,81
chr27-5371225_5371334,cPa75,1,1,5371282,5371245,cPa75,6,109,37
chr27-5371380_5371543,cPa75,1,1,5371491,5371430,cPa75,5,163,61
chr27-5474977_5475079,cPa62,1,1,5475066,5475027,cPa62,2,102,39
chr27-5475104_5475214,cPa62,1,1,5475162,5475154,cPa62,2,110,8
chr27-5483592_5483779,cPa75,1,1,5483727,5483642,cPa75,2,187,85
chr27-5484043_5484145,cPa75,1,1,5484093,5484093,cPa75,1,102,0
chr27-5519538_5519644,HERV-W_repbase_HERV17_LTR17,0.48,5,5519643,5519546,cPa62-cPa75-hybrid_cPa62-HERV-W_repbase_HERV17_LTR17-hybrid_cPa75_cPa75-HERV-W_repbase_HERV17_LTR17-hybrid_HERV-W_repbase_HERV17_LTR17,1_3_8_1_12,106,97
chr27-630556_630665,cPa75-unknown,0.833333333333333,2,630613,630589,cPa75_cPa75-unknown,1_5,109,24
chr27-660390_660492,cPa16_cPa16-unknown_cPa379-unknown,0.333333333333333,3,660476,660440,cPa16_cPa16-unknown_cPa379-unknown,1_1_1,102,36
chr27-660525_660627,cPa16_cPa379-cPa16-hybrid_cPa379-cPa71-hybrid,0.333333333333333,3,660575,660547,cPa16_cPa379-cPa16-hybrid_cPa379-cPa71-hybrid,1_1_1,102,28
chr27-661002_661104,cPa16,1,1,661052,661052,cPa16,1,102,0
chr27-661198_661300,cPa16,1,1,661248,661248,cPa16,1,102,0
chr27-661376_661478,cPa16,1,1,661475,661426,cPa16,2,102,49
chr27-661532_661634,cPa16,1,1,661582,661582,cPa16,1,102,0
chr27-661845_661947,cPa16,1,1,661895,661895,cPa16,1,102,0
chr27-662120_662303,cPa16,1,1,662251,662170,cPa16,2,183,81
chr27-735961_736063,cPa67,0.666666666666667,3,736027,735961,cPa194_cPa194-cPa345-hybrid_cPa67,1_1_4,102,66
chr27-759728_759830,cPa158_cPa229,0.5,2,759809,759756,cPa158_cPa229,3_3,102,53
chr27-768554_768656,cPa163_cPa360,0.5,2,768604,768604,cPa163_cPa360,1_1,102,0
chr27-772654_772756,cPa75,0.8,2,772705,772693,cPa260_cPa75,1_4,102,12
chr27-773416_773518,cPa75,1,1,773480,773433,cPa75,3,102,47
chr27-796587_796689,cPa199,0.5,6,796653,796586,cPa199_cPa227_cPa273_cPa273-cPa199-hybrid_cPa345_cPa450,7_1_2_2_1_1,102,67
chr27-818385_818778,cPa323,0.546666666666667,3,818753,818395,cPa323_cPa323-cPa371-hybrid_cPa371,41_2_32,393,358
chr27-820125_820227,cPa260,1,1,820175,820175,cPa260,1,102,0
chr27-880351_880453,cPa62-cPa402-hybrid,0.447368421052632,10,880452,880352,cPa201-cPa75-hybrid_cPa402_cPa62_cPa62-cPa201-hybrid_cPa62-cPa402-hybrid_cPa62-cPa71-hybrid_cPa62-cPa75-hybrid_cPa62-unknown_cPa75_cPa75-cPa402-hybrid,1_1_11_1_17_1_1_2_2_1,102,100
chr27-891181_891294,cPa482,1,1,891292,891188,cPa482,68,113,104
chr27-909107_909209,cPa75,1,1,909157,909112,cPa75,9,102,45
chr27-914509_914611,cPa75,0.75,2,914570,914548,cPa75_cPa75-unknown,3_1,102,22
chr27-925431_925619,cPa75,1,1,925567,925481,cPa75,2,188,86
chr27-925620_925722,cPa75,1,1,925670,925670,cPa75,1,102,0
chr27-925731_925833,cPa75,1,1,925781,925781,cPa75,1,102,0
chr27-926133_926438,cPa75,1,1,926386,926183,cPa75,5,305,203
chr27-926914_927028,cPa75,1,1,926976,926964,cPa75,4,114,12
chr27-927086_927207,cPa75,1,1,927165,927136,cPa75,7,121,29
chr27-940149_940251,cPa323,0.666666666666667,3,940233,940176,cPa323_cPa371_cPa371-unknown,8_2_2,102,57
chr28-1051993_1052095,cPa75,1,1,1052043,1052043,cPa75,1,102,0
chr28-1052332_1052587,cPa75,1,1,1052537,1052378,cPa75,6,255,159
chr28-1053013_1053217,cPa75,1,1,1053165,1053063,cPa75,2,204,102
chr28-1080060_1080253,cPa56,0.833333333333333,2,1080203,1080106,cPa56_cPa56-unknown,5_1,193,97
chr28-1084216_1084318,cPa371,0.75,2,1084277,1084266,cPa323_cPa371,1_3,102,11
chr28-1084342_1084501,cPa371,0.590909090909091,5,1084464,1084360,cPa323_cPa323-cPa371-hybrid_cPa371_cPa371-cPa323-hybrid_cPa371-unknown,6_1_13_1_1,159,104
chr28-1084552_1084759,cPa371,0.583333333333333,3,1084750,1084572,cPa323_cPa371_cPa371-cPa323-hybrid,9_14_1,207,178
chr28-1103308_1103447,cPa199,0.769230769230769,8,1103446,1103333,cPa199_cPa199-unknown_cPa273_cPa273-cPa199-hybrid_cPa482_cPa482-cPa199-hybrid_cPa482-unknown_MSFV_NC010819,40_1_1_1_4_2_2_1,139,113
chr28-1120309_1120411,cPa75,1,1,1120359,1120359,cPa75,1,102,0
chr28-1178458_1178560,cPa75,1,1,1178537,1178508,cPa75,5,102,29
chr28-1179971_1180073,cPa75,1,1,1180021,1180021,cPa75,1,102,0
chr28-1180272_1180374,cPa75,1,1,1180339,1180322,cPa75,3,102,17
chr28-1181391_1181493,cPa75,1,1,1181441,1181441,cPa75,1,102,0
chr28-1182074_1182218,cPa75,1,1,1182166,1182124,cPa75,2,144,42
chr28-1182940_1183042,cPa75,1,1,1182990,1182990,cPa75,2,102,0
chr28-120961_121063,cPa75,1,1,121011,121011,cPa75,1,102,0
chr28-143184_143321,cPa75,1,1,143269,143234,cPa75,3,137,35
chr28-143593_143695,cPa75,1,1,143643,143643,cPa75,1,102,0
chr28-143768_143970,cPa75,1,1,143918,143818,cPa75,7,202,100
chr28-143997_144114,cPa75,1,1,144062,144047,cPa75,2,117,15
chr28-144146_144336,cPa75,1,1,144284,144196,cPa75,6,190,88
chr28-151793_151895,cPa75,1,1,151843,151843,cPa75,1,102,0
chr28-1591334_1591436,cPa75,1,1,1591409,1591381,cPa75,3,102,28
chr28-167959_168061,cPa75,1,1,168009,168009,cPa75,1,102,0
chr28-1728995_1729130,cPa75,1,1,1729109,1729020,cPa75,19,135,89
chr28-1769886_1769988,cPa75,0.4,4,1769979,1769936,cPa492-cPa75-hybrid_cPa75_cPa75-cPa62-hybrid_HERV-W_repbase_HERV17_LTR17-cPa62-hybrid,1_2_1_1,102,43
chr28-1770408_1770644,cPa75,0.4375,6,1770592,1770416,cPa492-cPa62-hybrid_cPa75_HERV-W_repbase_HERV17_LTR17_HERV-W_repbase_HERV17_LTR17-cPa293-hybrid_HERV-W_repbase_HERV17_LTR17-cPa62-hybrid_HERV-W_repbase_HERV17_LTR17-cPa75-hybrid,1_7_2_1_4_1,236,176
chr28-178437_178539,cPa360,1,1,178487,178487,cPa360,1,102,0
chr28-1945834_1946158,cPa356,0.488372093023256,3,1946125,1945883,cPa356_cPa428_cPa428-unknown,21_19_3,324,242
chr28-1946181_1946395,cPa356_cPa428,0.5,2,1946346,1946205,cPa356_cPa428,32_32,214,141
chr28-1947868_1947970,cPa428,1,1,1947918,1947918,cPa428,1,102,0
chr28-1948797_1948922,cPa356_cPa428,0.5,2,1948904,1948847,cPa356_cPa428,5_5,125,57
chr28-1948938_1949040,cPa428,0.6,2,1949003,1948988,cPa356_cPa428,2_3,102,15
chr28-1949067_1949190,cPa356,0.6,2,1949185,1949085,cPa356_cPa428,15_10,123,100
chr28-1949203_1949305,cPa428,0.64,2,1949304,1949248,cPa356_cPa428,9_16,102,56
chr28-1950981_1951083,cPa356,0.714285714285714,2,1951038,1951031,cPa356_cPa428,5_2,102,7
chr28-1952374_1952476,cPa428,0.6,2,1952471,1952411,cPa356_cPa428,2_3,102,60
chr28-1952984_1953086,cPa356,0.571428571428571,2,1953085,1952994,cPa356_cPa428,8_6,102,91
chr28-1953135_1953237,cPa356_cPa428,0.5,2,1953235,1953144,cPa356_cPa428,25_25,102,91
chr28-1953893_1953995,cPa356_cPa428,0.5,2,1953943,1953921,cPa356_cPa428,2_2,102,22
chr28-1954261_1954363,cPa356,0.666666666666667,2,1954359,1954311,cPa356_cPa428,2_1,102,48
chr28-1954726_1954832,cPa356,0.578947368421053,2,1954828,1954765,cPa356_cPa428,11_8,106,63
chr28-1955587_1955978,cPa356,0.547619047619048,3,1955956,1955586,cPa356_cPa356-cPa428-hybrid_cPa428,115_1_94,391,370
chr28-1960304_1960487,cPa428,0.634920634920635,2,1960487,1960313,cPa356_cPa428,23_40,183,174
chr28-1960528_1960696,cPa428,0.592592592592593,2,1960685,1960546,cPa356_cPa428,11_16,168,139
chr28-1961146_1961335,cPa428,0.652173913043478,2,1961302,1961148,cPa356_cPa428,8_15,189,154
chr28-1961353_1961455,cPa356_cPa428,0.5,2,1961425,1961365,cPa356_cPa428,3_3,102,60
chr28-1961691_1961964,cPa356,0.504273504273504,2,1961954,1961737,cPa356_cPa428,59_58,273,217
chr28-1962198_1962302,cPa428,1,1,1962266,1962248,cPa428,5,104,18
chr28-1962425_1962688,cPa356,0.578512396694215,2,1962645,1962454,cPa356_cPa428,70_51,263,191
chr28-1963107_1963209,cPa428,1,1,1963157,1963157,cPa428,1,102,0
chr28-1963386_1963488,cPa356_cPa428,0.466666666666667,3,1963478,1963406,cPa356_cPa419_cPa428,7_1_7,102,72
chr28-1999495_1999597,cPa75,1,1,1999545,1999545,cPa75,1,102,0
chr28-1999608_1999732,cPa75,1,1,1999680,1999658,cPa75,4,124,22
chr28-2001580_2001682,cPa75,1,1,2001630,2001630,cPa75,1,102,0
chr28-2002381_2002548,cPa75,1,1,2002505,2002431,cPa75,17,167,74
chr28-2003515_2003617,cPa75,1,1,2003565,2003565,cPa75,1,102,0
chr28-2013789_2013900,cPa75,1,1,2013848,2013833,cPa75,4,111,15
chr28-2068447_2068552,cPa75,1,1,2068526,2068497,cPa75,2,105,29
chr28-2114621_2114723,cPa163,1,1,2114671,2114671,cPa163,1,102,0
chr28-2144979_2145081,cPa446,0.3,6,2145031,2145007,cPa15_cPa183_cPa327-cPa183-hybrid_cPa446_cPa446-cPa223-hybrid_cPa446-cPa75-hybrid,2_2_1_3_1_1,102,24
chr28-2146216_2146318,cPa446-cPa75-hybrid,0.4,4,2146287,2146217,cPa183-cPa75-hybrid_cPa223-cPa75-hybrid_cPa446-cPa75-hybrid_cPa452-cPa75-hybrid,1_1_2_1,102,70
chr28-2146354_2146456,cPa363-cPa75-hybrid,1,1,2146404,2146404,cPa363-cPa75-hybrid,1,102,0
chr28-21776_21884,cPa75,1,1,21832,21826,cPa75,2,108,6
chr28-21969_22071,cPa75,1,1,22019,22019,cPa75,2,102,0
chr28-2204632_2204734,cPa62-cPa67-hybrid,0.285714285714286,6,2204728,2204644,cPa62_cPa62-cPa199-hybrid_cPa62-cPa482-hybrid_cPa62-cPa505-hybrid_cPa62-cPa67-hybrid_cPa62-unknown,1_1_1_1_2_1,102,84
chr28-2205669_2205771,cPa199,0.545454545454545,4,2205768,2205700,cPa199_cPa505_cPa505-cPa539-hybrid_cPa62-cPa505-hybrid,6_3_1_1,102,68
chr28-2219641_2219743,cPa75,1,1,2219691,2219691,cPa75,1,102,0
chr28-2235059_2235166,cPa62,0.875,2,2235147,2235083,cPa62_cPa62-unknown,7_1,107,64
chr28-2238365_2238467,cPa583,1,1,2238415,2238397,cPa583,2,102,18
chr28-22483_22585,cPa75,1,1,22533,22533,cPa75,1,102,0
chr28-2255716_2255818,cPa75,1,1,2255769,2255766,cPa75,2,102,3
chr28-2267273_2267375,cPa391,0.75,2,2267337,2267318,cPa293_cPa391,1_3,102,19
chr28-23105_23300,cPa75,1,1,23290,23155,cPa75,8,195,135
chr28-2321539_2321641,cPa62,1,1,2321589,2321579,cPa62,4,102,10
chr28-2330651_2330753,cPa75,1,1,2330701,2330679,cPa75,2,102,22
chr28-2428077_2428206,cPa199,0.595744680851064,11,2428182,2428077,cPa199_cPa273_cPa273-cPa482-hybrid_cPa273-cPa542-hybrid_cPa450_cPa450-cPa199-hybrid_cPa482_cPa542_cPa542-unknown_cPa553_cPa553-unknown,28_1_1_1_4_1_1_6_2_1_1,129,105
chr28-2429025_2429127,cPa199,0.833333333333333,2,2429076,2429051,cPa199_cPa482,5_1,102,25
chr28-2429309_2429411,cPa199,0.571428571428571,4,2429401,2429313,cPa109-cPa199-hybrid_cPa199_cPa482_cPa482-cPa199-hybrid,1_4_1_1,102,88
chr28-2454091_2454286,cPa113_cPa293,0.25,6,2454234,2454122,cPa113_cPa293_cPa62_cPa62-cPa75-hybrid_cPa67_cPa75,2_2_1_1_1_1,195,112
chr28-2474012_2474455,cPa75,0.944444444444444,2,2474452,2474054,cPa75_cPa75-unknown,34_2,443,398
chr28-2474466_2474568,cPa75,1,1,2474516,2474516,cPa75,1,102,0
chr28-2551367_2551469,cPa323,0.5,3,2551433,2551375,cPa323_cPa333-cPa50-hybrid_cPa371,3_1_2,102,58
chr28-2623249_2623351,cPa62,0.888888888888889,2,2623329,2623292,cPa285_cPa62,1_8,102,37
chr28-2636964_2637066,cPa67,0.526315789473684,6,2637061,2636969,cPa194_cPa345_cPa345-unknown_cPa67_cPa67-cPa194-hybrid_cPa67-cPa542-hybrid,4_1_2_10_1_1,102,92
chr28-2667426_2667528,cPa452,0.415094339622642,10,2667527,2667428,cPa345-cPa446-hybrid_cPa363_cPa363-cPa194-hybrid_cPa363-cPa446-hybrid_cPa379_cPa446_cPa452_cPa452-cPa379-hybrid_cPa67-cPa379-hybrid_cPa67-cPa446-hybrid,1_13_1_1_5_3_22_2_4_1,102,99
chr28-2674059_2674161,cPa62,1,1,2674143,2674109,cPa62,13,102,34
chr28-2798282_2798384,cPa67,0.6,3,2798332,2798327,cPa345_cPa67_FeFV_NC001871,1_3_1,102,5
chr28-280891_280993,cPa75,1,1,280941,280941,cPa75,1,102,0
chr28-308471_308582,cPa62,1,1,308530,308516,cPa62,5,111,14
chr28-31218_31320,cPa75,1,1,31268,31268,cPa75,1,102,0
chr28-3125026_3125128,cPa323,0.454545454545455,3,3125082,3125039,cPa323_cPa323-cPa371-hybrid_cPa371,5_3_3,102,43
chr28-3148473_3148575,cPa482,0.848484848484849,4,3148574,3148472,cPa199_cPa273-unknown_cPa482_cPa505-cPa199-hybrid,3_1_28_1,102,102
chr28-316001_316302,cPa62-cPa75-hybrid,0.6,4,316265,316051,cPa254-cPa75-hybrid_cPa62_cPa62-cPa486-hybrid_cPa62-cPa75-hybrid,1_2_1_6,301,214
chr28-316366_316468,cPa62,0.666666666666667,2,316416,316368,cPa62_cPa62-cPa75-hybrid,4_2,102,48
chr28-316651_316909,cPa62-cPa75-hybrid,1,1,316875,316701,cPa62-cPa75-hybrid,7,258,174
chr28-317018_317301,cPa62-cPa75-hybrid,1,1,317249,317019,cPa62-cPa75-hybrid,23,283,230
chr28-317904_318008,cPa117,0.5,3,317975,317932,cPa117_cPa363-cPa117-hybrid_cPa452,2_1_1,104,43
chr28-318148_318844,cPa117,0.958333333333333,2,318792,318193,cPa117_cPa75,23_1,696,599
chr28-3271890_3271992,WDSV_NC001867,1,1,3271940,3271940,WDSV_NC001867,1,102,0
chr28-328320_328422,cPa539,1,1,328370,328370,cPa539,1,102,0
chr28-332379_332539,WDSV_NC001867-cPa62-hybrid,0.421052631578947,6,332504,332388,cPa119_cPa566-cPa62-hybrid_cPa62_WDSV_NC001867_WDSV_NC001867-cPa62-hybrid_WDSV_NC001867-unknown,1_1_4_14_16_2,160,116
chr28-332616_332718,WDSV_NC001867,0.714285714285714,3,332671,332616,cPa62_WDSV_NC001867_WDSV_NC001867-cPa62-hybrid,1_5_1,102,55
chr28-3422843_3422945,cPa264,0.277777777777778,9,3422897,3422871,cPa118_cPa15_cPa248_cPa248-cPa264-hybrid_cPa248-unknown_cPa264_cPa443_cPa443-cPa264-hybrid_cPa443-unknown,4_1_2_1_1_5_1_1_2,102,26
chr28-344782_344894,cPa75,1,1,344842,344807,cPa75,3,112,35
chr28-344930_345142,cPa75-unknown,0.4,4,345090,344980,cPa447_cPa75_cPa75-cPa447-hybrid_cPa75-unknown,1_1_1_2,212,110
chr28-3466406_3466508,cPa75-unknown,0.8,2,3466506,3466442,cPa75_cPa75-unknown,2_8,102,64
chr28-3479091_3479193,cPa199_cPa223_cPa273_cPa542_cPa553,0.181818181818182,6,3479189,3479129,cPa199_cPa223_cPa273_cPa450_cPa542_cPa553,2_2_2_1_2_2,102,60
chr28-350011_350153,cPa75,1,1,350101,350061,cPa75,2,142,40
chr28-350271_350633,cPa75,1,1,350581,350321,cPa75,11,362,260
chr28-3523501_3523605,cPa260-cPa62-hybrid,0.333333333333333,5,3523604,3523503,cPa260_cPa260-cPa293-hybrid_cPa260-cPa62-hybrid_cPa260-cPa75-hybrid_cPa260-unknown,3_1_8_5_7,104,101
chr28-3622182_3622284,cPa75,1,1,3622232,3622232,cPa75,1,102,0
chr28-3635255_3635413,cPa75,1,1,3635361,3635305,cPa75,6,158,56
chr28-3664836_3664938,cPa260,1,1,3664886,3664886,cPa260,1,102,0
chr28-367142_367548,cPa62-unknown,0.444444444444444,10,367519,367152,cPa381_cPa381-unknown_cPa381-WDSV_NC001867-hybrid_cPa62_cPa62-cPa381-hybrid_cPa62-MMTV_NC001503-hybrid_cPa62-unknown_cPa62-WDSV_NC001867-hybrid_MMTV_NC001503_WDSV_NC001867,2_1_2_4_1_20_36_3_1_11,406,367
chr28-3703400_3703653,cPa223,0.537634408602151,14,3703642,3703413,cPa199_cPa199-cPa223-hybrid_cPa199-cPa345-hybrid_cPa199-cPa450-hybrid_cPa199-cPa553-hybrid_cPa223_cPa223-cPa199-hybrid_cPa223-cPa345-hybrid_cPa223-unknown_cPa345_cPa345-cPa199-hybrid_cPa345-cPa553-hybrid_cPa450_cPa542,12_1_1_1_2_50_1_2_5_13_1_1_1_2,253,229
chr28-3703658_3703760,cPa223,0.714285714285714,3,3703749,3703665,cPa223_cPa223-unknown_cPa345,5_1_1,102,84
chr28-3708664_3708889,cPa273,0.571428571428571,4,3708887,3708680,cPa227_cPa273_cPa345_cPa553,1_4_1_1,225,207
chr28-3756556_3756658,cPa75-cPa379-hybrid,1,1,3756606,3756606,cPa75-cPa379-hybrid,1,102,0
chr28-3776163_3776265,cPa553,0.214285714285714,9,3776213,3776163,cPa199_cPa199-unknown_cPa223-cPa75-hybrid_cPa227_cPa345_cPa450_cPa450-cPa75-hybrid_cPa553_PERVE_NC003059,2_1_2_1_1_1_1_3_2,102,50
chr28-3786150_3786252,cPa323_cPa371,0.5,2,3786200,3786184,cPa323_cPa371,1_1,102,16
chr28-3786423_3786664,cPa323,0.689655172413793,4,3786634,3786436,cPa323_cPa323-unknown_cPa371_cPa371-unknown,20_1_7_1,241,198
chr28-3868422_3868573,HFV_NC001736,1,1,3868521,3868472,HFV_NC001736,2,151,49
chr28-3885794_3885896,cPa419,1,1,3885844,3885844,cPa419,1,102,0
chr28-39516_39618,cPa75,1,1,39566,39566,cPa75,1,102,0
chr28-39765_40791,cPa75,1,1,40739,39815,cPa75,58,1026,924
chr28-3978344_3978446,cPa260,0.777777777777778,3,3978415,3978356,cPa260_cPa568-cPa228-hybrid_FeLV_NC001940-cPa260-hybrid,7_1_1,102,59
chr28-4042831_4042933,cPa323,0.6,3,4042909,4042878,cPa323_cPa323-cPa333-hybrid_cPa333-cPa158-hybrid,3_1_1,102,31
chr28-4043061_4043163,cPa323,0.75,2,4043111,4043073,cPa323_cPa333,3_1,102,38
chr28-4043176_4043352,cPa323,0.8,2,4043300,4043196,cPa323_cPa75-cPa371-hybrid,4_1,176,104
chr28-4045809_4045952,cPa75-cPa323-hybrid,1,1,4045900,4045848,cPa75-cPa323-hybrid,6,143,52
chr28-4046025_4046220,cPa75-cPa371-hybrid,0.6,2,4046213,4046075,cPa75-cPa323-hybrid_cPa75-cPa371-hybrid,2_3,195,138
chr28-4046355_4046457,cPa75-cPa323-hybrid,1,1,4046405,4046405,cPa75-cPa323-hybrid,1,102,0
chr28-4046773_4046987,cPa323_cPa75-cPa323-hybrid,0.285714285714286,5,4046935,4046823,cPa323_cPa323-cPa371-hybrid_cPa371_cPa75-cPa323-hybrid_cPa75-cPa363-hybrid,2_1_1_2_1,214,112
chr28-4051683_4051835,cPa75,1,1,4051783,4051719,cPa75,4,152,64
chr28-4051837_4052074,cPa75,1,1,4052022,4051887,cPa75,4,237,135
chr28-4078095_4078213,cPa62,0.75,2,4078161,4078145,cPa285-cPa62-hybrid_cPa62,1_3,118,16
chr28-40847_40949,cPa75,1,1,40897,40897,cPa75,1,102,0
chr28-409472_409574,HERV-W_repbase_HERV17_LTR17-cPa75-hybrid,1,1,409522,409522,HERV-W_repbase_HERV17_LTR17-cPa75-hybrid,1,102,0
chr28-4096951_4097254,cPa75,0.941176470588235,2,4097253,4096958,cPa75_cPa75-unknown,16_1,303,295
chr28-41337_41439,cPa75,1,1,41387,41387,cPa75,1,102,0
chr28-41515_41663,cPa75,1,1,41611,41565,cPa75,2,148,46
chr28-4168953_4169055,WDSV_NC001867,1,1,4169003,4168956,WDSV_NC001867,2,102,47
chr28-4196131_4196233,cPa363_cPa452,0.25,6,4196230,4196181,cPa363_cPa363-cPa228-hybrid_cPa379_cPa379-cPa260-hybrid_cPa452_cPa452-cPa424-hybrid,2_1_1_1_2_1,102,49
chr28-426753_426855,cPa75,1,1,426803,426803,cPa75,1,102,0
chr28-426873_426975,cPa425,1,1,426923,426923,cPa425,1,102,0
chr28-426978_427080,cPa75-unknown,1,1,427028,427028,cPa75-unknown,1,102,0
chr28-428121_428513,cPa75-unknown,0.5,3,428480,428171,cPa75_cPa75-cPa543-hybrid_cPa75-unknown,11_1_12,392,309
chr28-428515_428617,cPa75-unknown,1,1,428565,428565,cPa75-unknown,1,102,0
chr28-4303316_4303467,cPa75,1,1,4303419,4303366,cPa75,9,151,53
chr28-4303516_4303666,cPa75,1,1,4303624,4303566,cPa75,13,150,58
chr28-4303795_4303959,cPa75,1,1,4303943,4303796,cPa75,9,164,147
chr28-4303982_4304084,cPa75,1,1,4304032,4304025,cPa75,2,102,7
chr28-4304124_4304226,cPa75,1,1,4304174,4304174,cPa75,1,102,0
chr28-4304296_4304509,cPa75,1,1,4304457,4304346,cPa75,5,213,111
chr28-4304680_4304782,cPa75,1,1,4304730,4304730,cPa75,1,102,0
chr28-4304830_4304932,cPa75,1,1,4304880,4304880,cPa75,1,102,0
chr28-434837_435122,cPa117,0.9,2,435098,434887,cPa117_cPa452,9_1,285,211
chr28-435200_435544,cPa117,1,1,435492,435250,cPa117,16,344,242
chr28-435924_436026,cPa452-cPa75-hybrid,1,1,435974,435974,cPa452-cPa75-hybrid,1,102,0
chr28-439254_439356,cPa75,1,1,439304,439304,cPa75,1,102,0
chr28-439437_439539,cPa75,1,1,439487,439487,cPa75,1,102,0
chr28-440990_441092,cPa113,1,1,441040,441040,cPa113,1,102,0
chr28-4429361_4429463,cPa539-cPa582-hybrid,1,1,4429411,4429411,cPa539-cPa582-hybrid,1,102,0
chr28-444096_444198,cPa260-cPa62-hybrid,1,1,444146,444146,cPa260-cPa62-hybrid,1,102,0
chr28-444221_444323,WDSV_NC001867,1,1,444271,444271,WDSV_NC001867,1,102,0
chr28-4490824_4490926,cPa15,0.833333333333333,2,4490907,4490860,cPa118-cPa140-hybrid_cPa15,1_5,102,47
chr28-4492956_4493058,cPa260,1,1,4493024,4493006,cPa260,3,102,18
chr28-452976_453078,cPa75,1,1,453026,453026,cPa75,1,102,0
chr28-4554434_4554557,cPa75,1,1,4554505,4554474,cPa75,8,123,31
chr28-4555351_4555464,cPa75,1,1,4555413,4555401,cPa75,5,113,12
chr28-4555701_4555803,cPa75,1,1,4555751,4555747,cPa75,2,102,4
chr28-4555885_4556025,cPa75,1,1,4555982,4555913,cPa75,19,140,69
chr28-458243_458345,cPa75,1,1,458293,458293,cPa75,1,102,0
chr28-458778_458880,cPa75,1,1,458828,458828,cPa75,1,102,0
chr28-458961_459083,cPa75,1,1,459031,459011,cPa75,6,122,20
chr28-459119_459451,cPa75,1,1,459399,459169,cPa75,4,332,230
chr28-4617482_4617588,cPa62,1,1,4617541,4617526,cPa62,18,106,15
chr28-463771_463938,cPa486-cPa62-hybrid,0.421052631578947,6,463938,463807,cPa486_cPa486-cPa62-hybrid_cPa486-cPa75-hybrid_cPa62_WDSV_NC001867_WDSV_NC001867-unknown,2_8_2_4_1_2,167,131
chr28-464036_464138,cPa486-cPa62-hybrid,0.5,4,464125,464036,cPa486_cPa486-cPa62-hybrid_cPa486-cPa75-hybrid_cPa62,1_3_1_1,102,89
chr28-464208_464310,cPa75,1,1,464258,464258,cPa75,1,102,0
chr28-464705_464807,cPa486-cPa75-hybrid,1,1,464755,464728,cPa486-cPa75-hybrid,3,102,27
chr28-4649986_4650097,cPa62,0.875,3,4650045,4650017,cPa62_cPa62-cPa75-hybrid_cPa62-unknown,14_1_1,111,28
chr28-4650886_4651234,cPa75,1,1,4651182,4650936,cPa75,14,348,246
chr28-4651290_4651392,cPa75,1,1,4651343,4651340,cPa75,2,102,3
chr28-4702035_4702546,cPa75,1,1,4702509,4702085,cPa75,20,511,424
chr28-4702795_4702971,cPa75,1,1,4702928,4702839,cPa75,18,176,89
chr28-4703037_4703139,cPa75,1,1,4703087,4703087,cPa75,1,102,0
chr28-4712076_4712178,cPa199_cPa505,0.5,2,4712169,4712126,cPa199_cPa505,1_1,102,43
chr28-484225_484327,cPa456,1,1,484275,484275,cPa456,1,102,0
chr28-4859367_4859469,cPa75-cPa260-hybrid,1,1,4859417,4859369,cPa75-cPa260-hybrid,2,102,48
chr28-4873273_4873375,MLV_Xmv43-unknown,1,1,4873323,4873323,MLV_Xmv43-unknown,1,102,0
chr28-4912062_4912164,cPa75,1,1,4912163,4912112,cPa75,5,102,51
chr28-4912370_4912568,cPa75,1,1,4912555,4912390,cPa75,9,198,165
chr28-4912581_4912816,cPa75,1,1,4912813,4912631,cPa75,14,235,182
chr28-4912933_4913188,cPa75,1,1,4913136,4912983,cPa75,12,255,153
chr28-4937304_4937406,cPa75,1,1,4937354,4937354,cPa75,1,102,0
chr28-4939250_4939352,cPa75-cPa62-hybrid,1,1,4939300,4939300,cPa75-cPa62-hybrid,1,102,0
chr28-4978593_4978695,cPa75,1,1,4978643,4978643,cPa75,1,102,0
chr28-4978948_4979097,cPa75,1,1,4979045,4978998,cPa75,2,149,47
chr28-501801_501903,cPa75-cPa553-hybrid,1,1,501851,501851,cPa75-cPa553-hybrid,1,102,0
chr28-5026006_5026220,cPa117,0.4,4,5026168,5026056,cPa117_cPa260_cPa260-cPa75-hybrid_cPa452,2_1_1_1,214,112
chr28-5026291_5026393,cPa117,0.666666666666667,2,5026341,5026325,cPa117_cPa117-cPa75-hybrid,2_1,102,16
chr28-5374864_5374966,cPa118,0.473684210526316,8,5374923,5374892,cPa118_cPa118-cPa15-hybrid_cPa125-cPa15-hybrid_cPa125-cPa516-hybrid_cPa15_cPa248-unknown_cPa268-cPa118-hybrid_cPa268-cPa15-hybrid,27_2_1_1_22_1_1_2,102,31
chr28-5845560_5845662,cPa308-unknown,0.8,2,5845611,5845610,cPa308-cPa362-hybrid_cPa308-unknown,1_4,102,1
chr28-5863784_5863886,cPa360-cPa363-hybrid,1,1,5863834,5863834,cPa360-cPa363-hybrid,1,102,0
chr28-5864531_5864633,cPa360-cPa363-hybrid,1,1,5864581,5864581,cPa360-cPa363-hybrid,1,102,0
chr28-5883204_5883306,cPa502,1,1,5883254,5883254,cPa502,1,102,0
chr28-635538_635640,cPa75,1,1,635588,635588,cPa75,1,102,0
chr28-659248_659350,cPa75,1,1,659298,659298,cPa75,1,102,0
chr28-66599_66701,cPa75,1,1,66649,66649,cPa75,1,102,0
chr28-67326_67428,cPa75,1,1,67376,67376,cPa75,1,102,0
chr28-67443_67691,cPa75,1,1,67639,67493,cPa75,37,248,146
chr28-68077_68179,cPa75,1,1,68131,68081,cPa75,17,102,50
chr28-69982_70084,cPa75,1,1,70032,70032,cPa75,1,102,0
chr28-70173_70275,cPa75,1,1,70223,70223,cPa75,1,102,0
chr28-70398_70500,cPa75,1,1,70448,70448,cPa75,1,102,0
chr28-70838_70940,cPa75,1,1,70888,70888,cPa75,1,102,0
chr28-722789_722891,cPa62,1,1,722839,722839,cPa62,1,102,0
chr28-723171_723276,cPa75,1,1,723251,723194,cPa75,10,105,57
chr28-74107_74209,cPa75,1,1,74157,74157,cPa75,1,102,0
chr28-758359_758461,cPa482,1,1,758409,758393,cPa482,2,102,16
chr28-799774_800193,cPa75,1,1,800141,799820,cPa75,21,419,321
chr28-802929_803031,cPa75,1,1,802979,802979,cPa75,1,102,0
chr28-803146_803248,cPa75,1,1,803196,803196,cPa75,1,102,0
chr28-807777_808020,cPa56,0.714285714285714,3,807987,807783,cPa56_cPa56-unknown_cPa75-unknown,5_1_1,243,204
chr28-849283_849400,cPa62,1,1,849348,849333,cPa62,2,117,15
chr28-87655_87765,cPa75,1,1,87713,87705,cPa75,2,110,8
chr28-87769_87910,cPa75,1,1,87858,87819,cPa75,2,141,39
chr28-88162_88329,cPa75,1,1,88277,88212,cPa75,2,167,65
chr28-88410_88801,cPa75,1,1,88749,88460,cPa75,11,391,289
chr28-889238_889340,cPa75,1,1,889288,889288,cPa75,1,102,0
chr28-91876_91978,cPa75,1,1,91940,91926,cPa75,3,102,14
chr28-926210_926350,cPa323,0.714285714285714,2,926326,926236,cPa323_cPa371,5_2,140,90
chr28-926359_926543,cPa323,0.545454545454545,3,926537,926367,cPa323_cPa371_cPa371-cPa323-hybrid,12_8_2,184,170
chr28-951489_951591,cPa75,1,1,951539,951539,cPa75,1,102,0
chr28-960111_960213,cPa62,1,1,960182,960161,cPa62,3,102,21
chr28-979069_979171,cPa75,1,1,979119,979119,cPa75,1,102,0
chr3-100110657_100110759,cPa14-cPa104-hybrid_cPa190_cPa219_cPa220,0.25,4,100110707,100110707,cPa14-cPa104-hybrid_cPa190_cPa219_cPa220,1_1_1_1,102,0
chr3-100160561_100160663,cPa456,0.4,5,100160627,100160605,cPa363_cPa456_cPa456-cPa117-hybrid_cPa456-cPa452-hybrid_cPa587-cPa117-hybrid,5_6_1_1_2,102,22
chr3-100245351_100245466,cPa15,0.5,3,100245414,100245401,cPa118_cPa118-cPa248-hybrid_cPa15,1_1_2,115,13
chr3-100291002_100291106,cPa4_cPa541,0.4,3,100291104,100291052,cPa14-cPa18-hybrid_cPa4_cPa541,1_2_2,104,52
chr3-10045282_10045438,HERV-W_repbase_HERV17_LTR17,0.833333333333333,2,10045386,10045332,HERV-W_repbase_HERV17_LTR17_KoRV_AF151794-HERV-W_repbase_HERV17_LTR17-hybrid,5_1,156,54
chr3-10045525_10045650,HERV-W_repbase_HERV17_LTR17,1,1,10045598,10045568,HERV-W_repbase_HERV17_LTR17,15,125,30
chr3-100476980_100477109,cPa492,1,1,100477108,100477014,cPa492,49,129,94
chr3-100517620_100517722,cPa363,0.666666666666667,2,100517722,100517670,cPa363_cPa452,2_1,102,52
chr3-100721287_100721389,cPa62,0.875,2,100721347,100721299,cPa308-cPa62-hybrid_cPa62,1_7,102,48
chr3-100791590_100791693,cPa229_cPa500,0.307692307692308,6,100791645,100791611,cPa157_cPa183_cPa193_cPa193-unknown_cPa229_cPa500,1_1_2_1_4_4,103,34
chr3-100843308_100843493,cPa75,0.409090909090909,6,100843441,100843342,cPa113_cPa62_cPa62-cPa293-hybrid_cPa62-cPa75-hybrid_cPa62-unknown_cPa75,1_3_1_5_3_9,185,99
chr3-100998324_100998426,cPa456,0.444444444444444,4,100998425,100998367,cPa363_cPa363-cPa117-hybrid_cPa456_cPa587-cPa117-hybrid,3_1_4_1,102,58
chr3-101009319_101009421,cPa62,0.75,2,101009411,101009369,cPa62_cPa62-unknown,3_1,102,42
chr3-101153873_101153975,cPa363_cPa456,0.411764705882353,5,101153927,101153905,cPa363_cPa363-cPa117-hybrid_cPa456_cPa587-cPa117-hybrid_cPa587-cPa452-hybrid,7_1_7_1_1,102,22
chr3-101223524_101223626,cPa127_cPa241-cPa11-hybrid_cPa515_cPa540_cPa540-cPa290-hybrid,0.2,5,101223574,101223542,cPa127_cPa241-cPa11-hybrid_cPa515_cPa540_cPa540-cPa290-hybrid,1_1_1_1_1,102,32
chr3-101346407_101346518,cPa339,0.428571428571429,8,101346471,101346451,cPa339_cPa339-cPa444-hybrid_cPa390-cPa444-hybrid_cPa419_cPa447_cPa447-cPa353-hybrid_cPa447-cPa444-hybrid_cPa62-cPa444-hybrid,12_1_4_1_2_1_6_1,111,20
chr3-101373089_101373191,cPa255,0.428571428571429,3,101373152,101373120,cPa131_cPa255_cPa478,2_3_2,102,32
chr3-101427502_101427604,cPa246,0.8,2,101427570,101427510,cPa246_cPa302,4_1,102,60
chr3-101485199_101485306,HERV-W_repbase_HERV17_LTR17,1,1,101485263,101485213,HERV-W_repbase_HERV17_LTR17,6,107,50
chr3-101545028_101545130,cPa254,0.666666666666667,2,101545104,101545055,cPa254_cPa254-cPa188-hybrid,2_1,102,49
chr3-101556962_101557064,cPa131-cPa216-hybrid,0.75,2,101557056,101557012,cPa131-cPa216-hybrid_cPa255-cPa216-hybrid,3_1,102,44
chr3-101562046_101562148,cPa62,0.714285714285714,2,101562096,101562056,cPa285_cPa62,2_5,102,40
chr3-101616968_101617070,cPa205,1,1,101617028,101617005,cPa205,4,102,23
chr3-10177797_10177899,cPa75,0.952380952380952,2,10177897,10177847,cPa75_cPa75-unknown,20_1,102,50
chr3-101838929_101839031,cPa254,0.5,3,101838979,101838967,cPa174-cPa404-hybrid_cPa254_cPa47,1_3_2,102,12
chr3-101853231_101853335,cPa113-unknown,0.857142857142857,2,101853294,101853271,cPa113-unknown_cPa332-unknown,12_2,104,23
chr3-101871381_101871487,cPa15,0.666666666666667,5,101871468,101871422,cPa118-unknown_cPa15_cPa248-cPa118-hybrid_cPa248-cPa268-hybrid_cPa248-unknown,1_12_1_2_2,106,46
chr3-101918178_101918322,cPa152,0.448275862068966,6,101918318,101918228,cPa109_cPa109-cPa201-hybrid_cPa152_cPa152-cPa201-hybrid_cPa201_cPa505,3_1_13_1_5_6,144,90
chr3-101920073_101920175,cPa109,1,1,101920136,101920123,cPa109,2,102,13
chr3-101931271_101931373,cPa450,0.478260869565217,7,101931369,101931321,cPa199_cPa199-cPa227-hybrid_cPa199-cPa273-hybrid_cPa199-cPa553-hybrid_cPa199-unknown_cPa450_cPa553-cPa273-hybrid,2_1_5_2_1_11_1,102,48
chr3-102002139_102002241,cPa456-unknown,1,1,102002189,102002189,cPa456-unknown,1,102,0
chr3-102002265_102002456,cPa456-unknown,0.5,4,102002404,102002276,cPa456_cPa456-cPa526-hybrid_cPa456-HML4_repbase_HERVK13I_LTR13-hybrid_cPa456-unknown,4_1_1_6,191,128
chr3-102307935_102308037,cPa419,1,1,102307985,102307985,cPa419,1,102,0
chr3-102343740_102343842,cPa419,1,1,102343790,102343790,cPa419,1,102,0
chr3-102526345_102526447,cPa419,1,1,102526395,102526395,cPa419,1,102,0
chr3-102968772_102968876,cPa450,0.59375,8,102968835,102968820,cPa199-cPa542-hybrid_cPa223-cPa542-hybrid_cPa345-cPa450-hybrid_cPa345-cPa542-hybrid_cPa450_cPa482-cPa542-hybrid_cPa482-unknown_cPa553,1_1_1_1_19_2_1_6,104,15
chr3-103201357_103201459,cPa62-cPa75-hybrid,0.4,4,103201428,103201407,cPa62_cPa62-cPa75-hybrid_cPa62-HERV-W_repbase_HERV17_LTR17-hybrid_cPa62-unknown,1_2_1_1,102,21
chr3-103201637_103201973,cPa75,0.385416666666667,12,103201932,103201658,cPa293_cPa62_cPa62-cPa71-hybrid_cPa62-cPa75-hybrid_cPa62-unknown_cPa71_cPa75_HERV-E_repbase_HERVE_LTR2-cPa75-hybrid_HERV-W_repbase_HERV17_LTR17_KWERV_GQ222416_KWERV_GQ222416-cPa62-hybrid_KWERV_GQ222416-cPa75-hybrid,1_20_3_10_15_3_37_1_1_3_1_1,336,274
chr3-103202185_103202287,cPa62,0.714285714285714,2,103202241,103202233,cPa62_cPa75,5_2,102,8
chr3-103659691_103659793,cPa339_cPa447,0.3,5,103659741,103659727,cPa339_cPa390_cPa444-cPa62-hybrid_cPa444-unknown_cPa447,3_1_2_1_3,102,14
chr3-103665096_103665198,cPa419_cPa456,0.5,2,103665147,103665146,cPa419_cPa456,1_1,102,1
chr3-103817743_103818037,cPa62-unknown,0.625,3,103818037,103817757,cPa62-cPa75-hybrid_cPa62-unknown_cPa75,3_10_3,294,280
chr3-103847318_103847420,cPa75,0.347826086956522,7,103847368,103847317,cPa293_cPa62_cPa62-cPa293-hybrid_cPa62-cPa75-hybrid_cPa62-unknown_cPa75_PERVB_AY099324-cPa413-hybrid,2_5_3_2_2_8_1,102,51
chr3-103847532_103847634,cPa75,0.357142857142857,9,103847629,103847538,cPa113-cPa413-hybrid_cPa293_cPa62_cPa62-cPa293-hybrid_cPa62-cPa75-hybrid_cPa62-unknown_cPa75_cPa75-unknown_PERVA_AY099323,1_1_4_1_2_7_10_1_1,102,91
chr3-103855583_103855685,cPa174_cPa254_cPa404_cPa425,0.25,4,103855633,103855633,cPa174_cPa254_cPa404_cPa425,1_1_1_1,102,0
chr3-103876222_103876334,cPa363_cPa456_cPa75-cPa117-hybrid,0.333333333333333,3,103876282,103876272,cPa363_cPa456_cPa75-cPa117-hybrid,1_1_1,112,10
chr3-103961351_103961474,cPa75,0.523809523809524,7,103961433,103961354,cPa553-cPa113-hybrid_cPa62_cPa62-unknown_cPa75_cPa75-cPa228-hybrid_cPa75-unknown_HERV-W_repbase_HERV17_LTR17,1_2_3_11_1_2_1,123,79
chr3-103986004_103986106,HFV_NC001736,1,1,103986054,103986054,HFV_NC001736,1,102,0
chr3-104014505_104014607,cPa254-cPa75-hybrid,1,1,104014555,104014555,cPa254-cPa75-hybrid,1,102,0
chr3-104030889_104030998,cPa363_cPa452,0.333333333333333,5,104030976,104030934,cPa176_cPa363_cPa452_cPa452-unknown_cPa71,1_5_5_1_3,109,42
chr3-104049665_104049767,cPa419,1,1,104049715,104049715,cPa419,1,102,0
chr3-104068748_104068850,cPa62,0.6,2,104068849,104068762,cPa419_cPa62,2_3,102,87
chr3-10413666_10413768,cPa419,1,1,10413716,10413716,cPa419,1,102,0
chr3-104810771_104810873,cPa62,0.925,3,104810832,104810804,cPa285_cPa62_cPa62-unknown,1_37_2,102,28
chr3-104819448_104819550,cPa131,0.243243243243243,14,104819502,104819465,cPa131_cPa131-cPa255-hybrid_cPa216-cPa255-hybrid_cPa216-cPa479-hybrid_cPa255_cPa438-cPa131-hybrid_cPa438-cPa255-hybrid_cPa438-cPa479-hybrid_cPa438-unknown_cPa478_cPa478-cPa131-hybrid_cPa478-cPa255-hybrid_cPa478-unknown_cPa479,9_2_1_1_4_3_6_1_1_3_1_1_2_2,102,37
chr3-10493259_10493361,cPa199,1,1,10493309,10493286,cPa199,3,102,23
chr3-105032027_105032129,cPa220,1,1,105032077,105032068,cPa220,2,102,9
chr3-105042157_105042263,cPa104-cPa531-hybrid_cPa11_cPa127_cPa515_cPa540,0.2,5,105042211,105042207,cPa104-cPa531-hybrid_cPa11_cPa127_cPa515_cPa540,1_1_1_1_1,106,4
chr3-105203677_105203779,cPa62_cPa62-cPa75-hybrid,0.407407407407407,6,105203763,105203706,cPa113_cPa62_cPa62-cPa293-hybrid_cPa62-cPa413-hybrid_cPa62-cPa75-hybrid_cPa75,1_11_1_1_11_2,102,57
chr3-105260652_105260756,cPa4,0.916666666666667,2,105260704,105260662,cPa4_cPa541,11_1,104,42
chr3-105260864_105260966,cPa4,0.805970149253731,7,105260957,105260900,cPa4_cPa4-cPa14-hybrid_cPa4-unknown_cPa419-cPa14-hybrid_cPa541_cPa541-cPa14-hybrid_HML4_repbase_HERVK13I_LTR13-cPa14-hybrid,108_5_1_1_7_1_11,102,57
chr3-105261112_105261215,cPa4,0.833333333333333,2,105261163,105261150,cPa4_cPa541,5_1,103,13
chr3-105480914_105481198,cPa456,0.65,9,105481146,105480936,cPa117-cPa363-hybrid_cPa117-cPa456-hybrid_cPa117-cPa587-hybrid_cPa117-unknown_cPa363_cPa456_cPa456-cPa363-hybrid_cPa456-cPa587-hybrid_cPa456-unknown,3_2_3_2_1_26_1_1_1,284,210
chr3-105527992_105528094,cPa387,1,1,105528042,105528042,cPa387,1,102,0
chr3-10554243_10554345,cPa62,0.875,3,10554297,10554281,cPa254_cPa254-cPa62-hybrid_cPa62,1_1_14,102,16
chr3-105553282_105553384,cPa419_cPa71,0.5,2,105553345,105553332,cPa419_cPa71,1_1,102,13
chr3-105619161_105619311,HERV-W_repbase_HERV17_LTR17,0.529411764705882,5,105619292,105619165,cPa62_cPa75_cPa75-cPa62-hybrid_HERV-W_repbase_HERV17_LTR17_HERV-W_repbase_HERV17_LTR17-unknown,2_2_2_9_2,150,127
chr3-105619397_105619789,HERV-W_repbase_HERV17_LTR17,0.790123456790123,7,105619761,105619403,cPa450-HERV-W_repbase_HERV17_LTR17-hybrid_cPa62_cPa62-unknown_cPa75_HERV-W_repbase_HERV17_LTR17_HERV-W_repbase_HERV17_LTR17-cPa75-hybrid_HERV-W_repbase_HERV17_LTR17-unknown,1_5_2_6_64_1_2,392,358
chr3-105622202_105622304,cPa241,0.241935483870968,19,105622285,105622201,cPa11_cPa11-cPa515-hybrid_cPa127_cPa241_cPa290_cPa290-cPa531-hybrid_cPa419-cPa531-hybrid_cPa515_cPa515-cPa531-hybrid_cPa530_cPa530-cPa11-hybrid_cPa530-cPa127-hybrid_cPa530-cPa241-hybrid_cPa530-cPa290-hybrid_cPa530-cPa515-hybrid_cPa530-cPa531-hybrid_cPa530-unknown_cPa540_cPa540-cPa241-hybrid,2_1_11_15_3_1_1_8_1_3_1_2_1_1_1_1_3_4_2,102,84
chr3-105653452_105653554,cPa62,0.96875,2,105653521,105653495,cPa62_cPa62-unknown,31_1,102,26
chr3-10590061_10590163,cPa117,0.666666666666667,2,10590111,10590093,cPa117_cPa539-unknown,2_1,102,18
chr3-105920903_105921005,cPa228_cPa228-cPa158-hybrid_cPa228-PERV_AJ293656-hybrid,0.333333333333333,3,105920953,105920945,cPa228_cPa228-cPa158-hybrid_cPa228-PERV_AJ293656-hybrid,1_1_1,102,8
chr3-105944886_105944992,cPa425,0.266666666666667,7,105944978,105944918,cPa174_cPa174-cPa47-hybrid_cPa254_cPa254-cPa174-hybrid_cPa254-cPa47-hybrid_cPa425_cPa47,3_2_2_1_1_4_2,106,60
chr3-106045091_106045193,cPa456,0.3,10,106045176,106045093,cPa363_cPa363-cPa117-hybrid_cPa363-cPa452-hybrid_cPa456_cPa456-cPa452-hybrid_cPa563-cPa117-hybrid_cPa563-cPa363-hybrid_cPa563-cPa452-hybrid_cPa587-cPa363-hybrid_cPa75-cPa363-hybrid,3_1_5_9_1_3_1_5_1_1,102,83
chr3-106201896_106201998,cPa75-cPa62-hybrid,0.454545454545455,4,106201951,106201904,cPa118_cPa15_cPa62_cPa75-cPa62-hybrid,2_2_2_5,102,47
chr3-106251835_106251937,cPa363_cPa456_FeLV_NC001940-cPa257-hybrid,0.333333333333333,3,106251885,106251885,cPa363_cPa456_FeLV_NC001940-cPa257-hybrid,1_1_1,102,0
chr3-106347488_106347590,HERV-F_repbase_HERVFH19I_LTR19A,1,1,106347538,106347515,HERV-F_repbase_HERVFH19I_LTR19A,8,102,23
chr3-106432969_106433170,cPa75_cPa75-cPa62-hybrid,0.375,4,106433118,106433019,cPa419_cPa62_cPa75_cPa75-cPa62-hybrid,1_1_3_3,201,99
chr3-106433217_106433319,cPa75,0.428571428571429,4,106433280,106433251,cPa413-cPa62-hybrid_cPa62_cPa75_cPa75-cPa62-hybrid,1_1_3_2,102,29
chr3-106433441_106433684,cPa75-cPa62-hybrid,0.619047619047619,5,106433660,106433459,cPa413-cPa62-hybrid_cPa62_cPa71-cPa62-hybrid_cPa75_cPa75-cPa62-hybrid,1_2_1_4_13,243,201
chr3-107077945_107078047,cPa392,0.833333333333333,2,107078046,107077994,cPa392_cPa392-unknown,5_1,102,52
chr3-107078114_107078286,cPa392,0.928571428571429,3,107078245,107078153,cPa392_cPa392-cPa163-hybrid_cPa392-cPa587-hybrid,26_1_1,172,92
chr3-107078489_107078593,cPa392,1,1,107078587,107078511,cPa392,12,104,76
chr3-107078657_107078976,cPa392,1,1,107078970,107078687,cPa392,17,319,283
chr3-107079042_107079180,cPa392,1,1,107079128,107079092,cPa392,2,138,36
chr3-107080914_107081016,cPa392,0.75,2,107080964,107080947,cPa392_cPa419,3_1,102,17
chr3-107081870_107081972,cPa392,1,1,107081926,107081874,cPa392,3,102,52
chr3-107086021_107086123,cPa413-cPa270-hybrid_cPa419,0.5,2,107086078,107086071,cPa413-cPa270-hybrid_cPa419,1_1,102,7
chr3-107086381_107086557,cPa270,0.8,3,107086516,107086422,cPa270_cPa419_Xen1_AJ506107,8_1_1,176,94
chr3-107091742_107091850,cPa293_cPa391,0.5,2,107091798,107091792,cPa293_cPa391,1_1,108,6
chr3-107096205_107096307,cPa543-cPa419-hybrid,1,1,107096255,107096255,cPa543-cPa419-hybrid,1,102,0
chr3-107135453_107135555,cPa363_cPa456,0.4,3,107135512,107135501,cPa363_cPa456_cPa75-cPa452-hybrid,2_2_1,102,11
chr3-10737100_10737217,cPa62,0.923076923076923,2,10737190,10737150,cPa62_cPa62-unknown,24_2,117,40
chr3-107393728_107393834,cPa62,0.884615384615385,3,107393784,107393777,cPa254-cPa62-hybrid_cPa254-unknown_cPa62,1_2_23,106,7
chr3-107395106_107395439,cPa75-cPa62-hybrid,0.444444444444444,6,107395387,107395156,cPa71_cPa71-cPa62-hybrid_cPa75_cPa75-cPa62-hybrid_HERV-W_repbase_HERV17_LTR17_HERV-W_repbase_HERV17_LTR17-cPa62-hybrid,1_3_4_8_1_1,333,231
chr3-107395456_107396104,cPa75-cPa62-hybrid,0.548780487804878,7,107396071,107395458,cPa62_cPa71-cPa62-hybrid_cPa75_cPa75-cPa62-hybrid_cPa75-unknown_HERV-W_repbase_HERV17_LTR17_HERV-W_repbase_HERV17_LTR17-cPa62-hybrid,4_14_13_45_1_4_1,648,613
chr3-107396391_107396493,HERV-W_repbase_HERV17_LTR17,1,1,107396441,107396441,HERV-W_repbase_HERV17_LTR17,1,102,0
chr3-107575206_107575320,cPa391,0.285714285714286,7,107575273,107575229,cPa287-cPa293-hybrid_cPa287-cPa426-hybrid_cPa287-unknown_cPa293_cPa293-cPa426-hybrid_cPa391_cPa426,1_1_2_3_1_4_2,114,44
chr3-107645530_107645632,cPa62,1,1,107645580,107645580,cPa62,1,102,0
chr3-107651123_107651225,cPa419,1,1,107651173,107651173,cPa419,1,102,0
chr3-107770034_107770136,cPa456,0.481481481481481,11,107770126,107770041,cPa117-cPa363-hybrid_cPa117-cPa456-hybrid_cPa117-cPa587-hybrid_cPa117-unknown_cPa363_cPa363-cPa456-hybrid_cPa452-cPa363-hybrid_cPa452-cPa456-hybrid_cPa452-cPa587-hybrid_cPa452-unknown_cPa456,4_3_1_2_19_1_4_2_1_5_39,102,85
chr3-108026555_108026657,cPa529,1,1,108026605,108026605,cPa529,1,102,0
chr3-108281889_108281991,cPa260,0.833333333333333,3,108281978,108281903,cPa260_cPa260-cPa75-hybrid_cPa260-unknown,10_1_1,102,75
chr3-108469508_108469610,cPa118,1,1,108469558,108469558,cPa118,1,102,0
chr3-108522399_108522519,cPa62,1,1,108522467,108522426,cPa62,7,120,41
chr3-108555868_108555970,cPa62,1,1,108555918,108555918,cPa62,1,102,0
chr3-108556072_108556179,cPa62,0.795454545454545,4,108556127,108556102,cPa285_cPa285-unknown_cPa62_cPa62-unknown,3_1_35_5,107,25
chr3-108616012_108616134,cPa62,1,1,108616082,108616058,cPa62,14,122,24
chr3-108625432_108625534,cPa62,0.6,4,108625528,108625476,cPa254_cPa62_cPa62-cPa75-hybrid_cPa62-unknown,1_6_2_1,102,52
chr3-108634545_108634647,HERV-W_repbase_HERV17_LTR17,0.375,4,108634647,108634573,cPa62-HERV-W_repbase_HERV17_LTR17-hybrid_cPa62-unknown_HERV-W_repbase_HERV17_LTR17_KoRV_AF151794,2_2_3_1,102,74
chr3-108634788_108634890,HERV-W_repbase_HERV17_LTR17,0.555555555555556,5,108634890,108634793,cPa62-HERV-W_repbase_HERV17_LTR17-hybrid_cPa62-unknown_cPa75-unknown_HERV-W_repbase_HERV17_LTR17_S71_repbase_HERVS71_LTR6A,1_1_1_5_1,102,97
chr3-108634914_108635119,HERV-W_repbase_HERV17_LTR17,0.553571428571429,8,108635117,108634921,cPa62_cPa62-cPa75-hybrid_cPa62-HERV-W_repbase_HERV17_LTR17-hybrid_cPa62-unknown_cPa75_cPa75-unknown_HERV-W_repbase_HERV17_LTR17_HERV-W_repbase_HERV17_LTR17-cPa75-hybrid,1_1_7_11_3_1_31_1,205,196
chr3-108642985_108643087,cPa419,1,1,108643035,108643035,cPa419,1,102,0
chr3-108700001_108700194,cPa16,1,1,108700142,108700051,cPa16,2,193,91
chr3-108722010_108722112,cPa117-cPa62-hybrid_cPa62,0.5,2,108722060,108722046,cPa117-cPa62-hybrid_cPa62,1_1,102,14
chr3-108731311_108731616,HERV-W_repbase_HERV17_LTR17,0.8,6,108731613,108731356,cPa62_cPa67_cPa75_cPa75-unknown_HERV-W_repbase_HERV17_LTR17_HERV-W_repbase_HERV17_LTR17-unknown,2_1_1_2_32_2,305,257
chr3-108731723_108731825,HERV-W_repbase_HERV17_LTR17,0.933333333333333,2,108731823,108731737,HERV-W_repbase_HERV17_LTR17_HERV-W_repbase_HERV17_LTR17-unknown,14_1,102,86
chr3-108731851_108731953,HERV-W_repbase_HERV17_LTR17,1,1,108731938,108731851,HERV-W_repbase_HERV17_LTR17,7,102,87
chr3-108832201_108832330,cPa260,0.5,3,108832300,108832243,cPa260_cPa260-unknown_WDSV_NC001867,2_1_1,129,57
chr3-108911537_108911932,cPa62,0.939393939393939,3,108911880,108911539,cPa419_cPa62_cPa62-unknown,1_31_1,395,341
chr3-109116564_109116707,cPa75-cPa62-hybrid,0.375,5,109116699,109116577,cPa62_cPa71-cPa62-hybrid_cPa75-cPa62-hybrid_cPa75-HERV-W_repbase_HERV17_LTR17-hybrid_KWERV_GQ222416,2_1_3_1_1,143,122
chr3-109131099_109131226,cPa75,0.48,6,109131226,109131147,cPa62_cPa62-cPa75-hybrid_cPa62-HERV-W_repbase_HERV17_LTR17-hybrid_cPa62-unknown_cPa75_HERV-W_repbase_HERV17_LTR17,1_2_1_8_12_1,127,79
chr3-109131337_109131439,cPa75,0.6,4,109131418,109131340,cPa62_cPa62-cPa75-hybrid_cPa62-unknown_cPa75,1_3_2_9,102,78
chr3-109142316_109142418,cPa75,1,1,109142366,109142366,cPa75,1,102,0
chr3-109519967_109520077,cPa339,0.4,5,109520025,109519972,cPa339_cPa444-cPa390-hybrid_cPa444-cPa447-hybrid_cPa444-unknown_cPa447,4_2_2_1_1,110,53
chr3-109550174_109550276,WDSV_NC001867,1,1,109550224,109550224,WDSV_NC001867,1,102,0
chr3-109716871_109716981,cPa62,0.571428571428571,4,109716929,109716915,cPa285_cPa62_cPa62-cPa285-hybrid_cPa62-unknown,1_4_1_1,110,14
chr3-109796326_109796555,cPa62,0.673076923076923,5,109796533,109796326,cPa62_cPa62-cPa285-hybrid_cPa62-cPa75-hybrid_cPa62-unknown_cPa75,35_1_6_2_8,229,207
chr3-109895420_109895522,cPa75,0.5,14,109895508,109895427,cPa285_cPa285-cPa293-hybrid_cPa293_cPa293-cPa285-hybrid_cPa293-cPa75-hybrid_cPa293-unknown_cPa62-cPa285-hybrid_cPa62-cPa293-hybrid_cPa62-cPa75-hybrid_cPa75_cPa75-cPa285-hybrid_PERV_AJ293656-cPa285-hybrid_PERV_AJ293656-cPa293-hybrid_PERVC_HM159246-cPa75-hybrid,1_1_5_1_1_1_1_1_1_17_1_1_1_1,102,81
chr3-109926208_109926310,cPa452_cPa456,0.4,3,109926261,109926258,cPa363_cPa452_cPa456,1_2_2,102,3
chr3-109969440_109969542,cPa62,0.971428571428571,2,109969534,109969456,cPa62_cPa62-unknown,34_1,102,78
chr3-110003576_110003819,cPa62-unknown,0.407407407407407,5,110003778,110003576,cPa62_cPa62-cPa75-hybrid_cPa62-unknown_cPa75_HERV-W_repbase_HERV17_LTR17-unknown,1_9_11_5_1,243,202
chr3-110104651_110104755,HERV-W_repbase_HERV17_LTR17,0.9375,2,110104746,110104650,HERV-W_repbase_HERV17_LTR17_HERV-W_repbase_HERV17_LTR17-unknown,15_1,104,96
chr3-110104807_110104924,HERV-W_repbase_HERV17_LTR17,1,1,110104920,110104813,HERV-W_repbase_HERV17_LTR17,17,117,107
chr3-110119383_110119485,cPa260_PERVE_NC003059,0.5,2,110119433,110119433,cPa260_PERVE_NC003059,1_1,102,0
chr3-110124601_110124703,cPa62,0.862068965517241,5,110124700,110124622,cPa254_cPa293_cPa293-cPa285-hybrid_cPa62_cPa62-unknown,1_2_1_50_4,102,78
chr3-110224429_110224531,HERV-W_repbase_HERV17_LTR17,0.48,5,110224508,110224437,cPa75_HERV-W_repbase_HERV17_LTR17_HERV-W_repbase_HERV17_LTR17-cPa62-hybrid_HERV-W_repbase_HERV17_LTR17-cPa75-hybrid_HERV-W_repbase_HERV17_LTR17-unknown,5_12_5_1_2,102,71
chr3-110307667_110307769,cPa62,1,1,110307745,110307717,cPa62,2,102,28
chr3-110397184_110397286,cPa113-cPa75-hybrid,0.777777777777778,3,110397285,110397228,cPa113-cPa75-hybrid_cPa113-unknown_cPa67-unknown,7_1_1,102,57
chr3-110464486_110464592,cPa62,1,1,110464542,110464526,cPa62,46,106,16
chr3-110741074_110741265,cPa75,1,1,110741213,110741124,cPa75,6,191,89
chr3-110741273_110741375,cPa75,1,1,110741323,110741316,cPa75,3,102,7
chr3-110888061_110888163,cPa539,0.666666666666667,2,110888111,110888092,cPa119-cPa539-hybrid_cPa539,1_2,102,19
chr3-110929420_110929522,cPa62,0.84375,4,110929521,110929428,cPa293_cPa62_cPa62-cPa293-hybrid_cPa62-unknown,3_27_1_1,102,93
chr3-110968328_110968442,HFV_NC001736-unknown,0.666666666666667,3,110968390,110968378,cPa419_HFV_NC001736-cPa157-hybrid_HFV_NC001736-unknown,1_3_8,114,12
chr3-110999033_110999135,cPa62,1,1,110999084,110999074,cPa62,6,102,10
chr3-111167906_111168008,cPa75-HERV-W_repbase_HERV17_LTR17-hybrid,1,1,111167956,111167913,cPa75-HERV-W_repbase_HERV17_LTR17-hybrid,6,102,43
chr3-111207523_111207625,cPa246,0.555555555555556,3,111207573,111207561,cPa246_cPa302-cPa246-hybrid_cPa302-unknown,5_1_3,102,12
chr3-111237176_111237278,cPa260-cPa75-hybrid,0.666666666666667,2,111237227,111237176,cPa260-cPa75-hybrid_cPa260-unknown,4_2,102,51
chr3-111302690_111303037,WDSV_NC001867-cPa62-hybrid,0.461538461538462,12,111303028,111302691,cPa118-cPa62-hybrid_cPa16-cPa62-hybrid_cPa248-cPa62-hybrid_cPa486-cPa62-hybrid_cPa566-cPa62-hybrid_cPa62_WDSV_NC001867_WDSV_NC001867-cPa118-hybrid_WDSV_NC001867-cPa254-hybrid_WDSV_NC001867-cPa486-hybrid_WDSV_NC001867-cPa62-hybrid_WDSV_NC001867-unknown,1_1_3_2_1_11_7_1_1_1_30_6,347,337
chr3-111306571_111306673,WDSV_NC001867,1,1,111306621,111306621,WDSV_NC001867,1,102,0
chr3-111315043_111315145,cPa199_cPa273-unknown,0.5,2,111315093,111315049,cPa199_cPa273-unknown,1_1,102,44
chr3-111315154_111315256,cPa505,0.75,2,111315241,111315162,cPa199_cPa505,1_3,102,79
chr3-111325743_111325845,cPa260,1,1,111325827,111325793,cPa260,2,102,34
chr3-111377146_111377248,cPa62,1,1,111377196,111377188,cPa62,2,102,8
chr3-111377262_111377463,cPa62,1,1,111377432,111377262,cPa62,11,201,170
chr3-111377682_111377784,cPa62,1,1,111377732,111377732,cPa62,1,102,0
chr3-111377912_111378096,cPa62,1,1,111378059,111377918,cPa62,5,184,141
chr3-111378849_111378951,cPa74,1,1,111378899,111378899,cPa74,1,102,0
chr3-111405264_111405366,cPa419,1,1,111405314,111405314,cPa419,1,102,0
chr3-111417860_111417962,WDSV_NC001867,0.666666666666667,2,111417931,111417910,WDSV_NC001867_WDSV_NC001867-cPa539-hybrid,2_1,102,21
chr3-111417983_111418114,WDSV_NC001867-cPa62-hybrid,0.428571428571429,4,111418101,111418010,cPa62_WDSV_NC001867_WDSV_NC001867-cPa62-hybrid_WDSV_NC001867-HML2_Pheonix-hybrid,1_2_3_1,131,91
chr3-111418942_111419124,cPa492,0.555555555555556,4,111419108,111418952,cPa199_cPa482_cPa492_cPa505,1_5_10_2,182,156
chr3-111419150_111419252,cPa482,0.428571428571429,4,111419244,111419200,cPa199_cPa482_cPa482-cPa505-hybrid_cPa492,1_3_1_2,102,44
chr3-111424623_111425140,cPa62-unknown,0.563636363636364,8,111425110,111424645,cPa293_cPa62_cPa62-cPa293-hybrid_cPa62-cPa413-hybrid_cPa62-cPa75-hybrid_cPa62-unknown_cPa62-WDSV_NC001867-hybrid_cPa75,1_2_8_2_7_31_1_3,517,465
chr3-111456338_111456440,cPa75,1,1,111456415,111456388,cPa75,2,102,27
chr3-111466645_111466836,cPa109,0.734375,9,111466811,111466666,cPa109_cPa109-cPa174-hybrid_cPa109-cPa539-hybrid_cPa109-unknown_cPa199_cPa201-cPa199-hybrid_cPa539_cPa539-cPa109-hybrid_cPa539-unknown,47_1_2_4_1_1_4_3_1,191,145
chr3-111466847_111466966,cPa109,1,1,111466914,111466897,cPa109,2,119,17
chr3-111467884_111468033,cPa174_cPa254_cPa47-cPa174-hybrid,0.333333333333333,3,111468028,111467934,cPa174_cPa254_cPa47-cPa174-hybrid,1_1_1,149,94
chr3-111469648_111469883,cPa75-unknown,0.236559139784946,17,111469855,111469649,cPa260_cPa260-unknown_cPa285-cPa260-hybrid_cPa285-cPa62-hybrid_cPa293_cPa293-cPa260-hybrid_cPa293-cPa62-hybrid_cPa293-unknown_cPa413_cPa413-cPa62-hybrid_cPa62_cPa75_cPa75-cPa260-hybrid_cPa75-cPa293-hybrid_cPa75-cPa62-hybrid_cPa75-unknown_PERVC_HM159246,7_1_1_1_9_1_5_3_1_1_15_14_2_1_7_22_2,235,206
chr3-111485460_111485562,cPa15,1,1,111485510,111485510,cPa15,1,102,0
chr3-111485711_111485895,cPa15,1,1,111485843,111485761,cPa15,6,184,82
chr3-111502992_111503194,cPa75,1,1,111503142,111503005,cPa75,3,202,137
chr3-111503292_111503442,cPa75,1,1,111503390,111503342,cPa75,3,150,48
chr3-111503450_111503552,cPa125-cPa71-hybrid_cPa71_cPa75-unknown,0.333333333333333,3,111503500,111503472,cPa125-cPa71-hybrid_cPa71_cPa75-unknown,1_1_1,102,28
chr3-111503617_111503719,cPa75,1,1,111503667,111503667,cPa75,1,102,0
chr3-111504037_111504279,cPa75,1,1,111504227,111504087,cPa75,4,242,140
chr3-111504411_111504513,cPa62-cPa75-hybrid,1,1,111504461,111504461,cPa62-cPa75-hybrid,1,102,0
chr3-111504538_111504640,cPa75,1,1,111504588,111504588,cPa75,1,102,0
chr3-111504995_111505097,cPa62-cPa75-hybrid,1,1,111505045,111505045,cPa62-cPa75-hybrid,1,102,0
chr3-111505107_111505311,cPa75,0.6,2,111505259,111505157,cPa62-cPa75-hybrid_cPa75,2_3,204,102
chr3-111511979_111512081,cPa75,1,1,111512029,111512029,cPa75,1,102,0
chr3-111547771_111547873,cPa75,1,1,111547821,111547821,cPa75,1,102,0
chr3-111563750_111563885,cPa75,0.833333333333333,2,111563833,111563781,cPa62-unknown_cPa75,1_5,135,52
chr3-111566624_111566726,cPa75,1,1,111566674,111566674,cPa75,1,102,0
chr3-111567335_111567505,cPa75,1,1,111567453,111567385,cPa75,2,170,68
chr3-111567525_111567627,cPa75,1,1,111567575,111567575,cPa75,1,102,0
chr3-111606230_111606354,cPa75_EqFV_NC002201-unknown,0.2,8,111606326,111606267,cPa119-cPa67-hybrid_cPa285-cPa392-hybrid_cPa381-unknown_cPa67_cPa67-unknown_cPa75_cPa75-unknown_EqFV_NC002201-unknown,1_1_1_1_1_2_1_2,124,59
chr3-111662484_111662586,cPa75,1,1,111662534,111662534,cPa75,1,102,0
chr3-111668082_111668184,cPa75-unknown,1,1,111668132,111668132,cPa75-unknown,1,102,0
chr3-111668508_111668764,cPa75-unknown,0.875,2,111668712,111668558,cPa75-cPa523-hybrid_cPa75-unknown,1_7,256,154
chr3-111733851_111733953,cPa273,1,1,111733901,111733901,cPa273,1,102,0
chr3-111736723_111736825,cPa360_HTLV2_M10060_HTLV2_M10060-unknown,0.333333333333333,3,111736791,111736773,cPa360_HTLV2_M10060_HTLV2_M10060-unknown,1_1_1,102,18
chr3-111745251_111745382,cPa75,1,1,111745335,111745301,cPa75,3,131,34
chr3-111745600_111745702,cPa75,1,1,111745650,111745650,cPa75,1,102,0
chr3-111761455_111761557,cPa75,1,1,111761505,111761505,cPa75,1,102,0
chr3-111772860_111772962,cPa75,1,1,111772958,111772910,cPa75,2,102,48
chr3-111773271_111773505,cPa75,0.666666666666667,2,111773453,111773321,cPa75_cPa75-unknown,2_1,234,132
chr3-111773588_111773697,cPa75,0.555555555555556,2,111773674,111773590,cPa75_cPa75-unknown,5_4,109,84
chr3-111775842_111775944,cPa523-cPa107-hybrid,1,1,111775892,111775892,cPa523-cPa107-hybrid,1,102,0
chr3-111854670_111854772,HFV_NC001736,1,1,111854720,111854720,HFV_NC001736,1,102,0
chr3-111862846_111862948,cPa75-unknown,1,1,111862896,111862896,cPa75-unknown,1,102,0
chr3-111902905_111903007,cPa62,1,1,111902955,111902955,cPa62,1,102,0
chr3-111903489_111903591,cPa62,1,1,111903539,111903539,cPa62,1,102,0
chr3-111920499_111920601,cPa75,0.888888888888889,2,111920601,111920549,cPa75_cPa75-unknown,8_1,102,52
chr3-111923239_111923437,cPa75-unknown,0.307692307692308,8,111923385,111923276,cPa285_cPa285-cPa381-hybrid_cPa285-unknown_cPa419_cPa75_cPa75-cPa381-hybrid_cPa75-S71_repbase_HERVS71_LTR6A-hybrid_cPa75-unknown,2_1_1_1_2_1_1_4,198,109
chr3-111923504_111923726,cPa285_cPa285-cPa260-hybrid_cPa285-S71_repbase_HERVS71_LTR6A-hybrid_cPa75_cPa75-unknown,0.2,5,111923674,111923554,cPa285_cPa285-cPa260-hybrid_cPa285-S71_repbase_HERVS71_LTR6A-hybrid_cPa75_cPa75-unknown,1_1_1_1_1,222,120
chr3-111923731_111923997,cPa75-unknown,0.3125,8,111923945,111923781,cPa168-cPa381-hybrid_cPa285_cPa285-cPa168-hybrid_cPa285-cPa260-hybrid_cPa285-cPa381-hybrid_cPa75-cPa168-hybrid_cPa75-cPa260-hybrid_cPa75-unknown,1_1_2_1_2_3_1_5,266,164
chr3-111932055_111932157,cPa360,0.846153846153846,5,111932153,111932063,cPa247_cPa360_cPa545_cPa62_cPa62-cPa434-hybrid,1_22_1_1_1,102,90
chr3-111932170_111932386,cPa360-cPa75-hybrid,0.35,8,111932361,111932173,cPa247_cPa247-cPa75-hybrid_cPa360_cPa360-cPa75-hybrid_cPa392-cPa75-hybrid_cPa545_cPa545-cPa75-hybrid_cPa62-cPa75-hybrid,1_1_4_7_2_1_2_2,216,188
chr3-111942420_111942536,cPa285,1,1,111942484,111942470,cPa285,2,116,14
chr3-111950288_111950390,cPa75,1,1,111950338,111950292,cPa75,4,102,46
chr3-111958726_111958828,cPa71,1,1,111958827,111958762,cPa71,3,102,65
chr3-111958904_111959033,cPa71,1,1,111958981,111958905,cPa71,8,129,76
chr3-111959192_111959294,cPa71,1,1,111959242,111959242,cPa71,1,102,0
chr3-111977466_111977568,cPa75,1,1,111977516,111977516,cPa75,1,102,0
chr3-112001031_112001228,cPa75,1,1,112001176,112001073,cPa75,6,197,103
chr3-112001686_112001788,cPa75,1,1,112001736,112001728,cPa75,3,102,8
chr3-112001805_112001907,cPa75,1,1,112001855,112001855,cPa75,1,102,0
chr3-112008425_112008527,cPa452-cPa117-hybrid,1,1,112008475,112008475,cPa452-cPa117-hybrid,1,102,0
chr3-112008537_112008693,cPa117,1,1,112008641,112008587,cPa117,2,156,54
chr3-112008830_112008932,cPa117,1,1,112008880,112008880,cPa117,1,102,0
chr3-112008954_112009056,cPa117,1,1,112009004,112009004,cPa117,1,102,0
chr3-112009070_112009172,cPa117-cPa452-hybrid,1,1,112009120,112009120,cPa117-cPa452-hybrid,1,102,0
chr3-112009199_112009301,cPa117,1,1,112009249,112009249,cPa117,1,102,0
chr3-112009444_112009546,cPa117,1,1,112009494,112009494,cPa117,1,102,0
chr3-112030323_112030496,cPa260_cPa527,0.4,3,112030485,112030373,cPa260_cPa260-unknown_cPa527,2_1_2,173,112
chr3-112073984_112074086,cPa539-unknown,0.846153846153846,2,112074042,112074032,cPa539-cPa157-hybrid_cPa539-unknown,2_11,102,10
chr3-112089727_112089829,cPa75-unknown,1,1,112089777,112089777,cPa75-unknown,2,102,0
chr3-112089957_112090135,cPa75_cPa75-unknown,0.5,2,112090083,112090007,cPa75_cPa75-unknown,1_1,178,76
chr3-112102110_112102235,cPa486-cPa62-hybrid,0.384615384615385,6,112102232,112102153,cPa381_cPa381-cPa62-hybrid_cPa381-unknown_cPa486-cPa62-hybrid_cPa486-unknown_cPa62,2_3_1_5_1_1,125,79
chr3-112113367_112113469,cPa75,1,1,112113417,112113417,cPa75,1,102,0
chr3-112123497_112123637,WDSV_NC001867,0.695652173913043,5,112123627,112123518,cPa381_cPa62_cPa62-unknown_cPa62-WDSV_NC001867-hybrid_WDSV_NC001867,1_3_12_5_48,140,109
chr3-112138640_112138742,HML8_repbase_HERVK11I_MER11A,1,1,112138690,112138690,HML8_repbase_HERVK11I_MER11A,2,102,0
chr3-112170063_112170192,cPa75,1,1,112170140,112170113,cPa75,8,129,27
chr3-112170690_112170875,cPa75,1,1,112170823,112170693,cPa75,6,185,130
chr3-112182211_112182322,cPa62,0.8,2,112182270,112182255,cPa62_cPa62-cPa75-hybrid,4_1,111,15
chr3-112185519_112185621,cPa75,1,1,112185569,112185519,cPa75,3,102,50
chr3-112187439_112187541,cPa75,1,1,112187489,112187486,cPa75,2,102,3
chr3-112187614_112187783,cPa75,1,1,112187731,112187640,cPa75,7,169,91
chr3-112299006_112299108,cPa16,0.5,3,112299079,112299044,cPa16_cPa379_cPa71,2_1_1,102,35
chr3-112299213_112299315,cPa16_cPa71,0.5,2,112299275,112299263,cPa16_cPa71,1_1,102,12
chr3-112379672_112379867,cPa75,0.666666666666667,2,112379815,112379722,cPa75_cPa75-unknown,2_1,195,93
chr3-112394753_112394855,cPa75_cPa75-cPa293-hybrid,0.5,2,112394832,112394803,cPa75_cPa75-cPa293-hybrid,1_1,102,29
chr3-112395137_112395672,cPa75,0.826666666666667,6,112395638,112395187,cPa285_cPa62_cPa62-cPa293-hybrid_cPa75_cPa75-cPa293-hybrid_cPa75-cPa62-hybrid,3_7_1_62_1_1,535,451
chr3-112423914_112424016,cPa75,1,1,112423964,112423964,cPa75,1,102,0
chr3-112431471_112431587,cPa190-cPa220-hybrid,1,1,112431535,112431521,cPa190-cPa220-hybrid,2,116,14
chr3-112431943_112432045,cPa190-cPa75-hybrid,1,1,112431993,112431993,cPa190-cPa75-hybrid,1,102,0
chr3-112446245_112446347,cPa75-cPa205-hybrid,1,1,112446295,112446295,cPa75-cPa205-hybrid,1,102,0
chr3-112446446_112446548,cPa75-cPa205-hybrid,1,1,112446496,112446496,cPa75-cPa205-hybrid,1,102,0
chr3-112446645_112446760,cPa75-cPa205-hybrid,0.8,2,112446708,112446695,cPa75_cPa75-cPa205-hybrid,1_4,115,13
chr3-112458780_112458882,cPa75,1,1,112458830,112458830,cPa75,1,102,0
chr3-112458985_112459107,cPa75,1,1,112459055,112459035,cPa75,3,122,20
chr3-112459142_112459293,cPa75,1,1,112459241,112459192,cPa75,3,151,49
chr3-112459380_112459482,cPa75,1,1,112459430,112459430,cPa75,1,102,0
chr3-112460124_112460226,cPa75,1,1,112460174,112460174,cPa75,1,102,0
chr3-112460325_112460427,cPa75,1,1,112460375,112460375,cPa75,1,102,0
chr3-112465459_112465561,cPa75,1,1,112465509,112465509,cPa75,1,102,0
chr3-112465612_112465715,cPa75,1,1,112465663,112465662,cPa75,2,103,1
chr3-112465857_112466153,cPa75,1,1,112466101,112465907,cPa75,6,296,194
chr3-112477624_112477796,cPa75-unknown,1,1,112477744,112477674,cPa75-unknown,2,172,70
chr3-112494131_112494233,cPa356-HML4_repbase_HERVK13I_LTR13-hybrid,0.692307692307692,4,112494181,112494181,cPa356-cPa199-hybrid_cPa356-cPa529-hybrid_cPa356-HML4_repbase_HERVK13I_LTR13-hybrid_cPa75-HML4_repbase_HERVK13I_LTR13-hybrid,2_1_9_1,102,0
chr3-112494999_112495101,cPa256-cPa419-hybrid_cPa308-cPa199-hybrid_cPa419,0.333333333333333,3,112495065,112495017,cPa256-cPa419-hybrid_cPa308-cPa199-hybrid_cPa419,1_1_1,102,48
chr3-112541235_112541441,cPa75,0.615384615384615,5,112541389,112541285,cPa256-cPa60-hybrid_cPa256-cPa71-hybrid_cPa394-cPa60-hybrid_cPa75_PERVB_AY099324-cPa75-hybrid,2_1_1_8_1,206,104
chr3-112541589_112541691,cPa75,0.285714285714286,7,112541639,112541638,cPa256-cPa60-hybrid_cPa256-cPa71-hybrid_cPa394-cPa60-hybrid_cPa402-cPa75-hybrid_cPa544-cPa363-hybrid_cPa544-cPa60-hybrid_cPa75,1_1_1_1_3_3_4,102,1
chr3-112584020_112584122,cPa260,1,1,112584109,112584020,cPa260,8,102,89
chr3-112607511_112607613,cPa75,1,1,112607563,112607544,cPa75,7,102,19
chr3-112607693_112607795,cPa75,1,1,112607743,112607717,cPa75,3,102,26
chr3-112625466_112625568,cPa260,1,1,112625516,112625495,cPa260,3,102,21
chr3-112674107_112674209,rRVRV_JQ303225,1,1,112674195,112674157,rRVRV_JQ303225,2,102,38
chr3-112685626_112685728,cPa75,1,1,112685676,112685676,cPa75,1,102,0
chr3-112711763_112711865,cPa394,0.5,3,112711817,112711806,cPa339_cPa362-cPa394-hybrid_cPa394,4_1_5,102,11
chr3-112711896_112711998,cPa339,1,1,112711946,112711946,cPa339,1,102,0
chr3-112745078_112745180,cPa62-cPa75-hybrid,1,1,112745128,112745128,cPa62-cPa75-hybrid,1,102,0
chr3-112765723_112765847,cPa260,1,1,112765795,112765773,cPa260,2,124,22
chr3-112766003_112766105,cPa260,0.666666666666667,2,112766059,112766014,cPa260_cPa511,2_1,102,45
chr3-112770639_112770741,cPa223,1,1,112770689,112770689,cPa223,1,102,0
chr3-112808701_112808803,WDSV_NC001867,0.8,2,112808751,112808728,cPa62-WDSV_NC001867-hybrid_WDSV_NC001867,1_4,102,23
chr3-112808891_112808993,WDSV_NC001867,1,1,112808941,112808929,WDSV_NC001867,2,102,12
chr3-112820275_112820377,cPa199,1,1,112820338,112820325,cPa199,9,102,13
chr3-112820411_112820541,cPa199,0.875,3,112820513,112820438,cPa199_cPa199-cPa539-hybrid_cPa482,14_1_1,130,75
chr3-112825116_112825218,cPa260,1,1,112825184,112825166,cPa260,3,102,18
chr3-112841432_112841534,WDSV_NC001867,1,1,112841532,112841439,WDSV_NC001867,3,102,93
chr3-112847913_112848015,cPa199,0.625,5,112847965,112847928,cPa199_cPa199-cPa273-hybrid_cPa199-cPa482-hybrid_cPa199-unknown_cPa482,15_1_3_3_2,102,37
chr3-112859921_112860180,cPa75-unknown,0.666666666666667,2,112860128,112859971,cPa75-CAEV_NC001463-hybrid_cPa75-unknown,1_2,259,157
chr3-112877377_112877479,cPa260,0.833333333333333,2,112877476,112877377,cPa260_cPa260-unknown,10_2,102,99
chr3-112880140_112880294,cPa223,1,1,112880274,112880182,cPa223,5,154,92
chr3-112880582_112880684,cPa223,1,1,112880632,112880632,cPa223,1,102,0
chr3-112886026_112886261,WDSV_NC001867,0.75,3,112886228,112886076,cPa260-WDSV_NC001867-hybrid_WDSV_NC001867_WDSV_NC001867-cPa260-hybrid,1_6_1,235,152
chr3-112892132_112892465,cPa539,1,1,112892413,112892166,cPa539,23,333,247
chr3-112896880_112896982,cPa75,1,1,112896930,112896930,cPa75,1,102,0
chr3-112931350_112931452,cPa75,1,1,112931400,112931400,cPa75,1,102,0
chr3-112964024_112964490,cPa260,0.974683544303797,3,112964439,112964074,cPa228_cPa260_cPa61-cPa260-hybrid,1_77_1,466,365
chr3-112988798_112988934,cPa75,1,1,112988882,112988848,cPa75,6,136,34
chr3-112989585_112989701,cPa75,1,1,112989649,112989635,cPa75,2,116,14
chr3-112990001_112990103,cPa75,1,1,112990051,112990051,cPa75,1,102,0
chr3-112990119_112990315,cPa75,1,1,112990263,112990169,cPa75,7,196,94
chr3-112990486_112990746,cPa75,1,1,112990694,112990536,cPa75,3,260,158
chr3-113002538_113002805,cPa75-unknown,0.909090909090909,2,113002753,113002588,cPa75_cPa75-unknown,2_20,267,165
chr3-113003713_113003921,cPa75,0.846153846153846,2,113003869,113003763,cPa260_cPa75,2_11,208,106
chr3-113003949_113004051,cPa75,1,1,113003999,113003999,cPa75,1,102,0
chr3-113004057_113004277,cPa75,1,1,113004257,113004078,cPa75,12,220,179
chr3-113004398_113004795,cPa75,1,1,113004743,113004448,cPa75,18,397,295
chr3-113016172_113016274,cPa75,1,1,113016222,113016222,cPa75,1,102,0
chr3-113039397_113039499,cPa260,0.962962962962963,2,113039499,113039398,cPa260_PtERV1_AC142352-unknown,26_1,102,101
chr3-113139828_113139930,cPa75,1,1,113139878,113139878,cPa75,1,102,0
chr3-113140107_113140275,cPa75,1,1,113140223,113140157,cPa75,2,168,66
chr3-113140389_113140544,cPa75,1,1,113140492,113140439,cPa75,3,155,53
chr3-113158749_113158851,cPa75-cPa163-hybrid,1,1,113158799,113158799,cPa75-cPa163-hybrid,1,102,0
chr3-113167084_113167186,cPa323_cPa371_cPa371-unknown,0.210526315789474,6,113167161,113167118,cPa224-cPa323-hybrid_cPa224-cPa371-hybrid_cPa323_cPa323-unknown_cPa371_cPa371-unknown,3_3_4_1_4_4,102,43
chr3-113208235_113208337,cPa194_cPa67,0.5,2,113208325,113208285,cPa194_cPa67,1_1,102,40
chr3-113208424_113208526,cPa194,0.642857142857143,3,113208520,113208426,cPa194_cPa360_cPa67,9_1_4,102,94
chr3-113208567_113208669,cPa194,0.888888888888889,2,113208657,113208579,cPa194_cPa67,8_1,102,78
chr3-113292003_113292105,cPa15,1,1,113292053,113292053,cPa15,1,102,0
chr3-1152548_1152650,cPa75-cPa552-hybrid,1,1,1152598,1152598,cPa75-cPa552-hybrid,1,102,0
chr3-11693483_11693585,cPa62,0.888888888888889,3,11693578,11693533,cPa285-unknown_cPa62_cPa62-unknown,1_16_1,102,45
chr3-1178859_1178961,cPa363_cPa452_cPa71,0.333333333333333,3,1178909,1178909,cPa363_cPa452_cPa71,1_1_1,102,0
chr3-11877226_11877328,cPa75,1,1,11877276,11877260,cPa75,3,102,16
chr3-12105594_12105696,cPa75,1,1,12105644,12105635,cPa75,3,102,9
chr3-12137048_12137150,cPa62,1,1,12137111,12137085,cPa62,7,102,26
chr3-12146329_12146435,cPa62_cPa75,0.5,2,12146383,12146379,cPa62_cPa75,1_1,106,4
chr3-12171672_12171774,cPa62,0.875,2,12171747,12171722,cPa333-cPa254-hybrid_cPa62,1_7,102,25
chr3-12276979_12277081,cPa363_cPa452,0.4,3,12277058,12276990,cPa363_cPa452_cPa71,2_2_1,102,68
chr3-12964874_12964976,cPa118_cPa15,0.363636363636364,4,12964936,12964900,cPa118_cPa15_cPa248-unknown_cPa268,4_4_2_1,102,36
chr3-13017336_13017438,cPa117,0.588235294117647,3,13017414,13017383,cPa117_cPa117-unknown_cPa452,10_1_6,102,31
chr3-13245606_13245738,cPa220-cPa518-hybrid,0.272727272727273,7,13245738,13245656,cPa220-cPa407-hybrid_cPa220-cPa518-hybrid_cPa425-HML1b_repbase_HERV-K14I_LTR14A-hybrid_cPa478-cPa518-hybrid_cPa549-cPa518-hybrid_cPa549-HML1b_repbase_HERV-K14I_LTR14A-hybrid_cPa60-cPa407-hybrid,2_3_1_1_2_1_1,132,82
chr3-13740129_13740231,cPa62,0.875,2,13740184,13740130,cPa419_cPa62,1_7,102,54
chr3-14129854_14129956,cPa113,1,1,14129904,14129904,cPa113,1,102,0
chr3-14213341_14213443,cPa419-cPa15-hybrid,0.428571428571429,4,14213403,14213385,cPa419_cPa419-cPa15-hybrid_cPa419-cPa371-hybrid_cPa419-cPa443-hybrid,2_3_1_1,102,18
chr3-14213605_14213707,cPa419-cPa15-hybrid_cPa419-unknown,0.5,2,14213655,14213655,cPa419-cPa15-hybrid_cPa419-unknown,1_1,102,0
chr3-14269626_14269731,cPa456_cPa482-cPa456-hybrid,0.5,2,14269679,14269676,cPa456_cPa482-cPa456-hybrid,1_1,105,3
chr3-14476845_14476996,cPa357,0.196581196581197,15,14476996,14476895,cPa164-cPa168-hybrid_cPa168_cPa168-cPa357-hybrid_cPa227_cPa273_cPa273-cPa227-hybrid_cPa273-cPa357-hybrid_cPa273-cPa583-hybrid_cPa357_cPa450_cPa450-cPa357-hybrid_cPa469-cPa450-hybrid_cPa475_cPa583_cPa583-cPa227-hybrid,1_22_3_20_7_2_3_2_23_18_1_1_2_11_1,151,101
chr3-14492260_14492363,cPa425_cPa47,0.333333333333333,5,14492311,14492295,cPa174-cPa404-hybrid_cPa174-unknown_cPa254_cPa425_cPa47,1_1_1_3_3,103,16
chr3-14602897_14603024,HERV-W_repbase_HERV17_LTR17,0.5,3,14602973,14602936,cPa176-HERV-W_repbase_HERV17_LTR17-hybrid_cPa75_HERV-W_repbase_HERV17_LTR17,1_2_3,127,37
chr3-14603439_14603541,HERV-W_repbase_HERV17_LTR17,0.888888888888889,2,14603541,14603443,cPa75-HERV-W_repbase_HERV17_LTR17-hybrid_HERV-W_repbase_HERV17_LTR17,1_8,102,98
chr3-14603556_14603658,cPa75,1,1,14603606,14603606,cPa75,2,102,0
chr3-14604682_14604784,cPa75-cPa308-hybrid,1,1,14604732,14604732,cPa75-cPa308-hybrid,1,102,0
chr3-14608176_14608282,cPa339-cPa75-hybrid,0.5,3,14608230,14608205,cPa339-cPa308-hybrid_cPa339-cPa75-hybrid_FIV_NC001482-cPa308-hybrid,1_2_1,106,25
chr3-14608943_14609045,cPa339-cPa75-hybrid,1,1,14608993,14608993,cPa339-cPa75-hybrid,1,102,0
chr3-14672145_14672405,cPa449,0.323809523809524,16,14672403,14672152,cPa199-cPa363-hybrid_cPa223-cPa183-hybrid_cPa223-cPa75-hybrid_cPa229_cPa313_cPa449_cPa469_cPa469-cPa75-hybrid_cPa475-cPa183-hybrid_cPa475-cPa227-hybrid_cPa475-cPa313-hybrid_cPa475-cPa62-hybrid_cPa475-cPa75-hybrid_cPa583-cPa75-hybrid_cPa62_cPa62-unknown,1_1_3_11_32_34_1_1_1_1_3_1_12_1_1_1,260,251
chr3-14672514_14672616,cPa229_cPa313_cPa419,0.333333333333333,3,14672590,14672564,cPa229_cPa313_cPa419,1_1_1,102,26
chr3-14682354_14682456,cPa200-cPa446-hybrid,1,1,14682405,14682404,cPa200-cPa446-hybrid,2,102,1
chr3-14684104_14684259,cPa273-cPa381-hybrid,0.442176870748299,23,14684252,14684154,cPa168-cPa199-hybrid_cPa168-cPa208-hybrid_cPa227_cPa227-cPa199-hybrid_cPa227-cPa208-hybrid_cPa227-cPa345-hybrid_cPa227-cPa381-hybrid_cPa227-HML4_repbase_HERVK13I_LTR13-hybrid_cPa273_cPa273-cPa199-hybrid_cPa273-cPa208-hybrid_cPa273-cPa223-hybrid_cPa273-cPa227-hybrid_cPa273-cPa345-hybrid_cPa273-cPa381-hybrid_cPa273-cPa450-hybrid_cPa273-cPa62-hybrid_cPa357-cPa381-hybrid_cPa357-cPa410-hybrid_cPa419_cPa583-cPa199-hybrid_cPa583-cPa208-hybrid_cPa583-cPa381-hybrid,1_2_6_4_3_2_10_1_14_1_18_1_1_5_65_1_1_5_1_1_2_1_1,155,98
chr3-14686102_14686204,cPa345_cPa62_cPa62-cPa254-hybrid,0.2,7,14686158,14686136,cPa199_cPa345_cPa345-cPa254-hybrid_cPa345-cPa381-hybrid_cPa419_cPa62_cPa62-cPa254-hybrid,1_2_1_1_1_2_2,102,22
chr3-14686233_14686335,cPa345,1,1,14686283,14686283,cPa345,1,102,0
chr3-14690218_14690332,cPa75,1,1,14690280,14690268,cPa75,4,114,12
chr3-14700889_14701016,cPa75-unknown,0.666666666666667,2,14700964,14700923,cPa75_cPa75-unknown,1_2,127,41
chr3-14701357_14701459,cPa360-MoMLV_J02255-hybrid,1,1,14701407,14701407,cPa360-MoMLV_J02255-hybrid,1,102,0
chr3-14703505_14704031,cPa486,0.193029490616622,39,14704019,14703507,cPa15_cPa15-cPa360-hybrid_cPa268_cPa268-cPa308-hybrid_cPa268-cPa353-hybrid_cPa268-cPa356-hybrid_cPa268-cPa360-hybrid_cPa268-cPa486-hybrid_cPa268-cPa75-hybrid_cPa268-HERV-F_repbase_HERVFH19I_LTR19A-hybrid_cPa268-unknown_cPa308_cPa308-cPa356-hybrid_cPa339_cPa353_cPa356_cPa356-cPa353-hybrid_cPa356-cPa583-hybrid_cPa381_cPa381-cPa111-hybrid_cPa381-cPa268-hybrid_cPa381-cPa308-hybrid_cPa381-cPa353-hybrid_cPa381-cPa356-hybrid_cPa381-cPa486-hybrid_cPa381-HERV-F_repbase_HERVFH19I_LTR19A-hybrid_cPa381-unknown_cPa419_cPa434_cPa434-cPa111-hybrid_cPa434-cPa308-hybrid_cPa434-cPa353-hybrid_cPa434-cPa356-hybrid_cPa434-cPa360-hybrid_cPa434-cPa447-hybrid_cPa434-cPa486-hybrid_cPa434-unknown_cPa486_cPa486-cPa353-hybrid,1_1_42_2_7_11_3_5_1_1_18_8_1_1_9_8_1_1_47_2_1_4_7_8_5_1_31_3_32_3_1_8_6_2_1_2_15_72_1,526,512
chr3-14704175_14704277,cPa268-cPa356-hybrid_cPa268-cPa447-hybrid_cPa308_cPa381-cPa356-hybrid_MDEV_AF053745-cPa583-hybrid,0.2,5,14704257,14704225,cPa268-cPa356-hybrid_cPa268-cPa447-hybrid_cPa308_cPa381-cPa356-hybrid_MDEV_AF053745-cPa583-hybrid,1_1_1_1_1,102,32
chr3-14704540_14704642,cPa308,0.444444444444444,3,14704627,14704590,cPa308_cPa356_cPa419,4_3_2,102,37
chr3-14704753_14704862,cPa356,0.4,5,14704862,14704780,cPa268-cPa356-hybrid_cPa308_cPa356_cPa381-cPa356-hybrid_cPa425-cPa356-hybrid,2_2_6_1_4,109,82
chr3-14704928_14705030,cPa308_cPa356_MDEV_AF053745-cPa486-hybrid,0.333333333333333,3,14704978,14704946,cPa308_cPa356_MDEV_AF053745-cPa486-hybrid,1_1_1,102,32
chr3-14705045_14705147,cPa356,0.4,4,14705108,14705076,cPa293-cPa356-hybrid_cPa308-cPa356-hybrid_cPa356_cPa447-cPa308-hybrid,1_1_2_1,102,32
chr3-14707072_14707302,cPa425-cPa363-hybrid,0.714285714285714,3,14707250,14707094,cPa345-cPa363-hybrid_cPa425-cPa363-hybrid_cPa425-cPa47-hybrid,1_5_1,230,156
chr3-14707308_14707438,cPa425-cPa363-hybrid,1,1,14707386,14707312,cPa425-cPa363-hybrid,10,130,74
chr3-14715023_14715135,HERV-W_repbase_HERV17_LTR17,0.666666666666667,6,14715129,14715025,cPa75_HERV-W_repbase_HERV17_LTR17_HERV-W_repbase_HERV17_LTR17-cPa62-hybrid_HERV-W_repbase_HERV17_LTR17-cPa75-hybrid_HERV-W_repbase_HERV17_LTR17-unknown_KoRV_AF151794,1_16_3_1_2_1,112,104
chr3-14715146_14715322,HERV-W_repbase_HERV17_LTR17,0.62962962962963,8,14715312,14715196,cPa419-cPa62-hybrid_cPa419-cPa75-hybrid_cPa75-cPa62-hybrid_HERV-W_repbase_HERV17_LTR17_HERV-W_repbase_HERV17_LTR17-cPa419-hybrid_HERV-W_repbase_HERV17_LTR17-cPa62-hybrid_HERV-W_repbase_HERV17_LTR17-cPa75-hybrid_HERV-W_repbase_HERV17_LTR17-unknown,2_1_1_17_1_3_1_1,176,116
chr3-14716774_14716876,cPa419,1,1,14716824,14716779,cPa419,2,102,45
chr3-14716993_14717095,cPa419,1,1,14717043,14716992,cPa419,3,102,51
chr3-14718789_14718960,cPa223,0.909090909090909,3,14718959,14718800,cPa223_cPa315-cPa447-hybrid_cPa358-cPa428-hybrid,20_1_1,171,159
chr3-14719552_14719723,cPa456,0.4,5,14719720,14719588,cPa223-cPa381-hybrid_cPa358_cPa358-cPa428-hybrid_cPa419_cPa456,1_1_1_3_4,171,132
chr3-14719843_14719945,cPa208_cPa254_cPa456,0.333333333333333,3,14719916,14719889,cPa208_cPa254_cPa456,1_1_1,102,27
chr3-14721958_14722066,cPa229,0.8,6,14722036,14721958,cPa229_cPa360-cPa61-hybrid_cPa419_cPa419-cPa381-hybrid_cPa62-cPa75-hybrid_cPa75,28_1_2_1_1_2,108,78
chr3-14722124_14722296,cPa229,0.68,6,14722277,14722144,cPa223-cPa229-hybrid_cPa229_cPa356-cPa298-hybrid_cPa419_cPa456-cPa542-hybrid_cPa553-cPa542-hybrid,1_17_1_4_1_1,172,133
chr3-14723079_14723219,cPa419,0.625,3,14723203,14723080,cPa273-cPa542-hybrid_cPa419_cPa452,1_5_2,140,123
chr3-14728533_14728635,cPa345,1,1,14728583,14728583,cPa345,1,102,0
chr3-14739980_14740082,cPa75,0.5,3,14740061,14739992,cPa419-cPa308-hybrid_cPa62_cPa75,1_1_2,102,69
chr3-14754411_14754513,cPa254_cPa425,0.333333333333333,4,14754502,14754422,cPa174_cPa254_cPa425_cPa47,2_3_3_1,102,80
chr3-14774163_14774265,cPa199-cPa273-hybrid_cPa443-cPa273-hybrid_cPa450,0.333333333333333,3,14774213,14774207,cPa199-cPa273-hybrid_cPa443-cPa273-hybrid_cPa450,1_1_1,102,6
chr3-14833546_14833648,cPa75_HERV-W_repbase_HERV17_LTR17-cPa75-hybrid,0.5,2,14833596,14833587,cPa75_HERV-W_repbase_HERV17_LTR17-cPa75-hybrid,1_1,102,9
chr3-14846191_14846408,PRIMA41_repbase_PRIMA41_MER41A-cPa285-hybrid,0.404255319148936,22,14846367,14846190,cPa117-cPa285-hybrid_cPa2-cPa285-hybrid_cPa357_cPa357-cPa363-hybrid_cPa419_cPa447-cPa323-hybrid_cPa447-cPa339-hybrid_cPa452-cPa285-hybrid_cPa75-cPa285-hybrid_PERVC_HM159246-cPa363-hybrid_PRIMA41_repbase_PRIMA41_MER41A_PRIMA41_repbase_PRIMA41_MER41A-cPa138-hybrid_PRIMA41_repbase_PRIMA41_MER41A-cPa15-hybrid_PRIMA41_repbase_PRIMA41_MER41A-cPa285-hybrid_PRIMA41_repbase_PRIMA41_MER41A-cPa357-hybrid_PRIMA41_repbase_PRIMA41_MER41A-cPa395-hybrid_PRIMA41_repbase_PRIMA41_MER41A-cPa482-hybrid_SIV_NC001549-cPa395-hybrid_VISNA_S55323-cPa15-hybrid_VISNA_S55323-cPa285-hybrid_VISNA_S55323-cPa395-hybrid_VISNA_S55323-cPa75-hybrid,1_2_1_1_1_1_1_1_1_1_1_1_3_19_2_2_1_1_1_3_1_1,217,177
chr3-14846491_14846665,PRIMA41_repbase_PRIMA41_MER41A-cPa285-hybrid,0.869565217391304,4,14846665,14846541,cPa107-cPa285-hybrid_cPa419_PRIMA41_repbase_PRIMA41_MER41A-cPa285-hybrid_VISNA_S55323-cPa285-hybrid,1_1_20_1,174,124
chr3-14848066_14848171,cPa357,0.421052631578947,6,14848160,14848093,cPa357_cPa357-cPa15-hybrid_cPa357-cPa333-hybrid_cPa419_cPa447_cPa449,8_4_2_1_3_1,105,67
chr3-14848187_14848395,cPa447,0.348837209302326,15,14848393,14848191,cPa194-cPa15-hybrid_cPa194-cPa553-hybrid_cPa254_cPa333-cPa15-hybrid_cPa339-cPa15-hybrid_cPa357_cPa357-cPa15-hybrid_cPa357-cPa395-hybrid_cPa363-cPa15-hybrid_cPa419_cPa447_cPa449_cPa449-cPa333-hybrid_HIV2_NC001722-cPa395-hybrid_PERVC_HM159246,1_1_1_5_1_2_1_1_1_1_15_10_1_1_1,208,202
chr3-14849710_14849812,cPa447,0.333333333333333,7,14849774,14849744,cPa113-cPa568-hybrid_cPa333_cPa363_cPa419_cPa447_cPa449_cPa449-cPa333-hybrid,2_5_1_2_6_1_1,102,30
chr3-14849862_14849964,cPa449,1,1,14849912,14849912,cPa449,1,102,0
chr3-14850000_14850162,cPa449,0.258620689655172,20,14850110,14850018,cPa113-cPa117-hybrid_cPa113-cPa308-hybrid_cPa113-cPa456-hybrid_cPa260-cPa194-hybrid_cPa273-cPa67-hybrid_cPa333_cPa333-cPa568-hybrid_cPa363_cPa379-cPa333-hybrid_cPa447_cPa449_cPa452_cPa456-cPa67-hybrid_cPa50-cPa15-hybrid_cPa50-cPa194-hybrid_cPa568_FrMuLV_NC001362-cPa67-hybrid_HML8_repbase_HERVK11I_MER11A-cPa194-hybrid_HML8_repbase_HERVK11I_MER11A-cPa254-hybrid_PERV_AJ293656-cPa568-hybrid,1_1_1_1_1_22_1_8_1_15_30_3_1_1_1_24_1_1_1_1,162,92
chr3-14850323_14850428,cPa449,0.38,14,14850425,14850352,cPa168-cPa568-hybrid_cPa323-cPa67-hybrid_cPa333_cPa333-cPa449-hybrid_cPa357-cPa568-hybrid_cPa363_cPa419_cPa447_cPa449_cPa452_cPa482-cPa254-hybrid_cPa518-cPa194-hybrid_cPa542-cPa333-hybrid_cPa568,1_1_5_1_1_1_1_14_19_1_1_1_1_2,105,73
chr3-15007228_15007330,cPa118_cPa15-cPa125-hybrid,0.5,2,15007278,15007278,cPa118_cPa15-cPa125-hybrid,1_1,102,0
chr3-15061010_15061112,cPa15,1,1,15061060,15061060,cPa15,1,102,0
chr3-15124556_15124705,cPa208,0.764705882352941,5,15124691,15124568,cPa208_cPa208-cPa194-hybrid_cPa208-HERV-E_repbase_HERVE_LTR2-hybrid_cPa447-cPa428-hybrid_GaLV_M26927-cPa176-hybrid,13_1_1_1_1,149,123
chr3-15150791_15151110,cPa228,0.544117647058823,12,15151084,15150790,cPa228_cPa258-unknown_cPa308_cPa308-cPa449-hybrid_cPa413_cPa419_cPa449_cPa449-cPa228-hybrid_cPa449-unknown_cPa62_cPa62-cPa75-hybrid_HERV30_repbase_HERV30I_LTR30-cPa308-hybrid,74_1_1_9_1_4_26_3_11_4_1_1,319,294
chr3-15151145_15151344,cPa228,0.84375,5,15151335,15151176,cPa228_cPa308-cPa75-hybrid_cPa449-unknown_cPa540-cPa62-hybrid_cPa540-cPa75-hybrid,27_1_1_2_1,199,159
chr3-15151983_15152085,cPa228,0.285714285714286,6,15152038,15151982,cPa228_cPa308_cPa308-cPa251-hybrid_cPa308-cPa75-hybrid_cPa308-unknown_cPa419,2_1_1_1_1_1,102,56
chr3-15153480_15153596,cPa228,0.375,4,15153581,15153517,cPa173-unknown_cPa220-cPa247-hybrid_cPa228_cPa419,2_1_3_2,116,64
chr3-15216142_15216244,cPa419_cPa62-HERV-W_repbase_HERV17_LTR17-hybrid,0.5,2,15216215,15216192,cPa419_cPa62-HERV-W_repbase_HERV17_LTR17-hybrid,1_1,102,23
chr3-1536303_1536405,cPa62,0.538461538461538,6,1536358,1536317,cPa293_cPa293-cPa62-hybrid_cPa293-unknown_cPa62_cPa62-unknown_cPa75,1_1_2_7_1_1,102,41
chr3-15406236_15406351,cPa257_cPa257-cPa546-hybrid_cPa285-cPa257-hybrid_cPa285-cPa546-hybrid,0.25,4,15406315,15406280,cPa257_cPa257-cPa546-hybrid_cPa285-cPa257-hybrid_cPa285-cPa546-hybrid,1_1_1_1,115,35
chr3-15530256_15530442,cPa75-unknown,0.714285714285714,3,15530424,15530261,cPa419_cPa546_cPa75-unknown,1_1_5,186,163
chr3-15655386_15655488,cPa138,0.333333333333333,5,15655470,15655399,cPa138_cPa138-cPa419-hybrid_cPa419_cPa75_cPa75-cPa425-hybrid,2_1_1_1_1,102,71
chr3-15655505_15655673,cPa138,0.305555555555556,13,15655658,15655504,cPa117-cPa332-hybrid_cPa138_cPa257_cPa395_cPa419_cPa456-cPa254-hybrid_cPa518_cPa527-cPa518-hybrid_cPa546_cPa60_cPa75_cPa75-cPa425-hybrid_cPa75-cPa47-hybrid,1_11_1_2_3_1_1_1_2_1_4_7_1,168,154
chr3-15656400_15656635,cPa138,0.15,16,15656583,15656431,cPa138_cPa138-cPa419-hybrid_cPa220-cPa425-hybrid_cPa220-cPa47-hybrid_cPa257-cPa125-hybrid_cPa257-cPa425-hybrid_cPa257-cPa47-hybrid_cPa257-unknown_cPa258-unknown_cPa285_cPa419_cPa42-cPa125-hybrid_cPa435-cPa125-hybrid_cPa456-unknown_cPa60_cPa75,3_1_1_1_1_1_2_1_2_1_1_1_1_1_1_1,235,152
chr3-15698812_15698914,cPa419,1,1,15698862,15698862,cPa419,1,102,0
chr3-15727645_15727761,cPa450,0.3,7,15727715,15727695,cPa199_cPa199-cPa273-hybrid_cPa199-cPa553-hybrid_cPa227-cPa553-hybrid_cPa273_cPa450_cPa553-cPa273-hybrid,1_2_1_1_1_3_1,116,20
chr3-16022712_16022824,cPa75,1,1,16022772,16022762,cPa75,4,112,10
chr3-16135909_16136011,cPa75,1,1,16135959,16135959,cPa75,1,102,0
chr3-16399209_16399372,cPa62,0.981132075471698,2,16399322,16399210,cPa62_cPa75,52_1,163,112
chr3-16399756_16399947,cPa62,0.770833333333333,3,16399936,16399758,cPa285_cPa62_cPa75,1_74_21,191,178
chr3-16400301_16400426,cPa62,0.901960784313726,3,16400423,16400301,cPa199-cPa75-hybrid_cPa62_cPa75,1_46_4,125,122
chr3-16455136_16455238,cPa75,1,1,16455186,16455179,cPa75,3,102,7
chr3-16466707_16466819,cPa176_cPa363_cPa452_cPa71,0.25,4,16466767,16466757,cPa176_cPa363_cPa452_cPa71,1_1_1_1,112,10
chr3-16504230_16504338,cPa62-unknown,0.5,3,16504294,16504236,cPa62_cPa62-unknown_cPa75,1_3_2,108,58
chr3-16675593_16675695,cPa424-cPa363-hybrid,0.238095238095238,9,16675677,16675594,cPa183_cPa183-cPa363-hybrid_cPa183-cPa452-hybrid_cPa223_cPa223-cPa183-hybrid_cPa223-cPa363-hybrid_cPa223-cPa452-hybrid_cPa327-cPa363-hybrid_cPa424-cPa363-hybrid,2_1_2_4_1_4_1_1_5,102,83
chr3-17038837_17038939,cPa117,1,1,17038887,17038887,cPa117,1,102,0
chr3-17632973_17633075,cPa419,1,1,17633074,17633023,cPa419,3,102,51
chr3-17633272_17633432,cPa419,1,1,17633380,17633288,cPa419,6,160,92
chr3-17633867_17633969,cPa419,1,1,17633940,17633917,cPa419,3,102,23
chr3-17633972_17634074,cPa419,1,1,17634034,17634000,cPa419,7,102,34
chr3-17646036_17646138,cPa228,0.505376344086022,28,17646135,17646045,cPa101-cPa228-hybrid_cPa107-cPa228-hybrid_cPa107-cPa260-hybrid_cPa107-cPa308-hybrid_cPa107-cPa433-hybrid_cPa173-cPa196-hybrid_cPa173-cPa228-hybrid_cPa173-cPa260-hybrid_cPa173-cPa308-hybrid_cPa173-cPa371-hybrid_cPa173-cPa449-hybrid_cPa220-cPa449-hybrid_cPa228_cPa419_cPa540-cPa196-hybrid_cPa540-cPa260-hybrid_cPa540-cPa308-hybrid_cPa540-cPa371-hybrid_cPa542-cPa371-hybrid_cPa544-cPa196-hybrid_cPa544-cPa228-hybrid_cPa544-cPa260-hybrid_cPa544-cPa308-hybrid_cPa544-cPa371-hybrid_cPa544-cPa449-hybrid_cPa544-cPa75-hybrid_cPa62-cPa371-hybrid_HIV2_NC001722-cPa228-hybrid,2_1_2_1_1_1_2_1_1_3_2_1_47_5_1_2_2_1_1_1_3_5_2_1_1_1_1_1,102,90
chr3-17647108_17647210,cPa173_cPa544-cPa75-hybrid,0.5,2,17647202,17647158,cPa173_cPa544-cPa75-hybrid,1_1,102,44
chr3-17647693_17647812,cPa228,1,1,17647765,17647712,cPa228,5,119,53
chr3-17647944_17648140,cPa228,0.803571428571429,5,17648140,17647973,cPa107-cPa75-hybrid_cPa173-cPa75-hybrid_cPa199-cPa228-hybrid_cPa228_cPa449,1_1_1_45_8,196,167
chr3-17717607_17717709,cPa101-HIV1_NC001802-hybrid_cPa333-cPa142-hybrid,0.5,2,17717664,17717657,cPa101-HIV1_NC001802-hybrid_cPa333-cPa142-hybrid,1_1,102,7
chr3-17721815_17722187,HERV-W_repbase_HERV17_LTR17,0.952941176470588,4,17722186,17721845,cPa75-cPa62-hybrid_HERV-W_repbase_HERV17_LTR17_HERV-W_repbase_HERV17_LTR17-cPa419-hybrid_HERV-W_repbase_HERV17_LTR17-unknown,1_81_2_1,372,341
chr3-17723360_17723481,cPa419,0.8,2,17723429,17723360,cPa419_HERV-W_repbase_HERV17_LTR17-cPa419-hybrid,4_1,121,69
chr3-17763892_17763994,cPa308-cPa227-hybrid_JSRV_DQ838494-cPa357-hybrid_JSRV_DQ838494-cPa75-hybrid,0.333333333333333,3,17763946,17763905,cPa308-cPa227-hybrid_JSRV_DQ838494-cPa357-hybrid_JSRV_DQ838494-cPa75-hybrid,1_1_1,102,41
chr3-18002737_18002839,cPa47-cPa174-hybrid,0.486486486486487,8,18002831,18002736,cPa174_cPa254_cPa254-cPa174-hybrid_cPa404_cPa404-cPa254-hybrid_cPa425_cPa47-cPa174-hybrid_cPa47-cPa254-hybrid,3_22_3_5_1_2_36_2,102,95
chr3-18727647_18727879,cPa75,0.423728813559322,5,18727876,18727665,cPa62-cPa75-hybrid_cPa62-HERV-W_repbase_HERV17_LTR17-hybrid_cPa62-unknown_cPa75_cPa75-unknown,7_1_23_25_3,232,211
chr3-1960748_1960850,cPa109-cPa75-hybrid,1,1,1960798,1960798,cPa109-cPa75-hybrid,1,102,0
chr3-19721216_19721318,cPa75,0.857142857142857,2,19721266,19721266,cPa75_cPa75-cPa285-hybrid,6_1,102,0
chr3-19859717_19859863,cPa62-unknown,0.411764705882353,4,19859821,19859744,cPa293_cPa62_cPa62-cPa293-hybrid_cPa62-unknown,3_5_2_7,146,77
chr3-20607576_20607678,HML6_repbase_HERVK3I_LTR3,0.75,2,20607638,20607626,HML6_repbase_HERVK3I_LTR3_VISNA_S55323,3_1,102,12
chr3-20608062_20608229,cPa62,0.655913978494624,8,20608226,20608064,CAEV_NC001463-cPa293-hybrid_cPa293_cPa62_cPa62-cPa293-hybrid_cPa62-cPa413-hybrid_cPa62-cPa75-hybrid_cPa62-unknown_cPa75,1_1_61_1_1_1_2_25,167,162
chr3-21131887_21132438,cPa75,0.825,3,21132386,21131937,cPa62_cPa75_cPa75-cPa62-hybrid,3_33_4,551,449
chr3-21132720_21132822,cPa75,1,1,21132770,21132722,cPa75,2,102,48
chr3-21518369_21518471,cPa71,0.4,3,21518457,21518419,cPa363_cPa452_cPa71,3_3_4,102,38
chr3-22008619_22008721,cPa47,0.428571428571429,6,22008680,22008658,cPa174_cPa254_cPa254-cPa174-hybrid_cPa404-cPa174-hybrid_cPa425_cPa47,4_8_1_2_1_12,102,22
chr3-22383047_22383153,cPa118,0.526315789473684,6,22383118,22383059,cPa118_cPa118-unknown_cPa125-cPa118-hybrid_cPa125-cPa15-hybrid_cPa15_cPa248-cPa15-hybrid,20_1_1_3_12_1,106,59
chr3-22451288_22451390,cPa254,0.8,2,22451338,22451327,cPa254_cPa425-cPa404-hybrid,4_1,102,11
chr3-22949160_22949262,cPa452,0.4,4,22949223,22949210,cPa363_cPa452_cPa71_cPa71-cPa452-hybrid,1_2_1_1,102,13
chr3-22987072_22987174,cPa75,1,1,22987137,22987122,cPa75,8,102,15
chr3-22997611_22997716,cPa452,0.4,4,22997664,22997660,cPa363_cPa363-cPa71-hybrid_cPa452_cPa71,1_1_2_1,105,4
chr3-23098204_23098430,cPa75,0.454545454545455,7,23098378,23098227,cPa62_cPa75_cPa75-unknown_HERV-W_repbase_HERV17_LTR17_HERV-W_repbase_HERV17_LTR17-cPa75-hybrid_HERV-W_repbase_HERV17_LTR17-unknown_KWERV_GQ222416-cPa75-hybrid,1_5_1_1_1_1_1,226,151
chr3-23098477_23098579,cPa75,1,1,23098527,23098527,cPa75,1,102,0
chr3-23098626_23098741,cPa75,1,1,23098689,23098676,cPa75,2,115,13
chr3-23098842_23098957,cPa75,1,1,23098925,23098892,cPa75,3,115,33
chr3-23244738_23244840,cPa62,1,1,23244834,23244772,cPa62,30,102,62
chr3-23324572_23324963,cPa62-unknown,0.880952380952381,5,23324916,23324590,cPa62_cPa62-HERV-W_repbase_HERV17_LTR17-hybrid_cPa62-unknown_HERV-W_repbase_HERV17_LTR17_HERV-W_repbase_HERV17_LTR17-unknown,1_1_37_1_2,391,326
chr3-23502160_23502262,cPa419,1,1,23502210,23502210,cPa419,1,102,0
chr3-23567650_23567823,cPa183_cPa452-cPa183-hybrid_cPa452-cPa223-hybrid,0.222222222222222,6,23567775,23567700,cPa183_cPa223_cPa363-cPa183-hybrid_cPa363-cPa327-hybrid_cPa452-cPa183-hybrid_cPa452-cPa223-hybrid,2_1_1_1_2_2,173,75
chr3-24163201_24163303,cPa444,0.375,5,24163270,24163207,cPa419_cPa444_cPa447_cPa447-cPa339-hybrid_cPa486-cPa339-hybrid,1_3_2_1_1,102,63
chr3-2428220_2428322,cPa75,1,1,2428270,2428270,cPa75,1,102,0
chr3-24407103_24407211,cPa456,0.375,5,24407162,24407153,cPa119-cPa587-hybrid_cPa363_cPa452-cPa587-hybrid_cPa452-unknown_cPa456,1_2_1_1_3,108,9
chr3-2495221_2495323,cPa62,1,1,2495274,2495271,cPa62,2,102,3
chr3-2526813_2527125,cPa62,0.892857142857143,7,2527110,2526837,cPa285_cPa293-unknown_cPa62_cPa62-unknown_cPa75_cPa75-cPa293-hybrid_cPa75-unknown,1_2_75_1_3_1_1,312,273
chr3-25634428_25634867,cPa62,0.777777777777778,6,25634832,25634448,cPa363_cPa363-cPa456-hybrid_cPa363-cPa47-hybrid_cPa363-cPa62-hybrid_cPa452-cPa62-hybrid_cPa62,1_1_1_4_1_28,439,384
chr3-25940483_25940585,HERV-W_repbase_HERV17_LTR17,1,1,25940533,25940533,HERV-W_repbase_HERV17_LTR17,1,102,0
chr3-25940973_25941138,HERV-W_repbase_HERV17_LTR17,0.846153846153846,5,25941129,25940974,cPa75_HERV-W_repbase_HERV17_LTR17_HERV-W_repbase_HERV17_LTR17-cPa62-hybrid_HERV-W_repbase_HERV17_LTR17-unknown_KoRV_AF151794-cPa75-hybrid,2_44_2_3_1,165,155
chr3-25941179_25941281,cPa75,0.5,3,25941265,25941192,cPa75_cPa75-cPa62-hybrid_HERV-W_repbase_HERV17_LTR17-cPa75-hybrid,2_1_1,102,73
chr3-26352519_26352621,cPa62,1,1,26352569,26352544,cPa62,5,102,25
chr3-26633418_26633520,cPa62,0.972972972972973,2,26633472,26633452,cPa254-cPa62-hybrid_cPa62,1_36,102,20
chr3-26700016_26700118,cPa62,0.967741935483871,2,26700082,26700065,cPa62_cPa62-unknown,30_1,102,17
chr3-26820972_26821080,cPa459,1,1,26821050,26821021,cPa459,36,108,29
chr3-26821638_26821749,cPa459,0.979166666666667,2,26821697,26821688,cPa459_cPa459-cPa15-hybrid,47_1,111,9
chr3-26821765_26821867,cPa459,1,1,26821815,26821785,cPa459,9,102,30
chr3-27146028_27146320,cPa456,0.65,4,27146277,27146078,cPa363_cPa456_cPa456-cPa587-hybrid_cPa587,1_13_1_5,292,199
chr3-27146408_27146510,cPa456,1,1,27146458,27146458,cPa456,1,102,0
chr3-27426175_27426295,cPa323,0.333333333333333,5,27426287,27426213,cPa323_cPa323-cPa50-hybrid_cPa323-cPa568-hybrid_cPa333_cPa371-cPa568-hybrid,4_3_2_2_1,120,74
chr3-27993925_27994051,cPa223,0.37378640776699,20,27994050,27993952,cPa164-cPa223-hybrid_cPa164-cPa327-hybrid_cPa164-cPa363-hybrid_cPa164-cPa452-hybrid_cPa223_cPa223-cPa363-hybrid_cPa327_cPa327-cPa363-hybrid_cPa424_cPa424-cPa223-hybrid_cPa424-cPa327-hybrid_cPa424-cPa363-hybrid_cPa424-cPa446-hybrid_cPa424-cPa452-hybrid_cPa424-unknown_cPa446_cPa446-cPa223-hybrid_cPa446-cPa327-hybrid_cPa446-cPa363-hybrid_cPa446-cPa452-hybrid,2_3_21_3_77_1_20_3_23_3_1_15_1_3_2_20_1_2_4_1,126,98
chr3-28295418_28295520,cPa62,0.777777777777778,7,28295484,28295438,cPa117_cPa117-cPa285-hybrid_cPa117-cPa47-hybrid_cPa285_cPa452_cPa62_cPa62-unknown,1_1_1_2_1_28_2,102,46
chr3-28297352_28297454,cPa47,0.285714285714286,12,28297422,28297395,cPa174_cPa174-cPa254-hybrid_cPa174-cPa285-hybrid_cPa174-cPa392-hybrid_cPa174-cPa47-hybrid_cPa174-unknown_cPa254_cPa254-cPa47-hybrid_cPa254-cPa62-hybrid_cPa425_cPa425-cPa62-hybrid_cPa47,2_3_1_2_4_2_14_2_1_8_1_16,102,27
chr3-28297845_28297947,cPa62,0.555555555555556,5,28297899,28297879,cPa254-cPa62-hybrid_cPa285_cPa293-cPa62-hybrid_cPa62_cPa75,1_1_1_5_1,102,20
chr3-28356508_28356610,cPa425,0.4,4,28356584,28356558,cPa174_cPa254_cPa425_cPa47-unknown,1_1_2_1,102,26
chr3-28441083_28441231,cPa71-cPa62-hybrid,0.3,5,28441199,28441095,cPa71-cPa62-hybrid_cPa75_cPa75-cPa62-hybrid_HERV-W_repbase_HERV17_LTR17_HERV-W_repbase_HERV17_LTR17-cPa62-hybrid,12_8_10_5_5,148,104
chr3-28441275_28441377,cPa75-cPa62-hybrid,0.288135593220339,10,28441374,28441274,cPa293-cPa62-hybrid_cPa71_cPa71-cPa62-hybrid_cPa75_cPa75-cPa62-hybrid_HERV-W_repbase_HERV17_LTR17_HERV-W_repbase_HERV17_LTR17-cPa62-hybrid_HERV-W_repbase_HERV17_LTR17-cPa71-hybrid_HERV-W_repbase_HERV17_LTR17-unknown_PERV_AJ293656-KoRV_AF151794-hybrid,1_2_6_10_17_11_9_1_1_1,102,100
chr3-28518824_28519205,cPa75,0.313725490196078,12,28519191,28518843,cPa260_cPa260-cPa75-hybrid_cPa260-unknown_cPa293-cPa260-hybrid_cPa62_cPa62-cPa260-hybrid_cPa62-cPa293-hybrid_cPa62-cPa413-hybrid_cPa62-cPa75-hybrid_cPa62-unknown_cPa75_cPa75-cPa260-hybrid,7_1_1_1_6_6_2_3_1_6_16_1,381,348
chr3-28842677_28842796,cPa539,0.857142857142857,3,28842769,28842727,cPa539_cPa539-unknown_rRVRV_JQ303225,12_1_1,119,42
chr3-29057519_29057621,HERV-W_repbase_HERV17_LTR17,0.5,4,29057592,29057534,cPa360-HERV-W_repbase_HERV17_LTR17-hybrid_cPa75-HERV-W_repbase_HERV17_LTR17-hybrid_HERV-F_repbase_HERVFH19I_LTR19A_HERV-W_repbase_HERV17_LTR17,1_1_1_3,102,58
chr3-29061237_29061339,cPa543,1,1,29061287,29061287,cPa543,1,102,0
chr3-30087491_30087593,cPa75,0.857142857142857,2,30087541,30087495,cPa62_cPa75,1_6,102,46
chr3-30283611_30283713,cPa450,0.666666666666667,10,30283675,30283651,cPa227_cPa273-cPa199-hybrid_cPa273-cPa223-hybrid_cPa450_cPa450-cPa199-hybrid_cPa450-cPa482-hybrid_cPa553_cPa553-cPa199-hybrid_cPa553-cPa223-hybrid_cPa553-cPa345-hybrid,2_2_2_32_1_2_3_2_1_1,102,24
chr3-31055056_31055174,cPa118_cPa15,0.5,2,31055122,31055106,cPa118_cPa15,2_2,118,16
chr3-31580432_31580534,cPa419,1,1,31580482,31580482,cPa419,1,102,0
chr3-31809920_31810022,cPa62-cPa75-hybrid_cPa75,0.384615384615385,3,31810018,31809963,cPa62-cPa75-hybrid_cPa62-HERV-W_repbase_HERV17_LTR17-hybrid_cPa75,5_3_5,102,55
chr3-32142678_32142795,cPa62,0.5,7,32142753,32142726,cPa254_cPa254-cPa293-hybrid_cPa254-unknown_cPa285_cPa62_HERV30_repbase_HERV30I_LTR30-cPa293-hybrid_HERV30_repbase_HERV30I_LTR30-cPa62-hybrid,1_1_1_3_10_1_3,117,27
chr3-32180991_32181123,cPa194_cPa67,0.5,2,32181071,32181041,cPa194_cPa67,1_1,132,30
chr3-32264752_32264854,cPa61,0.571428571428571,2,32264805,32264768,cPa205_cPa61,3_4,102,37
chr3-32267720_32267822,cPa62,0.354838709677419,5,32267794,32267731,cPa62_cPa71-cPa62-hybrid_cPa75_cPa75-cPa62-hybrid_cPa75-unknown,11_4_7_7_2,102,63
chr3-32269441_32269549,cPa75,0.833333333333333,2,32269497,32269491,cPa62-cPa75-hybrid_cPa75,1_5,108,6
chr3-32314632_32314734,cPa391,0.428571428571429,4,32314693,32314679,cPa293_cPa391_cPa391-cPa287-hybrid_cPa426,2_3_1_1,102,14
chr3-32537616_32537718,cPa62,0.974358974358974,2,32537672,32537655,cPa254_cPa62,1_38,102,17
chr3-32582918_32583020,cPa75,0.75,2,32583012,32582952,cPa75_cPa75-unknown,3_1,102,60
chr3-32583132_32583234,cPa75,0.666666666666667,3,32583207,32583145,cPa260-cPa75-hybrid_cPa260-unknown_cPa75,1_2_6,102,62
chr3-32690675_32690799,cPa220,0.307692307692308,7,32690747,32690725,cPa104_cPa18-cPa190-hybrid_cPa18-cPa220-hybrid_cPa190_cPa219-cPa190-hybrid_cPa220_cPa258-cPa220-hybrid,2_2_1_1_2_4_1,124,22
chr3-32889868_32889974,cPa15,0.657142857142857,6,32889943,32889897,cPa118_cPa15_cPa15-cPa118-hybrid_cPa268_cPa268-cPa118-hybrid_cPa268-unknown,4_23_1_2_4_1,106,46
chr3-33190740_33190917,HERV-W_repbase_HERV17_LTR17,0.888888888888889,2,33190913,33190763,cPa75_HERV-W_repbase_HERV17_LTR17,1_8,177,150
chr3-33191456_33192021,HERV-W_repbase_HERV17_LTR17,0.940594059405941,6,33192010,33191476,cPa62-unknown_HERV-W_repbase_HERV17_LTR17_KoRV_AF151794_KoRV_AF151794-unknown_PERV_AJ293656_S71_repbase_HERVS71_LTR6A,1_95_2_1_1_1,565,534
chr3-33192026_33192619,HERV-W_repbase_HERV17_LTR17,0.875,6,33192567,33192031,cPa62-unknown_cPa75_HERV-W_repbase_HERV17_LTR17_HERV-W_repbase_HERV17_LTR17-unknown_KoRV_AF151794_S71_repbase_HERVS71_LTR6A-KoRV_AF151794-hybrid,1_5_77_2_2_1,593,536
chr3-33246489_33246701,cPa62,0.981818181818182,2,33246669,33246518,cPa62_cPa62-unknown,54_1,212,151
chr3-33350788_33350927,cPa315,0.714285714285714,3,33350895,33350831,cPa285-cPa315-hybrid_cPa315_cPa62-cPa254-hybrid,1_5_1,139,64
chr3-33599905_33600007,cPa392_cPa425,0.272727272727273,6,33599965,33599915,cPa254_cPa392_cPa404_cPa404-cPa47-hybrid_cPa425_cPa47,2_3_1_1_3_1,102,50
chr3-33942721_33942832,cPa62,1,1,33942793,33942771,cPa62,7,111,22
chr3-33972945_33973087,cPa62,0.962962962962963,2,33973054,33972993,cPa62_cPa62-unknown,26_1,142,61
chr3-34032206_34032308,cPa363,1,1,34032256,34032244,cPa363,3,102,12
chr3-34059054_34059293,cPa75,0.18,14,34059293,34059093,CAEV_NC001463-cPa62-hybrid_cPa113_cPa260_cPa260-cPa113-hybrid_cPa260-cPa62-hybrid_cPa260-unknown_cPa293_cPa293-cPa113-hybrid_cPa293-cPa260-hybrid_cPa293-cPa62-hybrid_cPa293-unknown_cPa62_cPa75_PERVC_HM159246-cPa260-hybrid,1_1_5_8_6_2_5_1_2_7_1_1_9_1,239,200
chr3-34059549_34059683,cPa260,0.714285714285714,2,34059631,34059571,cPa260_cPa293-cPa260-hybrid,5_2,134,60
chr3-34059687_34059789,cPa260,0.666666666666667,3,34059737,34059699,cPa260_cPa293-cPa260-hybrid_cPa75-cPa260-hybrid,4_1_1,102,38
chr3-34059886_34059988,cPa75-cPa260-hybrid,0.8,2,34059936,34059912,cPa260_cPa75-cPa260-hybrid,1_4,102,24
chr3-34105752_34105866,cPa150_cPa302,0.333333333333333,4,34105814,34105782,cPa150_cPa255_cPa302_cPa479,2_1_2_1,114,32
chr3-34266929_34267031,cPa174_cPa425,0.444444444444444,3,34266979,34266943,cPa174_cPa254-cPa392-hybrid_cPa425,4_1_4,102,36
chr3-34605337_34605439,cPa71,1,1,34605431,34605337,cPa71,48,102,94
chr3-36329104_36329208,cPa323_cPa323-cPa568-hybrid_cPa333_cPa371-cPa568-hybrid,0.25,4,36329156,36329154,cPa323_cPa323-cPa568-hybrid_cPa333_cPa371-cPa568-hybrid,1_1_1_1,104,2
chr3-36700812_36700914,cPa14_cPa4_cPa541,0.333333333333333,3,36700862,36700862,cPa14_cPa4_cPa541,1_1_1,102,0
chr3-37076752_37076854,cPa62,1,1,37076828,37076795,cPa62,5,102,33
chr3-37133653_37133756,cPa104-cPa18-hybrid_cPa220,0.5,2,37133704,37133703,cPa104-cPa18-hybrid_cPa220,1_1,103,1
chr3-37245131_37245435,cPa75,0.785714285714286,4,37245383,37245181,cPa260_cPa293-cPa75-hybrid_cPa62_cPa75,1_1_1_11,304,202
chr3-37246262_37246364,cPa75,1,1,37246327,37246312,cPa75,2,102,15
chr3-37246392_37246494,cPa75,1,1,37246442,37246442,cPa75,1,102,0
chr3-37246791_37246993,cPa75,0.6,3,37246941,37246841,cPa260_cPa293-cPa75-hybrid_cPa75,1_1_3,202,100
chr3-37247086_37247188,cPa75,1,1,37247136,37247136,cPa75,1,102,0
chr3-37717942_37718044,cPa62,0.966666666666667,2,37717998,37717958,cPa419_cPa62,1_29,102,40
chr3-3782415_3782517,cPa542_cPa553,0.5,2,3782479,3782465,cPa542_cPa553,1_1,102,14
chr3-37906498_37906600,cPa392,1,1,37906548,37906548,cPa392,1,102,0
chr3-37907001_37907129,cPa392,1,1,37907120,37907047,cPa392,9,128,73
chr3-37907218_37907320,cPa392,1,1,37907274,37907217,cPa392,4,102,57
chr3-37907774_37908617,cPa392,0.909090909090909,5,37908614,37907823,cPa152-unknown_cPa392_HML1a_repbase_HERV-K14CI_LTR14C-cPa125-hybrid_HML1a_repbase_HERV-K14CI_LTR14C-cPa371-hybrid_MDEV_AF053745,1_160_5_1_9,843,791
chr3-37908698_37908811,cPa392,1,1,37908759,37908729,cPa392,16,113,30
chr3-37908892_37909021,cPa392,0.95,2,37908985,37908912,cPa392_MDEV_AF053745,19_1,129,73
chr3-37909035_37909137,cPa392,1,1,37909092,37909069,cPa392,6,102,23
chr3-37988008_37988110,cPa492,1,1,37988060,37988037,cPa492,6,102,23
chr3-38022320_38022423,cPa540,0.558139534883721,10,38022376,38022354,cPa11_cPa11-cPa127-hybrid_cPa290_cPa515_cPa515-cPa127-hybrid_cPa530_cPa530-cPa127-hybrid_cPa540_cPa540-cPa127-hybrid_cPa540-unknown,6_1_4_3_1_1_1_24_1_1,103,22
chr3-38070623_38070725,cPa62,1,1,38070673,38070628,cPa62,42,102,45
chr3-38213998_38214100,cPa529,0.666666666666667,2,38214068,38214048,cPa247-cPa14-hybrid_cPa529,1_2,102,20
chr3-38317470_38317572,cPa62,0.976744186046512,2,38317547,38317498,cPa62_cPa62-unknown,42_1,102,49
chr3-38445381_38445493,cPa363,0.5,3,38445450,38445382,cPa363_cPa452_cPa71,3_2_1,112,68
chr3-38673096_38673229,cPa62,1,1,38673200,38673114,cPa62,56,133,86
chr3-39010428_39010567,cPa452,0.333333333333333,6,39010515,39010478,cPa223-cPa176-hybrid_cPa327-unknown_cPa363_cPa363-cPa71-hybrid_cPa452_cPa71,1_1_1_1_3_2,139,37
chr3-39248841_39248945,cPa452,0.444444444444444,4,39248893,39248875,cPa363_cPa363-cPa176-hybrid_cPa452_cPa71,2_1_4_2,104,18
chr3-39287969_39288071,cPa452,0.533333333333333,5,39288060,39288003,cPa363_cPa452_cPa71_cPa71-cPa363-hybrid_cPa71-cPa452-hybrid,28_40_4_2_1,102,57
chr3-39406922_39407104,cPa75,0.588235294117647,8,39407080,39406924,cPa62-cPa75-hybrid_cPa62-HERV-W_repbase_HERV17_LTR17-hybrid_cPa62-unknown_cPa75_cPa75-HERV-W_repbase_HERV17_LTR17-hybrid_cPa75-unknown_HERV-W_repbase_HERV17_LTR17_HERV-W_repbase_HERV17_LTR17-unknown,1_1_7_40_1_4_10_4,182,156
chr3-39407135_39407237,cPa75,0.333333333333333,5,39407186,39407139,cPa62-unknown_cPa75_HERV-F_repbase_HERVFH19I_LTR19A_HERV-W_repbase_HERV17_LTR17_KoRV_AF151794-S71_repbase_HERVS71_LTR6A-hybrid,1_2_1_1_1,102,47
chr3-39669418_39669520,cPa62,1,1,39669495,39669441,cPa62,21,102,54
chr3-39727226_39727342,cPa199,0.895833333333333,2,39727307,39727276,cPa199_cPa254-unknown,43_5,116,31
chr3-39765389_39765491,cPa15,0.529411764705882,9,39765463,39765398,cPa118_cPa118-cPa15-hybrid_cPa118-cPa264-hybrid_cPa118-cPa268-hybrid_cPa118-unknown_cPa15_cPa15-cPa264-hybrid_cPa268_cPa268-unknown,9_2_5_2_1_27_1_3_1,102,65
chr3-39835598_39835700,cPa174_cPa47,0.166666666666667,11,39835655,39835598,cPa174_cPa254_cPa254-cPa174-hybrid_cPa392_cPa404_cPa404-cPa174-hybrid_cPa404-cPa254-hybrid_cPa425_cPa425-cPa174-hybrid_cPa47_cPa47-cPa174-hybrid,3_2_1_1_2_1_1_2_1_3_1,102,57
chr3-40052283_40052385,BIV_NC001413,0.875,2,40052333,40052295,BIV_NC001413_CAEV_NC001463,14_2,102,38
chr3-40199753_40199870,cPa75,0.4,4,40199822,40199767,cPa75_cPa75-unknown_HERV-W_repbase_HERV17_LTR17-cPa62-hybrid_HERV-W_repbase_HERV17_LTR17-cPa75-hybrid,4_3_1_2,117,55
chr3-40200204_40200306,cPa75,0.666666666666667,2,40200306,40200254,cPa75_cPa75-cPa62-hybrid,2_1,102,52
chr3-40381131_40381233,cPa117,0.5,3,40381219,40381145,cPa117_cPa117-unknown_cPa452,2_1_1,102,74
chr3-40381322_40381524,cPa117,0.584615384615385,5,40381475,40381356,cPa117_cPa117-cPa452-hybrid_cPa363_cPa452_cPa452-cPa117-hybrid,38_1_1_24_1,202,119
chr3-40785025_40785161,HERV-W_repbase_HERV17_LTR17,0.888888888888889,2,40785124,40785024,HERV-W_repbase_HERV17_LTR17_KoRV_AF151794,8_1,136,100
chr3-40785183_40785715,HERV-W_repbase_HERV17_LTR17,0.767857142857143,4,40785663,40785183,HERV-W_repbase_HERV17_LTR17_HERV-W_repbase_HERV17_LTR17-cPa75-hybrid_HERV-W_repbase_HERV17_LTR17-unknown_KoRV_AF151794,43_1_10_2,532,480
chr3-41519497_41519599,cPa47,0.5,9,41519563,41519523,cPa174-cPa425-hybrid_cPa174-unknown_cPa254_cPa254-cPa404-hybrid_cPa254-unknown_cPa392-unknown_cPa404_cPa425_cPa47,2_3_23_2_2_1_2_2_37,102,40
chr3-41539707_41539809,HERV-W_repbase_HERV17_LTR17,1,1,41539758,41539756,HERV-W_repbase_HERV17_LTR17,3,102,2
chr3-41540362_41540464,cPa75,1,1,41540412,41540412,cPa75,1,102,0
chr3-41679423_41679525,cPa15,0.333333333333333,5,41679475,41679462,cPa118_cPa15_cPa248-cPa118-hybrid_cPa248-unknown_cPa268-unknown,1_2_1_1_1,102,13
chr3-41911412_41911526,cPa118_cPa15_cPa443,0.333333333333333,3,41911474,41911462,cPa118_cPa15_cPa443,1_1_1,114,12
chr3-41917223_41917325,HERV-W_repbase_HERV17_LTR17-unknown,1,1,41917273,41917273,HERV-W_repbase_HERV17_LTR17-unknown,1,102,0
chr3-42338636_42338743,cPa254_cPa47,0.4,3,42338693,42338686,cPa174_cPa254_cPa47,1_2_2,107,7
chr3-42360958_42361060,cPa62,0.944444444444444,2,42361030,42361005,cPa62_cPa62-unknown,17_1,102,25
chr3-42653733_42653846,cPa15,0.625,4,42653804,42653782,cPa118_cPa15_cPa268_cPa268-cPa118-hybrid,3_10_1_2,113,22
chr3-42877795_42877897,cPa62,1,1,42877857,42877839,cPa62,9,102,18
chr3-43105043_43105145,cPa15,0.578947368421053,4,43105101,43105047,cPa118_cPa15_cPa248-unknown_cPa443-cPa118-hybrid,6_11_1_1,102,54
chr3-43122861_43122963,cPa254-cPa404-hybrid,0.3,5,43122926,43122905,cPa174-cPa404-hybrid_cPa254_cPa254-cPa404-hybrid_cPa425_cPa47,2_1_3_2_2,102,21
chr3-43286381_43286552,cPa104,0.461538461538462,14,43286539,43286431,ALVJ_Z46390-cPa104-hybrid_ALVJ_Z46390-cPa220-hybrid_ALVJ_Z46390-unknown_cPa104_cPa190_cPa219_cPa219-cPa220-hybrid_cPa219-unknown_cPa220_cPa220-cPa190-hybrid_cPa220-unknown_cPa258-cPa104-hybrid_cPa258-cPa190-hybrid_cPa258-cPa220-hybrid,2_4_1_42_8_10_1_1_15_1_1_1_1_3,171,108
chr3-43386699_43386809,cPa75-cPa62-hybrid,0.5,3,43386774,43386706,cPa75_cPa75-cPa62-hybrid_HERV-W_repbase_HERV17_LTR17-cPa62-hybrid,1_4_3,110,68
chr3-43386850_43387065,cPa75-cPa62-hybrid,0.4,4,43387013,43386900,cPa260_cPa75_cPa75-cPa62-hybrid_cPa75-unknown,1_1_2_1,215,113
chr3-43387066_43387168,cPa260-cPa62-hybrid_cPa75,0.5,2,43387116,43387068,cPa260-cPa62-hybrid_cPa75,1_1,102,48
chr3-43677485_43677587,cPa75,1,1,43677535,43677535,cPa75,1,102,0
chr3-43678675_43678819,cPa75,1,1,43678767,43678725,cPa75,2,144,42
chr3-43736561_43736663,cPa254,0.3,7,43736636,43736606,cPa174_cPa174-cPa404-hybrid_cPa254_cPa254-cPa404-hybrid_cPa425_cPa425-cPa404-hybrid_cPa47,3_5_15_4_12_5_6,102,30
chr3-44000421_44000523,cPa273-HML4_repbase_HERVK13I_LTR13-hybrid,1,1,44000471,44000471,cPa273-HML4_repbase_HERVK13I_LTR13-hybrid,1,102,0
chr3-44247658_44247762,cPa287-cPa426-hybrid_cPa293_cPa391,0.25,5,44247710,44247660,cPa287-cPa426-hybrid_cPa287-unknown_cPa293_cPa391_cPa426,2_1_2_2_1,104,50
chr3-44277069_44277183,cPa456,0.375,6,44277132,44277086,cPa363_cPa452_cPa456_cPa456-cPa452-hybrid_cPa587-cPa117-hybrid_cPa75-cPa117-hybrid,4_3_6_1_1_1,114,46
chr3-44603384_44603486,cPa118_cPa125_cPa15,0.333333333333333,3,44603434,44603424,cPa118_cPa125_cPa15,1_1_1,102,10
chr3-44782759_44782861,cPa62,1,1,44782809,44782809,cPa62,1,102,0
chr3-45121049_45121151,cPa315_cPa456_cPa587,0.333333333333333,3,45121099,45121054,cPa315_cPa456_cPa587,1_1_1,102,45
chr3-45451893_45451995,cPa75,0.423076923076923,5,45451985,45451926,cPa75_cPa75-cPa62-hybrid_HERV-W_repbase_HERV17_LTR17_HERV-W_repbase_HERV17_LTR17-cPa62-hybrid_S71_repbase_HERVS71_LTR6A-PERV_AJ293656-hybrid,11_3_4_7_1,102,59
chr3-45871928_45872030,cPa419,1,1,45871978,45871978,cPa419,1,102,0
chr3-45944496_45944606,cPa456,0.490196078431373,12,45944597,45944505,cPa117-cPa363-hybrid_cPa117-cPa456-hybrid_cPa117-cPa587-hybrid_cPa285-cPa587-hybrid_cPa363_cPa363-cPa587-hybrid_cPa452_cPa452-cPa363-hybrid_cPa452-cPa456-hybrid_cPa452-cPa587-hybrid_cPa452-unknown_cPa456,8_1_13_1_28_2_1_7_1_15_1_75,110,92
chr3-4594524_4594626,cPa15,0.5,3,4594575,4594564,cPa118-unknown_cPa15_cPa268,1_2_1,102,11
chr3-46009503_46009605,cPa395,0.512820512820513,14,46009605,46009521,cPa270-cPa511-hybrid_cPa270-cPa572-hybrid_cPa395_cPa395-cPa270-hybrid_cPa395-cPa472-hybrid_cPa395-cPa572-hybrid_cPa472_cPa472-cPa572-hybrid_cPa511_cPa511-cPa472-hybrid_cPa527-cPa270-hybrid_cPa572_cPa572-cPa511-hybrid_cPa575,2_2_40_1_4_1_7_1_11_1_1_3_1_3,102,84
chr3-46009728_46009845,cPa395,0.5,6,46009840,46009741,cPa395_cPa472_cPa511_cPa527_cPa572_cPa575-cPa572-hybrid,6_1_2_1_1_1,117,99
chr3-46009854_46009956,cPa395_cPa511,0.272727272727273,7,46009904,46009854,cPa270-cPa395-hybrid_cPa395_cPa472_cPa511_cPa527-cPa270-hybrid_cPa543_cPa575-cPa472-hybrid,1_3_1_3_1_1_1,102,50
chr3-46011193_46011295,HFV_NC001736,0.75,2,46011278,46011218,cPa270_HFV_NC001736,1_3,102,60
chr3-46020731_46020833,cPa392,0.9,2,46020821,46020776,cPa392_cPa392-cPa285-hybrid,9_1,102,45
chr3-46021396_46021501,cPa392,0.6,3,46021497,46021446,cPa392_cPa402_HERV-ADP_repbase_HERVP71A_I_LTR71A,3_1_1,105,51
chr3-46023815_46023917,cPa392,0.916666666666667,2,46023917,46023838,cPa392_cPa419,11_1,102,79
chr3-46025694_46025796,cPa392,1,1,46025744,46025744,cPa392,1,102,0
chr3-46271524_46271626,cPa113,0.666666666666667,2,46271574,46271571,cPa113_cPa75,2_1,102,3
chr3-46526230_46526348,cPa62,0.933333333333333,3,46526304,46526280,cPa419_cPa62_EqFV_NC002201-cPa62-hybrid,1_28_1,118,24
chr3-46825209_46825361,cPa254-cPa117-hybrid_cPa254-cPa456-hybrid,0.307692307692308,7,46825334,46825230,cPa174-cPa117-hybrid_cPa254-cPa117-hybrid_cPa254-cPa456-hybrid_cPa425-cPa117-hybrid_cPa425-cPa456-hybrid_cPa425-unknown_cPa47-cPa456-hybrid,1_4_4_1_1_1_1,152,104
chr3-46839181_46839296,cPa75_cPa75-cPa62-hybrid,0.5,2,46839244,46839231,cPa75_cPa75-cPa62-hybrid,2_2,115,13
chr3-46840172_46840274,cPa75-cPa62-hybrid,1,1,46840222,46840222,cPa75-cPa62-hybrid,1,102,0
chr3-47348500_47348602,cPa131-cPa438-hybrid,0.4,4,47348552,47348540,cPa131-cPa438-hybrid_cPa255_cPa478_cPa479-cPa438-hybrid,2_1_1_1,102,12
chr3-47942592_47942694,cPa16,1,1,47942642,47942610,cPa16,5,102,32
chr3-47942814_47942916,cPa16,0.75,2,47942866,47942853,cPa16_cPa260,3_1,102,13
chr3-47988753_47988855,cPa402,1,1,47988828,47988803,cPa402,4,102,25
chr3-48112757_48112874,cPa220,0.375,5,48112822,48112767,cPa104_cPa219_cPa220_cPa258-cPa104-hybrid_cPa419,1_2_3_1_1,117,55
chr3-48118458_48118560,cPa174-cPa47-hybrid,0.363636363636364,5,48118508,48118507,cPa174_cPa174-cPa254-hybrid_cPa174-cPa47-hybrid_cPa254_cPa404,1_3_4_1_2,102,1
chr3-4831761_4831863,cPa62,1,1,4831853,4831811,cPa62,2,102,42
chr3-4835635_4835767,cPa75,1,1,4835715,4835685,cPa75,4,132,30
chr3-4835813_4835968,cPa75,1,1,4835919,4835863,cPa75,13,155,56
chr3-4836023_4836127,cPa75,1,1,4836084,4836055,cPa75,6,104,29
chr3-4837128_4837264,cPa62,0.909090909090909,2,4837227,4837166,cPa62_cPa75,30_3,136,61
chr3-4838416_4838518,cPa62-cPa75-hybrid,1,1,4838466,4838466,cPa62-cPa75-hybrid,1,102,0
chr3-48504562_48504670,cPa15,0.5,4,48504623,48504612,cPa118_cPa118-cPa15-hybrid_cPa118-unknown_cPa15,2_1_1_4,108,11
chr3-48550160_48550262,cPa254_cPa47,0.5,2,48550210,48550210,cPa254_cPa47,1_1,102,0
chr3-48599550_48599663,cPa452,0.479591836734694,11,48599661,48599570,cPa176_cPa183-cPa16-hybrid_cPa363_cPa363-cPa16-hybrid_cPa363-cPa71-hybrid_cPa363-unknown_cPa452_cPa71_cPa71-cPa16-hybrid_cPa71-cPa363-hybrid_cPa71-unknown,1_1_65_3_2_1_94_26_1_1_1,113,91
chr3-48656698_48656800,cPa62,1,1,48656753,48656735,cPa62,3,102,18
chr3-48858956_48859058,cPa174_cPa425-unknown,0.5,2,48859012,48859006,cPa174_cPa425-unknown,1_1,102,6
chr3-49207293_49207408,RELIK_ERVK-cPa287-hybrid,0.428571428571429,4,49207362,49207340,cPa293_cPa391_cPa426_RELIK_ERVK-cPa287-hybrid,1_2_1_3,115,22
chr3-49345610_49345791,HERV-W_repbase_HERV17_LTR17,0.6,3,49345739,49345656,cPa62-HERV-W_repbase_HERV17_LTR17-hybrid_cPa75-cPa113-hybrid_HERV-W_repbase_HERV17_LTR17,1_1_3,181,83
chr3-49345863_49345965,cPa62-cPa113-hybrid,1,1,49345913,49345913,cPa62-cPa113-hybrid,1,102,0
chr3-49346168_49346301,cPa75,0.375,5,49346286,49346218,cPa113_cPa62-cPa113-hybrid_cPa62-HERV-W_repbase_HERV17_LTR17-hybrid_cPa75_HERV-W_repbase_HERV17_LTR17,1_1_1_3_2,133,68
chr3-49399984_49400086,HERV-W_repbase_HERV17_LTR17,1,1,49400034,49400034,HERV-W_repbase_HERV17_LTR17,1,102,0
chr3-49400357_49400553,HERV-W_repbase_HERV17_LTR17,1,1,49400501,49400407,HERV-W_repbase_HERV17_LTR17,2,196,94
chr3-49412677_49412779,cPa285,0.666666666666667,2,49412727,49412699,cPa285_cPa293,2_1,102,28
chr3-49512622_49512724,cPa62,1,1,49512672,49512672,cPa62,1,102,0
chr3-4956400_4956502,cPa75_cPa75-unknown,0.5,2,4956497,4956450,cPa75_cPa75-unknown,1_1,102,47
chr3-4956555_4956657,cPa75,1,1,4956605,4956605,cPa75,1,102,0
chr3-4956810_4956912,cPa75,1,1,4956908,4956860,cPa75,2,102,48
chr3-4957849_4957951,cPa75,1,1,4957925,4957867,cPa75,4,102,58
chr3-4958025_4958127,cPa62-cPa75-hybrid,0.666666666666667,2,4958086,4958067,cPa62-cPa75-hybrid_cPa62-unknown,2_1,102,19
chr3-49698447_49698549,PERVC_HM159246-cPa449-hybrid,0.4,4,49698539,49698450,cPa413-cPa447-hybrid_cPa413-cPa469-hybrid_cPa449-cPa450-hybrid_PERVC_HM159246-cPa449-hybrid,1_1_1_2,102,89
chr3-49699553_49699861,cPa449,0.388888888888889,8,49699853,49699562,cPa363_cPa413-cPa447-hybrid_cPa447_cPa449_cPa449-cPa447-hybrid_cPa450-cPa456-hybrid_cPa452-cPa227-hybrid_cPa456,1_1_4_7_1_1_1_2,308,291
chr3-49699899_49700001,cPa449,0.4,4,49700000,49699911,cPa177-cPa227-hybrid_cPa447_cPa449_PERVC_HM159246-cPa447-hybrid,1_1_2_1,102,89
chr3-49976569_49976689,cPa167,0.823529411764706,3,49976637,49976619,cPa167_cPa167-unknown_cPa419,14_2_1,120,18
chr3-50108345_50108456,cPa113,0.636363636363636,4,50108454,50108389,cPa113_cPa75-cPa113-hybrid_cPa75-cPa67-hybrid_cPa75-unknown,7_1_2_1,111,65
chr3-50377271_50377373,cPa219_cPa258,0.230769230769231,6,50377322,50377273,cPa219_cPa219-cPa190-hybrid_cPa220_cPa220-cPa104-hybrid_cPa220-cPa190-hybrid_cPa258,3_2_2_1_2_3,102,49
chr3-50507387_50507489,cPa104-cPa219-hybrid,0.347826086956522,9,50507469,50507429,cPa104_cPa104-cPa219-hybrid_cPa104-cPa220-hybrid_cPa104-cPa258-hybrid_cPa104-cPa62-hybrid_cPa104-unknown_cPa190_cPa190-cPa219-hybrid_cPa220,3_24_3_2_1_1_11_9_15,102,40
chr3-50538291_50538393,cPa75,0.818181818181818,3,50538357,50538341,cPa413-cPa75-hybrid_cPa75_cPa75-cPa62-hybrid,1_9_1,102,16
chr3-50540044_50540146,cPa62,0.944444444444444,3,50540136,50540054,cPa293-cPa62-hybrid_cPa62_cPa75-cPa62-hybrid,1_34_1,102,82
chr3-50586827_50586934,cPa452,0.375,6,50586882,50586865,cPa183-cPa452-hybrid_cPa363_cPa452_cPa452-cPa363-hybrid_cPa452-unknown_cPa71,1_5_9_4_1_4,107,17
chr3-50798730_50798832,cPa255-cPa302-hybrid,0.421052631578947,7,50798784,50798758,cPa246_cPa255-cPa150-hybrid_cPa255-cPa302-hybrid_cPa255-unknown_cPa438-cPa302-hybrid_cPa479-cPa150-hybrid_cPa479-unknown,1_3_8_4_1_1_1,102,26
chr3-50872169_50872271,cPa62,0.972972972972973,2,50872234,50872209,cPa419_cPa62,1_36,102,25
chr3-5098059_5098177,cPa75-unknown,0.6,3,5098158,5098062,cPa260-cPa308-hybrid_cPa62-cPa308-hybrid_cPa75-unknown,1_1_3,118,96
chr3-51036045_51036151,cPa452,0.555555555555556,9,51036141,51036072,cPa223-cPa363-hybrid_cPa223-unknown_cPa363_cPa363-cPa176-hybrid_cPa452_cPa452-cPa363-hybrid_cPa71_cPa71-cPa176-hybrid_cPa71-cPa363-hybrid,1_2_5_1_20_1_4_1_1,106,69
chr3-51089072_51089174,cPa75,1,1,51089122,51089122,cPa75,1,102,0
chr3-51168144_51168246,cPa62,1,1,51168202,51168187,cPa62,6,102,15
chr3-51271778_51271880,cPa62,1,1,51271828,51271827,cPa62,2,102,1
chr3-51336611_51336747,cPa62,1,1,51336739,51336661,cPa62,28,136,78
chr3-52345041_52345148,cPa450,0.456647398843931,16,52345134,52345045,cPa223_cPa227_cPa273-cPa223-hybrid_cPa273-cPa553-hybrid_cPa345_cPa450_cPa450-cPa223-hybrid_cPa450-cPa345-hybrid_cPa450-cPa553-hybrid_cPa450-unknown_cPa542-cPa223-hybrid_cPa542-unknown_cPa553_cPa553-cPa223-hybrid_cPa553-cPa345-hybrid_cPa553-cPa450-hybrid,1_1_8_1_2_79_4_1_1_3_6_2_38_23_2_1,107,89
chr3-52922200_52922302,cPa419,1,1,52922250,52922250,cPa419,1,102,0
chr3-53025002_53025112,cPa117,0.777777777777778,2,53025090,53025036,cPa117_cPa452,7_2,110,54
chr3-53103431_53103571,HERV-W_repbase_HERV17_LTR17,0.613636363636364,10,53103535,53103432,cPa75_cPa75-KoRV_AF151794-hybrid_cPa75-unknown_HERV-W_repbase_HERV17_LTR17_HERV-W_repbase_HERV17_LTR17-unknown_KoRV_AF151794_KoRV_AF151794-HERV-F_repbase_HERVFH19I_LTR19A-hybrid_KoRV_AF151794-unknown_PERV_AJ293656_S71_repbase_HERVS71_LTR6A-unknown,6_1_2_27_1_1_2_1_2_1,140,103
chr3-53103615_53103766,HERV-W_repbase_HERV17_LTR17,0.566265060240964,10,53103755,53103639,cPa62_cPa67_cPa75_cPa75-cPa62-hybrid_cPa75-PERV_AJ293656-hybrid_cPa75-unknown_HERV-W_repbase_HERV17_LTR17_HERV-W_repbase_HERV17_LTR17-unknown_KoRV_AF151794_PERV_AJ293656,1_1_22_5_1_2_47_1_2_1,151,116
chr3-53103771_53103873,HERV-W_repbase_HERV17_LTR17,0.7,3,53103852,53103785,cPa75_cPa75-unknown_HERV-W_repbase_HERV17_LTR17,2_1_7,102,67
chr3-53145171_53145273,cPa452,0.5,3,53145234,53145221,cPa363_cPa452_cPa71,7_9_2,102,13
chr3-53250851_53250953,cPa447,0.428571428571429,4,53250908,53250901,cPa339_cPa339-cPa62-hybrid_cPa447_cPa62,2_1_3_1,102,7
chr3-53321580_53321693,cPa254,0.305785123966942,16,53321677,53321589,cPa174_cPa254_cPa254-cPa174-hybrid_cPa254-cPa75-hybrid_cPa404_cPa404-cPa174-hybrid_cPa425_cPa425-cPa174-hybrid_cPa425-cPa254-hybrid_cPa47_cPa47-cPa174-hybrid_cPa47-cPa254-hybrid_cPa47-cPa404-hybrid_cPa47-cPa425-hybrid_cPa47-cPa75-hybrid_cPa47-unknown,13_37_1_1_8_3_8_1_1_7_30_4_1_2_1_3,113,88
chr3-53537924_53538026,cPa492,0.75,2,53538013,53537937,cPa492_cPa492-unknown,6_2,102,76
chr3-5357053_5357155,cPa62,0.923076923076923,2,5357154,5357079,cPa62_cPa75-cPa62-hybrid,12_1,102,75
chr3-53690456_53690595,HERV-W_repbase_HERV17_LTR17,0.6,2,53690543,53690505,cPa75-HERV-W_repbase_HERV17_LTR17-hybrid_HERV-W_repbase_HERV17_LTR17,2_3,139,38
chr3-53690812_53691195,HERV-W_repbase_HERV17_LTR17,0.783783783783784,3,53691155,53690857,cPa62-HERV-W_repbase_HERV17_LTR17-hybrid_cPa75-HERV-W_repbase_HERV17_LTR17-hybrid_HERV-W_repbase_HERV17_LTR17,1_7_29,383,298
chr3-53691276_53691612,HERV-W_repbase_HERV17_LTR17,0.645161290322581,4,53691601,53691326,cPa75-HERV-W_repbase_HERV17_LTR17-hybrid_cPa75-S71_repbase_HERVS71_LTR6A-hybrid_HERV-F_repbase_HERVFH19I_LTR19A-HERV-W_repbase_HERV17_LTR17-hybrid_HERV-W_repbase_HERV17_LTR17,9_1_1_20,336,275
chr3-53691747_53692008,cPa75-HERV-W_repbase_HERV17_LTR17-hybrid,0.571428571428571,2,53691956,53691797,cPa75-HERV-W_repbase_HERV17_LTR17-hybrid_HERV-W_repbase_HERV17_LTR17,4_3,261,159
chr3-53812441_53812614,cPa62,1,1,53812562,53812463,cPa62,34,173,99
chr3-54026652_54026757,cPa62,0.96078431372549,3,54026726,54026674,cPa285-cPa125-hybrid_cPa285-unknown_cPa62,1_1_49,105,52
chr3-54165475_54165585,cPa131-cPa14-hybrid_cPa216,0.5,2,54165533,54165525,cPa131-cPa14-hybrid_cPa216,1_1,110,8
chr3-54180011_54180117,cPa452,0.428571428571429,4,54180065,54180052,cPa363_cPa452_cPa71_cPa71-unknown,2_3_1_1,106,13
chr3-54232537_54232644,cPa447,0.5,3,54232593,54232581,cPa339_cPa339-cPa444-hybrid_cPa447,1_1_2,107,12
chr3-54251374_54251476,cPa15,0.538461538461538,2,54251433,54251396,cPa118_cPa15,6_7,102,37
chr3-5525737_5525848,cPa285_cPa62,0.4,3,5525796,5525773,cPa285_cPa285-cPa62-hybrid_cPa62,2_1_2,111,23
chr3-55361103_55361205,cPa15,0.5,7,55361176,55361106,cPa118_cPa140-cPa118-hybrid_cPa140-cPa15-hybrid_cPa15_cPa248-cPa118-hybrid_cPa248-unknown_cPa268,7_1_1_15_1_3_2,102,70
chr3-55783231_55783333,cPa199,1,1,55783294,55783267,cPa199,11,102,27
chr3-56256162_56256264,cPa118_cPa15,0.444444444444444,3,56256228,56256207,cPa118_cPa118-unknown_cPa15,4_1_4,102,21
chr3-56288673_56288775,cPa125-Cer1_U15406-hybrid,0.625,3,56288731,56288700,cPa125-Cer1_U15406-hybrid_cPa125-cPa449-hybrid_cPa125-unknown,5_1_2,102,31
chr3-56739577_56739826,cPa75,0.71875,6,56739826,56739617,cPa62_cPa62-cPa75-hybrid_cPa62-HERV-W_repbase_HERV17_LTR17-hybrid_cPa62-unknown_cPa71-cPa75-hybrid_cPa75,5_6_1_5_1_46,249,209
chr3-5694554_5694747,cPa553,0.333333333333333,7,5694695,5694604,cPa199_cPa223_cPa273_cPa345_cPa450-cPa113-hybrid_cPa542_cPa553,1_3_1_1_1_1_4,193,91
chr3-5694806_5694950,cPa199_cPa345,0.5,2,5694898,5694856,cPa199_cPa345,1_1,144,42
chr3-57728184_57728348,cPa71,1,1,57728296,57728210,cPa71,4,164,86
chr3-57728619_57728721,cPa71,1,1,57728669,57728669,cPa71,1,102,0
chr3-57817196_57817307,cPa104_cPa190,0.4,3,57817281,57817246,cPa104_cPa190_cPa219,2_2_1,111,35
chr3-57911333_57911435,cPa419,1,1,57911383,57911383,cPa419,1,102,0
chr3-57911445_57911579,cPa150-cPa131-hybrid_cPa150-cPa246-hybrid_cPa478_cPa479,0.25,4,57911527,57911495,cPa150-cPa131-hybrid_cPa150-cPa246-hybrid_cPa478_cPa479,1_1_1_1,134,32
chr3-58168447_58168549,cPa419,1,1,58168497,58168497,cPa419,1,102,0
chr3-58219259_58219726,cPa273,0.188218390804598,54,58219708,58219279,cPa199_cPa199-cPa223-hybrid_cPa199-cPa227-hybrid_cPa199-cPa273-hybrid_cPa199-cPa345-hybrid_cPa199-cPa450-hybrid_cPa223_cPa223-cPa345-hybrid_cPa227_cPa227-cPa223-hybrid_cPa227-cPa273-hybrid_cPa227-cPa345-hybrid_cPa273_cPa273-cPa199-hybrid_cPa273-cPa223-hybrid_cPa273-cPa227-hybrid_cPa273-cPa345-hybrid_cPa345_cPa345-cPa223-hybrid_cPa345-cPa227-hybrid_cPa345-cPa273-hybrid_cPa345-cPa450-hybrid_cPa345-cPa542-hybrid_cPa419_cPa450_cPa450-cPa223-hybrid_cPa450-cPa273-hybrid_cPa450-cPa345-hybrid_cPa450-cPa542-hybrid_cPa482_cPa482-cPa199-hybrid_cPa482-cPa223-hybrid_cPa482-cPa227-hybrid_cPa482-cPa273-hybrid_cPa482-cPa345-hybrid_cPa482-cPa450-hybrid_cPa482-cPa542-hybrid_cPa482-cPa553-hybrid_cPa482-unknown_cPa539_cPa539-cPa223-hybrid_cPa539-cPa227-hybrid_cPa539-cPa345-hybrid_cPa539-unknown_cPa542_cPa542-cPa223-hybrid_cPa553_cPa553-cPa223-hybrid_cPa553-cPa227-hybrid_cPa553-cPa345-hybrid_cPa553-cPa450-hybrid_cPa553-cPa542-hybrid_cPa553-unknown_EIAV_NC001450-cPa223-hybrid,88_19_12_3_3_2_24_1_76_1_1_1_131_2_3_1_2_59_7_7_1_3_1_3_35_13_1_1_1_22_3_28_20_2_5_2_4_2_2_2_7_3_1_2_13_3_56_6_3_2_1_1_3_1,467,429
chr3-58220657_58220759,cPa391,1,1,58220707,58220707,cPa391,1,102,0
chr3-58222578_58222816,cPa152-unknown,0.695652173913043,6,58222789,58222588,cPa106-cPa505-hybrid_cPa152-cPa505-hybrid_cPa152-cPa62-hybrid_cPa152-unknown_cPa419_cPa62,1_2_1_16_2_1,238,201
chr3-58222872_58223058,cPa152-unknown,0.916666666666667,2,58223011,58222909,cPa106-unknown_cPa152-unknown,1_11,186,102
chr3-58428019_58428121,cPa62,0.866666666666667,3,58428093,58428063,cPa254-unknown_cPa62_cPa62-unknown,1_13_1,102,30
chr3-58466627_58466741,cPa15,0.431818181818182,9,58466695,58466673,cPa118_cPa118-cPa15-hybrid_cPa118-cPa268-hybrid_cPa118-unknown_cPa140-cPa268-hybrid_cPa140-unknown_cPa15_cPa268_cPa268-unknown,1_3_6_6_1_2_19_4_2,114,22
chr3-58723115_58723240,cPa456,0.526315789473684,4,58723215,58723165,cPa363_cPa363-cPa452-hybrid_cPa456_cPa587-cPa452-hybrid,11_2_20_5,125,50
chr3-59080092_59080220,cPa15,0.754098360655738,4,59080168,59080098,cPa118_cPa118-cPa15-hybrid_cPa15_cPa268,9_1_46_5,128,70
chr3-59353165_59353267,cPa62,0.775,2,59353258,59353179,cPa62_cPa62-unknown,31_9,102,79
chr3-59405884_59405986,cPa174_cPa254_cPa425_cPa47,0.25,4,59405934,59405934,cPa174_cPa254_cPa425_cPa47,1_1_1_1,102,0
chr3-59667341_59667455,cPa174-cPa392-hybrid_cPa254_cPa425_cPa47-cPa392-hybrid,0.25,4,59667403,59667391,cPa174-cPa392-hybrid_cPa254_cPa425_cPa47-cPa392-hybrid,1_1_1_1,114,12
chr3-59761347_59761449,cPa241,0.333333333333333,7,59761404,59761392,cPa127_cPa127-cPa290-hybrid_cPa241_cPa290_cPa530-cPa290-hybrid_cPa530-cPa540-hybrid_cPa540,3_1_4_1_1_1_1,102,12
chr3-59953543_59953645,cPa62,1,1,59953613,59953563,cPa62,11,102,50
chr3-60175012_60175114,cPa404-cPa174-hybrid,0.315789473684211,6,60175101,60175011,cPa254_cPa404-cPa174-hybrid_cPa404-cPa254-hybrid_cPa425_cPa47_cPa492-cPa174-hybrid,5_6_1_1_4_2,102,90
chr3-60256937_60257039,cPa117,0.857142857142857,3,60256995,60256946,cPa117_cPa75_cPa75-cPa117-hybrid,12_1_1,102,49
chr3-60257287_60257389,cPa117-cPa75-hybrid,1,1,60257337,60257337,cPa117-cPa75-hybrid,1,102,0
chr3-60282443_60282545,cPa62,0.833333333333333,2,60282516,60282493,cPa62_cPa62-unknown,5_1,102,23
chr3-60476706_60476808,cPa542-cPa62-hybrid_cPa553-cPa62-hybrid,0.333333333333333,4,60476802,60476755,cPa450_cPa542_cPa542-cPa62-hybrid_cPa553-cPa62-hybrid,1_1_2_2,102,47
chr3-60476809_60476911,cPa450,0.540983606557377,11,60476876,60476833,cPa199_cPa227_cPa227-cPa199-hybrid_cPa273_cPa450_cPa450-cPa199-hybrid_cPa542_cPa542-cPa199-hybrid_cPa553_cPa553-cPa199-hybrid_cPa553-cPa62-hybrid,2_1_1_1_33_3_1_6_5_7_1,102,43
chr3-61059310_61059412,cPa75,0.7,3,61059408,61059336,cPa62-cPa75-hybrid_cPa75_HERV-W_repbase_HERV17_LTR17,1_21_8,102,72
chr3-61227509_61227611,cPa542-cPa199-hybrid,0.428571428571429,4,61227576,61227547,cPa199_cPa273-unknown_cPa450_cPa542-cPa199-hybrid,1_1_2_3,102,29
chr3-6130202_6130304,cPa308,1,1,6130262,6130210,cPa308,7,102,52
chr3-6139756_6139881,cPa75-unknown,1,1,6139829,6139806,cPa75-unknown,3,125,23
chr3-61416032_61416145,SnRV_NC001724,0.555555555555556,4,61416107,61416058,cPa75_SnRV_NC001724_SnRV_NC001724-cPa75-hybrid_SnRV_NC001724-unknown,2_5_1_1,113,49
chr3-6145902_6146029,cPa492,0.923076923076923,2,6145993,6145906,cPa260_cPa492,1_12,127,87
chr3-61501152_61501254,cPa62,0.75,2,61501202,61501187,cPa254-cPa62-hybrid_cPa62,1_3,102,15
chr3-6206013_6206172,cPa15_cPa268,0.5,2,6206120,6206063,cPa15_cPa268,1_1,159,57
chr3-62189969_62190071,cPa158,0.5,3,62190033,62190019,cPa158_cPa194_cPa67,2_1_1,102,14
chr3-62208783_62208885,cPa62,1,1,62208844,62208787,cPa62,4,102,57
chr3-62435919_62436037,cPa104_cPa190-cPa18-hybrid_cPa190-cPa219-hybrid_cPa220,0.25,4,62435985,62435969,cPa104_cPa190-cPa18-hybrid_cPa190-cPa219-hybrid_cPa220,1_1_1_1,118,16
chr3-62934151_62934253,cPa220,0.5,4,62934201,62934165,cPa190_cPa219-cPa258-hybrid_cPa220_cPa258,1_1_4_2,102,36
chr3-62941331_62941433,cPa15,0.5,5,62941388,62941331,cPa118_cPa118-cPa15-hybrid_cPa15_cPa248-cPa118-hybrid_cPa268-cPa15-hybrid,7_2_11_1_1,102,57
chr3-62964914_62965026,cPa456,0.371428571428571,10,62965021,62964929,cPa117-cPa363-hybrid_cPa117-cPa456-hybrid_cPa117-cPa587-hybrid_cPa117-unknown_cPa363_cPa452-cPa363-hybrid_cPa452-cPa456-hybrid_cPa452-cPa587-hybrid_cPa452-unknown_cPa456,5_4_4_4_18_2_2_3_2_26,112,92
chr3-63005873_63005975,cPa419,1,1,63005923,63005923,cPa419,1,102,0
chr3-63008836_63008955,cPa18_cPa4_cPa541,0.285714285714286,4,63008903,63008886,cPa104-unknown_cPa18_cPa4_cPa541,1_2_2_2,119,17
chr3-63117396_63117512,cPa15,0.416666666666667,5,63117512,63117406,cPa118_cPa118-cPa15-hybrid_cPa118-unknown_cPa15_cPa268,4_3_5_15_9,116,106
chr3-63216911_63217013,cPa434,1,1,63216962,63216961,cPa434,2,102,1
chr3-63217055_63217157,cPa434,1,1,63217106,63217105,cPa434,2,102,1
chr3-63242837_63242939,cPa529,1,1,63242895,63242881,cPa529,6,102,14
chr3-63619993_63620098,cPa450,0.412371134020619,23,63620092,63620007,cPa199_cPa199-cPa227-hybrid_cPa199-cPa273-hybrid_cPa199-cPa450-hybrid_cPa199-cPa542-hybrid_cPa223-cPa199-hybrid_cPa223-cPa227-hybrid_cPa223-cPa273-hybrid_cPa223-cPa450-hybrid_cPa223-cPa542-hybrid_cPa223-cPa553-hybrid_cPa223-unknown_cPa227_cPa227-cPa199-hybrid_cPa345-cPa199-hybrid_cPa450_cPa450-cPa273-hybrid_cPa450-cPa542-hybrid_cPa482-cPa273-hybrid_cPa482-cPa542-hybrid_cPa553_cPa553-cPa199-hybrid_cPa553-cPa273-hybrid,17_3_1_1_4_13_12_9_4_14_3_6_12_2_2_80_1_2_1_1_3_1_2,105,85
chr3-63649835_63649938,cPa62,0.926829268292683,3,63649903,63649847,cPa285-cPa62-hybrid_cPa285-unknown_cPa62,2_1_38,103,56
chr3-64490726_64490877,cPa62,0.503937007874016,8,64490875,64490726,cPa285-cPa402-hybrid_cPa285-cPa62-hybrid_cPa285-unknown_cPa293-unknown_cPa62_cPa75_cPa75-cPa62-hybrid_cPa75-unknown,1_4_1_1_64_15_3_38,151,149
chr3-64605123_64605225,cPa75,1,1,64605202,64605171,cPa75,5,102,31
chr3-65286076_65286188,cPa293_cPa391,0.444444444444444,3,65286136,65286123,cPa293_cPa391_cPa426-unknown,4_4_1,112,13
chr3-65314399_65314559,cPa62,0.844444444444444,3,65314537,65314444,cPa254_cPa62_cPa62-cPa254-hybrid,3_38_4,160,93
chr3-65321013_65321248,cPa62,0.833333333333333,8,65321224,65321016,cPa109_cPa285-cPa75-hybrid_cPa285-unknown_cPa419_cPa62_cPa71_cPa75_cPa75-cPa150-hybrid,1_1_1_1_50_1_4_1,235,208
chr3-65337209_65337313,cPa540,0.375,5,65337261,65337235,cPa127-cPa290-hybrid_cPa127-unknown_cPa290_cPa515_cPa540,1_1_1_2_3,104,26
chr3-65416386_65416488,cPa529,0.625,4,65416439,65416424,cPa14-cPa247-hybrid_cPa14-unknown_cPa529_cPa95-cPa247-hybrid,1_1_5_1,102,15
chr3-65677480_65677593,cPa101_cPa256_cPa582,0.333333333333333,3,65677541,65677530,cPa101_cPa256_cPa582,1_1_1,113,11
chr3-65801177_65801279,cPa75-cPa452-hybrid,1,1,65801227,65801227,cPa75-cPa452-hybrid,1,102,0
chr3-65801392_65801626,cPa363,0.259259259259259,7,65801574,65801394,cPa363_cPa363-cPa117-hybrid_cPa363-cPa452-hybrid_cPa452_cPa587-cPa363-hybrid_cPa587-cPa452-hybrid_cPa75-cPa117-hybrid,7_5_5_6_1_2_1,234,180
chr3-65801871_65801973,cPa363-cPa452-hybrid_cPa587-cPa117-hybrid,0.5,2,65801937,65801921,cPa363-cPa452-hybrid_cPa587-cPa117-hybrid,1_1,102,16
chr3-65818185_65818287,cPa62,1,1,65818235,65818235,cPa62,1,102,0
chr3-66122485_66122590,cPa62,1,1,66122538,66122535,cPa62,2,105,3
chr3-66122606_66122773,cPa62,1,1,66122772,66122656,cPa62,15,167,116
chr3-66204055_66204157,cPa113_cPa75,0.444444444444444,5,66204156,66204101,cPa113_cPa62_cPa62-cPa113-hybrid_cPa75_cPa75-cPa113-hybrid,12_1_1_12_1,102,55
chr3-66205059_66205161,cPa75,0.642857142857143,4,66205161,66205109,cPa62_cPa62-cPa75-hybrid_cPa62-unknown_cPa75,5_1_4_18,102,52
chr3-66205491_66205593,cPa75,0.75,2,66205578,66205497,cPa62-unknown_cPa75,2_6,102,81
chr3-66206332_66206450,cPa62,1,1,66206445,66206362,cPa62,4,118,83
chr3-66206932_66207041,cPa62,0.933333333333333,2,66207040,66206940,cPa62_cPa75-cPa62-hybrid,14_1,109,100
chr3-66207065_66207240,cPa62,0.974358974358974,2,66207222,66207064,cPa285-cPa62-hybrid_cPa62,1_38,175,158
chr3-66439005_66439107,cPa363_cPa456,0.375,4,66439060,66439005,cPa363_cPa456_cPa587-cPa117-hybrid_cPa75-cPa117-hybrid,3_3_1_1,102,55
chr3-66550986_66551088,EIAV_NC001450-cPa260-hybrid,0.5,4,66551036,66551007,cPa260_EIAV_NC001450-cPa260-hybrid_EIAV_NC001450-unknown_WDSV_NC001867,2_6_3_1,102,29
chr3-66603247_66603399,cPa62,1,1,66603347,66603297,cPa62,10,152,50
chr3-66913821_66914103,HERV-W_repbase_HERV17_LTR17,0.363636363636364,15,66914082,66913847,cPa315-PERV_AJ293656-hybrid_cPa75_cPa75-cPa62-hybrid_cPa75-HERV-W_repbase_HERV17_LTR17-hybrid_cPa75-unknown_HERV-W_repbase_HERV17_LTR17_HERV-W_repbase_HERV17_LTR17-cPa62-hybrid_HERV-W_repbase_HERV17_LTR17-cPa75-hybrid_HERV-W_repbase_HERV17_LTR17-unknown_KoRV_AF151794-PERV_AJ293656-hybrid_MoMLV_J02255_MoMLV_J02255-cPa75-hybrid_MoMLV_J02255-unknown_PERV_AJ293656_PERV_AJ293656-HERV-W_repbase_HERV17_LTR17-hybrid,1_10_2_1_3_20_1_2_3_1_2_1_1_6_1,282,235
chr3-66914146_66914269,HERV-W_repbase_HERV17_LTR17,0.454545454545455,7,66914250,66914196,cPa75_cPa75-PERV_AJ293656-hybrid_cPa75-unknown_HERV-W_repbase_HERV17_LTR17_MLV_Mpmv5-HERV-W_repbase_HERV17_LTR17-hybrid_MoMLV_J02255_PERV_AJ293656,1_1_1_5_1_1_1,123,54
chr3-67167744_67167849,cPa62,1,1,67167797,67167744,cPa62,29,105,53
chr3-67212697_67212811,cPa456,0.634146341463415,8,67212769,67212716,cPa363_cPa363-cPa452-hybrid_cPa452_cPa456_cPa456-cPa452-hybrid_cPa587-cPa117-hybrid_cPa587-cPa363-hybrid_cPa75-cPa363-hybrid,6_3_2_26_1_1_1_1,114,53
chr3-67416106_67416208,cPa15,0.6,3,67416168,67416153,cPa118_cPa15_cPa268-unknown,3_6_1,102,15
chr3-67482374_67482476,cPa62,1,1,67482447,67482405,cPa62,4,102,42
chr3-67582016_67582128,cPa363,0.4,4,67582103,67582066,cPa117-unknown_cPa363_cPa452-unknown_cPa456,1_2_1_1,112,37
chr3-67635734_67635836,cPa62,1,1,67635801,67635741,cPa62,23,102,60
chr3-67881824_67881937,cPa15,0.450980392156863,12,67881895,67881831,cPa118_cPa118-cPa140-hybrid_cPa118-cPa15-hybrid_cPa118-cPa516-hybrid_cPa118-unknown_cPa15_cPa15-cPa268-hybrid_cPa443_cPa443-cPa118-hybrid_cPa443-cPa248-hybrid_cPa443-cPa268-hybrid_cPa443-unknown,11_1_1_1_1_23_1_3_1_4_3_1,113,64
chr3-6798670_6798884,HERV-W_repbase_HERV17_LTR17,0.727272727272727,4,6798840,6798669,cPa62-unknown_cPa75_HERV-W_repbase_HERV17_LTR17_HERV-W_repbase_HERV17_LTR17-cPa75-hybrid,1_1_8_1,214,171
chr3-6798938_6799360,HERV-W_repbase_HERV17_LTR17,0.790697674418605,12,6799357,6798945,cPa419_cPa62-cPa75-hybrid_cPa62-HERV-W_repbase_HERV17_LTR17-hybrid_cPa62-KoRV_AF151794-hybrid_cPa62-unknown_cPa75_cPa75-unknown_HERV-W_repbase_HERV17_LTR17_HERV-W_repbase_HERV17_LTR17-cPa71-hybrid_HERV-W_repbase_HERV17_LTR17-cPa75-hybrid_HERV-W_repbase_HERV17_LTR17-unknown_KoRV_AF151794-cPa71-hybrid,1_1_3_1_6_16_1_136_1_4_1_1,422,412
chr3-68267452_68267554,WDSV_NC001867,1,1,68267502,68267472,WDSV_NC001867,4,102,30
chr3-68390938_68391040,cPa142,0.75,2,68390988,68390951,cPa101-unknown_cPa142,1_3,102,37
chr3-68484036_68484138,cPa62,1,1,68484086,68484086,cPa62,1,102,0
chr3-68484139_68484255,cPa260_cPa260-cPa71-hybrid_cPa260-unknown_cPa308_cPa308-cPa62-hybrid_cPa308-cPa71-hybrid_cPa308-cPa75-hybrid_cPa459-cPa75-hybrid,0.125,8,68484239,68484160,cPa260_cPa260-cPa71-hybrid_cPa260-unknown_cPa308_cPa308-cPa62-hybrid_cPa308-cPa71-hybrid_cPa308-cPa75-hybrid_cPa459-cPa75-hybrid,1_1_1_1_1_1_1_1,116,79
chr3-68529964_68530066,cPa118_cPa15_cPa419,0.333333333333333,3,68530014,68529965,cPa118_cPa15_cPa419,1_1_1,102,49
chr3-68707765_68707867,cPa62,1,1,68707838,68707772,cPa62,15,102,66
chr3-68816319_68816487,cPa75,1,1,68816451,68816369,cPa75,3,168,82
chr3-68816695_68816797,cPa75,1,1,68816745,68816745,cPa75,1,102,0
chr3-68987763_68987960,cPa392,0.583333333333333,12,68987945,68987778,cPa152_cPa152-unknown_cPa229-cPa152-hybrid_cPa229-cPa505-hybrid_cPa392_cPa392-cPa152-hybrid_cPa392-unknown_cPa419_cPa419-cPa152-hybrid_cPa419-VISNA_S55323-hybrid_VISNA_S55323_VISNA_S55323-EqFV_NC002201-hybrid,13_1_1_1_35_1_2_2_1_1_1_1,197,167
chr3-69009975_69010077,cPa216-cPa131-hybrid_cPa216-cPa255-hybrid,0.5,2,69010027,69010025,cPa216-cPa131-hybrid_cPa216-cPa255-hybrid,1_1,102,2
chr3-6919543_6919645,cPa553,0.962962962962963,2,6919625,6919592,cPa553_cPa553-unknown,26_1,102,33
chr3-69310722_69310824,cPa163_cPa360,0.5,2,69310772,69310772,cPa163_cPa360,1_1,102,0
chr3-69667675_69667777,cPa308-cPa117-hybrid,1,1,69667725,69667725,cPa308-cPa117-hybrid,1,102,0
chr3-69668751_69668853,cPa363-cPa117-hybrid,1,1,69668801,69668801,cPa363-cPa117-hybrid,1,102,0
chr3-6971157_6971259,cPa345,0.666666666666667,2,6971252,6971207,cPa345_cPa542,2_1,102,45
chr3-69976332_69976434,cPa142,0.928571428571429,2,69976388,69976374,cPa101_cPa142,1_13,102,14
chr3-70141635_70141840,cPa254,0.366666666666667,9,70141791,70141659,cPa174_cPa174-cPa47-hybrid_cPa174-unknown_cPa254_cPa254-cPa47-hybrid_cPa425_cPa425-cPa254-hybrid_cPa425-cPa47-hybrid_cPa47,3_4_1_22_1_10_1_4_14,205,132
chr3-71055670_71055772,cPa142,0.5,3,71055722,71055703,cPa101_cPa142_cPa51-unknown,2_3_1,102,19
chr3-71103173_71103275,cPa75,1,1,71103230,71103223,cPa75,2,102,7
chr3-71103690_71103792,cPa75,1,1,71103740,71103740,cPa75,1,102,0
chr3-71103875_71103977,cPa75,1,1,71103925,71103925,cPa75,1,102,0
chr3-71137450_71137552,cPa529,0.75,3,71137506,71137457,cPa247_cPa247-cPa14-hybrid_cPa529,2_1_9,102,49
chr3-7120882_7121050,cPa446,0.196969696969697,23,7121023,7120881,cPa15-cPa452-hybrid_cPa176_cPa183_cPa183-cPa176-hybrid_cPa183-cPa452-hybrid_cPa183-unknown_cPa223_cPa223-cPa363-hybrid_cPa223-cPa452-hybrid_cPa327_cPa363_cPa363-cPa452-hybrid_cPa379_cPa379-cPa176-hybrid_cPa379-cPa452-hybrid_cPa424-cPa363-hybrid_cPa424-cPa452-hybrid_cPa446_cPa446-cPa363-hybrid_cPa446-cPa452-hybrid_cPa446-unknown_cPa452_cPa518-cPa176-hybrid,1_1_3_1_1_2_1_3_2_2_4_1_6_1_2_2_1_13_1_2_6_9_1,168,142
chr3-71236347_71236451,cPa62-unknown,0.666666666666667,2,71236400,71236397,cPa62-HERV-W_repbase_HERV17_LTR17-hybrid_cPa62-unknown,1_2,104,3
chr3-71569237_71569339,cPa308-cPa117-hybrid,1,1,71569287,71569287,cPa308-cPa117-hybrid,1,102,0
chr3-71669931_71670033,cPa62,1,1,71670009,71669967,cPa62,13,102,42
chr3-7176002_7176165,cPa308,1,1,7176144,7176052,cPa308,5,163,92
chr3-7176193_7176399,cPa308,1,1,7176362,7176243,cPa308,8,206,119
chr3-72451000_72451102,cPa363_cPa419,0.5,2,72451099,72451050,cPa363_cPa419,1_1,102,49
chr3-72614536_72614638,cPa15,0.444444444444444,4,72614607,72614549,cPa118_cPa15_cPa248-cPa118-hybrid_cPa248-unknown,3_4_1_1,102,58
chr3-72855102_72855204,cPa183-unknown_cPa193_cPa229_cPa500,0.25,4,72855152,72855152,cPa183-unknown_cPa193_cPa229_cPa500,1_1_1_1,102,0
chr3-72978442_72978544,cPa308-cPa62-hybrid,1,1,72978521,72978492,cPa308-cPa62-hybrid,4,102,29
chr3-73274537_73274639,cPa542,0.471074380165289,10,73274631,73274539,cPa199_cPa273_cPa273-cPa199-hybrid_cPa450_cPa450-cPa199-hybrid_cPa542_cPa542-cPa199-hybrid_cPa542-unknown_cPa553_cPa553-cPa199-hybrid,7_1_12_8_12_57_6_2_12_4,102,92
chr3-73482181_73482306,cPa75,0.75,4,73482255,73482199,cPa62-cPa75-hybrid_cPa62-HERV-W_repbase_HERV17_LTR17-hybrid_cPa75_HERV-W_repbase_HERV17_LTR17,3_1_15_1,125,56
chr3-73482656_73482771,cPa75,0.666666666666667,2,73482759,73482696,cPa62-cPa75-hybrid_cPa75,3_6,115,63
chr3-73482977_73483347,cPa75,0.644736842105263,5,73483301,73483019,cPa62-cPa75-hybrid_cPa62-HERV-W_repbase_HERV17_LTR17-hybrid_cPa62-KoRV_AF151794-hybrid_cPa75_HERV-W_repbase_HERV17_LTR17,15_6_1_49_5,370,282
chr3-73483395_73483533,cPa75,0.5,3,73483527,73483398,cPa62-cPa75-hybrid_cPa75_HERV-W_repbase_HERV17_LTR17,5_6_1,138,129
chr3-73483841_73483984,cPa75,0.6,2,73483983,73483846,cPa62-cPa75-hybrid_cPa75,2_3,143,137
chr3-73602617_73602719,cPa450,0.313432835820896,18,73602703,73602654,cPa199_cPa199-cPa227-hybrid_cPa199-cPa273-hybrid_cPa199-cPa345-hybrid_cPa199-cPa450-hybrid_cPa199-cPa542-hybrid_cPa199-unknown_cPa223-cPa273-hybrid_cPa223-cPa345-hybrid_cPa223-cPa542-hybrid_cPa227_cPa273_cPa345_cPa450_cPa482-cPa273-hybrid_cPa482-cPa450-hybrid_cPa482-cPa542-hybrid_cPa553,1_1_9_4_1_3_3_1_3_2_1_2_2_21_1_1_1_10,102,49
chr3-7384207_7384309,cPa273,1,1,7384287,7384257,cPa273,2,102,30
chr3-73966184_73966286,cPa75-unknown,0.615384615384615,5,73966276,73966183,cPa75_cPa75-cPa482-hybrid_cPa75-HERV30_repbase_HERV30I_LTR30-hybrid_cPa75-unknown_HERV30_repbase_HERV30I_LTR30,1_2_1_8_1,102,93
chr3-7418033_7418135,cPa75,1,1,7418087,7418074,cPa75,3,102,13
chr3-74440482_74440597,cPa363,0.444444444444444,4,74440545,74440532,cPa363_cPa456_cPa456-cPa452-hybrid_cPa587-cPa117-hybrid,4_3_1_1,115,13
chr3-74595062_74595164,cPa425,0.25,7,74595114,74595103,cPa174_cPa254_cPa404_cPa404-cPa254-hybrid_cPa425_cPa47_cPa47-unknown,1_1_1_1_2_1_1,102,11
chr3-74626875_74626977,cPa450,0.545454545454545,9,74626947,74626886,cPa199_cPa223-cPa273-hybrid_cPa227-cPa273-hybrid_cPa227-cPa553-hybrid_cPa450_cPa482-cPa273-hybrid_cPa482-cPa450-hybrid_cPa482-cPa553-hybrid_cPa553,1_1_1_1_12_1_1_1_3,102,61
chr3-74832707_74832809,cPa62,1,1,74832757,74832757,cPa62,1,102,0
chr3-74868990_74869101,cPa62,0.8125,2,74869056,74869032,cPa62_cPa62-unknown,13_3,111,24
chr3-75105865_75105967,cPa117_cPa363_cPa452,0.333333333333333,3,75105915,75105915,cPa117_cPa363_cPa452,1_1_1,102,0
chr3-75146589_75146701,cPa15,0.375,6,75146688,75146639,cPa118_cPa118-cPa248-hybrid_cPa118-unknown_cPa15_cPa62-cPa125-hybrid_cPa62-cPa248-hybrid,1_1_1_3_1_1,112,49
chr3-75456575_75456747,cPa62,0.933333333333333,2,75456710,75456625,cPa285_cPa62,1_14,172,85
chr3-75533435_75533664,cPa62,0.884615384615385,5,75533656,75533464,cPa285_cPa293_cPa356-unknown_cPa62_cPa62-unknown,1_1_1_46_3,229,192
chr3-75735405_75735518,cPa290_cPa356_cPa515-cPa127-hybrid_cPa515-cPa241-hybrid_cPa540_cPa540-cPa241-hybrid,0.166666666666667,6,75735466,75735451,cPa290_cPa356_cPa515-cPa127-hybrid_cPa515-cPa241-hybrid_cPa540_cPa540-cPa241-hybrid,1_1_1_1_1_1,113,15
chr3-75809741_75809843,cPa62,1,1,75809791,75809791,cPa62,1,102,0
chr3-76001195_76001297,cPa456,0.566666666666667,4,76001269,76001211,cPa363_cPa452-cPa363-hybrid_cPa456_REV_NC006934-cPa363-hybrid,11_1_17_1,102,58
chr3-76017306_76017408,cPa62,1,1,76017389,76017323,cPa62,19,102,66
chr3-76062420_76062522,cPa62,1,1,76062484,76062457,cPa62,20,102,27
chr3-76063679_76063781,cPa62,0.833333333333333,2,76063740,76063727,cPa539_cPa62,1_5,102,13
chr3-76123489_76123591,cPa62,1,1,76123546,76123528,cPa62,3,102,18
chr3-7617587_7617692,cPa62,0.666666666666667,2,7617640,7617636,cPa62_cPa62-cPa75-hybrid,2_1,105,4
chr3-7617777_7617879,cPa62-cPa75-hybrid,1,1,7617827,7617827,cPa62-cPa75-hybrid,1,102,0
chr3-76238766_76238868,cPa150-cPa246-hybrid,0.545454545454545,5,76238829,76238812,cPa150-cPa246-hybrid_cPa150-unknown_cPa216-cPa246-hybrid_cPa246_cPa438-cPa246-hybrid,6_1_1_1_2,102,17
chr3-76283964_76284066,cPa15,0.6,2,76284025,76284014,cPa118_cPa15,2_3,102,11
chr3-76328819_76328932,cPa450,0.37888198757764,15,76328910,76328822,cPa199_cPa223_cPa273_cPa273-cPa199-hybrid_cPa273-cPa223-hybrid_cPa273-unknown_cPa450_cPa450-cPa199-hybrid_cPa450-cPa223-hybrid_cPa450-unknown_cPa542-cPa199-hybrid_cPa542-cPa223-hybrid_cPa553_cPa553-cPa199-hybrid_cPa553-cPa223-hybrid,2_1_7_1_16_1_61_1_10_1_1_6_30_4_19,113,88
chr3-76447749_76447954,cPa62,0.459016393442623,6,76447908,76447799,cPa293_cPa62_cPa62-cPa260-hybrid_cPa62-cPa75-hybrid_cPa62-unknown_cPa75,2_28_4_16_2_9,205,109
chr3-76691667_76691769,cPa492-unknown,1,1,76691717,76691717,cPa492-unknown,1,102,0
chr3-76899061_76899163,cPa71,1,1,76899111,76899111,cPa71,1,102,0
chr3-77003525_77003627,cPa419,1,1,77003575,77003575,cPa419,1,102,0
chr3-77122202_77122307,cPa363_cPa452,0.375,4,77122276,77122252,cPa363_cPa452_cPa452-cPa363-hybrid_cPa71,6_6_1_3,105,24
chr3-77393787_77393964,cPa113,0.4,4,77393912,77393837,cPa113_HTLV1_NC001436-cPa201-hybrid_KWERV_GQ222416_MoMLV_J02255,2_1_1_1,177,75
chr3-77395981_77396083,cPa15,0.615384615384615,5,77396033,77395983,cPa118_cPa118-cPa268-hybrid_cPa118-unknown_cPa15_cPa268,7_5_6_32_2,102,50
chr3-77628216_77628356,cPa101,0.371428571428571,8,77628330,77628254,cPa101_cPa142_cPa256-cPa101-hybrid_cPa256-unknown_cPa582_cPa582-cPa101-hybrid_cPa582-cPa142-hybrid_cPa582-unknown,13_8_1_1_2_2_5_3,140,76
chr3-77820312_77820414,cPa15,0.5,6,77820387,77820314,cPa118_cPa118-cPa248-hybrid_cPa118-cPa268-hybrid_cPa118-unknown_cPa15_cPa15-cPa443-hybrid,5_2_1_1_10_1,102,73
chr3-77879698_77879800,cPa4,0.444444444444444,5,77879758,77879697,cPa14_cPa18-cPa14-hybrid_cPa18-unknown_cPa4_cPa541,1_1_1_4_2,102,61
chr3-77881321_77881427,cPa118_cPa15,0.333333333333333,4,77881376,77881362,cPa118_cPa15_cPa248-cPa264-hybrid_cPa248-cPa443-hybrid,2_2_1_1,106,14
chr3-78317456_78317558,cPa62,0.576923076923077,6,78317508,78317476,cPa254-cPa62-hybrid_cPa285_cPa285-cPa62-hybrid_cPa285-unknown_cPa62_cPa75-cPa62-hybrid,1_3_3_3_15_1,102,32
chr3-78317588_78317690,cPa62,0.666666666666667,6,78317681,78317592,cPa285_cPa285-cPa62-hybrid_cPa419_cPa62_cPa75-cPa62-hybrid_cPa75-unknown,1_3_1_14_1_1,102,89
chr3-78326921_78327023,cPa62,1,1,78326971,78326967,cPa62,2,102,4
chr3-78489147_78489249,cPa456-cPa273-hybrid,0.5,4,78489197,78489148,cPa332-cPa227-hybrid_cPa456-cPa157-hybrid_cPa456-cPa273-hybrid_cPa456-cPa542-hybrid,1_1_3_1,102,49
chr3-79238172_79238274,cPa15,0.5,5,79238230,79238213,cPa118_cPa118-cPa15-hybrid_cPa118-cPa268-hybrid_cPa118-unknown_cPa15,7_1_1_1_10,102,17
chr3-79347134_79347236,cPa583,0.565217391304348,7,79347218,79347137,cPa251_cPa251-cPa358-hybrid_cPa251-cPa583-hybrid_cPa298-cPa358-hybrid_cPa298-unknown_cPa358_cPa583,2_1_1_1_2_3_13,102,81
chr3-79347319_79347421,cPa358_cPa583,0.4,3,79347369,79347330,cPa358_cPa583_PyERV_AF500296-cPa583-hybrid,2_2_1,102,39
chr3-7938465_7938567,cPa62,1,1,7938515,7938500,cPa62,11,102,15
chr3-79442475_79442577,cPa500,0.4375,6,79442540,79442505,cPa183_cPa183-cPa193-hybrid_cPa183-unknown_cPa193_cPa229_cPa500,1_1_2_3_2_7,102,35
chr3-79491996_79492145,cPa62,0.875,4,79492145,79492034,cPa62_cPa62-cPa285-hybrid_cPa62-unknown_cPa75,28_1_1_2,149,111
chr3-79492153_79492544,cPa62,0.656716417910448,7,79492544,79492169,cPa285_cPa419_cPa62_cPa62-cPa285-hybrid_cPa62-cPa75-hybrid_cPa62-unknown_cPa75,1_1_44_1_4_2_14,391,375
chr3-79659391_79659493,cPa62,1,1,79659441,79659441,cPa62,1,102,0
chr3-79689015_79689117,cPa75,0.5625,4,79689117,79689020,cPa62_cPa75_cPa75-cPa62-hybrid_HERV-W_repbase_HERV17_LTR17-cPa62-hybrid,1_9_1_5,102,97
chr3-79758926_79759054,HERV-W_repbase_HERV17_LTR17,0.888888888888889,2,79759034,79758965,cPa62_HERV-W_repbase_HERV17_LTR17,1_8,128,69
chr3-79759256_79759358,cPa75,1,1,79759306,79759306,cPa75,1,102,0
chr3-79783158_79783260,cPa434,1,1,79783208,79783208,cPa434,2,102,0
chr3-79785057_79785159,cPa434,1,1,79785107,79785107,cPa434,1,102,0
chr3-79813533_79813652,cPa15,0.482758620689655,8,79813600,79813536,cPa118_cPa15_cPa248-cPa118-hybrid_cPa248-cPa443-hybrid_cPa248-unknown_cPa268-cPa118-hybrid_cPa443_cPa443-cPa118-hybrid,6_14_3_1_1_1_2_1,119,64
chr3-79832233_79832335,CAEV_NC001463,1,1,79832283,79832283,CAEV_NC001463,1,102,0
chr3-79851208_79851310,cPa62,1,1,79851258,79851258,cPa62,1,102,0
chr3-80301726_80301828,cPa118_cPa15,0.375,4,80301777,80301776,cPa118_cPa15_cPa248-unknown_cPa443-unknown,3_3_1_1,102,1
chr3-80407586_80407688,cPa62,0.7,4,80407660,80407612,cPa419-cPa75-hybrid_cPa62_cPa62-cPa75-hybrid_cPa75,1_14_2_3,102,48
chr3-80554431_80554533,cPa219,0.666666666666667,2,80554481,80554460,cPa104-cPa258-hybrid_cPa219,1_2,102,21
chr3-80554670_80554772,cPa219,0.481481481481481,6,80554746,80554720,cPa104_cPa104-cPa190-hybrid_cPa104-unknown_cPa190_cPa219_cPa220-cPa190-hybrid,8_2_1_1_13_2,102,26
chr3-80565242_80565344,cPa450,0.5,6,80565344,80565245,cPa273-cPa199-hybrid_cPa273-cPa482-hybrid_cPa273-cPa553-hybrid_cPa450_cPa542-cPa553-hybrid_cPa553,3_2_1_10_2_2,102,99
chr3-80793478_80793580,cPa190,0.666666666666667,2,80793536,80793528,cPa190_cPa220,2_1,102,8
chr3-8104843_8104945,cPa75-unknown,0.6,3,8104893,8104871,cPa62-cPa482-hybrid_cPa75-HERV-F_repbase_HERVFH19I_LTR19A-hybrid_cPa75-unknown,1_1_3,102,22
chr3-81238468_81238570,cPa118_cPa15,0.5,2,81238529,81238518,cPa118_cPa15,1_1,102,11
chr3-81343097_81343227,cPa15,0.563380281690141,16,81343208,81343141,cPa118_cPa118-cPa248-hybrid_cPa15_cPa248_cPa248-cPa15-hybrid_cPa248-unknown_cPa264-cPa118-hybrid_cPa264-cPa443-hybrid_cPa268_cPa443_cPa443-cPa118-hybrid_cPa443-cPa248-hybrid_cPa443-cPa268-hybrid_cPa443-unknown_cPa516-cPa118-hybrid_cPa516-cPa248-hybrid,10_1_40_1_1_1_1_1_1_3_5_2_1_1_1_1,130,67
chr3-81493661_81493825,cPa62,0.833333333333333,4,81493779,81493711,cPa285_cPa419_cPa62_cPa62-unknown,3_1_25_1,164,68
chr3-81855826_81855962,cPa62-cPa71-hybrid_cPa62-cPa75-hybrid_cPa75,0.2,7,81855950,81855859,cPa62_cPa62-cPa71-hybrid_cPa62-cPa75-hybrid_cPa71_cPa75_HERV-W_repbase_HERV17_LTR17_KWERV_GQ222416-cPa71-hybrid,1_2_2_1_2_1_1,136,91
chr3-81856510_81856663,cPa62-cPa75-hybrid,0.285714285714286,7,81856644,81856525,cPa62_cPa62-cPa71-hybrid_cPa62-cPa75-hybrid_cPa62-HERV-W_repbase_HERV17_LTR17-hybrid_cPa71_cPa75_PERV_AJ293656,3_1_4_1_2_2_1,153,119
chr3-81856965_81857251,cPa62_cPa62-cPa71-hybrid_cPa75,0.19047619047619,10,81857228,81856973,cPa62_cPa62-cPa71-hybrid_cPa62-cPa75-hybrid_cPa62-HERV-W_repbase_HERV17_LTR17-hybrid_cPa62-unknown_cPa71_cPa71-cPa75-hybrid_cPa75_cPa75-cPa71-hybrid_HERV-W_repbase_HERV17_LTR17,4_4_1_1_1_2_1_4_1_2,286,255
chr3-81966395_81966497,cPa456,1,1,81966445,81966445,cPa456,1,102,0
chr3-81976234_81976336,cPa456,0.472727272727273,9,81976319,81976239,cPa130-cPa452-hybrid_cPa363_cPa363-cPa452-hybrid_cPa363-unknown_cPa452_cPa456_cPa456-cPa452-hybrid_cPa587-cPa452-hybrid_cPa587-cPa456-hybrid,1_15_1_1_5_26_2_3_1,102,80
chr3-82103521_82103623,cPa260,0.6,3,82103590,82103550,cPa260_EIAV_NC001450-cPa260-hybrid_EIAV_NC001450-WDSV_NC001867-hybrid,6_3_1,102,40
chr3-82163820_82163967,cPa529,0.666666666666667,6,82163917,82163841,cPa14-cPa247-hybrid_cPa247_cPa529_cPa95-cPa247-hybrid_cPa95-cPa529-hybrid_cPa95-unknown,1_2_18_2_1_3,147,76
chr3-82178326_82178429,cPa104_cPa18-cPa190-hybrid_cPa219_cPa220-cPa190-hybrid,0.25,4,82178377,82178376,cPa104_cPa18-cPa190-hybrid_cPa219_cPa220-cPa190-hybrid,1_1_1_1,103,1
chr3-82251406_82251508,cPa541,0.45,4,82251473,82251437,cPa14_cPa4_cPa541_cPa541-cPa104-hybrid,7_1_9_3,102,36
chr3-82336479_82336581,cPa174_cPa254-unknown_cPa425_cPa47,0.25,4,82336529,82336529,cPa174_cPa254-unknown_cPa425_cPa47,1_1_1_1,102,0
chr3-82397709_82397811,cPa15,0.666666666666667,3,82397759,82397748,cPa118-cPa248-hybrid_cPa15_cPa443-unknown,1_4_1,102,11
chr3-82426142_82426244,cPa255-cPa150-hybrid,0.304347826086957,9,82426224,82426153,cPa150_cPa255_cPa255-cPa150-hybrid_cPa255-cPa220-hybrid_cPa255-cPa302-hybrid_cPa478_cPa479_cPa479-cPa150-hybrid_cPa479-cPa302-hybrid,2_2_7_1_3_1_5_1_1,102,71
chr3-82467488_82467591,cPa118_cPa118-unknown_cPa15-unknown,0.333333333333333,3,82467554,82467538,cPa118_cPa118-unknown_cPa15-unknown,1_1_1,103,16
chr3-82498755_82498857,cPa426,0.666666666666667,3,82498831,82498805,cPa287_cPa293_cPa426,1_1_4,102,26
chr3-82644982_82645140,cPa75,0.6,3,82645126,82644982,cPa62_cPa62-cPa413-hybrid_cPa75,3_1_6,158,144
chr3-82783147_82783249,HERV-W_repbase_HERV17_LTR17,1,1,82783208,82783197,HERV-W_repbase_HERV17_LTR17,3,102,11
chr3-83059199_83059301,cPa293,0.4,4,83059294,83059249,cPa287-cPa391-hybrid_cPa293_cPa293-cPa391-hybrid_cPa391,1_2_1_1,102,45
chr3-8314592_8314694,HML4_repbase_HERVK13I_LTR13,0.944444444444444,3,8314656,8314637,cPa542-HML4_repbase_HERVK13I_LTR13-hybrid_HML4_repbase_HERVK13I_LTR13_HML4_repbase_HERVK13I_LTR13-unknown,1_34_1,102,19
chr3-83238984_83239089,cPa333,0.446428571428571,8,83239089,83239003,cPa323_cPa323-cPa333-hybrid_cPa323-cPa50-hybrid_cPa333_cPa333-cPa50-hybrid_cPa371-cPa333-hybrid_cPa371-cPa50-hybrid_cPa371-cPa568-hybrid,5_2_3_25_4_1_14_2,105,86
chr3-83314535_83314637,cPa363_cPa452,0.428571428571429,3,83314585,83314584,cPa363_cPa452_cPa71-cPa16-hybrid,3_3_1,102,1
chr3-83434341_83434448,cPa118_cPa15,0.285714285714286,5,83434403,83434391,cPa118_cPa15_cPa248-cPa443-hybrid_cPa248-unknown_cPa443,2_2_1_1_1,107,12
chr3-83435651_83435792,cPa75-cPa62-hybrid,0.5,4,83435788,83435697,cPa75_cPa75-cPa62-hybrid_HERV-W_repbase_HERV17_LTR17_HERV-W_repbase_HERV17_LTR17-cPa62-hybrid,11_15_1_3,141,91
chr3-83436041_83436176,cPa75,0.7,3,83436170,83436091,cPa62_cPa75_cPa75-cPa62-hybrid,1_7_2,135,79
chr3-83436187_83436289,cPa75,1,1,83436237,83436237,cPa75,1,102,0
chr3-83828122_83828224,HERV-W_repbase_HERV17_LTR17,0.5,3,83828172,83828123,cPa62_HERV-W_repbase_HERV17_LTR17_HERV-W_repbase_HERV17_LTR17-cPa62-hybrid,2_3_1,102,49
chr3-83844048_83844199,cPa104_cPa104-unknown_cPa190_cPa219-unknown_cPa220,0.133333333333333,10,83844157,83844047,cPa104_cPa104-cPa190-hybrid_cPa104-cPa419-hybrid_cPa104-unknown_cPa18-cPa190-hybrid_cPa18-unknown_cPa190_cPa219-unknown_cPa220_cPa258-unknown,4_2_1_4_1_3_4_4_4_3,151,110
chr3-84141279_84141391,cPa62,1,1,84141339,84141329,cPa62,2,112,10
chr3-84180467_84180569,cPa14-cPa529-hybrid,1,1,84180517,84180517,cPa14-cPa529-hybrid,1,102,0
chr3-84204891_84204993,cPa254_cPa425_cPa47,0.333333333333333,3,84204941,84204941,cPa254_cPa425_cPa47,1_1_1,102,0
chr3-84214252_84214354,cPa62,1,1,84214302,84214267,cPa62,9,102,35
chr3-84262947_84263049,cPa131_cPa479,0.333333333333333,4,84263007,84262962,cPa131_cPa150-unknown_cPa255_cPa479,3_1_2_3,102,45
chr3-84294125_84294227,cPa419,1,1,84294175,84294175,cPa419,1,102,0
chr3-84448190_84448292,cPa163,0.375,5,84448264,84448240,cPa163_cPa182_cPa224_cPa224-unknown_cPa360,3_1_1_1_2,102,24
chr3-84467423_84467525,cPa363_cPa452,0.333333333333333,4,84467476,84467473,cPa363_cPa452_cPa71_cPa71-cPa16-hybrid,2_2_1_1,102,3
chr3-84499694_84499809,cPa404,0.4,4,84499757,84499737,cPa404_cPa425_cPa47_cPa47-cPa174-hybrid,2_1_1_1,115,20
chr3-84663958_84664060,cPa452,0.351351351351351,8,84664019,84663984,cPa176-cPa16-hybrid_cPa363_cPa419_cPa452_cPa452-unknown_cPa71_cPa71-cPa16-hybrid_cPa71-cPa452-hybrid,2_12_1_13_1_6_1_1,102,35
chr3-84724581_84724685,cPa219,0.333333333333333,6,84724669,84724618,cPa104_cPa18-cPa104-hybrid_cPa18-cPa190-hybrid_cPa219_cPa220_cPa258-cPa190-hybrid,3_1_1_4_2_1,104,51
chr3-84727468_84727570,HERV-I_repbase_HERVI_LTR10B,0.666666666666667,2,84727518,84727512,HERV-I_repbase_HERVI_LTR10B_HML8_repbase_HERVK11I_MER11A,2_1,102,6
chr3-84771745_84771847,cPa75,1,1,84771795,84771795,cPa75,1,102,0
chr3-84772166_84772268,cPa75,0.740740740740741,7,84772255,84772170,cPa260_cPa285-cPa62-hybrid_cPa285-unknown_cPa413-cPa285-hybrid_cPa413-cPa62-hybrid_cPa62_cPa75,1_1_1_1_1_2_20,102,85
chr3-84772334_84772555,cPa75,0.291666666666667,12,84772546,84772356,cPa285_cPa285-cPa62-hybrid_cPa285-cPa75-hybrid_cPa285-unknown_cPa413-cPa285-hybrid_cPa413-cPa62-hybrid_cPa413-cPa75-hybrid_cPa413-unknown_cPa62_cPa75_cPa75-cPa62-hybrid_cPa75-unknown,3_4_3_3_5_9_1_1_19_21_2_1,221,190
chr3-84790815_84791041,cPa75_HERV-W_repbase_HERV17_LTR17-cPa75-hybrid,0.333333333333333,4,84791040,84790865,cPa71-cPa75-hybrid_cPa75_HERV-W_repbase_HERV17_LTR17-cPa75-hybrid_KWERV_GQ222416-cPa75-hybrid,1_2_2_1,226,175
chr3-84791081_84791183,KWERV_GQ222416-cPa75-hybrid,1,1,84791131,84791131,KWERV_GQ222416-cPa75-hybrid,1,102,0
chr3-84791284_84791386,HERV-W_repbase_HERV17_LTR17-cPa75-hybrid,1,1,84791334,84791334,HERV-W_repbase_HERV17_LTR17-cPa75-hybrid,1,102,0
chr3-84865205_84865307,cPa75,0.583333333333333,3,84865277,84865205,cPa62-cPa293-hybrid_cPa62-unknown_cPa75,2_3_7,102,72
chr3-84978329_84978431,cPa62,1,1,84978382,84978367,cPa62,7,102,15
chr3-85023799_85023901,cPa75-cPa113-hybrid,0.333333333333333,5,85023881,85023843,cPa113_cPa419_cPa62_cPa75-cPa113-hybrid_cPa75-unknown,1_1_1_2_1,102,38
chr3-85189678_85189843,cPa15,0.416666666666667,9,85189824,85189728,cPa118_cPa118-unknown_cPa15_cPa443_cPa443-cPa118-hybrid_cPa443-cPa125-hybrid_cPa516-cPa125-hybrid_cPa516-cPa248-hybrid_cPa516-cPa264-hybrid,4_1_10_4_1_1_1_1_1,165,96
chr3-85247307_85247423,cPa47,0.333333333333333,5,85247389,85247357,cPa254_cPa254-cPa174-hybrid_cPa392_cPa425_cPa47,2_1_1_2_3,116,32
chr3-85389160_85389262,cPa419,1,1,85389210,85389210,cPa419,1,102,0
chr3-85620317_85620419,cPa62,0.875,2,85620367,85620320,cPa62_cPa75,7_1,102,47
chr3-85995607_85995710,cPa254,0.266666666666667,8,85995661,85995648,cPa174_cPa254_cPa392_cPa392-cPa174-hybrid_cPa392-cPa404-hybrid_cPa425_cPa47_cPa47-unknown,1_4_1_1_1_3_3_1,103,13
chr3-8620985_8621087,cPa62-unknown,1,1,8621035,8621035,cPa62-unknown,1,102,0
chr3-86467225_86467332,cPa363_cPa452,0.4,3,86467280,86467252,cPa363_cPa452_cPa71,2_2_1,107,28
chr3-86499758_86499860,cPa62,0.970588235294118,2,86499821,86499757,cPa62_cPa62-unknown,33_1,102,64
chr3-86649117_86649222,cPa62,1,1,86649178,86649167,cPa62,8,105,11
chr3-86682807_86682943,cPa62,0.697674418604651,3,86682921,86682807,cPa285_cPa62_cPa62-unknown,12_30_1,136,114
chr3-86761878_86761991,cPa363_cPa452,0.333333333333333,4,86761951,86761928,cPa176_cPa363_cPa452_cPa71,1_2_2_1,113,23
chr3-86814394_86814496,cPa425_cPa425-unknown,0.5,2,86814452,86814436,cPa425_cPa425-unknown,2_2,102,16
chr3-87232897_87233104,cPa456-cPa363-hybrid,0.375,5,87233052,87232939,cPa117_cPa363_cPa452-cPa363-hybrid_cPa456_cPa456-cPa363-hybrid,2_1_1_1_3,207,113
chr3-87233155_87233257,cPa456-cPa363-hybrid,1,1,87233205,87233205,cPa456-cPa363-hybrid,1,102,0
chr3-87233409_87233511,cPa117-cPa75-hybrid,1,1,87233459,87233459,cPa117-cPa75-hybrid,1,102,0
chr3-87233594_87233771,cPa363,0.6,3,87233719,87233593,cPa117-cPa363-hybrid_cPa363_cPa363-cPa452-hybrid,1_3_1,177,126
chr3-87326785_87326887,cPa450,0.428571428571429,5,87326835,87326805,cPa199_cPa273_cPa450_cPa542_cPa542-cPa199-hybrid,1_1_3_1_1,102,30
chr3-87608862_87608964,cPa62,1,1,87608950,87608912,cPa62,12,102,38
chr3-87964771_87964873,cPa157-cPa456-hybrid,1,1,87964823,87964791,cPa157-cPa456-hybrid,5,102,32
chr3-88044537_88044639,cPa62,0.964285714285714,2,88044636,88044580,cPa392-cPa62-hybrid_cPa62,1_27,102,56
chr3-88057003_88057117,cPa456-cPa452-hybrid,0.4,4,88057065,88057030,cPa363_cPa456_cPa456-cPa452-hybrid_cPa587-cPa117-hybrid,1_1_2_1,114,35
chr3-88088769_88088871,cPa363_cPa456,0.333333333333333,4,88088839,88088819,cPa363_cPa452_cPa456_cPa456-cPa452-hybrid,2_1_2_1,102,20
chr3-88671649_88671804,cPa14-cPa258-hybrid_cPa247-cPa258-hybrid,0.5,2,88671752,88671699,cPa14-cPa258-hybrid_cPa247-cPa258-hybrid,1_1,155,53
chr3-88772337_88772439,cPa62,0.931034482758621,3,88772429,88772382,cPa285_cPa62_cPa62-unknown,1_27_1,102,47
chr3-88915632_88915744,cPa456,0.375,4,88915694,88915682,cPa363_cPa363-cPa452-hybrid_cPa452_cPa456,2_1_2_3,112,12
chr3-89413120_89413222,cPa260-cPa62-hybrid_cPa75,0.5,2,89413173,89413170,cPa260-cPa62-hybrid_cPa75,1_1,102,3
chr3-89644663_89644765,cPa293-cPa62-hybrid,0.421052631578947,8,89644764,89644665,cPa260-cPa201-hybrid_cPa260-cPa62-hybrid_cPa260-unknown_cPa293_cPa293-cPa62-hybrid_cPa293-cPa75-hybrid_cPa293-unknown_cPa75,1_1_1_2_8_1_4_1,102,99
chr3-89921214_89921332,cPa75,0.685185185185185,10,89921311,89921257,cPa293_cPa293-cPa71-hybrid_cPa62-cPa293-hybrid_cPa62-cPa71-hybrid_cPa62-cPa75-hybrid_cPa62-unknown_cPa71_cPa75_cPa75-unknown_HFV_NC001736-cPa71-hybrid,1_1_1_3_1_1_7_37_1_1,118,54
chr3-90495470_90495572,cPa450,0.491803278688525,16,90495561,90495482,cPa199_cPa199-cPa273-hybrid_cPa199-cPa553-hybrid_cPa199-unknown_cPa223-cPa227-hybrid_cPa223-cPa273-hybrid_cPa223-cPa450-hybrid_cPa223-cPa542-hybrid_cPa223-cPa553-hybrid_cPa227-cPa273-hybrid_cPa345-cPa273-hybrid_cPa450_cPa482-cPa273-hybrid_cPa553_cPa553-cPa273-hybrid_cPa553-cPa450-hybrid,6_6_1_3_1_9_2_1_2_2_7_60_2_17_2_1,102,79
chr3-90895498_90895600,cPa529,0.6875,5,90895565,90895538,cPa247_cPa247-cPa14-hybrid_cPa529_cPa529-cPa95-hybrid_cPa95,2_1_11_1_1,102,27
chr3-91081492_91081594,cPa75,0.5,3,91081549,91081535,cPa71-unknown_cPa75_cPa75-unknown,1_2_1,102,14
chr3-91081975_91082077,cPa75-HERV30_repbase_HERV30I_LTR30-hybrid,1,1,91082025,91082025,cPa75-HERV30_repbase_HERV30I_LTR30-hybrid,1,102,0
chr3-91180529_91180710,HERV-W_repbase_HERV17_LTR17,0.428571428571429,7,91180658,91180532,cPa62_cPa62-cPa75-hybrid_cPa62-HERV-W_repbase_HERV17_LTR17-hybrid_cPa75_HERV-W_repbase_HERV17_LTR17_KoRV_AF151794_KWERV_GQ222416-unknown,1_2_2_1_6_1_1,181,126
chr3-91180887_91181112,cPa62-HERV-W_repbase_HERV17_LTR17-hybrid_cPa75,0.305555555555556,7,91181111,91180888,cPa62-cPa75-hybrid_cPa62-HERV-W_repbase_HERV17_LTR17-hybrid_cPa75_HERV-W_repbase_HERV17_LTR17_KoRV_AF151794-cPa75-hybrid_PERV_AJ293656_S71_repbase_HERVS71_LTR6A,2_11_11_8_1_1_2,225,223
chr3-91197769_91197883,cPa541_cPa541-cPa247-hybrid_cPa541-cPa529-hybrid_cPa545-cPa247-hybrid_cPa545-cPa529-hybrid,0.2,5,91197832,91197819,cPa541_cPa541-cPa247-hybrid_cPa541-cPa529-hybrid_cPa545-cPa247-hybrid_cPa545-cPa529-hybrid,1_1_1_1_1,114,13
chr3-91365783_91365885,cPa419,1,1,91365833,91365833,cPa419,1,102,0
chr3-91384594_91384696,cPa450,0.583333333333333,4,91384659,91384631,cPa199_cPa227_cPa450_cPa553,2_1_7_2,102,28
chr3-91398591_91398693,MSEV_CT990572-unknown,1,1,91398681,91398641,MSEV_CT990572-unknown,5,102,40
chr3-91870817_91870919,cPa285,1,1,91870867,91870862,cPa285,2,102,5
chr3-91953069_91953171,cPa15,1,1,91953119,91953119,cPa15,1,102,0
chr3-91972283_91972457,cPa95,0.333333333333333,7,91972405,91972325,cPa247_cPa247-unknown_cPa541_cPa545_cPa545-cPa14-hybrid_cPa545-unknown_cPa95,1_1_1_1_1_1_3,174,80
chr3-92037065_92037167,cPa363_cPa456,0.428571428571429,3,92037115,92037066,cPa260-cPa117-hybrid_cPa363_cPa456,1_3_3,102,49
chr3-92188517_92188619,PRIMA41_repbase_PRIMA41_MER41A,1,1,92188567,92188567,PRIMA41_repbase_PRIMA41_MER41A,2,102,0
chr3-92219035_92219148,cPa61,0.5,3,92219096,92219085,cPa205_cPa61_cPa62-unknown,1_2_1,113,11
chr3-92224857_92224972,cPa515_cPa540,0.333333333333333,4,92224922,92224889,cPa127-cPa256-hybrid_cPa515_cPa540_cPa540-unknown,1_2_2_1,115,33
chr3-9232263_9232365,WDSV_NC001867,0.5,3,9232343,9232313,cPa260_cPa413-WDSV_NC001867-hybrid_WDSV_NC001867,2_1_3,102,30
chr3-92536894_92536996,cPa75-unknown,0.666666666666667,2,92536983,92536917,cPa75_cPa75-unknown,1_2,102,66
chr3-9297473_9297593,cPa62,0.916666666666667,5,9297585,9297483,cPa285_cPa293_cPa293-cPa62-hybrid_cPa62_cPa62-cPa273-hybrid,3_1_1_66_1,120,102
chr3-92996664_92996766,FeFV_NC001871-HERV-W_repbase_HERV17_LTR17-hybrid_HERV-W_repbase_HERV17_LTR17,0.5,2,92996714,92996698,FeFV_NC001871-HERV-W_repbase_HERV17_LTR17-hybrid_HERV-W_repbase_HERV17_LTR17,1_1,102,16
chr3-9318961_9319323,cPa62-unknown,0.555555555555556,4,9319271,9318966,cPa293_cPa62_cPa62-unknown_cPa75,1_4_10_3,362,305
chr3-93215762_93216034,cPa62-unknown,0.44,8,93216001,93215792,cPa419_cPa62_cPa62-cPa75-hybrid_cPa62-HERV-W_repbase_HERV17_LTR17-hybrid_cPa62-unknown_cPa75_cPa75-unknown_HERV-W_repbase_HERV17_LTR17,2_1_5_3_22_12_1_4,272,209
chr3-93306363_93306487,cPa363,0.321428571428571,11,93306435,93306393,cPa117-cPa363-hybrid_cPa117-cPa456-hybrid_cPa117-cPa587-hybrid_cPa121-cPa456-hybrid_cPa121-cPa587-hybrid_cPa363_cPa363-unknown_cPa452-cPa363-hybrid_cPa452-cPa456-hybrid_cPa452-cPa587-hybrid_cPa456,1_3_1_1_1_9_1_1_2_1_7,124,42
chr3-93346911_93347013,cPa15,0.777777777777778,3,93346984,93346952,cPa140-cPa118-hybrid_cPa15_cPa268,1_7_1,102,32
chr3-93353576_93353678,cPa15,0.435897435897436,7,93353647,93353608,cPa118_cPa118-cPa125-hybrid_cPa118-cPa248-hybrid_cPa118-cPa268-hybrid_cPa15_cPa15-cPa125-hybrid_cPa15-unknown,14_3_1_2_17_1_1,102,39
chr3-93378266_93378368,cPa541,0.571428571428571,3,93378327,93378315,cPa4_cPa4-unknown_cPa541,1_2_4,102,12
chr3-93532729_93532900,cPa75,0.5,3,93532848,93532733,cPa62_cPa62-unknown_cPa75,1_1_2,171,115
chr3-93532923_93533049,cPa62-cPa67-hybrid_cPa62-unknown_cPa75,0.333333333333333,3,93533028,93532955,cPa62-cPa67-hybrid_cPa62-unknown_cPa75,2_2_2,126,73
chr3-93791680_93791782,cPa345,1,1,93791730,93791694,cPa345,2,102,36
chr3-93796341_93796479,cPa75,0.384615384615385,6,93796475,93796391,cPa113-cPa62-hybrid_cPa293-cPa62-hybrid_cPa419_cPa75_cPa75-cPa62-hybrid_cPa75-unknown,1_1_1_5_4_1,138,84
chr3-93796576_93796678,cPa75,0.666666666666667,2,93796640,93796626,cPa113-cPa62-hybrid_cPa75,1_2,102,14
chr3-93796799_93796901,cPa75,0.666666666666667,2,93796872,93796800,cPa113-cPa62-hybrid_cPa75,1_2,102,72
chr3-93798801_93798934,cPa15,0.492307692307692,12,93798899,93798804,cPa118_cPa118-unknown_cPa15_cPa248_cPa248-cPa118-hybrid_cPa248-cPa62-hybrid_cPa248-cPa75-hybrid_cPa248-unknown_cPa268-cPa118-hybrid_cPa268-cPa62-hybrid_cPa443_cPa443-cPa118-hybrid,40_1_64_1_5_2_3_5_3_2_3_1,133,95
chr3-93838337_93838439,cPa62,0.888888888888889,2,93838395,93838380,cPa62_cPa62-cPa254-hybrid,8_1,102,15
chr3-94058366_94058486,cPa47,0.333333333333333,9,94058448,94058416,cPa174_cPa174-cPa47-hybrid_cPa254_cPa254-cPa404-hybrid_cPa254-unknown_cPa392_cPa404_cPa425_cPa47,1_1_5_1_2_1_1_8_10,120,32
chr3-94215583_94215685,cPa15,0.458333333333333,4,94215650,94215620,cPa118_cPa118-cPa248-hybrid_cPa118-cPa268-hybrid_cPa15,9_2_2_11,102,30
chr3-94264637_94264745,cPa456,0.714285714285714,3,94264705,94264684,cPa363_cPa456_cPa62-cPa452-hybrid,1_5_1,108,21
chr3-94529074_94529176,cPa75-cPa298-hybrid,1,1,94529124,94529124,cPa75-cPa298-hybrid,1,102,0
chr3-94529944_94530046,cPa75-cPa298-hybrid,1,1,94529994,94529994,cPa75-cPa298-hybrid,1,102,0
chr3-94590309_94590411,cPa75,1,1,94590359,94590359,cPa75,1,102,0
chr3-9471342_9471507,FeFV_NC001871,0.933333333333333,2,9471455,9471367,cPa419_FeFV_NC001871,1_14,165,88
chr3-95185127_95185234,cPa174,0.4375,5,95185225,95185172,cPa174_cPa254_cPa254-cPa404-hybrid_cPa47_cPa553-cPa174-hybrid,7_6_1_1_1,107,53
chr3-95276326_95276559,HERV-W_repbase_HERV17_LTR17,0.72,5,95276533,95276367,cPa75_HERV-W_repbase_HERV17_LTR17_HERV-W_repbase_HERV17_LTR17-cPa62-hybrid_HERV-W_repbase_HERV17_LTR17-cPa75-hybrid_HERV-W_repbase_HERV17_LTR17-unknown,2_54_1_6_12,233,166
chr3-95276602_95276802,HERV-W_repbase_HERV17_LTR17,0.777777777777778,3,95276767,95276651,HERV-W_repbase_HERV17_LTR17_HERV-W_repbase_HERV17_LTR17-cPa75-hybrid_PERV_AJ293656,7_1_1,200,116
chr3-95277028_95277130,cPa75_HERV-W_repbase_HERV17_LTR17-unknown,0.5,2,95277078,95277037,cPa75_HERV-W_repbase_HERV17_LTR17-unknown,1_1,102,41
chr3-9554313_9554425,cPa260-unknown,0.5,3,9554373,9554363,cPa260-unknown_WDSV_NC001867_WDSV_NC001867-unknown,2_1_1,112,10
chr3-95641803_95641905,cPa142,0.5,3,95641869,95641853,cPa101_cPa142_cPa582,1_2_1,102,16
chr3-9569971_9570145,cPa379,0.451612903225806,9,9570138,9569984,cPa16_cPa16-cPa379-hybrid_cPa16-cPa424-hybrid_cPa199_cPa199-cPa379-hybrid_cPa379_cPa482_cPa482-cPa379-hybrid_cPa71-cPa379-hybrid,8_1_1_1_1_14_3_1_1,174,154
chr3-9570306_9570456,cPa482,0.470588235294118,9,9570437,9570349,cPa16_cPa16-cPa345-hybrid_cPa199_cPa199-unknown_cPa345_cPa345-cPa482-hybrid_cPa482_cPa482-cPa424-hybrid_cPa71-cPa482-hybrid,2_1_1_1_1_1_8_1_1,150,88
chr3-9570481_9570583,cPa345_cPa482,0.5,2,9570531,9570495,cPa345_cPa482,1_1,102,36
chr3-95920790_95920892,cPa62,1,1,95920852,95920793,cPa62,4,102,59
chr3-95938632_95938734,cPa62,0.909090909090909,2,95938690,95938681,cPa254_cPa62,1_10,102,9
chr3-96185087_96185189,cPa75,0.363636363636364,8,96185170,96185089,cPa505-cPa62-hybrid_cPa543_cPa543-cPa62-hybrid_cPa62_cPa75_cPa75-cPa62-hybrid_HERV-W_repbase_HERV17_LTR17_HERV-W_repbase_HERV17_LTR17-cPa62-hybrid,1_1_1_3_8_2_5_1,102,81
chr3-96291483_96291585,cPa443-cPa118-hybrid,1,1,96291533,96291533,cPa443-cPa118-hybrid,1,102,0
chr3-96386390_96386492,cPa255,0.51063829787234,7,96386473,96386394,cPa131_cPa131-cPa255-hybrid_cPa131-unknown_cPa255_cPa255-unknown_cPa478-cPa438-hybrid_cPa479-cPa438-hybrid,17_1_2_24_1_1_1,102,79
chr3-9639_9751,cPa323-cPa568-hybrid,0.333333333333333,7,9733,9688,cPa323_cPa323-cPa568-hybrid_cPa323-unknown_cPa333_cPa371-cPa568-hybrid_cPa371-unknown_cPa568,5_9_1_5_2_1_4,112,45
chr3-96490549_96490652,cPa118_cPa15,0.428571428571429,3,96490601,96490580,cPa118_cPa118-cPa248-hybrid_cPa15,3_1_3,103,21
chr3-9656961_9657063,cPa62,1,1,9657011,9657011,cPa62,1,102,0
chr3-9657065_9657394,cPa62,1,1,9657346,9657085,cPa62,32,329,261
chr3-96574694_96574796,cPa62,1,1,96574744,96574744,cPa62,1,102,0
chr3-96652699_96652801,cPa62-cPa285-hybrid,1,1,96652749,96652738,cPa62-cPa285-hybrid,2,102,11
chr3-96810853_96810957,cPa456,0.6,3,96810924,96810892,cPa363_cPa363-cPa452-hybrid_cPa456,3_1_6,104,32
chr3-96821418_96821560,cPa220,0.40625,14,96821558,96821433,cPa104_cPa104-cPa190-hybrid_cPa190_cPa190-cPa104-hybrid_cPa190-cPa18-hybrid_cPa190-cPa4-hybrid_cPa220_cPa220-cPa104-hybrid_cPa220-cPa18-hybrid_cPa220-cPa190-hybrid_cPa220-cPa258-hybrid_cPa220-unknown_cPa223-cPa18-hybrid_cPa223-cPa190-hybrid,10_1_41_4_2_1_52_1_6_2_2_4_1_1,142,125
chr3-96889046_96889148,cPa339,0.5,3,96889106,96889096,cPa339_cPa447_cPa447-cPa444-hybrid,3_2_1,102,10
chr3-96906624_96906726,cPa541,0.6,3,96906705,96906674,cPa18_cPa541_cPa545-cPa4-hybrid,1_3_1,102,31
chr3-96927581_96927683,cPa150_cPa216,0.285714285714286,7,96927667,96927603,cPa131_cPa150_cPa150-cPa255-hybrid_cPa216_cPa302-cPa255-hybrid_cPa478-cPa255-hybrid_cPa518-cPa479-hybrid,1_4_1_4_2_1_1,102,64
chr3-9707594_9707696,cPa219,1,1,9707644,9707644,cPa219,1,102,0
chr3-97078169_97078277,cPa150_cPa255-cPa104-hybrid_cPa255-cPa150-hybrid_cPa529-cPa104-hybrid,0.25,4,97078229,97078212,cPa150_cPa255-cPa104-hybrid_cPa255-cPa150-hybrid_cPa529-cPa104-hybrid,1_1_1_1,108,17
chr3-97147228_97147330,cPa101,0.5,7,97147318,97147227,cPa101_cPa142-cPa51-hybrid_cPa142-cPa551-hybrid_cPa142-cPa555-hybrid_cPa256-cPa582-hybrid_cPa552-cPa101-hybrid_cPa582,10_2_1_1_1_1_4,102,91
chr3-97386174_97386280,cPa174_cPa254_cPa404-cPa425-hybrid_cPa47,0.25,4,97386228,97386224,cPa174_cPa254_cPa404-cPa425-hybrid_cPa47,1_1_1_1,106,4
chr3-97477017_97477119,cPa174_cPa404-cPa254-hybrid_cPa425,0.333333333333333,3,97477067,97477067,cPa174_cPa404-cPa254-hybrid_cPa425,1_1_1,102,0
chr3-97718300_97718402,cPa391,0.666666666666667,2,97718350,97718344,cPa293_cPa391,1_2,102,6
chr3-97777319_97777437,cPa425,0.25,7,97777430,97777369,cPa174_cPa254_cPa254-cPa404-hybrid_cPa254-cPa47-hybrid_cPa404_cPa419-cPa47-hybrid_cPa425,1_1_1_1_1_1_2,118,61
chr3-97784777_97784892,cPa95,0.428571428571429,4,97784840,97784827,cPa247-cPa14-hybrid_cPa529-cPa14-hybrid_cPa529-cPa545-hybrid_cPa95,2_1_1_3,115,13
chr3-9806264_9806366,cPa71,0.666666666666667,7,9806364,9806264,cPa16_cPa16-cPa71-hybrid_cPa16-cPa75-hybrid_cPa16-PERVB_AY099324-hybrid_cPa379_cPa71_PERVC_HM159246,2_1_1_1_1_14_1,102,100
chr3-98190636_98190741,cPa62,1,1,98190689,98190686,cPa62,2,105,3
chr3-98413220_98413322,cPa150,0.5,4,98413281,98413269,cPa150_cPa246-cPa14-hybrid_cPa302-cPa255-hybrid_cPa302-unknown,3_1_1_1,102,12
chr3-98441370_98441472,cPa118-cPa248-hybrid_cPa15,0.5,2,98441420,98441420,cPa118-cPa248-hybrid_cPa15,1_1,102,0
chr3-98497858_98497972,cPa15_cPa248-cPa118-hybrid_cPa268-cPa118-hybrid,0.333333333333333,3,98497920,98497908,cPa15_cPa248-cPa118-hybrid_cPa268-cPa118-hybrid,1_1_1,114,12
chr3-98606241_98606354,cPa450_cPa553,0.333333333333333,4,98606303,98606291,cPa199-cPa227-hybrid_cPa199-unknown_cPa450_cPa553,1_1_2_2,113,12
chr3-98694272_98694380,cPa62,0.75,3,98694328,98694271,cPa293-cPa62-hybrid_cPa363-cPa75-hybrid_cPa62,1_1_6,108,57
chr3-98809134_98809250,cPa456,0.333333333333333,5,98809200,98809138,cPa363_cPa363-unknown_cPa452-cPa456-hybrid_cPa452-cPa587-hybrid_cPa456,4_2_2_2_5,116,62
chr3-98868442_98868544,cPa15,0.56043956043956,3,98868544,98868468,cPa118_cPa15_cPa268,39_51_1,102,76
chr3-98979474_98979576,cPa264_cPa62,0.5,2,98979524,98979513,cPa264_cPa62,1_1,102,11
chr3-99126653_99126761,cPa163,0.661290322580645,8,99126742,99126672,cPa163_cPa182_cPa182-cPa163-hybrid_cPa182-cPa360-hybrid_cPa182-unknown_cPa224_cPa224-cPa360-hybrid_cPa224-unknown,82_24_3_4_8_1_1_1,108,70
chr3-99167831_99168303,cPa434,0.995305164319249,2,99168285,99167844,cPa392_cPa434,1_212,472,441
chr3-99169273_99169375,cPa371_cPa392-cPa371-hybrid,0.5,2,99169348,99169323,cPa371_cPa392-cPa371-hybrid,1_1,102,25
chr3-9966736_9966844,cPa118_cPa15_cPa248-unknown,0.333333333333333,3,9966792,9966786,cPa118_cPa15_cPa248-unknown,1_1_1,108,6
chr3-9974944_9975046,cPa482,0.441176470588235,10,9975025,9974981,cPa199_cPa199-cPa482-hybrid_cPa273_cPa345-cPa199-hybrid_cPa345-cPa273-hybrid_cPa450_cPa450-cPa273-hybrid_cPa450-cPa345-hybrid_cPa482_cPa542,5_1_3_2_1_4_1_1_15_1,102,44
chr4-1006815_1006917,cPa106,0.909090909090909,2,1006911,1006832,cPa106_cPa260,10_1,102,79
chr4-10466824_10466926,cPa450,0.5,3,10466874,10466842,cPa227-cPa223-hybrid_cPa273-cPa223-hybrid_cPa450,1_1_2,102,32
chr4-10514176_10514278,cPa456,0.529411764705882,6,10514241,10514209,cPa363_cPa363-cPa587-hybrid_cPa456_cPa587_REV_NC006934-cPa363-hybrid_REV_NC006934-unknown,4_1_9_1_1_1,102,32
chr4-10630554_10630656,cPa223,0.461538461538462,6,10630612,10630578,cPa223_cPa424-cPa327-hybrid_cPa424-cPa363-hybrid_cPa424-cPa71-hybrid_cPa424-unknown_cPa446,6_2_1_1_2_1,102,34
chr4-10815777_10815879,cPa585-cPa75-hybrid,1,1,10815827,10815827,cPa585-cPa75-hybrid,1,102,0
chr4-10943901_10944003,cPa62,0.625,2,10943960,10943930,cPa285_cPa62,3_5,102,30
chr4-1105615_1105717,SFV_U04327,1,1,1105665,1105665,SFV_U04327,1,102,0
chr4-1106379_1106500,SFV_U04327,1,1,1106448,1106429,SFV_U04327,2,121,19
chr4-1106513_1106953,SFV_U04327,1,1,1106901,1106514,SFV_U04327,25,440,387
chr4-1110428_1110679,cPa106,0.571428571428571,3,1110657,1110478,cPa106_cPa106-cPa260-hybrid_cPa260,4_1_2,251,179
chr4-1112124_1112226,cPa118-unknown_cPa15_cPa268,0.333333333333333,3,1112174,1112174,cPa118-unknown_cPa15_cPa268,1_1_1,102,0
chr4-1117962_1118064,cPa75,1,1,1118012,1118012,cPa75,1,102,0
chr4-1118065_1118283,cPa75,1,1,1118253,1118115,cPa75,5,218,138
chr4-1147113_1147215,cPa228,0.5,3,1147208,1147155,cPa228_cPa260_cPa260-cPa228-hybrid,3_1_2,102,53
chr4-11732069_11732183,cPa452,0.5,3,11732131,11732119,cPa363_cPa452_cPa456,1_2_1,114,12
chr4-11802974_11803076,cPa157-cPa456-hybrid,0.666666666666667,2,11803024,11802997,cPa157-cPa332-hybrid_cPa157-cPa456-hybrid,1_2,102,27
chr4-1213132_1213234,cPa205-unknown,1,1,1213182,1213174,cPa205-unknown,6,102,8
chr4-1237758_1237860,cPa546-cPa228-hybrid,1,1,1237808,1237808,cPa546-cPa228-hybrid,1,102,0
chr4-1244795_1244897,cPa333,1,1,1244845,1244831,cPa333,2,102,14
chr4-1298704_1298806,cPa75,1,1,1298754,1298754,cPa75,1,102,0
chr4-13264324_13264426,cPa62,1,1,13264419,13264374,cPa62,20,102,45
chr4-13265106_13265214,cPa62,1,1,13265164,13265144,cPa62,5,108,20
chr4-13621176_13621278,cPa118_cPa15_cPa248-unknown_cPa443,0.25,4,13621226,13621226,cPa118_cPa15_cPa248-unknown_cPa443,1_1_1_1,102,0
chr4-13664033_13664135,cPa419,1,1,13664083,13664083,cPa419,1,102,0
chr4-13807312_13807446,cPa392,0.977777777777778,2,13807443,13807311,cPa392_cPa419,44_1,134,132
chr4-1400922_1401024,cPa75,0.75,2,1400997,1400948,cPa62-cPa75-hybrid_cPa75,1_3,102,49
chr4-1401274_1401440,cPa75,0.464285714285714,7,1401411,1401284,cPa293_cPa62_cPa62-cPa260-hybrid_cPa62-cPa413-hybrid_cPa62-cPa75-hybrid_cPa62-PERVC_HM159246-hybrid_cPa75,1_3_2_1_7_1_13,166,127
chr4-1401596_1401698,cPa75,1,1,1401646,1401646,cPa75,1,102,0
chr4-14084069_14084171,cPa450_cPa553,0.333333333333333,5,14084133,14084119,cPa199_cPa227_cPa450_cPa542-cPa223-hybrid_cPa553,1_1_3_1_3,102,14
chr4-14105368_14105470,cPa511-PERVE_NC003059-hybrid_cPa511-unknown,0.5,2,14105418,14105418,cPa511-PERVE_NC003059-hybrid_cPa511-unknown,1_1,102,0
chr4-1413165_1413267,cPa293,1,1,1413215,1413215,cPa293,1,102,0
chr4-1422904_1423006,cPa223-unknown_cPa327-cPa452-hybrid,0.333333333333333,4,1422954,1422911,cPa223_cPa223-cPa452-hybrid_cPa223-unknown_cPa327-cPa452-hybrid,1_1_2_2,102,43
chr4-1423691_1423793,cPa183-cPa228-hybrid,1,1,1423741,1423741,cPa183-cPa228-hybrid,1,102,0
chr4-14366150_14366252,cPa425-cPa62-hybrid_cPa543-cPa62-hybrid_cPa543-cPa75-hybrid,0.333333333333333,3,14366201,14366170,cPa425-cPa62-hybrid_cPa543-cPa62-hybrid_cPa543-cPa75-hybrid,1_1_1,102,31
chr4-14395813_14395915,cPa62,1,1,14395889,14395836,cPa62,5,102,53
chr4-14395978_14396096,cPa62,0.933333333333333,3,14396052,14395985,cPa254_cPa62_cPa62-unknown,1_28_1,118,67
chr4-14415265_14415367,cPa67,0.769230769230769,4,14415315,14415276,cPa113_cPa62-cPa67-hybrid_cPa67_cPa75-cPa67-hybrid,1_1_10_1,102,39
chr4-14476175_14476277,cPa62,1,1,14476229,14476208,cPa62,17,102,21
chr4-14608893_14609007,cPa118_cPa15,0.5,2,14608966,14608943,cPa118_cPa15,2_2,114,23
chr4-1473098_1473200,cPa260-unknown_cPa546-cPa75-hybrid,0.5,2,1473199,1473148,cPa260-unknown_cPa546-cPa75-hybrid,1_1,102,51
chr4-1473329_1473476,cPa75,0.666666666666667,2,1473424,1473379,cPa260-cPa75-hybrid_cPa75,1_2,147,45
chr4-15194097_15194202,cPa61,0.6,3,15194150,15194126,cPa205_cPa61_HERV-ADP_repbase_HERVP71A_I_LTR71A-cPa465-hybrid,1_3_1,105,24
chr4-15205459_15205561,cPa62,0.976190476190476,2,15205516,15205474,cPa62_cPa62-unknown,41_1,102,42
chr4-1534553_1534655,HERVHcons,1,1,1534604,1534603,HERVHcons,2,102,1
chr4-153712_153890,cPa260,0.486486486486487,5,153870,153719,cPa106_cPa106-unknown_cPa260_cPa260-cPa106-hybrid_cPa260-unknown,28_3_36_2_5,178,151
chr4-1549181_1549283,cPa469,1,1,1549231,1549231,cPa469,2,102,0
chr4-15503802_15504000,HERV-W_repbase_HERV17_LTR17,0.555555555555556,5,15503982,15503852,cPa62-CAEV_NC001463-hybrid_cPa62-HERV-W_repbase_HERV17_LTR17-hybrid_HERV-W_repbase_HERV17_LTR17_HERV-W_repbase_HERV17_LTR17-S71_repbase_HERVS71_LTR6A-hybrid_HERV-W_repbase_HERV17_LTR17-unknown,1_1_5_1_1,198,130
chr4-15504014_15504269,HERV-W_repbase_HERV17_LTR17,0.310344827586207,16,15504226,15504051,cPa419_cPa62_cPa62-CAEV_NC001463-hybrid_cPa62-cPa425-hybrid_cPa62-HERV-W_repbase_HERV17_LTR17-hybrid_cPa62-S71_repbase_HERVS71_LTR6A-hybrid_cPa62-unknown_cPa75_cPa75-CAEV_NC001463-hybrid_cPa75-HERV-W_repbase_HERV17_LTR17-hybrid_cPa75-unknown_HERV-W_repbase_HERV17_LTR17_HERV-W_repbase_HERV17_LTR17-CAEV_NC001463-hybrid_HERV-W_repbase_HERV17_LTR17-cPa575-hybrid_HERV-W_repbase_HERV17_LTR17-cPa75-hybrid_HERV-W_repbase_HERV17_LTR17-unknown,1_1_1_1_3_1_1_2_1_1_1_9_1_1_3_1,255,175
chr4-15504295_15504455,cPa62-PERV_AJ293656-hybrid_cPa62-unknown_HERV-W_repbase_HERV17_LTR17,0.25,5,15504403,15504302,cPa62-CAEV_NC001463-hybrid_cPa62-PERV_AJ293656-hybrid_cPa62-unknown_HERV-W_repbase_HERV17_LTR17_HERV-W_repbase_HERV17_LTR17-cPa75-hybrid,1_2_2_2_1,160,101
chr4-15726203_15726305,cPa62,0.928571428571429,2,15726254,15726231,cPa419_cPa62,1_13,102,23
chr4-15793674_15793776,cPa62,1,1,15793766,15793673,cPa62,15,102,93
chr4-15884772_15884924,cPa450,0.326241134751773,20,15884916,15884805,cPa199-cPa273-hybrid_cPa199-cPa542-hybrid_cPa223-cPa273-hybrid_cPa223-cPa542-hybrid_cPa223-cPa553-hybrid_cPa223-unknown_cPa227_cPa254-cPa273-hybrid_cPa273_cPa345-cPa273-hybrid_cPa450_cPa450-cPa273-hybrid_cPa450-cPa542-hybrid_cPa450-cPa553-hybrid_cPa450-unknown_cPa482-cPa273-hybrid_cPa542_cPa553_cPa553-cPa273-hybrid_cPa553-unknown,1_2_29_9_4_3_2_1_7_2_46_4_1_2_1_1_1_23_1_1,152,111
chr4-15938344_15938446,cPa402-cPa62-hybrid_cPa482-cPa75-hybrid,0.5,2,15938394,15938372,cPa402-cPa62-hybrid_cPa482-cPa75-hybrid,1_1,102,22
chr4-15966665_15966767,cPa456-unknown,0.243243243243243,10,15966718,15966670,cPa363_cPa363-cPa117-hybrid_cPa363-cPa308-hybrid_cPa363-cPa75-hybrid_cPa363-unknown_cPa456_cPa456-cPa75-hybrid_cPa456-unknown_cPa587_cPa75,7_1_1_3_7_2_2_9_3_2,102,48
chr4-15966783_15967106,cPa587,0.175,12,15967054,15966815,cPa363_cPa363-cPa587-hybrid_cPa363-unknown_cPa452_cPa456_cPa456-cPa363-hybrid_cPa456-cPa75-hybrid_cPa456-unknown_cPa587_cPa587-cPa363-hybrid_cPa587-unknown_cPa75,6_1_2_1_6_1_1_5_7_1_3_6,323,239
chr4-1597646_1597758,cPa75,0.588235294117647,8,1597707,1597647,cPa285-cPa293-hybrid_cPa285-cPa62-hybrid_cPa293_cPa293-cPa62-hybrid_cPa62_cPa75_cPa75-cPa62-hybrid_cPa75-unknown,1_1_1_1_5_20_3_2,112,60
chr4-1597791_1597902,cPa75,0.470588235294118,7,1597901,1597797,cPa285-cPa62-hybrid_cPa62_cPa71-cPa260-hybrid_cPa75_cPa75-cPa293-hybrid_cPa75-cPa62-hybrid_cPa75-unknown,1_3_1_8_1_2_1,111,104
chr4-1605206_1605308,cPa75-unknown,1,1,1605256,1605256,cPa75-unknown,1,102,0
chr4-16496496_16496598,cPa419,1,1,16496546,16496546,cPa419,1,102,0
chr4-16698702_16698804,cPa205,0.518518518518518,3,16698759,16698741,cPa205_cPa205-unknown_cPa61,42_4_35,102,18
chr4-1688723_1688912,cPa260,1,1,1688904,1688728,cPa260,17,189,176
chr4-1689004_1689161,cPa260,1,1,1689109,1689024,cPa260,12,157,85
chr4-16935184_16935345,cPa62-cPa75-hybrid_cPa75,0.357142857142857,3,16935319,16935191,cPa62-cPa75-hybrid_cPa62-unknown_cPa75,5_4_5,161,128
chr4-16935399_16935524,cPa62-cPa75-hybrid,0.866666666666667,2,16935520,16935449,cPa62-cPa75-hybrid_cPa75,13_2,125,71
chr4-16935525_16935627,cPa62-cPa75-hybrid,0.666666666666667,2,16935614,16935526,cPa62-cPa75-hybrid_cPa75,4_2,102,88
chr4-17238787_17238889,cPa75,0.333333333333333,5,17238887,17238795,cPa62_cPa62-cPa71-hybrid_cPa62-HERV-W_repbase_HERV17_LTR17-hybrid_cPa75_HERV-W_repbase_HERV17_LTR17,1_3_1_4_3,102,92
chr4-17238892_17239035,cPa62-cPa75-hybrid_HERV-W_repbase_HERV17_LTR17,0.2,8,17239024,17238896,cPa62_cPa62-cPa71-hybrid_cPa62-cPa75-hybrid_cPa62-HERV-W_repbase_HERV17_LTR17-hybrid_cPa71_cPa75_HERV-W_repbase_HERV17_LTR17_KoRV_AF151794,2_4_5_2_1_4_5_2,143,128
chr4-17296745_17296862,cPa540,0.333333333333333,7,17296848,17296795,cPa241_cPa290_cPa515_cPa515-unknown_cPa530_cPa531-unknown_cPa540,1_1_1_1_1_1_3,117,53
chr4-17327652_17327754,cPa273-cPa199-hybrid_cPa450,0.333333333333333,5,17327704,17327685,cPa227_cPa273_cPa273-cPa199-hybrid_cPa450_cPa450-cPa199-hybrid,1_4_6_6_1,102,19
chr4-1755077_1755179,cPa75,1,1,1755127,1755127,cPa75,1,102,0
chr4-17718335_17718446,cPa117-cPa62-hybrid_cPa363-cPa62-hybrid_cPa452-cPa62-hybrid_cPa456,0.25,4,17718394,17718385,cPa117-cPa62-hybrid_cPa363-cPa62-hybrid_cPa452-cPa62-hybrid_cPa456,1_1_1_1,111,9
chr4-1775958_1776060,cPa75-cPa260-hybrid,1,1,1776008,1776008,cPa75-cPa260-hybrid,1,102,0
chr4-1776083_1776310,cPa75,1,1,1776258,1776128,cPa75,8,227,130
chr4-1776769_1776960,cPa75,1,1,1776908,1776819,cPa75,2,191,89
chr4-1777674_1777776,cPa75,1,1,1777733,1777724,cPa75,2,102,9
chr4-1791408_1791949,cPa75,1,1,1791908,1791458,cPa75,21,541,450
chr4-1791970_1792072,cPa75,1,1,1792020,1792020,cPa75,1,102,0
chr4-1792081_1792353,cPa75,1,1,1792301,1792122,cPa75,19,272,179
chr4-1792583_1792828,cPa75,1,1,1792776,1792633,cPa75,11,245,143
chr4-1793199_1793449,cPa75,1,1,1793397,1793249,cPa75,9,250,148
chr4-1797098_1797214,cPa75,1,1,1797162,1797113,cPa75,3,116,49
chr4-1797295_1797397,cPa75,1,1,1797345,1797345,cPa75,1,102,0
chr4-1844004_1844106,cPa75,1,1,1844054,1844054,cPa75,1,102,0
chr4-1854892_1854997,cPa75,1,1,1854945,1854942,cPa75,2,105,3
chr4-1855089_1855191,cPa75,1,1,1855139,1855139,cPa75,1,102,0
chr4-1855239_1855393,cPa75,1,1,1855341,1855289,cPa75,6,154,52
chr4-1855465_1855567,cPa75,1,1,1855515,1855515,cPa75,1,102,0
chr4-1855627_1855812,cPa75,1,1,1855760,1855662,cPa75,5,185,98
chr4-1856071_1856173,cPa75,1,1,1856121,1856121,cPa75,1,102,0
chr4-1890618_1890720,cPa62-cPa228-hybrid,1,1,1890668,1890668,cPa62-cPa228-hybrid,1,102,0
chr4-1890743_1890845,cPa62-unknown,1,1,1890793,1890793,cPa62-unknown,1,102,0
chr4-1890895_1891024,cPa62-cPa228-hybrid_cPa62-cPa260-hybrid_cPa62-WDSV_NC001867-hybrid,0.333333333333333,3,1890972,1890945,cPa62-cPa228-hybrid_cPa62-cPa260-hybrid_cPa62-WDSV_NC001867-hybrid,1_1_1,129,27
chr4-18999800_18999902,cPa456,0.571428571428571,3,18999850,18999799,cPa117-cPa587-hybrid_cPa363_cPa456,1_2_4,102,51
chr4-19107887_19108016,HERV-W_repbase_HERV17_LTR17,0.578947368421053,4,19108008,19107918,HERV-W_repbase_HERV17_LTR17_HERV-W_repbase_HERV17_LTR17-cPa62-hybrid_HERV-W_repbase_HERV17_LTR17-cPa75-hybrid_HERV-W_repbase_HERV17_LTR17-unknown,11_1_2_5,129,90
chr4-1918950_1919076,cPa75,1,1,1919024,1919000,cPa75,2,126,24
chr4-1919880_1919982,cPa75,1,1,1919930,1919907,cPa75,2,102,23
chr4-1934330_1934432,cPa75,1,1,1934380,1934380,cPa75,1,102,0
chr4-1934795_1934897,cPa75,1,1,1934845,1934845,cPa75,1,102,0
chr4-1934963_1935083,cPa75,1,1,1935031,1935013,cPa75,11,120,18
chr4-1935375_1935477,cPa75,1,1,1935425,1935425,cPa75,1,102,0
chr4-1935559_1935701,cPa75,1,1,1935649,1935609,cPa75,3,142,40
chr4-19483649_19483752,cPa426,1,1,19483707,19483654,cPa426,18,103,53
chr4-1961319_1961512,cPa75,1,1,1961494,1961369,cPa75,3,193,125
chr4-1962010_1962112,cPa75,1,1,1962060,1962060,cPa75,1,102,0
chr4-1962303_1962405,cPa75,1,1,1962353,1962353,cPa75,1,102,0
chr4-1962478_1962580,cPa75,1,1,1962528,1962528,cPa75,1,102,0
chr4-19692049_19692151,cPa543,1,1,19692099,19692099,cPa543,1,102,0
chr4-19733779_19733979,HML4_repbase_HERVK13I_LTR13-VISNA_S55323-hybrid,0.75,2,19733930,19733829,HML4_repbase_HERVK13I_LTR13-unknown_HML4_repbase_HERVK13I_LTR13-VISNA_S55323-hybrid,3_9,200,101
chr4-1983078_1983224,cPa75,1,1,1983172,1983128,cPa75,2,146,44
chr4-1983487_1983733,cPa75,1,1,1983681,1983537,cPa75,13,246,144
chr4-1983803_1983986,cPa75,1,1,1983934,1983853,cPa75,3,183,81
chr4-1989569_1989671,cPa75,1,1,1989619,1989619,cPa75,1,102,0
chr4-1989772_1990001,cPa75,0.857142857142857,2,1989949,1989822,cPa75_cPa75-unknown,6_1,229,127
chr4-19931948_19932050,cPa118,0.463414634146341,8,19932050,19931985,cPa118_cPa118-cPa248-hybrid_cPa15_cPa15-cPa118-hybrid_cPa15-cPa125-hybrid_cPa15-unknown_cPa71-cPa118-hybrid_cPa71-cPa62-hybrid,19_1_15_1_2_1_1_1,102,65
chr4-20087500_20087613,cPa117-cPa456-hybrid_cPa363_cPa452_cPa452-cPa456-hybrid_cPa456,0.2,5,20087561,20087512,cPa117-cPa456-hybrid_cPa363_cPa452_cPa452-cPa456-hybrid_cPa456,1_1_1_1_1,113,49
chr4-20112949_20113051,cPa174_cPa254_cPa425_cPa47-cPa404-hybrid,0.25,4,20112999,20112999,cPa174_cPa254_cPa425_cPa47-cPa404-hybrid,1_1_1_1,102,0
chr4-2016232_2016334,cPa75,1,1,2016282,2016282,cPa75,1,102,0
chr4-2016532_2016634,cPa75,1,1,2016582,2016582,cPa75,1,102,0
chr4-2017057_2017159,cPa75,1,1,2017107,2017107,cPa75,1,102,0
chr4-2017185_2017287,cPa75,1,1,2017235,2017235,cPa75,1,102,0
chr4-2017365_2017467,cPa75,1,1,2017415,2017415,cPa75,1,102,0
chr4-20184768_20184870,cPa540,0.384615384615385,6,20184827,20184769,cPa127_cPa290_cPa290-cPa241-hybrid_cPa515_cPa530_cPa540,3_1_1_2_1_5,102,58
chr4-2042976_2043275,cPa260,0.774647887323944,6,2043261,2043017,cPa228_cPa251_cPa260_cPa260-cPa228-hybrid_cPa260-SFV_U04327-hybrid_cPa260-unknown,2_1_55_6_1_6,299,244
chr4-2044184_2044286,cPa285_cPa75,0.333333333333333,4,2044269,2044218,cPa260-cPa285-hybrid_cPa285_cPa75_cPa75-cPa228-hybrid,1_2_2_1,102,51
chr4-20493216_20493318,cPa119-cPa62-hybrid_cPa75,0.5,2,20493283,20493266,cPa119-cPa62-hybrid_cPa75,1_1,102,17
chr4-2060530_2060632,cPa75,1,1,2060580,2060580,cPa75,1,102,0
chr4-20795019_20795121,cPa14,0.666666666666667,3,20795073,20795020,cPa14_cPa541-cPa14-hybrid_cPa541-unknown,8_1_3,102,53
chr4-21048211_21048338,cPa456,0.464566929133858,13,21048329,21048226,cPa363_cPa363-BLV_NC001414-hybrid_cPa363-cPa117-hybrid_cPa363-cPa452-hybrid_cPa419_cPa456_cPa456-BLV_NC001414-hybrid_cPa456-cPa117-hybrid_cPa456-cPa452-hybrid_cPa456-unknown_cPa587-BLV_NC001414-hybrid_cPa587-cPa117-hybrid_cPa587-cPa452-hybrid,26_1_4_3_1_59_3_12_3_1_5_7_2,127,103
chr4-21115944_21116046,cPa315,0.75,2,21115999,21115994,cPa315_cPa587-cPa62-hybrid,3_1,102,5
chr4-21131187_21131289,cPa246,0.566666666666667,4,21131240,21131196,cPa150-cPa246-hybrid_cPa150-cPa302-hybrid_cPa246_cPa302,1_6_17_6,102,44
chr4-21131452_21131604,cPa246,0.534653465346535,5,21131580,21131491,cPa150-cPa246-hybrid_cPa150-cPa302-hybrid_cPa246_cPa302_cPa478,3_10_54_32_2,152,89
chr4-21170319_21170421,cPa62,1,1,21170382,21170369,cPa62,2,102,13
chr4-21170449_21170551,cPa62,0.9375,2,21170499,21170469,cPa419_cPa62,1_15,102,30
chr4-21258644_21258870,cPa75,0.432432432432432,11,21258855,21258644,cPa260_cPa260-cPa62-hybrid_cPa260-cPa75-hybrid_cPa260-unknown_cPa285-unknown_cPa293_cPa62_cPa75_cPa75-cPa62-hybrid_cPa75-unknown_PERVC_HM159246,2_3_3_3_1_2_13_32_3_11_1,226,211
chr4-2140878_2141072,cPa75,1,1,2141020,2140928,cPa75,6,194,92
chr4-2141188_2141377,cPa75,1,1,2141325,2141238,cPa75,6,189,87
chr4-2141451_2141583,cPa75,1,1,2141531,2141501,cPa75,5,132,30
chr4-2141998_2142100,cPa75,1,1,2142048,2142048,cPa75,1,102,0
chr4-2145726_2145828,cPa75,1,1,2145776,2145776,cPa75,1,102,0
chr4-2145897_2146022,cPa75,1,1,2145970,2145947,cPa75,2,125,23
chr4-2151281_2151413,WDSV_NC001867,0.571428571428571,3,2151361,2151296,cPa75_WDSV_NC001867_WDSV_NC001867-cPa75-hybrid,1_4_2,132,65
chr4-2151593_2151695,WDSV_NC001867-cPa75-hybrid,1,1,2151643,2151643,WDSV_NC001867-cPa75-hybrid,1,102,0
chr4-2151726_2151828,WDSV_NC001867-cPa75-hybrid,1,1,2151776,2151776,WDSV_NC001867-cPa75-hybrid,1,102,0
chr4-2151854_2151956,WDSV_NC001867-cPa75-hybrid,1,1,2151904,2151904,WDSV_NC001867-cPa75-hybrid,1,102,0
chr4-21539359_21539505,cPa247_cPa529_cPa545-unknown,0.333333333333333,3,21539453,21539409,cPa247_cPa529_cPa545-unknown,1_1_1,146,44
chr4-2155788_2155948,cPa228-cPa75-hybrid,1,1,2155941,2155807,cPa228-cPa75-hybrid,9,160,134
chr4-2179560_2179662,cPa260,0.6,2,2179629,2179583,cPa228_cPa260,2_3,102,46
chr4-2180609_2180711,WDSV_NC001867,1,1,2180659,2180659,WDSV_NC001867,1,102,0
chr4-21910066_21910176,cPa456,0.573333333333333,13,21910157,21910072,cPa117-cPa587-hybrid_cPa117-unknown_cPa363_cPa363-cPa587-hybrid_cPa363-unknown_cPa452-cPa121-hybrid_cPa452-cPa363-hybrid_cPa452-cPa587-hybrid_cPa452-unknown_cPa456_cPa456-cPa121-hybrid_cPa456-cPa363-hybrid_cPa555-cPa587-hybrid,2_3_10_1_1_2_2_5_3_43_1_1_1,110,85
chr4-21949980_21950106,cPa546-cPa257-hybrid_cPa555-cPa285-hybrid,0.222222222222222,7,21950054,21950019,cPa257_cPa419_cPa546-cPa257-hybrid_cPa546-cPa285-hybrid_cPa555_cPa555-cPa257-hybrid_cPa555-cPa285-hybrid,1_1_2_1_1_1_2,126,35
chr4-22009935_22010040,cPa118_cPa15_cPa248-cPa443-hybrid_cPa268-cPa443-hybrid,0.25,4,22009988,22009985,cPa118_cPa15_cPa248-cPa443-hybrid_cPa268-cPa443-hybrid,1_1_1_1,105,3
chr4-22060660_22060762,cPa391,0.75,2,22060710,22060693,cPa391_cPa426-cPa293-hybrid,3_1,102,17
chr4-22141624_22141726,cPa450,0.375,6,22141675,22141663,cPa199_cPa227_cPa273-cPa199-hybrid_cPa273-cPa223-hybrid_cPa450_cPa553,1_1_1_1_3_1,102,12
chr4-2237915_2238043,cPa75,1,1,2237991,2237965,cPa75,2,128,26
chr4-22458567_22458673,cPa163,0.39344262295082,8,22458668,22458581,cPa163_cPa163-cPa360-hybrid_cPa163-unknown_cPa224_cPa224-cPa360-hybrid_cPa224-unknown_cPa360_cPa360-unknown,96_5_18_45_4_5_70_1,106,87
chr4-2278531_2279113,cPa75,1,1,2279061,2278581,cPa75,39,582,480
chr4-22789583_22789691,cPa75,0.947368421052632,2,22789671,22789583,cPa62-cPa75-hybrid_cPa75,1_18,108,88
chr4-22789921_22790080,cPa75,0.925925925925926,3,22790028,22789971,cPa542-cPa293-hybrid_cPa62-unknown_cPa75,1_1_25,159,57
chr4-22805632_22805734,cPa285-cPa62-hybrid_cPa71-cPa62-hybrid_cPa75,0.333333333333333,3,22805682,22805635,cPa285-cPa62-hybrid_cPa71-cPa62-hybrid_cPa75,1_1_1,102,47
chr4-22805756_22805918,cPa62,0.363636363636364,5,22805890,22805759,cPa572-cPa62-hybrid_cPa62_cPa71_cPa71-cPa62-hybrid_cPa75,1_4_1_3_2,162,131
chr4-2286308_2286410,cPa75,1,1,2286358,2286358,cPa75,1,102,0
chr4-2292926_2293066,cPa75,1,1,2293014,2292970,cPa75,3,140,44
chr4-2301701_2302406,cPa75,0.975609756097561,2,2302389,2301749,cPa75_cPa75-unknown,40_1,705,640
chr4-2302479_2302581,cPa75,1,1,2302529,2302529,cPa75,1,102,0
chr4-2303961_2304063,cPa75,1,1,2304011,2304011,cPa75,1,102,0
chr4-2304065_2304477,cPa75,1,1,2304425,2304115,cPa75,19,412,310
chr4-2304497_2304611,cPa75,1,1,2304559,2304547,cPa75,2,114,12
chr4-2304858_2305066,cPa75,1,1,2305014,2304908,cPa75,5,208,106
chr4-2305107_2305209,cPa75,1,1,2305157,2305157,cPa75,1,102,0
chr4-2305884_2305986,cPa75,1,1,2305934,2305934,cPa75,1,102,0
chr4-2312889_2312991,cPa75,1,1,2312939,2312895,cPa75,2,102,44
chr4-2313541_2313643,cPa75,1,1,2313591,2313591,cPa75,1,102,0
chr4-2313673_2313783,cPa75,1,1,2313731,2313723,cPa75,2,110,8
chr4-2313955_2314057,cPa75,1,1,2314005,2314005,cPa75,1,102,0
chr4-2314250_2314352,cPa75,1,1,2314300,2314300,cPa75,1,102,0
chr4-2314442_2314544,cPa75,1,1,2314492,2314492,cPa75,1,102,0
chr4-2320297_2320508,cPa75,1,1,2320456,2320347,cPa75,5,211,109
chr4-2320573_2320675,cPa75,1,1,2320623,2320623,cPa75,1,102,0
chr4-2320711_2320813,cPa75,1,1,2320761,2320761,cPa75,1,102,0
chr4-2335768_2335870,cPa75,1,1,2335818,2335818,cPa75,1,102,0
chr4-2335924_2336026,cPa75,1,1,2335974,2335974,cPa75,1,102,0
chr4-2353965_2354067,cPa75,1,1,2354015,2354015,cPa75,1,102,0
chr4-23878373_23878475,cPa492,1,1,23878424,23878423,cPa492,2,102,1
chr4-23983701_23983803,cPa62,1,1,23983766,23983721,cPa62,20,102,45
chr4-2416331_2416433,cPa75,1,1,2416381,2416381,cPa75,1,102,0
chr4-2416757_2416859,cPa75,1,1,2416807,2416807,cPa75,1,102,0
chr4-24605160_24605262,cPa174-cPa47-hybrid_cPa254,0.25,6,24605223,24605201,cPa174-cPa47-hybrid_cPa254_cPa254-cPa47-hybrid_cPa404_cPa425_cPa47,2_2_1_1_1_1,102,22
chr4-24904764_24904878,cPa363_cPa452,0.285714285714286,5,24904827,24904814,cPa176_cPa363_cPa452_cPa71_cPa71-cPa176-hybrid,1_2_2_1_1,114,13
chr4-25002427_25002570,cPa62,0.714285714285714,3,25002518,25002474,cPa285_cPa62_cPa62-unknown,3_10_1,143,44
chr4-25225229_25225331,cPa363-cPa450-hybrid,0.25,12,25225291,25225228,cPa363-cPa199-hybrid_cPa363-cPa227-hybrid_cPa363-cPa273-hybrid_cPa363-cPa450-hybrid_cPa363-cPa542-hybrid_cPa363-cPa553-hybrid_cPa456-cPa199-hybrid_cPa456-cPa227-hybrid_cPa456-cPa273-hybrid_cPa456-cPa450-hybrid_cPa456-cPa542-hybrid_cPa587-cPa273-hybrid,4_4_2_8_1_1_1_1_2_5_1_2,102,63
chr4-25225941_25226083,cPa363-cPa542-hybrid,0.272727272727273,8,25226052,25225990,cPa363-cPa199-hybrid_cPa363-cPa227-hybrid_cPa363-cPa542-hybrid_cPa456-cPa450-hybrid_cPa587-cPa199-hybrid_cPa587-cPa273-hybrid_cPa587-cPa450-hybrid_cPa75-cPa450-hybrid,1_1_3_2_1_1_1_1,142,62
chr4-25241909_25242011,cPa62,0.727272727272727,3,25242006,25241908,cPa293_cPa62_cPa62-unknown,1_8_2,102,98
chr4-25269997_25270103,VISNA_S55323-cPa413-hybrid,0.333333333333333,5,25270089,25270013,cPa157-cPa413-hybrid_cPa285-cPa413-hybrid_cPa293-cPa413-hybrid_cPa402-cPa413-hybrid_VISNA_S55323-cPa413-hybrid,1_1_1_1_2,106,76
chr4-25305259_25305372,cPa363_cPa452_cPa71,0.272727272727273,5,25305320,25305309,cPa176-cPa16-hybrid_cPa223-cPa16-hybrid_cPa363_cPa452_cPa71,1_1_3_3_3,113,11
chr4-25311086_25311191,cPa142,0.5,3,25311172,25311136,cPa101_cPa101-unknown_cPa142,2_1_3,105,36
chr4-25507538_25507653,cPa118_cPa15,0.444444444444444,3,25507647,25507588,cPa118_cPa15_cPa443-unknown,4_4_1,115,59
chr4-25680932_25681034,HERV-W_repbase_HERV17_LTR17,0.666666666666667,3,25681003,25680942,cPa62-HERV-W_repbase_HERV17_LTR17-hybrid_cPa75-HERV-W_repbase_HERV17_LTR17-hybrid_HERV-W_repbase_HERV17_LTR17,1_1_4,102,61
chr4-25681119_25681486,HERV-W_repbase_HERV17_LTR17,0.72,10,25681465,25681169,cPa62-cPa75-hybrid_cPa62-HERV-W_repbase_HERV17_LTR17-hybrid_cPa62-unknown_cPa71_cPa75_cPa75-HERV-W_repbase_HERV17_LTR17-hybrid_cPa75-unknown_HERV-W_repbase_HERV17_LTR17_HERV-W_repbase_HERV17_LTR17-unknown_MER52A_repbase_MER52AI_MER52A,1_1_1_1_3_4_1_36_1_1,367,296
chr4-258682_258824,cPa15,0.628571428571429,9,258806,258720,cPa118_cPa118-cPa15-hybrid_cPa118-cPa248-hybrid_cPa118-cPa443-hybrid_cPa118-unknown_cPa15_cPa268_cPa268-cPa118-hybrid_cPa268-unknown,10_3_2_2_1_44_6_1_1,142,86
chr4-2588873_2588975,cPa16,0.5,4,2588972,2588872,cPa16_cPa16-unknown_cPa379_cPa379-unknown,14_2_10_2,102,100
chr4-26138543_26138649,cPa176-cPa16-hybrid_cPa363_cPa363-cPa16-hybrid_cPa452_cPa452-cPa16-hybrid_cPa71-cPa16-hybrid,0.166666666666667,6,26138597,26138588,cPa176-cPa16-hybrid_cPa363_cPa363-cPa16-hybrid_cPa452_cPa452-cPa16-hybrid_cPa71-cPa16-hybrid,1_1_1_1_1_1,106,9
chr4-26183296_26183399,cPa254_cPa404_cPa425,0.285714285714286,4,26183347,26183343,cPa174_cPa254_cPa404_cPa425,1_2_2_2,103,4
chr4-26229945_26230053,cPa450,0.4375,7,26230009,26229949,cPa199_cPa199-cPa227-hybrid_cPa223-cPa227-hybrid_cPa223-cPa273-hybrid_cPa227_cPa345-cPa227-hybrid_cPa450,2_1_3_1_1_1_7,108,60
chr4-2673560_2673662,cPa71,1,1,2673610,2673559,cPa71,5,102,51
chr4-2696192_2696294,cPa260_cPa539,0.5,2,2696244,2696242,cPa260_cPa539,1_1,102,2
chr4-27015374_27015476,cPa563,0.363636363636364,7,27015460,27015413,cPa131-cPa216-hybrid_cPa131-cPa438-hybrid_cPa523-cPa216-hybrid_cPa523-cPa438-hybrid_cPa523-cPa463-hybrid_cPa563_cPa563-cPa463-hybrid,1_2_1_1_1_4_1,102,47
chr4-2779059_2779161,cPa285-unknown,1,1,2779109,2779109,cPa285-unknown,1,102,0
chr4-2779191_2779310,cPa62,1,1,2779258,2779202,cPa62,3,119,56
chr4-2779399_2779510,cPa62,1,1,2779458,2779437,cPa62,5,111,21
chr4-27841893_27841999,cPa62,0.8,3,27841983,27841931,cPa285_cPa293_cPa62,1_1_8,106,52
chr4-28393951_28394053,cPa62,0.91304347826087,2,28394053,28393953,cPa62_cPa75,21_2,102,100
chr4-28527743_28527845,cPa62,0.5,4,28527830,28527745,cPa62_cPa62-cPa75-hybrid_cPa62-unknown_cPa75,4_1_1_2,102,85
chr4-28567953_28568099,cPa75,0.33,18,28568092,28567975,CAEV_NC001463-cPa113-hybrid_CAEV_NC001463-cPa293-hybrid_CAEV_NC001463-cPa62-hybrid_CAEV_NC001463-cPa75-hybrid_CAEV_NC001463-PERVA_AY099323-hybrid_CAEV_NC001463-unknown_cPa113_cPa260_cPa293_cPa293-unknown_cPa75_cPa75-unknown_PERVA_AY099323_PERVB_AY099324-cPa62-hybrid_PERVC_HM159246_PERVC_HM159246-cPa113-hybrid_PERVC_HM159246-cPa62-hybrid_PERVC_HM159246-cPa75-hybrid,5_1_22_2_1_6_13_1_4_1_33_1_1_1_5_1_1_1,146,117
chr4-28570520_28570622,cPa270-unknown,1,1,28570570,28570570,cPa270-unknown,1,102,0
chr4-28841312_28841421,cPa456,0.4,4,28841369,28841358,cPa117-cPa587-hybrid_cPa363_cPa452-cPa587-hybrid_cPa456,1_1_1_2,109,11
chr4-2899683_2899844,cPa452,0.666666666666667,6,2899792,2899722,cPa363_cPa363-cPa16-hybrid_cPa363-cPa71-hybrid_cPa363-unknown_cPa452_cPa71,1_1_2_2_22_5,161,70
chr4-2907853_2907955,cPa285_cPa62,0.5,2,2907903,2907861,cPa285_cPa62,1_1,102,42
chr4-29200139_29200254,cPa553,0.370786516853933,17,29200239,29200145,cPa199_cPa199-cPa273-hybrid_cPa199-cPa450-hybrid_cPa199-cPa542-hybrid_cPa223-cPa199-hybrid_cPa223-cPa273-hybrid_cPa223-cPa450-hybrid_cPa223-cPa542-hybrid_cPa223-unknown_cPa273_cPa345_cPa345-cPa273-hybrid_cPa345-cPa450-hybrid_cPa450_cPa482-cPa450-hybrid_cPa553_cPa553-cPa542-hybrid,1_1_1_1_1_2_4_9_1_6_5_1_3_18_1_33_1,115,94
chr4-2931796_2931898,cPa425_cPa47,0.333333333333333,4,2931857,2931801,cPa174-cPa223-hybrid_cPa254_cPa425_cPa47,1_1_2_2,102,56
chr4-29339480_29339604,cPa62-cPa75-hybrid_cPa62-unknown,0.333333333333333,4,29339599,29339497,cPa293_cPa62-cPa75-hybrid_cPa62-unknown_cPa75,2_3_3_1,124,102
chr4-2935386_2935488,cPa254-cPa425-hybrid_cPa47,0.333333333333333,4,2935436,2935411,cPa174_cPa254-cPa425-hybrid_cPa425_cPa47,1_2_1_2,102,25
chr4-29393807_29393923,cPa357-unknown,0.924528301886792,2,29393879,29393826,cPa357-unknown_cPa413-unknown,49_4,116,53
chr4-29415969_29416071,cPa553,0.428571428571429,6,29416020,29415989,cPa223-cPa273-hybrid_cPa273_cPa345_cPa345-cPa273-hybrid_cPa345-cPa450-hybrid_cPa553,3_2_1_1_1_6,102,31
chr4-29450839_29450941,cPa419,1,1,29450889,29450889,cPa419,1,102,0
chr4-29478331_29478433,cPa391-unknown,1,1,29478381,29478381,cPa391-unknown,1,102,0
chr4-2958835_2958937,cPa391-cPa287-hybrid,1,1,2958885,2958885,cPa391-cPa287-hybrid,1,102,0
chr4-29604397_29604499,cPa363_cPa456,0.428571428571429,3,29604449,29604447,cPa363_cPa452_cPa456,3_1_3,102,2
chr4-296711_296813,cPa260,0.4,4,296778,296760,cPa106_cPa260_cPa260-cPa106-hybrid_cPa260-unknown,1_2_1_1,102,18
chr4-29807772_29807874,cPa182,0.714285714285714,3,29807822,29807811,cPa182_cPa182-cPa34-hybrid_cPa34,5_1_1,102,11
chr4-29942753_29942855,cPa363_cPa452_cPa71,0.333333333333333,3,29942803,29942800,cPa363_cPa452_cPa71,2_2_2,102,3
chr4-29944351_29944453,cPa15,0.409090909090909,11,29944410,29944375,cPa118_cPa118-cPa15-hybrid_cPa118-unknown_cPa125-cPa118-hybrid_cPa125-unknown_cPa15_cPa248-cPa118-hybrid_cPa248-unknown_cPa268-unknown_cPa419_cPa443-cPa118-hybrid,15_1_1_1_1_18_3_1_1_1_1,102,35
chr4-30101620_30101722,cPa285_cPa62,0.5,2,30101670,30101670,cPa285_cPa62,1_1,102,0
chr4-30563189_30563291,cPa62,0.974358974358974,2,30563271,30563217,cPa62_cPa62-cPa254-hybrid,38_1,102,54
chr4-3061161_3061263,cPa75,1,1,3061211,3061211,cPa75,1,102,0
chr4-3062109_3062377,cPa75,1,1,3062325,3062135,cPa75,12,268,190
chr4-3062436_3062562,cPa75,1,1,3062510,3062486,cPa75,18,126,24
chr4-3062649_3062808,cPa75,1,1,3062757,3062699,cPa75,8,159,58
chr4-3062898_3063014,cPa75,1,1,3062962,3062948,cPa75,2,116,14
chr4-3063368_3063623,cPa75,1,1,3063571,3063418,cPa75,22,255,153
chr4-3078635_3078818,cPa62,0.833333333333333,2,3078766,3078685,cPa285-cPa62-hybrid_cPa62,1_5,183,81
chr4-30802746_30802851,cPa255,0.454545454545455,6,30802801,30802754,cPa131_cPa255_cPa255-cPa131-hybrid_cPa438-unknown_cPa478_cPa478-unknown,3_10_1_2_5_1,105,47
chr4-30831719_30831827,cPa529,0.416666666666667,6,30831781,30831768,cPa14-cPa247-hybrid_cPa529_cPa545-cPa247-hybrid_cPa545-cPa529-hybrid_cPa545-unknown_cPa95-cPa247-hybrid,1_5_2_2_1_1,108,13
chr4-30832773_30832875,cPa456,0.384615384615385,5,30832830,30832807,cPa117-cPa587-hybrid_cPa363_cPa452_cPa452-unknown_cPa456,1_4_2_1_5,102,23
chr4-30960655_30960759,cPa220,0.666666666666667,3,30960707,30960671,cPa190_cPa220_cPa258,1_4_1,104,36
chr4-3120149_3120251,cPa546_cPa75-cPa260-hybrid,0.5,2,3120199,3120188,cPa546_cPa75-cPa260-hybrid,1_1,102,11
chr4-31237619_31237721,cPa62,0.8,2,31237693,31237641,cPa419_cPa62,1_4,102,52
chr4-31281879_31281981,cPa419,1,1,31281929,31281929,cPa419,1,102,0
chr4-313494_313597,cPa223_cPa345,0.222222222222222,7,313595,313534,cPa223_cPa227_cPa273_cPa345_cPa450_cPa542_cPa553,2_1_1_2_1_1_1,103,61
chr4-3142633_3142735,cPa75-cPa62-hybrid,0.666666666666667,2,3142683,3142676,cPa75_cPa75-cPa62-hybrid,1_2,102,7
chr4-31588481_31588639,cPa75,0.5,4,31588587,31588484,cPa62_cPa62-cPa71-hybrid_cPa62-cPa75-hybrid_cPa75,1_1_3_5,158,103
chr4-31588907_31589143,cPa75,0.814814814814815,4,31589091,31588942,cPa62-cPa71-hybrid_cPa62-cPa75-hybrid_cPa62-HERV-W_repbase_HERV17_LTR17-hybrid_cPa75,1_1_3_22,236,149
chr4-31589265_31589367,cPa75,1,1,31589315,31589315,cPa75,1,102,0
chr4-31589393_31589546,cPa75,0.625,4,31589521,31589434,cPa293-cPa71-hybrid_cPa62-cPa75-hybrid_cPa75_HERV-W_repbase_HERV17_LTR17,1_1_5_1,153,87
chr4-32121770_32121872,cPa363_cPa456,0.285714285714286,5,32121865,32121810,cPa117-cPa456-hybrid_cPa117-cPa587-hybrid_cPa363_cPa452-cPa587-hybrid_cPa456,1_1_2_1_2,102,55
chr4-32131476_32131579,cPa315,1,1,32131527,32131526,cPa315,2,103,1
chr4-32522719_32522821,cPa62-cPa75-hybrid,1,1,32522769,32522740,cPa62-cPa75-hybrid,2,102,29
chr4-32674480_32674582,cPa15,0.5,3,32674582,32674530,cPa118_cPa15_cPa268,1_2_1,102,52
chr4-32960997_32961112,cPa404-cPa174-hybrid_cPa425_cPa47,0.333333333333333,3,32961060,32961047,cPa404-cPa174-hybrid_cPa425_cPa47,1_1_1,115,13
chr4-3312520_3312622,cPa260-unknown_cPa572,0.5,2,3312583,3312570,cPa260-unknown_cPa572,1_1,102,13
chr4-3312627_3312729,CAEV_NC001463-cPa75-hybrid,1,1,3312677,3312677,CAEV_NC001463-cPa75-hybrid,1,102,0
chr4-33674787_33674908,cPa62_cPa75-cPa62-hybrid,0.307692307692308,4,33674899,33674820,cPa62_cPa75_cPa75-cPa62-hybrid_cPa75-unknown,4_2_4_3,121,79
chr4-3372214_3372316,cPa566_cPa62,0.5,2,3372315,3372264,cPa566_cPa62,1_1,102,51
chr4-33881634_33881736,cPa339,0.333333333333333,6,33881724,33881673,cPa339_cPa390-cPa447-hybrid_cPa390-cPa62-hybrid_cPa444-cPa447-hybrid_cPa444-unknown_cPa447,4_1_1_1_2_3,102,51
chr4-34093627_34093737,cPa254,0.333333333333333,6,34093686,34093675,cPa174_cPa174-cPa425-hybrid_cPa174-cPa47-hybrid_cPa254_cPa425_cPa47,1_1_1_3_2_1,110,11
chr4-34170968_34171091,HERV-W_repbase_HERV17_LTR17,0.384615384615385,6,34171048,34170996,cPa75_HERV-W_repbase_HERV17_LTR17_KoRV_AF151794_KoRV_AF151794-cPa419-hybrid_PERV_AJ293656_S71_repbase_HERVS71_LTR6A,2_5_3_1_1_1,123,52
chr4-34330786_34330888,cPa62,1,1,34330836,34330827,cPa62,3,102,9
chr4-34413451_34413560,cPa456,0.481481481481481,13,34413526,34413488,cPa117-cPa363-hybrid_cPa117-cPa456-hybrid_cPa117-cPa587-hybrid_cPa117-unknown_cPa363_cPa363-cPa456-hybrid_cPa363-unknown_cPa452_cPa452-cPa363-hybrid_cPa452-cPa456-hybrid_cPa452-cPa587-hybrid_cPa452-unknown_cPa456,1_3_4_1_14_1_1_8_1_1_6_1_39,109,38
chr4-34530888_34530990,cPa75-cPa62-hybrid,0.416666666666667,4,34530938,34530892,cPa75_cPa75-cPa113-hybrid_cPa75-cPa62-hybrid_cPa75-unknown,4_1_5_2,102,46
chr4-34531050_34531152,cPa75,0.5,5,34531141,34531100,cPa260-cPa62-hybrid_cPa293_cPa62_cPa75_cPa75-cPa62-hybrid,1_1_1_4_1,102,41
chr4-34570895_34570999,cPa104_cPa18-unknown_cPa190_cPa219-unknown,0.25,4,34570957,34570945,cPa104_cPa18-unknown_cPa190_cPa219-unknown,1_1_1_1,104,12
chr4-34644973_34645075,cPa363_cPa456,0.428571428571429,4,34645046,34644975,cPa117-cPa587-hybrid_cPa117-unknown_cPa363_cPa456,2_1_9_9,102,71
chr4-346787_346889,cPa260,1,1,346837,346820,cPa260,2,102,17
chr4-34757826_34757928,cPa62,1,1,34757876,34757843,cPa62,5,102,33
chr4-3479414_3479622,cPa539,0.75,3,3479570,3479463,cPa15_cPa492_cPa539,1_1_6,208,107
chr4-35464943_35465056,cPa444,0.5,3,35465004,35464993,cPa390_cPa444_cPa447,1_2_1,113,11
chr4-35548372_35548474,cPa174-cPa425-hybrid_cPa254_cPa254-cPa425-hybrid_cPa404_cPa47_cPa62-cPa425-hybrid_cPa62-cPa47-hybrid,0.142857142857143,7,35548422,35548386,cPa174-cPa425-hybrid_cPa254_cPa254-cPa425-hybrid_cPa404_cPa47_cPa62-cPa425-hybrid_cPa62-cPa47-hybrid,1_1_1_1_1_1_1,102,36
chr4-35550716_35550818,cPa62-cPa75-hybrid,0.75,3,35550797,35550766,cPa62_cPa62-cPa75-hybrid_cPa62-unknown,1_6_1,102,31
chr4-35551019_35551205,cPa62-cPa75-hybrid,0.833333333333333,2,35551153,35551069,cPa62_cPa62-cPa75-hybrid,1_5,186,84
chr4-35946979_35947090,cPa75-cPa62-hybrid,0.344827586206897,8,35947089,35946987,cPa62_cPa75_cPa75-cPa62-hybrid_cPa75-unknown_HERV-W_repbase_HERV17_LTR17_HERV-W_repbase_HERV17_LTR17-cPa62-hybrid_HERV-W_repbase_HERV17_LTR17-cPa75-hybrid_HERV-W_repbase_HERV17_LTR17-unknown,2_7_10_2_4_2_1_1,111,102
chr4-3595014_3595116,cPa581,0.666666666666667,2,3595064,3595029,cPa173_cPa581,1_2,102,35
chr4-35962184_35962286,cPa391,0.7,3,35962254,35962199,cPa293_cPa391_cPa426,2_7_1,102,55
chr4-35978683_35978785,cPa247_cPa529,0.5,2,35978745,35978733,cPa247_cPa529,1_1,102,12
chr4-3614105_3614207,cPa62,1,1,3614196,3614155,cPa62,7,102,41
chr4-36306366_36306468,cPa62,0.666666666666667,2,36306459,36306394,cPa62_cPa62-cPa419-hybrid,2_1,102,65
chr4-36437507_36437616,cPa62,0.936170212765957,4,36437569,36437553,cPa254_cPa62_cPa62-cPa117-hybrid_cPa62-cPa254-hybrid,1_44_1_1,109,16
chr4-36459994_36460152,HERV-W_repbase_HERV17_LTR17,0.875,3,36460145,36460044,HERV-W_repbase_HERV17_LTR17_HERV-W_repbase_HERV17_LTR17-cPa62-hybrid_HERV-W_repbase_HERV17_LTR17-unknown,21_2_1,158,101
chr4-36460165_36460412,HERV-W_repbase_HERV17_LTR17,0.867924528301887,6,36460387,36460184,cPa62_HERV-W_repbase_HERV17_LTR17_HERV-W_repbase_HERV17_LTR17-cPa62-hybrid_HERV-W_repbase_HERV17_LTR17-unknown_KoRV_AF151794_KoRV_AF151794-cPa62-hybrid,3_46_1_1_1_1,247,203
chr4-36461779_36461892,cPa62_HERV-W_repbase_HERV17_LTR17-cPa62-hybrid,0.5,2,36461843,36461829,cPa62_HERV-W_repbase_HERV17_LTR17-cPa62-hybrid,3_3,113,14
chr4-36985971_36986073,cPa419,1,1,36986021,36986021,cPa419,1,102,0
chr4-3800488_3800590,cPa583,0.6,4,3800589,3800488,cPa358_cPa358-cPa583-hybrid_cPa358-unknown_cPa583,7_1_2_15,102,101
chr4-3806193_3806404,HERV-W_repbase_HERV17_LTR17,0.888888888888889,2,3806352,3806243,HERV-W_repbase_HERV17_LTR17_HERV-W_repbase_HERV17_LTR17-unknown,8_1,211,109
chr4-3806438_3806540,HERV-W_repbase_HERV17_LTR17,1,1,3806488,3806488,HERV-W_repbase_HERV17_LTR17,1,102,0
chr4-3806556_3806658,HERV-W_repbase_HERV17_LTR17,0.666666666666667,2,3806606,3806562,cPa75-HERV-W_repbase_HERV17_LTR17-hybrid_HERV-W_repbase_HERV17_LTR17,1_2,102,44
chr4-3807079_3807181,HERV-W_repbase_HERV17_LTR17,1,1,3807157,3807129,HERV-W_repbase_HERV17_LTR17,2,102,28
chr4-3815456_3815558,cPa71,1,1,3815506,3815506,cPa71,1,102,0
chr4-3816163_3816280,cPa71,1,1,3816228,3816213,cPa71,2,117,15
chr4-38269120_38269222,cPa419,1,1,38269170,38269170,cPa419,1,102,0
chr4-38375497_38375599,cPa67,1,1,38375566,38375547,cPa67,2,102,19
chr4-38523376_38523478,cPa542,0.5,7,38523426,38523395,cPa199_cPa273-cPa199-hybrid_cPa345_cPa450_cPa450-cPa199-hybrid_cPa542_cPa553-cPa199-hybrid,1_2_2_2_2_10_1,102,31
chr4-38670105_38670219,cPa15_cPa268,0.5,2,38670167,38670155,cPa15_cPa268,1_1,114,12
chr4-39020988_39021090,cPa62,1,1,39021056,39021038,cPa62,31,102,18
chr4-39168082_39168184,cPa75,1,1,39168132,39168132,cPa75,1,102,0
chr4-39627716_39627825,cPa456,0.666666666666667,3,39627775,39627765,cPa363_cPa452_cPa456,1_1_4,109,10
chr4-3994992_3995094,cPa75-cPa62-hybrid,0.333333333333333,5,3995079,3995029,cPa285_cPa419_cPa62_cPa75_cPa75-cPa62-hybrid,1_1_1_1_2,102,50
chr4-40124639_40124763,cPa270-cPa572-hybrid,0.75,4,40124724,40124646,cPa270-cPa152-hybrid_cPa270-cPa572-hybrid_cPa270-unknown_cPa419,1_21_5_1,124,78
chr4-40197751_40197853,cPa62,0.75,2,40197801,40197763,cPa419_cPa62,1_3,102,38
chr4-40211832_40211939,cPa15_cPa248-cPa268-hybrid,0.5,2,40211887,40211882,cPa15_cPa248-cPa268-hybrid,1_1,107,5
chr4-40280328_40280437,cPa450,0.363636363636364,8,40280390,40280359,cPa199-cPa223-hybrid_cPa273-cPa199-hybrid_cPa273-cPa450-hybrid_cPa273-cPa482-hybrid_cPa450_cPa542-cPa482-hybrid_cPa553_cPa553-cPa450-hybrid,1_1_1_1_4_1_1_1,109,31
chr4-40294126_40294230,cPa104-cPa18-hybrid_cPa190-cPa18-hybrid,0.285714285714286,5,40294191,40294172,cPa104-cPa18-hybrid_cPa104-cPa219-hybrid_cPa104-cPa258-hybrid_cPa190-cPa18-hybrid_cPa220,2_1_1_2_1,104,19
chr4-40329640_40329742,cPa127-cPa241-hybrid_cPa515,0.5,2,40329702,40329690,cPa127-cPa241-hybrid_cPa515,1_1,102,12
chr4-4037902_4038004,cPa450,0.285714285714286,15,4038002,4037932,cPa199_cPa199-cPa273-hybrid_cPa199-cPa450-hybrid_cPa199-cPa553-hybrid_cPa223-cPa227-hybrid_cPa223-cPa273-hybrid_cPa223-cPa450-hybrid_cPa223-cPa553-hybrid_cPa223-unknown_cPa227_cPa345-cPa227-hybrid_cPa345-cPa273-hybrid_cPa450_cPa482-cPa227-hybrid_cPa553,6_1_2_1_1_4_2_1_2_1_2_6_18_3_13,102,70
chr4-404727_404913,cPa260,0.9375,2,404905,404756,cPa106_cPa260,1_15,186,149
chr4-404988_405090,cPa260,1,1,405050,405007,cPa260,5,102,43
chr4-40780686_40780788,cPa456,0.468085106382979,8,40780788,40780692,cPa363_cPa363-cPa117-hybrid_cPa363-cPa452-hybrid_cPa456_cPa456-cPa117-hybrid_cPa456-cPa452-hybrid_cPa587-cPa117-hybrid_cPa587-cPa363-hybrid,26_3_2_44_5_6_6_2,102,96
chr4-411002_411104,cPa260,0.578947368421053,4,411103,411010,cPa106_cPa106-cPa260-hybrid_cPa260_cPa260-cPa75-hybrid,19_4_33_1,102,93
chr4-41209351_41209453,cPa15_cPa248-cPa140-hybrid_cPa268_cPa443,0.25,4,41209416,41209401,cPa15_cPa248-cPa140-hybrid_cPa268_cPa443,1_1_1_1,102,15
chr4-41234_41336,cPa62,1,1,41295,41275,cPa62,14,102,20
chr4-41598847_41598949,cPa419,1,1,41598897,41598897,cPa419,1,102,0
chr4-416739_416841,cPa174_cPa47,0.5,2,416789,416789,cPa174_cPa47,1_1,102,0
chr4-418622_418724,cPa62-cPa581-hybrid,1,1,418672,418672,cPa62-cPa581-hybrid,1,102,0
chr4-420172_420274,cPa75,1,1,420222,420222,cPa75,1,102,0
chr4-42281299_42281401,cPa62,1,1,42281349,42281349,cPa62,2,102,0
chr4-4264423_4264537,cPa452,0.5,3,4264488,4264426,cPa363_cPa452_cPa71,2_5_3,114,62
chr4-4279184_4279318,cPa62,0.5,4,4279298,4279201,cPa285_cPa285-cPa62-hybrid_cPa293_cPa62,1_1_2_4,134,97
chr4-42874416_42874518,cPa449-unknown,1,1,42874468,42874465,cPa449-unknown,3,102,3
chr4-43084126_43084283,cPa62,0.978723404255319,2,43084244,43084131,cPa62_cPa62-unknown,46_1,157,113
chr4-43358912_43359014,cPa419,1,1,43358962,43358962,cPa419,1,102,0
chr4-4340933_4341193,cPa62,0.523809523809524,3,4341150,4340972,cPa228-cPa62-hybrid_cPa62_cPa62-unknown,1_11_9,260,178
chr4-43412487_43412589,cPa62,1,1,43412564,43412495,cPa62,57,102,69
chr4-43644951_43645053,cPa62,0.5,3,43645003,43645001,cPa254_cPa516-cPa254-hybrid_cPa62,1_1_2,102,2
chr4-43645163_43645265,cPa62,0.657894736842105,4,43645260,43645191,cPa254_cPa516-cPa62-hybrid_cPa516-unknown_cPa62,1_5_7_25,102,69
chr4-43664796_43664906,cPa75,0.6,3,43664899,43664846,cPa62_cPa62-unknown_cPa75,1_1_3,110,53
chr4-43664975_43665077,cPa62-unknown_cPa75,0.4,3,43665034,43664980,cPa62-unknown_cPa75_PERVC_HM159246,2_2_1,102,54
chr4-43744367_43744474,cPa176-cPa16-hybrid_cPa363_cPa452_cPa71,0.25,4,43744422,43744417,cPa176-cPa16-hybrid_cPa363_cPa452_cPa71,1_1_1_1,107,5
chr4-438326_438517,cPa67,0.628571428571429,3,438517,438332,cPa345_cPa67_cPa75-cPa67-hybrid,11_22_2,191,185
chr4-44231902_44232004,cPa392,1,1,44231970,44231901,cPa392,3,102,69
chr4-44236914_44237016,cPa188-cPa419-hybrid,1,1,44236964,44236964,cPa188-cPa419-hybrid,1,102,0
chr4-44447387_44447504,cPa391,0.6,4,44447465,44447435,cPa201-cPa426-hybrid_cPa293_cPa293-cPa426-hybrid_cPa391,1_2_1_6,117,30
chr4-445334_445533,cPa363_cPa450_cPa452,0.333333333333333,3,445481,445384,cPa363_cPa450_cPa452,1_1_1,199,97
chr4-44857505_44857607,cPa62,1,1,44857603,44857511,cPa62,30,102,92
chr4-44981237_44981339,cPa15,0.375,4,44981325,44981270,cPa118_cPa15_cPa15-unknown_cPa268,1_3_2_2,102,55
chr4-45269357_45269459,cPa62,1,1,45269415,45269396,cPa62,22,102,19
chr4-459252_459354,cPa260,0.673076923076923,6,459350,459277,cPa106_cPa106-cPa260-hybrid_cPa199-cPa260-hybrid_cPa260_cPa551_HERVHcons-unknown,13_1_1_35_1_1,102,73
chr4-460948_461050,cPa223,1,1,461046,460998,cPa223,3,102,48
chr4-461108_461210,cPa223,1,1,461158,461130,cPa223,4,102,28
chr4-461216_461443,cPa223,1,1,461391,461253,cPa223,10,227,138
chr4-461595_461721,cPa223,1,1,461669,461608,cPa223,4,126,61
chr4-46348438_46348591,HERV-W_repbase_HERV17_LTR17,0.3125,5,46348585,46348445,cPa75_cPa75-cPa62-hybrid_HERV-W_repbase_HERV17_LTR17_HERV-W_repbase_HERV17_LTR17-cPa62-hybrid_KoRV_AF151794-cPa75-hybrid,4_4_5_2_1,153,140
chr4-46348636_46348738,HERV-W_repbase_HERV17_LTR17,0.4,6,46348707,46348637,cPa75_cPa75-HERV-W_repbase_HERV17_LTR17-hybrid_HERV-W_repbase_HERV17_LTR17_HERV-W_repbase_HERV17_LTR17-cPa62-hybrid_HERV-W_repbase_HERV17_LTR17-unknown_KoRV_AF151794-cPa425-hybrid,2_1_4_1_1_1,102,70
chr4-46348750_46348940,HERV-W_repbase_HERV17_LTR17,0.580645161290323,8,46348931,46348763,cPa75_cPa75-cPa425-hybrid_cPa75-cPa62-hybrid_cPa75-HERV-W_repbase_HERV17_LTR17-hybrid_HERV-W_repbase_HERV17_LTR17_HERV-W_repbase_HERV17_LTR17-cPa62-hybrid_HERV-W_repbase_HERV17_LTR17-unknown_KoRV_AF151794,3_1_4_1_18_2_1_1,190,168
chr4-46349081_46349212,HERV-W_repbase_HERV17_LTR17,0.490196078431373,7,46349210,46349084,cPa62_cPa75_cPa75-cPa62-hybrid_cPa75-HERV-W_repbase_HERV17_LTR17-hybrid_HERV-W_repbase_HERV17_LTR17_HERV-W_repbase_HERV17_LTR17-cPa62-hybrid_PERV_AJ293656-HERV-W_repbase_HERV17_LTR17-hybrid,1_17_3_1_25_3_1,131,126
chr4-4650792_4650946,cPa62-cPa71-hybrid,0.3125,5,4650943,4650820,cPa62_cPa62-cPa71-hybrid_cPa62-cPa75-hybrid_cPa62-unknown_cPa75,1_5_4_3_3,154,123
chr4-4651155_4651269,cPa62-cPa71-hybrid_cPa62-unknown,0.428571428571429,3,4651249,4651171,cPa62-cPa71-hybrid_cPa62-unknown_cPa75,3_3_1,114,78
chr4-4672919_4673026,cPa391,0.405405405405405,8,4672986,4672921,cPa293_cPa293-cPa426-hybrid_cPa293-cPa62-hybrid_cPa293-unknown_cPa391_cPa391-cPa426-hybrid_cPa391-cPa62-hybrid_cPa426,17_10_1_1_30_6_2_7,107,65
chr4-47619255_47619357,cPa118_cPa15,0.5,2,47619342,47619305,cPa118_cPa15,2_2,102,37
chr4-4763283_4763468,cPa62,0.478260869565217,8,4763464,4763327,cPa260_cPa260-cPa293-hybrid_cPa260-cPa62-hybrid_cPa260-unknown_cPa285_cPa62_cPa75_cPa75-unknown,1_1_1_1_2_11_5_1,185,137
chr4-47782760_47782862,cPa75,0.666666666666667,2,47782829,47782810,cPa260_cPa75,1_2,102,19
chr4-47786465_47786567,cPa15,0.53125,4,47786524,47786503,cPa118_cPa15_cPa15-cPa118-hybrid_cPa443-cPa15-hybrid,13_17_1_1,102,21
chr4-488096_488198,cPa260-cPa75-hybrid,1,1,488161,488146,cPa260-cPa75-hybrid,2,102,15
chr4-48931696_48931798,cPa419,1,1,48931746,48931746,cPa419,1,102,0
chr4-49062060_49062163,cPa456,0.333333333333333,5,49062111,49062063,cPa117-unknown_cPa363_cPa452-cPa363-hybrid_cPa452-unknown_cPa456,1_1_1_1_2,103,48
chr4-4915713_4915815,cPa62,0.948717948717949,2,4915776,4915762,cPa285_cPa62,2_37,102,14
chr4-49187752_49187866,cPa363_cPa71,0.333333333333333,4,49187814,49187802,cPa363_cPa452_cPa452-unknown_cPa71,2_1_1_2,114,12
chr4-49497131_49497233,cPa62-unknown,0.473684210526316,6,49497190,49497135,cPa293_cPa62_cPa62-cPa75-hybrid_cPa62-unknown_cPa75_HERV-W_repbase_HERV17_LTR17,1_5_2_9_1_1,102,55
chr4-49715936_49716053,cPa452,0.461538461538462,4,49716019,49715965,cPa363_cPa452_cPa452-cPa71-hybrid_cPa71,15_18_1_5,117,54
chr4-499470_499667,cPa71,0.568627450980392,6,499647,499492,cPa379_cPa62-cPa71-hybrid_cPa62-cPa75-hybrid_cPa71_cPa75_cPa75-cPa71-hybrid,7_4_5_29_5_1,197,155
chr4-50001160_50001271,cPa75,0.5,6,50001219,50001175,cPa62-cPa75-hybrid_cPa62-unknown_cPa75_HERV-W_repbase_HERV17_LTR17_KoRV_AF151794_PERV_AJ293656,1_2_6_1_1_1,111,44
chr4-50114317_50114432,cPa450,0.6,3,50114402,50114367,cPa199_cPa450_cPa542,1_3_1,115,35
chr4-50238921_50239039,cPa540,0.5,6,50238987,50238971,cPa11_cPa127_cPa290-cPa127-hybrid_cPa356-cPa11-hybrid_cPa515_cPa540,1_1_1_1_1_5,118,16
chr4-50239059_50239161,cPa540,1,1,50239109,50239109,cPa540,1,102,0
chr4-50314743_50314856,cPa450,0.411764705882353,5,50314804,50314747,cPa199_cPa227_cPa273-cPa199-hybrid_cPa450_cPa553,1_1_3_7_5,113,57
chr4-50318079_50318181,cPa118_cPa15,0.333333333333333,4,50318138,50318129,cPa118_cPa15_cPa248-unknown_cPa443,2_2_1_1,102,9
chr4-50325711_50325824,cPa456,0.384615384615385,5,50325772,50325755,cPa363_cPa419_cPa452-cPa587-hybrid_cPa452-unknown_cPa456,4_1_1_2_5,113,17
chr4-50436673_50436905,cPa450,0.296296296296296,21,50436876,50436682,cPa199_cPa199-cPa273-hybrid_cPa199-cPa542-hybrid_cPa199-cPa553-hybrid_cPa199-KWERV_GQ222416-hybrid_cPa199-unknown_cPa227_cPa227-cPa273-hybrid_cPa227-cPa542-hybrid_cPa227-KWERV_GQ222416-hybrid_cPa227-unknown_cPa273_cPa450_cPa450-cPa273-hybrid_cPa450-cPa542-hybrid_cPa450-KWERV_GQ222416-hybrid_cPa450-unknown_cPa542_cPa553_cPa553-KWERV_GQ222416-hybrid_KWERV_GQ222416,2_9_6_1_3_3_4_2_3_3_1_5_32_4_4_2_6_4_4_1_9,232,194
chr4-5093273_5093375,cPa15,0.526315789473684,5,5093323,5093296,cPa15_cPa15-cPa392-hybrid_cPa15-unknown_cPa260-cPa516-hybrid_cPa61-cPa516-hybrid,10_1_6_1_1,102,27
chr4-51232530_51232634,cPa62,1,1,51232582,51232580,cPa62,2,104,2
chr4-51292653_51292779,cPa545,0.428571428571429,12,51292760,51292663,cPa14-cPa4-hybrid_cPa14-cPa545-hybrid_cPa14-cPa62-hybrid_cPa14-unknown_cPa247-cPa95-hybrid_cPa541-cPa4-hybrid_cPa541-cPa545-hybrid_cPa541-cPa95-hybrid_cPa545_cPa545-cPa62-hybrid_cPa545-cPa95-hybrid_cPa95,2_1_1_1_1_2_1_4_27_1_2_20,126,97
chr4-513431_513549,cPa75,1,1,513497,513481,cPa75,3,118,16
chr4-513599_513701,cPa75,1,1,513649,513649,cPa75,1,102,0
chr4-514243_514395,cPa75,1,1,514343,514293,cPa75,7,152,50
chr4-51662480_51662589,cPa323,0.7,3,51662582,51662526,cPa285_cPa323_cPa419,1_7_2,109,56
chr4-51742174_51742276,cPa62,0.826086956521739,5,51742224,51742197,cPa254_cPa254-cPa62-hybrid_cPa62_cPa62-unknown_cPa75-cPa62-hybrid,1_1_19_1_1,102,27
chr4-5183259_5183361,cPa75,0.545454545454545,5,5183321,5183285,cPa419_cPa62_cPa62-cPa75-hybrid_cPa62-unknown_cPa75,1_1_2_1_6,102,36
chr4-5183521_5183739,cPa75,0.709677419354839,11,5183707,5183534,cPa293_cPa293-MMTV_NC001503-hybrid_cPa62_cPa62-cPa402-hybrid_cPa62-cPa75-hybrid_cPa62-MMTV_NC001503-hybrid_cPa62-unknown_cPa75_GaLV_M26927_KoRV_AF151794_KoRV_AF151794-MMTV_NC001503-hybrid,2_1_4_1_3_3_9_66_1_2_1,218,173
chr4-5183811_5183998,cPa75,0.857142857142857,2,5183995,5183810,cPa62-cPa75-hybrid_cPa75,1_6,187,185
chr4-51880381_51880483,cPa15,0.523255813953488,6,51880473,51880419,cPa118_cPa118-cPa15-hybrid_cPa118-cPa248-hybrid_cPa118-cPa268-hybrid_cPa118-unknown_cPa15,30_1_3_1_6_45,102,54
chr4-51893141_51893243,cPa419,1,1,51893191,51893191,cPa419,1,102,0
chr4-5210336_5210438,cPa15,0.666666666666667,2,5210386,5210372,cPa118_cPa15,1_2,102,14
chr4-5226777_5226882,cPa199,0.289473684210526,13,5226872,5226781,cPa199_cPa199-cPa223-hybrid_cPa199-cPa345-hybrid_cPa199-cPa553-hybrid_cPa223_cPa227_cPa227-cPa223-hybrid_cPa273_cPa345_cPa419_cPa450_cPa542_cPa553,11_1_2_1_1_3_2_1_8_1_1_1_5,105,91
chr4-5227586_5227688,cPa47,0.230769230769231,10,5227636,5227619,cPa174_cPa174-cPa404-hybrid_cPa174-unknown_cPa254_cPa254-cPa404-hybrid_cPa425_cPa425-cPa404-hybrid_cPa450-cPa47-hybrid_cPa47_cPa505-cPa404-hybrid,2_1_1_1_1_1_1_1_3_1,102,17
chr4-52276942_52277044,cPa18,0.541666666666667,3,52276999,52276985,cPa18_cPa18-unknown_cPa258,13_1_10,102,14
chr4-52438825_52438927,cPa75-unknown,1,1,52438906,52438875,cPa75-unknown,2,102,31
chr4-52512627_52512729,cPa452-cPa16-hybrid_cPa71,0.285714285714286,5,52512699,52512648,cPa363_cPa363-cPa16-hybrid_cPa452_cPa452-cPa16-hybrid_cPa71,1_1_1_2_2,102,51
chr4-53028190_53028292,cPa62,1,1,53028242,53028218,cPa62,12,102,24
chr4-53156701_53156803,cPa11_cPa540,0.333333333333333,5,53156760,53156748,cPa11_cPa241-cPa530-hybrid_cPa290-cPa127-hybrid_cPa290-cPa515-hybrid_cPa540,3_1_1_1_3,102,12
chr4-5332692_5332798,cPa75,0.6,2,5332791,5332742,cPa75_cPa75-cPa62-hybrid,3_2,106,49
chr4-5332844_5332971,cPa75,0.5,3,5332929,5332884,cPa75_cPa75-cPa62-hybrid_HERV-W_repbase_HERV17_LTR17,4_1_3,127,45
chr4-5333409_5333511,HERV-W_repbase_HERV17_LTR17,0.666666666666667,2,5333487,5333459,cPa75-cPa62-hybrid_HERV-W_repbase_HERV17_LTR17,1_2,102,28
chr4-5333528_5333630,cPa75_cPa75-cPa62-hybrid,0.375,3,5333622,5333529,cPa75_cPa75-cPa62-hybrid_HERV-W_repbase_HERV17_LTR17,3_3_2,102,93
chr4-5337049_5337151,cPa75-cPa260-hybrid,0.333333333333333,5,5337128,5337068,cPa260_cPa62-cPa260-hybrid_cPa75-cPa119-hybrid_cPa75-cPa260-hybrid_cPa75-cPa539-hybrid,1_1_1_2_1,102,60
chr4-53420448_53420550,cPa583,0.727272727272727,3,53420547,53420478,cPa251_cPa358_cPa583,1_5_16,102,69
chr4-53427164_53427377,cPa553,0.375,5,53427346,53427213,cPa199_cPa542_cPa542-unknown_cPa553_cPa553-unknown,1_10_17_21_7,213,133
chr4-53555384_53555486,cPa62,1,1,53555434,53555434,cPa62,1,102,0
chr4-53555596_53555711,cPa62,0.95,2,53555663,53555641,cPa62_cPa62-cPa254-hybrid,19_1,115,22
chr4-53814670_53814772,cPa75,0.294117647058824,10,53814767,53814686,cPa293-cPa62-hybrid_cPa413_cPa413-cPa539-hybrid_cPa413-cPa62-hybrid_cPa62_cPa75_cPa75-cPa419-hybrid_cPa75-cPa62-hybrid_cPa75-unknown_PERVC_HM159246-cPa62-hybrid,2_4_1_8_2_10_1_3_2_1,102,81
chr4-5389597_5389773,cPa505,0.452380952380952,8,5389721,5389601,cPa109_cPa199-cPa482-hybrid_cPa273_cPa482_cPa482-unknown_cPa505_cPa505-unknown_cPa553,5_1_1_11_3_19_1_1,176,120
chr4-5389787_5389889,cPa109_cPa273_cPa482_cPa505,0.25,4,5389844,5389815,cPa109_cPa273_cPa482_cPa505,1_1_1_1,102,29
chr4-54129633_54129735,cPa246,0.529411764705882,4,54129692,54129671,cPa150_cPa246_cPa302_cPa478,3_9_3_2,102,21
chr4-54272664_54272769,cPa62,1,1,54272724,54272714,cPa62,4,105,10
chr4-54382075_54382177,cPa62,0.958333333333333,2,54382167,54382097,cPa62_cPa62-cPa419-hybrid,23_1,102,70
chr4-54566723_54566825,cPa450,0.6,3,54566784,54566773,cPa223-cPa273-hybrid_cPa450_cPa553,1_3_1,102,11
chr4-5458066_5458168,cPa391,0.622222222222222,4,5458129,5458108,cPa293_cPa293-cPa426-hybrid_cPa293-unknown_cPa391,13_3_1_28,102,21
chr4-54785158_54785260,cPa62,0.8,2,54785229,54785162,cPa285-cPa62-hybrid_cPa62,1_4,102,67
chr4-54820164_54820323,cPa62,0.909090909090909,2,54820287,54820214,cPa285_cPa62,3_30,159,73
chr4-5488165_5488402,cPa62,0.91304347826087,3,5488396,5488215,cPa62_cPa62-cPa75-hybrid_cPa62-unknown,42_2_2,237,181
chr4-5488985_5489087,cPa62-cPa75-hybrid,1,1,5489035,5489035,cPa62-cPa75-hybrid,1,102,0
chr4-5489697_5489799,cPa62-cPa75-hybrid,1,1,5489760,5489747,cPa62-cPa75-hybrid,2,102,13
chr4-55384651_55384753,cPa456,0.5,4,55384744,55384694,cPa363_cPa456_cPa456-cPa452-hybrid_cPa587-cPa117-hybrid,3_5_1_1,102,50
chr4-55444342_55444638,cPa75,0.566666666666667,12,55444632,55444388,cPa113_cPa113-cPa62-hybrid_cPa293_cPa293-cPa62-hybrid_cPa293-PERVC_HM159246-hybrid_cPa293-unknown_cPa413-unknown_cPa62_cPa75_cPa75-cPa62-hybrid_cPa75-unknown_PERVC_HM159246,1_1_10_4_2_2_1_16_68_3_8_4,296,244
chr4-55460376_55460478,WDSV_NC001867,1,1,55460426,55460426,WDSV_NC001867,1,102,0
chr4-55460500_55460686,WDSV_NC001867,0.806451612903226,5,55460645,55460500,cPa254-cPa62-hybrid_cPa62_WDSV_NC001867_WDSV_NC001867-cPa62-hybrid_WDSV_NC001867-unknown,1_1_25_2_2,186,145
chr4-55491009_55491111,cPa75,0.333333333333333,5,55491109,55491029,cPa113_cPa113-cPa75-hybrid_cPa113-unknown_cPa293-unknown_cPa75,2_2_3_1_4,102,80
chr4-55775491_55775593,cPa452,0.5,8,55775593,55775535,cPa15-cPa176-hybrid_cPa363_cPa363-cPa446-hybrid_cPa452_cPa71_cPa71-cPa176-hybrid_cPa71-cPa363-hybrid_cPa71-unknown,1_21_1_32_5_1_1_2,102,58
chr4-55777984_55778128,cPa15,0.444444444444444,5,55778076,55778034,cPa118_cPa15_cPa15-cPa118-hybrid_cPa15-cPa75-hybrid_cPa268,1_4_1_1_2,144,42
chr4-56066195_56066297,cPa150_cPa478-cPa246-hybrid,0.5,2,56066246,56066245,cPa150_cPa478-cPa246-hybrid,1_1,102,1
chr4-56150749_56150851,cPa199,1,1,56150799,56150797,cPa199,2,102,2
chr4-5657873_5658122,cPa298,0.424242424242424,15,5658115,5657892,cPa199-cPa358-hybrid_cPa199-unknown_cPa251_cPa251-cPa298-hybrid_cPa251-cPa358-hybrid_cPa298_cPa298-cPa251-hybrid_cPa298-cPa358-hybrid_cPa298-unknown_cPa358_cPa358-cPa298-hybrid_cPa583_cPa583-cPa298-hybrid_cPa583-cPa358-hybrid_cPa583-unknown,1_1_6_3_3_28_1_1_1_13_1_4_1_1_1,249,223
chr4-57093813_57093915,cPa62,0.75,2,57093912,57093843,cPa419_cPa62,1_3,102,69
chr4-5712575_5712709,cPa101,0.181818181818182,13,5712678,5712577,cPa101_cPa101-cPa142-hybrid_cPa101-cPa256-hybrid_cPa101-cPa379-hybrid_cPa101-cPa446-hybrid_cPa101-cPa552-hybrid_cPa101-cPa582-hybrid_cPa101-unknown_cPa256_cPa256-cPa582-hybrid_cPa424-cPa256-hybrid_cPa446_cPa582,6_4_3_3_1_1_4_2_1_1_1_2_4,134,101
chr4-57224560_57224685,cPa75-unknown,0.4,5,57224637,57224590,cPa62-cPa75-hybrid_cPa62-HERV-W_repbase_HERV17_LTR17-hybrid_cPa62-S71_repbase_HERVS71_LTR6A-hybrid_cPa75_cPa75-unknown,1_1_1_3_4,125,47
chr4-57224828_57224930,cPa75-unknown,0.421052631578947,6,57224915,57224837,cPa62-cPa71-hybrid_cPa62-S71_repbase_HERVS71_LTR6A-hybrid_cPa62-unknown_cPa75_cPa75-cPa71-hybrid_cPa75-unknown,2_1_1_6_1_8,102,78
chr4-57315612_57315714,cPa75,1,1,57315677,57315662,cPa75,2,102,15
chr4-57316758_57316939,cPa75,1,1,57316887,57316803,cPa75,8,181,84
chr4-57487526_57487635,SFV_U04327-unknown,1,1,57487589,57487575,SFV_U04327-unknown,10,109,14
chr4-5759428_5759530,cPa392,0.75,2,5759485,5759473,cPa392_cPa419,3_1,102,12
chr4-57769151_57769833,HERV-W_repbase_HERV17_LTR17,0.921348314606742,6,57769806,57769193,cPa543-HERV-W_repbase_HERV17_LTR17-hybrid_cPa75_cPa75-cPa62-hybrid_cPa75-HERV-W_repbase_HERV17_LTR17-hybrid_cPa75-unknown_HERV-W_repbase_HERV17_LTR17,1_3_1_1_1_82,682,613
chr4-58709021_58709170,cPa75,0.978260869565217,2,58709167,58709071,cPa62_cPa75,1_45,149,96
chr4-58709222_58709324,cPa75,0.75,3,58709285,58709228,cPa62_cPa75_HERV-W_repbase_HERV17_LTR17-unknown,2_9_1,102,57
chr4-58791280_58791406,cPa444,0.222222222222222,16,58791373,58791311,cPa118-cPa205-hybrid_cPa205_cPa205-cPa444-hybrid_cPa390_cPa390-cPa205-hybrid_cPa390-cPa447-hybrid_cPa444_cPa447_cPa447-cPa390-hybrid_cPa447-cPa444-hybrid_cPa447-unknown_cPa62_cPa62-cPa205-hybrid_cPa62-cPa390-hybrid_cPa62-cPa444-hybrid_cPa62-unknown,1_16_1_13_1_2_24_18_1_2_1_21_2_2_2_1,126,62
chr4-58931606_58931708,cPa486,1,1,58931656,58931656,cPa486,1,102,0
chr4-589397_589499,cPa260,1,1,589459,589396,cPa260,4,102,63
chr4-5918524_5918628,cPa62,1,1,5918591,5918561,cPa62,11,104,30
chr4-59463181_59463283,cPa75,1,1,59463231,59463231,cPa75,1,102,0
chr4-59463743_59463845,cPa75,1,1,59463793,59463778,cPa75,8,102,15
chr4-59464123_59464225,cPa75,1,1,59464173,59464173,cPa75,1,102,0
chr4-597005_597173,cPa106,0.529411764705882,5,597121,597033,cPa106_cPa106-HERVHcons-hybrid_cPa106-unknown_cPa290_HERVHcons,9_1_1_1_5,168,88
chr4-59904699_59904814,cPa118_cPa15,0.5,2,59904762,59904749,cPa118_cPa15,2_2,115,13
chr4-59925793_59925895,cPa62-cPa308-hybrid_cPa62-unknown,0.5,2,59925886,59925843,cPa62-cPa308-hybrid_cPa62-unknown,1_1,102,43
chr4-60035643_60035745,cPa199-HERV-F_repbase_HERVFH19I_LTR19A-hybrid,1,1,60035695,60035648,cPa199-HERV-F_repbase_HERVFH19I_LTR19A-hybrid,16,102,47
chr4-60035892_60035994,cPa199-HERV-F_repbase_HERVFH19I_LTR19A-hybrid,0.769230769230769,3,60035944,60035942,cPa199-HERV-F_repbase_HERVFH19I_LTR19A-hybrid_cPa199-unknown_cPa419,20_5_1,102,2
chr4-60487919_60488046,cPa75,1,1,60487994,60487930,cPa75,5,127,64
chr4-60872946_60873048,cPa15,0.8,2,60872998,60872996,cPa15_cPa268-cPa118-hybrid,8_2,102,2
chr4-61613178_61613297,HERV-W_repbase_HERV17_LTR17,0.882352941176471,3,61613245,61613225,HERV-W_repbase_HERV17_LTR17_HERV-W_repbase_HERV17_LTR17-cPa75-hybrid_SIV_NC001549,15_1_1,119,20
chr4-61642353_61642455,cPa75,1,1,61642403,61642403,cPa75,1,102,0
chr4-62257985_62258095,cPa118_cPa15,0.333333333333333,4,62258044,62258035,cPa118_cPa15_cPa248-unknown_cPa268-unknown,2_2_1_1,110,9
chr4-62266467_62266569,cPa419_cPa75-cPa339-hybrid,0.5,2,62266517,62266512,cPa419_cPa75-cPa339-hybrid,1_1,102,5
chr4-622895_622997,cPa117,1,1,622945,622945,cPa117,1,102,0
chr4-623054_623264,cPa117,1,1,623212,623104,cPa117,4,210,108
chr4-62305964_62306066,cPa75,1,1,62306014,62305991,cPa75,3,102,23
chr4-623336_623438,cPa117,1,1,623386,623386,cPa117,1,102,0
chr4-62391725_62391829,cPa549,0.272727272727273,12,62391793,62391732,cPa216_cPa216-cPa463-hybrid_cPa216-cPa523-hybrid_cPa387-cPa523-hybrid_cPa463_cPa518_cPa518-cPa463-hybrid_cPa526_cPa526-cPa463-hybrid_cPa549_cPa549-cPa463-hybrid_cPa549-cPa523-hybrid,3_3_1_1_5_6_1_1_1_9_1_1,104,61
chr4-62393943_62394045,cPa419,1,1,62393993,62393993,cPa419,1,102,0
chr4-62394109_62394219,cPa323,0.375,5,62394208,62394159,cPa323_cPa333_cPa371_cPa419_cPa75-unknown,3_2_1_1_1,110,49
chr4-62402422_62402524,cPa61,1,1,62402472,62402472,cPa61,5,102,0
chr4-62435273_62435375,cPa419,0.5,3,62435369,62435294,cPa157-cPa345-hybrid_cPa419_cPa419-cPa345-hybrid,1_2_1,102,75
chr4-62443122_62443224,cPa419,1,1,62443172,62443169,cPa419,2,102,3
chr4-62443838_62443940,cPa391-cPa287-hybrid,0.310344827586207,8,62443907,62443871,cPa254_cPa287_cPa293_cPa391_cPa391-cPa287-hybrid_cPa426_cPa426-cPa287-hybrid_cPa426-cPa293-hybrid,1_1_6_2_9_4_5_1,102,36
chr4-62537755_62537869,cPa363_cPa452_cPa456,0.333333333333333,3,62537817,62537805,cPa363_cPa452_cPa456,1_1_1,114,12
chr4-62541527_62541641,cPa450,0.333333333333333,5,62541589,62541577,cPa199_cPa223-cPa553-hybrid_cPa227-cPa553-hybrid_cPa450_cPa553,1_1_1_2_1,114,12
chr4-626349_626451,cPa371,0.744186046511628,4,626450,626390,cPa323_cPa371_cPa371-cPa323-hybrid_cPa371-unknown,5_32_3_3,102,60
chr4-63319218_63319359,cPa75,1,1,63319350,63319268,cPa75,4,141,82
chr4-63319794_63319897,cPa75,1,1,63319845,63319823,cPa75,3,103,22
chr4-63607298_63607403,cPa456,0.454545454545455,8,63607402,63607304,cPa363_cPa363-cPa452-hybrid_cPa456_cPa456-cPa363-hybrid_cPa456-cPa452-hybrid_cPa456-unknown_cPa587-cPa452-hybrid_cPa75-cPa452-hybrid,10_4_20_1_6_1_1_1,105,98
chr4-63651889_63652172,cPa428,0.613636363636364,5,63652121,63651939,cPa356_cPa356-cPa428-hybrid_cPa356-unknown_cPa428_cPa428-cPa356-hybrid,31_1_1_54_1,283,182
chr4-63785126_63785228,cPa327,0.5,4,63785197,63785176,cPa183_cPa327_cPa327-unknown_cPa446,1_3_1_1,102,21
chr4-63871922_63872032,cPa15,0.466666666666667,6,63871990,63871962,cPa118_cPa15_cPa248-cPa118-hybrid_cPa248-unknown_cPa268-cPa118-hybrid_cPa452-cPa118-hybrid,4_7_1_1_1_1,110,28
chr4-6387618_6387720,cPa62,1,1,6387713,6387619,cPa62,16,102,94
chr4-64659300_64659451,cPa456,0.419354838709677,9,64659399,64659305,cPa117-cPa363-hybrid_cPa117-cPa456-hybrid_cPa363_cPa363-cPa456-hybrid_cPa452_cPa452-cPa363-hybrid_cPa452-cPa456-hybrid_cPa452-cPa587-hybrid_cPa456,1_1_9_1_1_1_2_2_13,151,94
chr4-65095556_65095658,cPa62,1,1,65095652,65095599,cPa62,30,102,53
chr4-65181738_65181840,cPa62,1,1,65181809,65181782,cPa62,6,102,27
chr4-652926_653028,cPa260_HERVHcons,0.5,2,652977,652976,cPa260_HERVHcons,1_1,102,1
chr4-65372701_65372803,WDSV_NC001867,1,1,65372751,65372735,WDSV_NC001867,2,102,16
chr4-6551847_6551954,cPa62,1,1,6551910,6551878,cPa62,29,107,32
chr4-65572539_65572641,cPa15,0.461538461538462,6,65572590,65572578,cPa118_cPa118-cPa248-hybrid_cPa15_cPa443_cPa443-cPa248-hybrid_cPa443-unknown,2_1_6_1_1_2,102,12
chr4-66204195_66204467,cPa75-cPa62-hybrid,0.651162790697674,7,66204459,66204218,cPa62_cPa75_cPa75-cPa62-hybrid_cPa75-unknown_HERV-W_repbase_HERV17_LTR17-cPa62-hybrid_HERV-W_repbase_HERV17_LTR17-PERV_AJ293656-hybrid_HML1b_repbase_HERV-K14I_LTR14A-cPa62-hybrid,3_8_28_1_1_1_1,272,241
chr4-66313626_66313746,cPa227-cPa482-hybrid_cPa273-cPa583-hybrid,0.5,2,66313694,66313676,cPa227-cPa482-hybrid_cPa273-cPa583-hybrid,1_1,120,18
chr4-66373228_66373330,cPa260-cPa62-hybrid_cPa260-cPa75-hybrid_GaLV_M26927-cPa75-hybrid,0.333333333333333,3,66373304,66373278,cPa260-cPa62-hybrid_cPa260-cPa75-hybrid_GaLV_M26927-cPa75-hybrid,1_1_1,102,26
chr4-66373479_66373594,cPa260-cPa62-hybrid,0.9,2,66373579,66373486,cPa260-cPa62-hybrid_cPa75,9_1,115,93
chr4-66436829_66436953,cPa254,0.333333333333333,5,66436901,66436879,cPa174-cPa47-hybrid_cPa254_cPa404-cPa47-hybrid_cPa425_cPa47,1_3_2_2_1,124,22
chr4-66565664_66565766,cPa62,1,1,66565755,66565666,cPa62,20,102,89
chr4-66567441_66567665,cPa62,0.964285714285714,2,66567640,66567454,cPa285_cPa62,2_54,224,186
chr4-66591206_66591308,WDSV_NC001867,1,1,66591303,66591256,WDSV_NC001867,3,102,47
chr4-66645821_66645975,cPa62,0.846153846153846,6,66645927,66645832,cPa125_cPa285_cPa285-cPa62-hybrid_cPa293-cPa62-hybrid_cPa62_cPa62-cPa254-hybrid,1_2_1_1_33_1,154,95
chr4-66689299_66689402,HIV2_NC001722,0.416666666666667,6,66689400,66689306,cPa425_cPa425-unknown_HIV2_NC001722_HIV2_NC001722-cPa425-hybrid_HIV2_NC001722-HIV1_NC001802-hybrid_HIV2_NC001722-unknown,8_2_15_4_2_5,103,94
chr4-66689669_66689771,HIV2_NC001722,1,1,66689719,66689719,HIV2_NC001722,1,102,0
chr4-6684779_6684881,cPa62-cPa413-hybrid,0.7,3,6684842,6684794,cPa62-cPa413-hybrid_cPa62-cPa75-hybrid_cPa62-unknown,7_2_1,102,48
chr4-66872479_66872606,cPa62,0.944444444444444,2,66872565,66872481,cPa62_cPa62-unknown,17_1,127,84
chr4-66879642_66879907,cPa553,0.219512195121951,20,66879904,66879659,cPa199_cPa199-cPa227-hybrid_cPa199-cPa273-hybrid_cPa199-cPa345-hybrid_cPa199-unknown_cPa223_cPa227_cPa227-cPa199-hybrid_cPa227-cPa482-hybrid_cPa273_cPa273-cPa227-hybrid_cPa345_cPa345-unknown_cPa450_cPa542-cPa450-hybrid_cPa553_cPa553-cPa199-hybrid_cPa553-cPa227-hybrid_cPa553-cPa273-hybrid_cPa553-unknown,17_1_1_2_1_9_8_1_1_18_1_19_1_8_1_27_2_3_1_1,265,245
chr4-66920792_66920894,cPa75-unknown,1,1,66920842,66920842,cPa75-unknown,1,102,0
chr4-66964954_66965056,cPa62,1,1,66965010,66964961,cPa62,9,102,49
chr4-66973860_66973962,cPa229-unknown,0.8,2,66973910,66973859,cPa229-cPa450-hybrid_cPa229-unknown,1_4,102,51
chr4-67004077_67004203,HERV-W_repbase_HERV17_LTR17,0.625,3,67004151,67004127,HERV-W_repbase_HERV17_LTR17_HERV-W_repbase_HERV17_LTR17-cPa75-hybrid_HERV-W_repbase_HERV17_LTR17-HML5_repbase_HERVK22I_LTR22-hybrid,5_2_1,126,24
chr4-67004363_67004518,HERV-W_repbase_HERV17_LTR17,0.363636363636364,5,67004507,67004413,cPa62_cPa75_cPa75-unknown_HERV-W_repbase_HERV17_LTR17_HERV-W_repbase_HERV17_LTR17-cPa75-hybrid,1_3_1_4_2,155,94
chr4-67031495_67031597,cPa199_cPa223_cPa223-cPa273-hybrid_cPa273_cPa450_cPa553-unknown,0.166666666666667,6,67031597,67031536,cPa199_cPa223_cPa223-cPa273-hybrid_cPa273_cPa450_cPa553-unknown,1_1_1_1_1_1,102,61
chr4-67179163_67179265,cPa109-cPa62-hybrid_cPa285-cPa117-hybrid_cPa419,0.333333333333333,3,67179213,67179182,cPa109-cPa62-hybrid_cPa285-cPa117-hybrid_cPa419,1_1_1,102,31
chr4-67179311_67179413,cPa285-unknown_cPa62-unknown,0.5,2,67179361,67179354,cPa285-unknown_cPa62-unknown,1_1,102,7
chr4-67179416_67179518,cPa62-unknown,1,1,67179466,67179466,cPa62-unknown,1,102,0
chr4-67293534_67293838,cPa75,0.285714285714286,12,67293786,67293584,cPa308-cPa273-hybrid_cPa308-cPa450-hybrid_cPa345-cPa75-hybrid_cPa390_cPa450_cPa486-cPa542-hybrid_cPa75_cPa75-cPa308-hybrid_cPa75-cPa381-hybrid_cPa75-cPa413-hybrid_cPa75-cPa62-hybrid_cPa75-unknown,1_1_1_1_1_1_6_1_1_1_3_3,304,202
chr4-67293850_67294034,cPa75,0.666666666666667,4,67294013,67293854,cPa345-cPa75-hybrid_cPa75_cPa75-cPa62-hybrid_cPa75-unknown,1_10_3_1,184,159
chr4-67294096_67294227,cPa75,1,1,67294209,67294146,cPa75,6,131,63
chr4-67375898_67376008,cPa118_cPa15,0.4,3,67375956,67375938,cPa118_cPa15_cPa248-unknown,2_2_1,110,18
chr4-67385792_67385894,cPa62,1,1,67385842,67385842,cPa62,1,102,0
chr4-67445642_67445837,cPa553,0.2,13,67445807,67445692,cPa199_cPa199-cPa227-hybrid_cPa223_cPa223-unknown_cPa227_cPa227-unknown_cPa273_cPa345_cPa450_cPa450-cPa227-hybrid_cPa450-cPa553-hybrid_cPa529_cPa553,2_1_1_1_2_2_2_1_1_1_1_1_4,195,115
chr4-67576357_67576459,cPa356_cPa428,0.5,2,67576407,67576407,cPa356_cPa428,1_1,102,0
chr4-67576659_67576811,cPa428,0.666666666666667,2,67576759,67576709,cPa356_cPa428,2_4,152,50
chr4-67576993_67577147,cPa428,0.692307692307692,2,67577095,67577043,cPa356_cPa428,4_9,154,52
chr4-67577254_67577356,cPa356_cPa428,0.5,2,67577304,67577304,cPa356_cPa428,1_1,102,0
chr4-67703788_67703890,cPa339,0.465116279069767,5,67703884,67703807,cPa339_cPa390_cPa447_cPa447-cPa353-hybrid_cPa447-unknown,20_6_14_1_2,102,77
chr4-67905369_67905471,cPa62,1,1,67905441,67905419,cPa62,6,102,22
chr4-67906824_67906926,cPa62,1,1,67906917,67906866,cPa62,8,102,51
chr4-68090674_68090776,cPa345_cPa553,0.285714285714286,5,68090748,68090677,cPa199_cPa273_cPa345_cPa553_cPa553-cPa199-hybrid,1_1_2_2_1,102,71
chr4-68091027_68091129,cPa345,0.375,6,68091124,68091057,cPa223_cPa273_cPa345_cPa419-cPa199-hybrid_cPa450_cPa553,1_1_3_1_1_1,102,67
chr4-68112971_68113226,cPa199,0.25,11,68113174,68112980,cPa199_cPa223_cPa227_cPa273-cPa199-hybrid_cPa345_cPa450_cPa450-cPa223-hybrid_cPa553_cPa553-cPa345-hybrid_cPa553-cPa450-hybrid_cPa553-unknown,9_4_2_1_8_1_1_7_1_1_1,255,194
chr4-68119245_68119347,cPa71,0.25,7,68119318,68119262,cPa16-cPa183-hybrid_cPa16-cPa452-hybrid_cPa379_cPa379-cPa363-hybrid_cPa379-cPa452-hybrid_cPa452_cPa71,2_2_2_1_1_1_3,102,56
chr4-68126636_68126738,cPa75_cPa75-unknown,0.5,2,68126686,68126668,cPa75_cPa75-unknown,1_1,102,18
chr4-68126820_68127003,cPa75,0.571428571428571,4,68126972,68126856,cPa62-HERV-W_repbase_HERV17_LTR17-hybrid_cPa75_cPa75-HERV-W_repbase_HERV17_LTR17-hybrid_cPa75-unknown,1_4_1_1,183,116
chr4-68127098_68127200,cPa75-unknown,1,1,68127164,68127148,cPa75-unknown,2,102,16
chr4-68340587_68341199,HERV-W_repbase_HERV17_LTR17,0.714285714285714,16,68341152,68340637,cPa152-cPa62-hybrid_cPa199-cPa75-hybrid_cPa227-cPa62-hybrid_cPa553-cPa62-hybrid_cPa62_cPa75_cPa75-cPa62-hybrid_cPa75-HERV-W_repbase_HERV17_LTR17-hybrid_cPa75-unknown_HERV-F_repbase_HERVFH19I_LTR19A_HERV-W_repbase_HERV17_LTR17_HERV-W_repbase_HERV17_LTR17-cPa62-hybrid_HERV-W_repbase_HERV17_LTR17-cPa75-hybrid_HERV-W_repbase_HERV17_LTR17-unknown_KoRV_AF151794_PERV_AJ293656,1_1_3_1_2_8_1_3_1_1_100_3_1_2_6_6,612,515
chr4-68393518_68393624,cPa62,0.846153846153846,3,68393610,68393517,cPa125_cPa285_cPa62,1_1_11,106,93
chr4-68420128_68420230,cPa381,0.470588235294118,7,68420227,68420146,cPa268_cPa268-cPa353-hybrid_cPa308_cPa339_cPa353_cPa381_cPa486,6_1_5_1_2_16_3,102,81
chr4-68436904_68437014,cPa363_cPa456_cPa456-cPa452-hybrid,0.333333333333333,3,68436962,68436954,cPa363_cPa456_cPa456-cPa452-hybrid,1_1_1,110,8
chr4-68453479_68453581,cPa268_cPa308_cPa353,0.333333333333333,3,68453529,68453529,cPa268_cPa308_cPa353,1_1_1,102,0
chr4-68453624_68453726,cPa308,0.321428571428571,8,68453726,68453633,cPa268_cPa268-unknown_cPa308_cPa308-unknown_cPa339_cPa353_cPa381_cPa381-unknown,3_1_9_1_2_1_8_3,102,93
chr4-68503609_68503711,cPa113-HERV-W_repbase_HERV17_LTR17-hybrid_cPa75_cPa75-HERV-W_repbase_HERV17_LTR17-hybrid,0.333333333333333,3,68503659,68503642,cPa113-HERV-W_repbase_HERV17_LTR17-hybrid_cPa75_cPa75-HERV-W_repbase_HERV17_LTR17-hybrid,1_1_1,102,17
chr4-68504247_68504386,cPa62-HERV-W_repbase_HERV17_LTR17-hybrid,0.34375,6,68504374,68504284,cPa113-HERV-W_repbase_HERV17_LTR17-hybrid_cPa62-HERV-F_repbase_HERVFH19I_LTR19A-hybrid_cPa62-HERV-W_repbase_HERV17_LTR17-hybrid_cPa75_cPa75-HERV-W_repbase_HERV17_LTR17-hybrid_HERV-W_repbase_HERV17_LTR17,4_3_11_8_5_1,139,90
chr4-68595401_68595503,cPa62,1,1,68595460,68595407,cPa62,5,102,53
chr4-68650948_68651067,cPa583,0.575342465753425,5,68651045,68650955,cPa251_cPa358_cPa358-cPa251-hybrid_cPa358-unknown_cPa583,1_20_4_6_42,119,90
chr4-68654556_68654670,cPa308-HERV-XA34_repbase_HERVFH21I_LTR21A-hybrid_cPa381-HERV-I_repbase_HERVI_LTR10B-hybrid,0.5,2,68654618,68654606,cPa308-HERV-XA34_repbase_HERVFH21I_LTR21A-hybrid_cPa381-HERV-I_repbase_HERVI_LTR10B-hybrid,1_1,114,12
chr4-68655321_68655423,HERV-XA34_repbase_HERVFH21I_LTR21A,1,1,68655371,68655371,HERV-XA34_repbase_HERVFH21I_LTR21A,1,102,0
chr4-68692908_68693010,cPa62,0.733333333333333,4,68692964,68692942,cPa293-cPa62-hybrid_cPa293-unknown_cPa62_cPa62-cPa419-hybrid,2_1_11_1,102,22
chr4-68700284_68700507,cPa62,0.888888888888889,2,68700507,68700334,cPa293_cPa62,1_8,223,173
chr4-68700601_68700703,cPa62,0.9,2,68700701,68700629,cPa293_cPa62,1_9,102,72
chr4-68700718_68700820,cPa62,0.8,2,68700796,68700717,cPa293-cPa62-hybrid_cPa62,1_4,102,79
chr4-68701016_68701162,cPa62,0.75,2,68701110,68701036,cPa62_cPa62-unknown,3_1,146,74
chr4-68821152_68821254,cPa363,0.5,4,68821251,68821159,cPa363_cPa452_cPa456_cPa456-cPa363-hybrid,4_2_1_1,102,92
chr4-68831155_68831358,cPa199,0.291666666666667,12,68831340,68831205,cPa199_cPa223_cPa273_cPa345_cPa450-cPa199-hybrid_cPa542_cPa542-cPa450-hybrid_cPa553_cPa553-cPa223-hybrid_cPa553-cPa450-hybrid_cPa62-cPa553-hybrid_PERVE_NC003059,7_1_2_1_1_1_1_6_1_1_1_1,203,135
chr4-69000590_69000692,cPa345,0.357142857142857,13,69000688,69000593,cPa199_cPa199-cPa345-hybrid_cPa223_cPa273_cPa345_cPa345-cPa273-hybrid_cPa345-unknown_cPa450_cPa450-unknown_cPa553_cPa553-cPa223-hybrid_cPa553-cPa345-hybrid_cPa553-unknown,6_1_2_2_25_1_1_21_1_7_1_1_1,102,95
chr4-69050181_69050283,cPa363_cPa452,0.333333333333333,4,69050231,69050208,cPa363_cPa379_cPa446_cPa452,2_1_1_2,102,23
chr4-69073478_69073580,HERV-XA34_repbase_HERVFH21I_LTR21A,1,1,69073528,69073528,HERV-XA34_repbase_HERVFH21I_LTR21A,1,102,0
chr4-69073659_69073835,HERV-XA34_repbase_HERVFH21I_LTR21A,1,1,69073783,69073709,HERV-XA34_repbase_HERVFH21I_LTR21A,7,176,74
chr4-69074076_69074178,HERV-XA34_repbase_HERVFH21I_LTR21A,1,1,69074126,69074126,HERV-XA34_repbase_HERVFH21I_LTR21A,1,102,0
chr4-69122600_69122702,cPa62-unknown,0.315789473684211,6,69122688,69122638,cPa285_cPa293_cPa62_cPa62-cPa75-hybrid_cPa62-unknown_cPa75,2_1_4_5_6_1,102,50
chr4-69256308_69256410,cPa62,0.875,2,69256362,69256350,cPa62_cPa62-unknown,7_1,102,12
chr4-69311564_69311675,cPa542,0.666666666666667,2,69311675,69311614,cPa542_cPa542-cPa47-hybrid,2_1,111,61
chr4-69375103_69375205,HERV-W_repbase_HERV17_LTR17,0.55,7,69375184,69375111,cPa419_cPa62_cPa62-HERV-W_repbase_HERV17_LTR17-hybrid_cPa75_HERV-W_repbase_HERV17_LTR17_HERV-W_repbase_HERV17_LTR17-cPa75-hybrid_HERV-W_repbase_HERV17_LTR17-unknown,1_1_1_1_11_1_4,102,73
chr4-69375233_69375456,HERV-W_repbase_HERV17_LTR17,0.583333333333333,7,69375454,69375252,cPa62-cPa75-hybrid_cPa62-HERV-W_repbase_HERV17_LTR17-hybrid_cPa62-unknown_cPa71-unknown_cPa75_cPa75-unknown_HERV-W_repbase_HERV17_LTR17,2_2_6_1_3_1_21,223,202
chr4-693810_693912,cPa75,1,1,693860,693860,cPa75,1,102,0
chr4-69381056_69381158,HIV2_NC001722,1,1,69381106,69381106,HIV2_NC001722,1,102,0
chr4-69381307_69381409,HIV2_NC001722,1,1,69381357,69381357,HIV2_NC001722,1,102,0
chr4-694064_694166,cPa75,1,1,694114,694114,cPa75,1,102,0
chr4-69486116_69486468,cPa419,1,1,69486420,69486121,cPa419,95,352,299
chr4-69609601_69609703,cPa568,0.333333333333333,5,69609695,69609643,cPa323_cPa333-unknown_cPa50_cPa568_cPa568-unknown,1_1_1_2_1,102,52
chr4-69609760_69609862,cPa333_cPa371_cPa568,0.333333333333333,3,69609823,69609810,cPa333_cPa371_cPa568,1_1_1,102,13
chr4-69745169_69745271,cPa62,1,1,69745266,69745219,cPa62,11,102,47
chr4-69814422_69814524,cPa323,0.5,3,69814472,69814471,cPa323_cPa568_cPa568-unknown,2_1_1,102,1
chr4-70425986_70426088,cPa456,0.785714285714286,3,70426045,70426028,cPa363_cPa452_cPa456,2_1_11,102,17
chr4-70551595_70551697,cPa419,1,1,70551645,70551645,cPa419,1,102,0
chr4-70700462_70700564,HERV-XA34_repbase_HERVFH21I_LTR21A,1,1,70700512,70700512,HERV-XA34_repbase_HERVFH21I_LTR21A,1,102,0
chr4-70700758_70700860,HERV-XA34_repbase_HERVFH21I_LTR21A,1,1,70700808,70700808,HERV-XA34_repbase_HERVFH21I_LTR21A,1,102,0
chr4-70701018_70701120,HERV-XA34_repbase_HERVFH21I_LTR21A,1,1,70701099,70701068,HERV-XA34_repbase_HERVFH21I_LTR21A,2,102,31
chr4-70828690_70828792,HERV-XA34_repbase_HERVFH21I_LTR21A,0.75,2,70828791,70828720,HERV-XA34_repbase_HERVFH21I_LTR21A_HERV-XA34_repbase_HERVFH21I_LTR21A-cPa62-hybrid,3_1,102,71
chr4-70828846_70829239,HERV-XA34_repbase_HERVFH21I_LTR21A,0.736842105263158,3,70829187,70828896,cPa587_HERV-XA34_repbase_HERVFH21I_LTR21A_HERV-XA34_repbase_HERVFH21I_LTR21A-unknown,1_14_4,393,291
chr4-70983627_70983729,cPa363_cPa452_cPa456,0.333333333333333,3,70983677,70983677,cPa363_cPa452_cPa456,1_1_1,102,0
chr4-70987627_70987729,cPa425,0.5,4,70987717,70987628,cPa254-cPa425-hybrid_cPa404_cPa425_cPa425-cPa47-hybrid,1_1_3_1,102,89
chr4-70988216_70988318,cPa174,1,1,70988266,70988266,cPa174,1,102,0
chr4-722437_722539,cPa75,1,1,722511,722442,cPa75,5,102,69
chr4-751861_752062,cPa62,0.625,4,752010,751903,cPa293_cPa566_cPa62_MSFV_NC010819-cPa62-hybrid,1_1_5_1,201,107
chr4-752121_752264,cPa62,0.571428571428571,5,752249,752121,cPa223-cPa285-hybrid_cPa285_cPa50-cPa62-hybrid_cPa566_cPa62,1_1_1_3_8,143,128
chr4-759629_759731,cPa75-unknown,1,1,759697,759679,cPa75-unknown,2,102,18
chr4-762739_762841,cPa260,1,1,762789,762789,cPa260,1,102,0
chr4-770637_770739,cPa539-cPa62-hybrid,1,1,770687,770687,cPa539-cPa62-hybrid,1,102,0
chr4-776467_776569,cPa75,1,1,776517,776517,cPa75,1,102,0
chr4-778170_778272,cPa106,0.4,4,778232,778214,cPa106_cPa106-cPa101-hybrid_cPa551_HERVFc2_repbase,4_1_2_3,102,18
chr4-791152_791351,cPa452,0.272727272727273,9,791320,791179,cPa183_cPa363_cPa379-cPa223-hybrid_cPa379-cPa446-hybrid_cPa379-unknown_cPa446_cPa446-cPa223-hybrid_cPa452_cPa452-cPa446-hybrid,1_1_1_1_1_1_1_3_1,199,141
chr4-801687_801789,cPa260,1,1,801737,801726,cPa260,2,102,11
chr4-810160_810362,cPa75,0.684210526315789,7,810310,810176,cPa138_cPa285-cPa75-hybrid_cPa285-unknown_cPa293_cPa293-cPa75-hybrid_cPa75_cPa75-cPa293-hybrid,1_1_1_1_1_13_1,202,134
chr4-8211884_8212179,cPa446,0.212365591397849,32,8212175,8211883,cPa183-cPa363-hybrid_cPa183-cPa452-hybrid_cPa223-cPa363-hybrid_cPa223-cPa379-hybrid_cPa223-cPa452-hybrid_cPa223-cPa71-hybrid_cPa223-unknown_cPa327-cPa363-hybrid_cPa327-cPa452-hybrid_cPa363_cPa379_cPa379-cPa363-hybrid_cPa379-cPa446-hybrid_cPa379-cPa452-hybrid_cPa379-cPa71-hybrid_cPa379-unknown_cPa424-cPa363-hybrid_cPa424-cPa446-hybrid_cPa424-cPa452-hybrid_cPa424-unknown_cPa446_cPa446-cPa363-hybrid_cPa446-cPa452-hybrid_cPa446-unknown_cPa452_cPa452-cPa446-hybrid_cPa518-cPa363-hybrid_cPa518-cPa452-hybrid_cPa518-cPa71-hybrid_cPa518-unknown_cPa71_cPa71-cPa363-hybrid,1_1_31_1_7_1_8_6_2_3_48_23_1_5_1_18_19_1_4_3_79_2_3_6_71_1_9_1_2_1_11_2,295,292
chr4-8227868_8227970,cPa62,1,1,8227918,8227908,cPa62,2,102,10
chr4-8801390_8801492,cPa444,0.75,2,8801440,8801432,cPa339_cPa444,1_3,102,8
chr4-924064_924166,cPa75-cPa260-hybrid,1,1,924114,924114,cPa75-cPa260-hybrid,1,102,0
chr4-924450_924552,cPa260_cPa425,0.5,2,924500,924483,cPa260_cPa425,1_1,102,17
chr4-927886_927988,cPa260,1,1,927936,927936,cPa260,1,102,0
chr4-933711_933813,cPa75-cPa15-hybrid,1,1,933761,933761,cPa75-cPa15-hybrid,1,102,0
chr4-959596_959698,cPa260,0.375,6,959696,959635,cPa106_cPa106-cPa260-hybrid_cPa260_cPa260-unknown_cPa34-cPa260-hybrid_HERVHcons,1_1_3_1_1_1,102,61
chr4-9774587_9774689,cPa492,1,1,9774637,9774637,cPa492,1,102,0
chr4-9798518_9798620,cPa254_cPa47,0.5,2,9798568,9798568,cPa254_cPa47,1_1,102,0
chr4-994715_994817,cPa118,0.5,4,994814,994753,cPa118_cPa15_cPa248-cPa118-hybrid_cPa248-cPa254-hybrid,3_1_1_1,102,61
chr4A-10533890_10533992,cPa339,0.384615384615385,5,10533955,10533911,cPa339_cPa444-cPa339-hybrid_cPa444-cPa447-hybrid_cPa444-unknown_cPa447,10_2_6_4_4,102,44
chr4A-1072414_1072516,cPa260_WDSV_NC001867,0.5,2,1072464,1072455,cPa260_WDSV_NC001867,1_1,102,9
chr4A-10825198_10825300,cPa419,1,1,10825248,10825248,cPa419,1,102,0
chr4A-11091840_11091942,cPa492,1,1,11091937,11091858,cPa492,14,102,79
chr4A-11283829_11283931,cPa419,1,1,11283879,11283879,cPa419,1,102,0
chr4A-11648652_11648754,cPa62,1,1,11648703,11648674,cPa62,16,102,29
chr4A-11881920_11882022,cPa482-cPa75-hybrid,1,1,11881970,11881970,cPa482-cPa75-hybrid,1,102,0
chr4A-12356009_12356120,cPa62,0.851063829787234,3,12356081,12356056,cPa285_cPa62_cPa62-cPa75-hybrid,5_40_2,111,25
chr4A-12434960_12435062,cPa62,0.846153846153846,3,12435018,12435007,cPa254_cPa62_cPa62-unknown,1_11_1,102,11
chr4A-12939160_12939262,cPa419,1,1,12939210,12939210,cPa419,1,102,0
chr4A-14057170_14057276,cPa75,1,1,14057224,14057220,cPa75,2,106,4
chr4A-14274183_14274285,cPa62,1,1,14274233,14274233,cPa62,2,102,0
chr4A-14558558_14558660,cPa363_cPa452_cPa71,0.333333333333333,3,14558608,14558608,cPa363_cPa452_cPa71,1_1_1,102,0
chr4A-14658039_14658141,cPa118_cPa15,0.5,2,14658089,14658089,cPa118_cPa15,1_1,102,0
chr4A-1466625_1466740,cPa75,1,1,1466688,1466675,cPa75,2,115,13
chr4A-1467022_1467124,cPa75,1,1,1467072,1467072,cPa75,1,102,0
chr4A-1467213_1467315,cPa75,1,1,1467263,1467263,cPa75,1,102,0
chr4A-1505521_1505656,cPa75,1,1,1505604,1505571,cPa75,2,135,33
chr4A-151677_151779,cPa75_cPa75-cPa434-hybrid,0.5,2,151745,151727,cPa75_cPa75-cPa434-hybrid,1_1,102,18
chr4A-15186364_15186466,cPa419,1,1,15186414,15186414,cPa419,1,102,0
chr4A-15236266_15236368,cPa75,1,1,15236316,15236316,cPa75,1,102,0
chr4A-15236523_15236625,cPa75,1,1,15236573,15236573,cPa75,1,102,0
chr4A-15826097_15826199,cPa62,0.888888888888889,2,15826166,15826147,cPa62_cPa62-unknown,8_1,102,19
chr4A-1601164_1601268,cPa118,0.5,3,1601265,1601206,cPa118_cPa118-cPa268-hybrid_cPa566-cPa248-hybrid,2_1_1,104,59
chr4A-1609485_1609613,cPa62,1,1,1609561,1609513,cPa62,3,128,48
chr4A-16096204_16096616,cPa75,0.666666666666667,3,16096564,16096254,cPa62-unknown_cPa75_cPa75-unknown,3_12_3,412,310
chr4A-16230790_16230892,WDSV_NC001867,1,1,16230840,16230840,WDSV_NC001867,1,102,0
chr4A-16441335_16441437,cPa419,1,1,16441385,16441385,cPa419,1,102,0
chr4A-16614022_16614137,cPa75-unknown,0.8,2,16614095,16614065,cPa75-unknown_HERV-W_repbase_HERV17_LTR17,4_1,115,30
chr4A-16649660_16649762,cPa447-cPa444-hybrid,0.285714285714286,11,16649749,16649662,cPa339_cPa339-cPa205-hybrid_cPa339-cPa444-hybrid_cPa390_cPa390-cPa205-hybrid_cPa390-cPa444-hybrid_cPa447_cPa447-cPa205-hybrid_cPa447-cPa444-hybrid_cPa447-unknown_cPa62-cPa205-hybrid,6_1_2_1_1_1_3_3_8_1_1,102,87
chr4A-16776394_16776546,cPa62,0.777777777777778,3,16776494,16776411,cPa285-cPa62-hybrid_cPa419_cPa62,1_1_7,152,83
chr4A-16832407_16832626,cPa62-cPa260-hybrid,0.4,5,16832580,16832447,cPa260_cPa293-cPa260-hybrid_cPa62-cPa260-hybrid_cPa62-unknown_cPa75-unknown,3_2_10_9_1,219,133
chr4A-16873985_16874087,cPa273-cPa62-hybrid_cPa450-cPa62-hybrid_cPa62,0.333333333333333,3,16874063,16874035,cPa273-cPa62-hybrid_cPa450-cPa62-hybrid_cPa62,1_1_1,102,28
chr4A-1756446_1756559,cPa62-cPa486-hybrid,0.333333333333333,6,1756507,1756454,cPa486_cPa62_cPa62-cPa486-hybrid_cPa62-unknown_cPa62-WDSV_NC001867-hybrid_WDSV_NC001867,1_1_3_2_1_1,113,53
chr4A-17710823_17710925,cPa15_cPa75-cPa118-hybrid,0.5,2,17710873,17710873,cPa15_cPa75-cPa118-hybrid,1_1,102,0
chr4A-17730118_17730220,cPa419,1,1,17730168,17730168,cPa419,1,102,0
chr4A-18113460_18113562,cPa199,0.666666666666667,5,18113561,18113493,cPa199_cPa413_cPa413-cPa113-hybrid_cPa482_cPa539-cPa199-hybrid,10_2_1_1_1,102,68
chr4A-18216085_18216187,WDSV_NC001867,0.5,3,18216135,18216118,cPa254-cPa62-hybrid_cPa62_WDSV_NC001867,1_1_2,102,17
chr4A-18248069_18248171,cPa199,0.692307692307692,4,18248141,18248107,cPa199_cPa199-cPa482-hybrid_cPa482_cPa505,9_1_2_1,102,34
chr4A-18248568_18248670,cPa199,0.666666666666667,4,18248645,18248618,cPa199_cPa482_cPa482-cPa505-hybrid_cPa505,6_1_1_1,102,27
chr4A-18325204_18325306,cPa75-cPa62-hybrid,1,1,18325254,18325254,cPa75-cPa62-hybrid,3,102,0
chr4A-1834982_1835084,cPa419,1,1,1835032,1835032,cPa419,1,102,0
chr4A-18417748_18417850,cPa540,0.5,4,18417802,18417798,cPa127_cPa241-cPa127-hybrid_cPa241-cPa515-hybrid_cPa540,1_1_1_3,102,4
chr4A-18799656_18799770,cPa75,0.818181818181818,2,18799758,18799705,cPa75_cPa75-unknown,9_2,114,53
chr4A-18800322_18800424,cPa75,1,1,18800372,18800372,cPa75,1,102,0
chr4A-18800468_18800713,cPa75,1,1,18800661,18800518,cPa75,11,245,143
chr4A-18986935_18987064,cPa62,0.88,3,18987012,18986972,cPa285_cPa293_cPa62,2_1_22,129,40
chr4A-19318561_19318663,cPa419,1,1,19318611,19318611,cPa419,1,102,0
chr4A-19429582_19429684,cPa254,0.314285714285714,12,19429638,19429600,cPa174_cPa174-cPa425-hybrid_cPa174-unknown_cPa254_cPa254-cPa392-hybrid_cPa254-cPa425-hybrid_cPa392_cPa404_cPa404-cPa47-hybrid_cPa425_cPa425-cPa47-hybrid_cPa47,2_1_1_11_1_1_1_7_1_4_2_3,102,38
chr4A-19493002_19493135,cPa62-unknown,0.368421052631579,3,19493090,19493048,cPa62_cPa62-cPa75-hybrid_cPa62-unknown,6_6_7,133,42
chr4A-19504003_19504129,cPa62,1,1,19504077,19504053,cPa62,11,126,24
chr4A-2152616_2152718,cPa228,0.666666666666667,2,2152701,2152641,cPa228_MER52A_repbase_MER52AI_MER52A,4_2,102,60
chr4A-2230377_2230491,cPa260,1,1,2230455,2230427,cPa260,6,114,28
chr4A-245733_245835,cPa118_cPa15,0.5,2,245783,245783,cPa118_cPa15,1_1,102,0
chr4A-2654142_2654244,cPa15,0.666666666666667,3,2654234,2654182,cPa118_cPa15_cPa268,1_4_1,102,52
chr4A-2684655_2684766,cPa199,0.666666666666667,2,2684719,2684705,cPa199_cPa199-unknown,2_1,111,14
chr4A-2796633_2797014,cPa356,0.512820512820513,5,2796997,2796665,cPa356_cPa356-unknown_cPa419_cPa428_cPa428-unknown,80_3_1_69_3,381,332
chr4A-2797283_2797419,cPa428,0.518518518518518,3,2797413,2797289,cPa356_cPa419_cPa428,11_2_14,136,124
chr4A-2797476_2797748,cPa356,0.510791366906475,2,2797741,2797517,cPa356_cPa428,71_68,272,224
chr4A-2797912_2798118,cPa356,0.666666666666667,2,2798113,2797920,cPa356_cPa428,10_5,206,193
chr4A-2798175_2798277,cPa356,0.558823529411765,2,2798225,2798176,cPa356_cPa428,19_15,102,49
chr4A-2798306_2798408,cPa356_cPa428,0.5,2,2798405,2798356,cPa356_cPa428,4_4,102,49
chr4A-2798524_2798744,cPa428,0.551724137931034,2,2798730,2798552,cPa356_cPa428,13_16,220,178
chr4A-2798925_2799027,cPa356_cPa428,0.5,2,2798986,2798952,cPa356_cPa428,11_11,102,34
chr4A-2799320_2799422,cPa356_cPa428,0.5,2,2799416,2799353,cPa356_cPa428,7_7,102,63
chr4A-2799577_2799679,cPa356_cPa428,0.5,2,2799627,2799627,cPa356_cPa428,1_1,102,0
chr4A-2820868_2820970,cPa356,0.592592592592593,2,2820920,2820900,cPa356_cPa428,16_11,102,20
chr4A-2823215_2823364,cPa356,0.636363636363636,2,2823361,2823214,cPa356_cPa428,7_4,149,147
chr4A-2823468_2823595,cPa428,0.631578947368421,2,2823543,2823473,cPa356_cPa428,7_12,127,70
chr4A-2823639_2823742,cPa428,0.666666666666667,2,2823739,2823659,cPa356_cPa428,2_4,103,80
chr4A-2823754_2824103,cPa428,0.557142857142857,2,2824093,2823804,cPa356_cPa428,31_39,349,289
chr4A-2824148_2824289,cPa428,0.545454545454545,2,2824262,2824197,cPa356_cPa428,5_6,141,65
chr4A-2824311_2824416,cPa356,0.5,3,2824412,2824341,cPa356_cPa356-unknown_cPa428,15_1_14,105,71
chr4A-2824883_2824994,cPa428,0.75,2,2824985,2824900,cPa356_cPa428,4_12,111,85
chr4A-2826364_2826466,cPa428,0.545454545454545,2,2826466,2826414,cPa356_cPa428,5_6,102,52
chr4A-2826545_2826811,cPa356,0.606060606060606,3,2826810,2826548,cPa356_cPa419_cPa428,40_1_25,266,262
chr4A-2827222_2827324,cPa356,0.875,2,2827282,2827272,cPa356_cPa428,7_1,102,10
chr4A-2827558_2827660,cPa428,1,1,2827642,2827608,cPa428,3,102,34
chr4A-2889953_2890067,cPa75,0.8,2,2890015,2890003,cPa363-cPa75-hybrid_cPa75,1_4,114,12
chr4A-2890189_2890291,cPa75,1,1,2890239,2890239,cPa75,1,102,0
chr4A-2981117_2981219,cPa542-cPa199-hybrid,0.363636363636364,7,2981214,2981118,cPa223_cPa227_cPa227-cPa199-hybrid_cPa345_cPa450-cPa199-hybrid_cPa542-cPa199-hybrid_cPa542-cPa553-hybrid,1_1_1_1_2_4_1,102,96
chr4A-3149774_3149876,cPa308,1,1,3149853,3149807,cPa308,4,102,46
chr4A-3325846_3325948,cPa424,1,1,3325897,3325847,cPa424,3,102,50
chr4A-3343172_3343294,cPa199,0.631578947368421,2,3343288,3343192,cPa199_cPa62,12_7,122,96
chr4A-3343360_3343462,cPa62,0.75,2,3343455,3343397,cPa199_cPa62,1_3,102,58
chr4A-3343527_3343672,cPa62,1,1,3343660,3343535,cPa62,30,145,125
chr4A-3413082_3413192,cPa62,0.888888888888889,2,3413140,3413125,cPa62_cPa62-cPa254-hybrid,8_1,110,15
chr4A-3551951_3552053,cPa75,0.545454545454545,5,3552040,3551963,cPa62-cPa113-hybrid_cPa62-HERV-W_repbase_HERV17_LTR17-hybrid_cPa75_cPa75-HERV-W_repbase_HERV17_LTR17-hybrid_HERV-W_repbase_HERV17_LTR17,1_1_6_2_1,102,77
chr4A-3552056_3552183,cPa75,0.62962962962963,7,3552178,3552078,cPa62-cPa113-hybrid_cPa62-cPa75-hybrid_cPa75_cPa75-cPa113-hybrid_cPa75-cPa71-hybrid_cPa75-HERV-W_repbase_HERV17_LTR17-hybrid_HERV-W_repbase_HERV17_LTR17,2_1_17_4_1_1_1,127,100
chr4A-3563500_3563602,cPa118-unknown,0.555555555555556,2,3563550,3563543,cPa118-unknown_cPa15,5_4,102,7
chr4A-3744409_3744511,cPa75-unknown,0.666666666666667,2,3744501,3744459,cPa75-cPa140-hybrid_cPa75-unknown,1_2,102,42
chr4A-3798351_3798586,cPa62,0.666666666666667,4,3798539,3798368,cPa62_cPa75_cPa75-cPa450-hybrid_cPa75-unknown,24_10_1_1,235,171
chr4A-3798645_3798888,cPa62,0.645833333333333,4,3798856,3798677,cPa62_cPa75_cPa75-cPa62-hybrid_cPa75-unknown,31_10_5_2,243,179
chr4A-3800894_3800996,HERV-W_repbase_HERV17_LTR17,0.377777777777778,9,3800986,3800895,cPa67_cPa75_cPa75-cPa62-hybrid_HERV-W_repbase_HERV17_LTR17_HERV-W_repbase_HERV17_LTR17-cPa62-hybrid_HERV-W_repbase_HERV17_LTR17-cPa75-hybrid_HERV-W_repbase_HERV17_LTR17-unknown_KoRV_AF151794-cPa62-hybrid_S71_repbase_HERVS71_LTR6A-cPa75-hybrid,1_4_3_17_8_2_7_2_1,102,91
chr4A-3801045_3801147,HERV-W_repbase_HERV17_LTR17,0.4,5,3801147,3801049,cPa75_cPa75-cPa62-hybrid_HERV-W_repbase_HERV17_LTR17_HERV-W_repbase_HERV17_LTR17-cPa62-hybrid_HERV-W_repbase_HERV17_LTR17-unknown,1_2_4_1_2,102,98
chr4A-409512_409757,cPa323,0.80952380952381,3,409750,409562,cPa323_cPa371_cPa371-cPa323-hybrid,17_3_1,245,188
chr4A-409822_409992,cPa323,0.846153846153846,3,409955,409851,cPa323_cPa371_cPa50,11_1_1,170,104
chr4A-410090_410221,cPa323_cPa371-cPa323-hybrid,0.5,2,410169,410140,cPa323_cPa371-cPa323-hybrid,1_1,131,29
chr4A-4346012_4346114,cPa75-unknown,1,1,4346062,4346062,cPa75-unknown,1,102,0
chr4A-4546156_4546266,cPa15,0.638888888888889,4,4546223,4546197,cPa15_cPa15-cPa118-hybrid_cPa268_cPa268-cPa118-hybrid,23_1_8_4,110,26
chr4A-4985222_4985324,WDSV_NC001867,0.8,2,4985280,4985272,cPa260_WDSV_NC001867,2_8,102,8
chr4A-5204222_5204324,cPa482,0.714285714285714,3,5204279,5204263,cPa201_cPa482_cPa542,1_5_1,102,16
chr4A-5237103_5237205,cPa260-cPa75-hybrid_cPa75,0.5,2,5237153,5237133,cPa260-cPa75-hybrid_cPa75,1_1,102,20
chr4A-5244550_5244654,cPa223,0.493333333333333,26,5244654,5244557,cPa16-cPa223-hybrid_cPa16-cPa327-hybrid_cPa16-cPa379-hybrid_cPa16-cPa424-hybrid_cPa16-cPa446-hybrid_cPa176_cPa183-cPa327-hybrid_cPa183-cPa424-hybrid_cPa223_cPa327_cPa327-cPa424-hybrid_cPa327-cPa446-hybrid_cPa363_cPa363-cPa327-hybrid_cPa363-cPa424-hybrid_cPa363-cPa446-hybrid_cPa379_cPa424_cPa446_cPa452_cPa452-cPa176-hybrid_cPa452-cPa327-hybrid_cPa452-cPa424-hybrid_cPa71_cPa71-cPa424-hybrid_cPa71-cPa446-hybrid,1_2_1_3_2_2_1_4_74_7_3_1_3_2_11_1_6_6_3_8_1_1_3_1_2_1,104,97
chr4A-5327637_5327739,cPa353_cPa381-cPa308-hybrid,0.5,2,5327687,5327687,cPa353_cPa381-cPa308-hybrid,1_1,102,0
chr4A-5459879_5459981,cPa290-cPa127-hybrid,1,1,5459929,5459929,cPa290-cPa127-hybrid,1,102,0
chr4A-5498303_5498405,cPa555-cPa257-hybrid,1,1,5498353,5498353,cPa555-cPa257-hybrid,1,102,0
chr4A-5519059_5519161,cPa293_cPa391,0.5,2,5519121,5519109,cPa293_cPa391,2_2,102,12
chr4A-5558602_5558704,cPa62,1,1,5558698,5558640,cPa62,32,102,58
chr4A-5907657_5907759,HERV-W_repbase_HERV17_LTR17-unknown,0.666666666666667,2,5907713,5907700,cPa260_HERV-W_repbase_HERV17_LTR17-unknown,1_2,102,13
chr4A-5908430_5908532,cPa260,0.857142857142857,2,5908513,5908480,cPa260_cPa75,6_1,102,33
chr4A-5909219_5909321,cPa260-cPa75-hybrid,1,1,5909269,5909269,cPa260-cPa75-hybrid,1,102,0
chr4A-5909447_5909549,cPa260-cPa75-hybrid,1,1,5909497,5909497,cPa260-cPa75-hybrid,1,102,0
chr4A-5942987_5943089,cPa285_cPa293_cPa62,0.333333333333333,3,5943037,5943017,cPa285_cPa293_cPa62,1_1_1,102,20
chr4A-6083804_6083906,cPa15,0.5,3,6083860,6083848,cPa118_cPa15_cPa443-cPa248-hybrid,2_3_1,102,12
chr4A-6284271_6284373,cPa62,1,1,6284344,6284320,cPa62,26,102,24
chr4A-6302111_6302213,cPa62,1,1,6302180,6302157,cPa62,11,102,23
chr4A-6717592_6717694,cPa62,1,1,6717642,6717642,cPa62,1,102,0
chr4A-71086_71188,cPa273-cPa339-hybrid,1,1,71136,71136,cPa273-cPa339-hybrid,1,102,0
chr4A-71196_71298,cPa188-cPa339-hybrid,1,1,71246,71246,cPa188-cPa339-hybrid,1,102,0
chr4A-724121_724225,cPa75,1,1,724173,724168,cPa75,3,104,5
chr4A-7456664_7456792,cPa390,0.488888888888889,8,7456788,7456663,cPa205_cPa339_cPa390_cPa390-cPa339-hybrid_cPa390-cPa444-hybrid_cPa390-unknown_cPa444_cPa62,7_1_22_2_1_2_9_1,128,125
chr4A-771461_771563,cPa75,1,1,771511,771511,cPa75,1,102,0
chr4A-771787_771889,cPa75,1,1,771837,771837,cPa75,1,102,0
chr4A-7895248_7895350,cPa223,0.375,8,7895338,7895264,cPa223_cPa327_cPa363-cPa183-hybrid_cPa363-cPa424-hybrid_cPa452-cPa183-hybrid_cPa452-cPa424-hybrid_cPa71-cPa183-hybrid_cPa71-cPa327-hybrid,6_1_4_1_1_1_1_1,102,74
chr4A-847732_847834,cPa75,1,1,847782,847782,cPa75,1,102,0
chr4A-847841_847943,cPa75,1,1,847891,847891,cPa75,1,102,0
chr4A-848092_848227,cPa75_cPa75-HFV_NC001736-hybrid,0.5,2,848175,848142,cPa75_cPa75-HFV_NC001736-hybrid,1_1,135,33
chr4A-889118_889220,cPa75,1,1,889168,889168,cPa75,1,102,0
chr4A-891662_891766,cPa254_cPa47,0.25,8,891721,891664,cPa174_cPa254_cPa404-cPa174-hybrid_cPa404-cPa254-hybrid_cPa425_cPa47_cPa47-cPa174-hybrid_cPa47-unknown,3_7_3_1_4_7_2_1,104,57
chr4A-895903_896725,cPa358,0.416417910447761,46,896725,895912,cPa121-cPa298-hybrid_cPa121-cPa357-hybrid_cPa193-cPa298-hybrid_cPa193-MER52A_repbase_MER52AI_MER52A-hybrid_cPa199-cPa298-hybrid_cPa199-cPa357-hybrid_cPa199-cPa583-hybrid_cPa199-HERV-ADP_repbase_HERVP71A_I_LTR71A-hybrid_cPa223-cPa228-hybrid_cPa223-cPa449-hybrid_cPa223-MER52A_repbase_MER52AI_MER52A-hybrid_cPa251_cPa293-cPa228-hybrid_cPa293-MER52A_repbase_MER52AI_MER52A-hybrid_cPa358_cPa402_cPa402-cPa118-hybrid_cPa402-cPa125-hybrid_cPa402-cPa15-hybrid_cPa402-cPa228-hybrid_cPa402-cPa248-hybrid_cPa402-cPa251-hybrid_cPa402-HERV-ADP_repbase_HERVP71A_I_LTR71A-hybrid_cPa402-HFV_NC001736-hybrid_cPa402-MER52A_repbase_MER52AI_MER52A-hybrid_cPa402-unknown_cPa419_EqFV_NC002201-MER52A_repbase_MER52AI_MER52A-hybrid_HERV-ADP_repbase_HERVP71A_I_LTR71A_HERV-ADP_repbase_HERVP71A_I_LTR71A-MER52A_repbase_MER52AI_MER52A-hybrid_HERV-F_repbase_HERVFH19I_LTR19A_HERV-I_repbase_HERVI_LTR10B-cPa188-hybrid_HERV-I_repbase_HERVI_LTR10B-cPa298-hybrid_HERV-I_repbase_HERVI_LTR10B-cPa583-hybrid_HERV-I_repbase_HERVI_LTR10B-MER52A_repbase_MER52AI_MER52A-hybrid_HIV2_NC001722_HIV2_NC001722-cPa224-hybrid_HIV2_NC001722-cPa228-hybrid_HIV2_NC001722-cPa251-hybrid_HIV2_NC001722-cPa298-hybrid_HIV2_NC001722-cPa452-hybrid_HIV2_NC001722-cPa456-hybrid_HIV2_NC001722-HERV-ADP_repbase_HERVP71A_I_LTR71A-hybrid_HIV2_NC001722-MER52A_repbase_MER52AI_MER52A-hybrid_HIV2_NC001722-unknown_MER52A_repbase_MER52AI_MER52A,1_1_1_1_1_1_2_3_1_1_1_195_3_1_279_21_1_1_1_2_1_5_2_1_35_8_4_1_2_3_3_1_1_1_1_52_1_1_4_1_2_2_1_10_4_5,822,813
chr4A-9154048_9154150,cPa450-cPa223-hybrid,0.384615384615385,9,9154104,9154064,cPa199-cPa223-hybrid_cPa273-cPa223-hybrid_cPa450_cPa450-cPa223-hybrid_cPa450-unknown_cPa542-cPa199-hybrid_cPa542-cPa223-hybrid_cPa553_cPa553-cPa223-hybrid,1_1_7_15_1_1_3_4_6,102,40
chr4A-970185_970298,cPa74-unknown,0.952380952380952,2,970267,970213,cPa449-unknown_cPa74-unknown,2_40,113,54
chr4A-9908203_9908305,cPa339,0.5,3,9908253,9908249,cPa339_cPa447_cPa447-cPa444-hybrid,2_1_1,102,4
chr5-10642807_10642909,cPa62,1,1,10642857,10642857,cPa62,1,102,0
chr5-10642922_10643024,cPa62,1,1,10642972,10642972,cPa62,1,102,0
chr5-10833935_10834037,cPa308,1,1,10833985,10833985,cPa308,1,102,0
chr5-12158410_12158512,cPa363_cPa456,0.2,8,12158495,12158419,cPa117-cPa456-hybrid_cPa117-cPa587-hybrid_cPa363_cPa452-cPa363-hybrid_cPa452-cPa456-hybrid_cPa452-cPa587-hybrid_cPa452-unknown_cPa456,2_1_3_1_2_1_2_3,102,76
chr5-12697578_12697680,cPa75,1,1,12697628,12697628,cPa75,3,102,0
chr5-12698248_12698363,cPa75,1,1,12698311,12698298,cPa75,5,115,13
chr5-12796461_12796563,cPa62-unknown_WDSV_NC001867,0.4,3,12796550,12796502,cPa62-unknown_cPa62-WDSV_NC001867-hybrid_WDSV_NC001867,2_1_2,102,48
chr5-12796675_12796777,cPa62_cPa62-unknown_WDSV_NC001867,0.333333333333333,3,12796756,12796725,cPa62_cPa62-unknown_WDSV_NC001867,1_1_1,102,31
chr5-12796794_12796896,WDSV_NC001867,1,1,12796885,12796829,WDSV_NC001867,3,102,56
chr5-1281651_1281753,cPa419,1,1,1281701,1281701,cPa419,1,102,0
chr5-13315930_13316032,cPa62,1,1,13315980,13315980,cPa62,1,102,0
chr5-13609964_13610131,HERV-W_repbase_HERV17_LTR17,0.885416666666667,8,13610131,13609985,cPa67_cPa67-KoRV_AF151794-hybrid_HERV-F_repbase_HERVFH19I_LTR19A_HERV-W_repbase_HERV17_LTR17_KoRV_AF151794_MLV_Xmv43_MoMLV_J02255_PERV_AJ293656,2_1_1_85_2_1_3_1,167,146
chr5-1408609_1408711,cPa452,0.524590163934426,6,1408698,1408608,cPa363_cPa363-cPa176-hybrid_cPa363-unknown_cPa452_cPa452-unknown_cPa71,18_1_1_32_2_7,102,90
chr5-1451770_1451913,cPa62,0.875,2,1451861,1451820,cPa62_cPa62-unknown,7_1,143,41
chr5-1459611_1459713,cPa75,1,1,1459661,1459632,cPa75,2,102,29
chr5-1503306_1503438,cPa75,0.666666666666667,2,1503386,1503356,cPa75_cPa75-unknown,2_1,132,30
chr5-1503528_1503630,cPa75,1,1,1503578,1503578,cPa75,1,102,0
chr5-15277421_15277559,cPa363_cPa363-unknown,0.4,3,15277507,15277471,cPa363_cPa363-unknown_cPa587,2_2_1,138,36
chr5-15306559_15306661,cPa287_cPa293,0.5,2,15306609,15306609,cPa287_cPa293,1_1,102,0
chr5-15412333_15412435,cPa62,1,1,15412387,15412368,cPa62,9,102,19
chr5-1541256_1541358,cPa62,1,1,1541306,1541306,cPa62,1,102,0
chr5-1541883_1541985,cPa62,1,1,1541933,1541933,cPa62,1,102,0
chr5-1542153_1542255,cPa62,1,1,1542219,1542201,cPa62,3,102,18
chr5-1559511_1559613,cPa75,1,1,1559561,1559561,cPa75,1,102,0
chr5-15817943_15818061,cPa450,0.473684210526316,14,15818040,15817942,cPa199_cPa199-cPa273-hybrid_cPa223-cPa227-hybrid_cPa223-cPa273-hybrid_cPa223-cPa450-hybrid_cPa223-cPa553-hybrid_cPa227_cPa227-cPa273-hybrid_cPa345-cPa273-hybrid_cPa345-cPa542-hybrid_cPa450_cPa482-cPa273-hybrid_cPa553_cPa553-cPa273-hybrid,1_3_1_6_1_1_2_1_2_1_27_3_5_3,118,98
chr5-15976854_15976956,cPa62-cPa75-hybrid,0.526315789473684,4,15976950,15976862,cPa62_cPa62-cPa285-hybrid_cPa62-cPa75-hybrid_cPa62-unknown,6_1_10_2,102,88
chr5-17025219_17025333,cPa553,0.333333333333333,6,17025281,17025246,cPa199_cPa227-cPa223-hybrid_cPa273-cPa223-hybrid_cPa450_cPa450-cPa199-hybrid_cPa553,1_1_2_1_1_3,114,35
chr5-17310_17465,cPa363-cPa117-hybrid,0.571428571428571,6,17425,17341,cPa363_cPa363-cPa117-hybrid_cPa363-cPa456-hybrid_cPa456_cPa456-cPa117-hybrid_cPa587,2_24_1_13_1_1,155,84
chr5-17528978_17529080,cPa62,1,1,17529039,17528997,cPa62,29,102,42
chr5-17589044_17589146,cPa75-unknown,1,1,17589094,17589094,cPa75-unknown,1,102,0
chr5-17851626_17851843,cPa62,0.833333333333333,2,17851806,17851676,cPa62_cPa62-unknown,20_4,217,130
chr5-18667163_18667265,cPa419,1,1,18667213,18667213,cPa419,1,102,0
chr5-18941217_18941517,cPa450,0.412371134020619,19,18941465,18941252,cPa199_cPa199-cPa223-hybrid_cPa199-cPa482-hybrid_cPa223_cPa223-cPa345-hybrid_cPa227_cPa227-cPa223-hybrid_cPa227-cPa345-hybrid_cPa345_cPa345-cPa223-hybrid_cPa419_cPa450_cPa450-cPa223-hybrid_cPa482_cPa553_cPa553-cPa223-hybrid_cPa553-cPa345-hybrid_cPa553-cPa482-hybrid_cPa553-unknown,7_5_1_28_1_4_6_1_5_2_1_80_3_1_28_15_1_1_4,300,213
chr5-19047608_19047715,cPa452,0.406779661016949,7,19047672,19047649,cPa363_cPa452_cPa452-cPa363-hybrid_cPa452-unknown_cPa71_cPa71-cPa16-hybrid_cPa71-unknown,16_24_1_1_14_1_2,107,23
chr5-19074687_19074789,cPa450,0.311111111111111,18,19074788,19074687,cPa199_cPa199-cPa553-hybrid_cPa223-cPa199-hybrid_cPa223-cPa227-hybrid_cPa223-cPa553-hybrid_cPa223-unknown_cPa227_cPa227-cPa199-hybrid_cPa227-cPa553-hybrid_cPa273_cPa273-cPa199-hybrid_cPa450_cPa482-cPa199-hybrid_cPa542-cPa199-hybrid_cPa542-cPa227-hybrid_cPa542-cPa553-hybrid_cPa553_cPa553-cPa227-hybrid,9_2_3_2_4_2_11_1_1_3_1_28_1_2_1_1_17_1,102,101
chr5-19074828_19074982,cPa450,0.315068493150685,12,19074958,19074852,cPa199_cPa223-cPa199-hybrid_cPa223-cPa227-hybrid_cPa223-cPa553-hybrid_cPa223-unknown_cPa227_cPa227-cPa553-hybrid_cPa273_cPa450_cPa450-cPa553-hybrid_cPa542_cPa553,4_6_4_2_6_10_1_5_23_1_1_10,154,106
chr5-1963473_1963621,cPa62,1,1,1963597,1963486,cPa62,14,148,111
chr5-1964195_1964311,cPa62,1,1,1964268,1964236,cPa62,33,116,32
chr5-19670203_19670331,cPa199_cPa450,0.3125,9,19670326,19670209,cPa199_cPa223_cPa223-cPa199-hybrid_cPa227_cPa227-cPa223-hybrid_cPa450_cPa542_cPa553_cPa553-unknown,10_1_1_6_1_10_1_1_1,128,117
chr5-19824679_19824781,cPa190-cPa150-hybrid_cPa302,0.5,2,19824735,19824729,cPa190-cPa150-hybrid_cPa302,1_1,102,6
chr5-19869635_19869753,cPa75-cPa482-hybrid_cPa75-unknown,0.5,2,19869701,19869685,cPa75-cPa482-hybrid_cPa75-unknown,1_1,118,16
chr5-19910123_19910225,cPa150_cPa302_cPa479,0.333333333333333,3,19910173,19910173,cPa150_cPa302_cPa479,1_1_1,102,0
chr5-1992353_1992455,cPa62,1,1,1992439,1992364,cPa62,6,102,75
chr5-20153100_20153212,cPa452,0.376344086021505,12,20153168,20153142,cPa16_cPa16-cPa452-hybrid_cPa176_cPa176-cPa363-hybrid_cPa176-cPa446-hybrid_cPa363_cPa452_cPa452-cPa71-hybrid_cPa452-unknown_cPa71_cPa71-cPa363-hybrid_cPa71-cPa452-hybrid,1_2_1_1_1_25_35_1_1_23_1_1,112,26
chr5-20317465_20317567,cPa62,1,1,20317515,20317515,cPa62,1,102,0
chr5-20318348_20318450,cPa62,0.722222222222222,2,20318409,20318394,cPa62_cPa62-unknown,13_5,102,15
chr5-20817577_20817679,cPa419,1,1,20817627,20817627,cPa419,1,102,0
chr5-21080965_21081071,cPa75,1,1,21081036,21080999,cPa75,12,106,37
chr5-21085622_21085730,cPa62-cPa75-hybrid,1,1,21085696,21085672,cPa62-cPa75-hybrid,9,108,24
chr5-21245129_21245239,cPa363_cPa452_cPa71,0.333333333333333,3,21245192,21245179,cPa363_cPa452_cPa71,2_2_2,110,13
chr5-21289194_21289296,cPa363,0.470588235294118,9,21289292,21289193,cPa363_cPa363-cPa456-hybrid_cPa363-unknown_cPa456-unknown_cPa587_cPa587-cPa363-hybrid_cPa587-unknown_cPa75-cPa363-hybrid_REV_NC006934-unknown,8_1_2_1_1_1_1_1_1,102,99
chr5-21289324_21289509,cPa363_cPa75-cPa117-hybrid,0.285714285714286,5,21289457,21289360,cPa363_cPa363-unknown_cPa587-cPa117-hybrid_cPa587-unknown_cPa75-cPa117-hybrid,2_1_1_1_2,185,97
chr5-2138_2240,cPa216-cPa62-hybrid_cPa419_HIV1_NC001802-unknown,0.333333333333333,3,2188,2152,cPa216-cPa62-hybrid_cPa419_HIV1_NC001802-unknown,1_1_1,102,36
chr5-21446357_21446492,cPa456,0.631578947368421,11,21446443,21446380,cPa363_cPa363-cPa117-hybrid_cPa363-cPa452-hybrid_cPa363-FeLV_NC001940-hybrid_cPa452_cPa456_cPa456-cPa117-hybrid_cPa587-cPa117-hybrid_cPa587-cPa452-hybrid_cPa587-FeLV_NC001940-hybrid_cPa75-cPa117-hybrid,13_8_5_1_1_60_2_1_2_1_1,135,63
chr5-21491874_21491976,cPa67-unknown,0.666666666666667,2,21491952,21491908,cPa67_cPa67-unknown,1_2,102,44
chr5-21605650_21605752,cPa391,0.571428571428571,3,21605712,21605681,cPa293_cPa391_cPa426,2_4_1,102,31
chr5-21712710_21712812,cPa62,1,1,21712760,21712758,cPa62,2,102,2
chr5-21712963_21713077,cPa62,0.942857142857143,3,21713074,21712976,cPa419_cPa62_cPa62-unknown,1_33_1,114,98
chr5-21713123_21713225,cPa62,1,1,21713173,21713173,cPa62,1,102,0
chr5-21733272_21733374,cPa15,0.555555555555556,4,21733337,21733276,cPa118_cPa15_cPa248-unknown_cPa268-unknown,2_5_1_1,102,61
chr5-21772050_21772152,cPa62,1,1,21772100,21772087,cPa62,3,102,13
chr5-21781_22070,cPa75-unknown,0.9,3,22040,21822,cPa75-cPa449-hybrid_cPa75-SIV_NC001549-hybrid_cPa75-unknown,2_1_27,289,218
chr5-21851002_21851106,cPa456,0.708333333333333,4,21851078,21851030,cPa117-unknown_cPa363_cPa452-unknown_cPa456,1_4_2_17,104,48
chr5-2192921_2193023,cPa428,1,1,2192971,2192971,cPa428,1,102,0
chr5-22219740_22219842,cPa62,1,1,22219790,22219772,cPa62,6,102,18
chr5-22254831_22254938,cPa456,0.75,4,22254922,22254878,cPa117-cPa363-hybrid_cPa117-cPa587-hybrid_cPa363_cPa456,1_1_1_9,107,44
chr5-22906543_22906645,cPa15,0.473684210526316,6,22906602,22906563,cPa118_cPa118-cPa15-hybrid_cPa118-cPa443-hybrid_cPa118-unknown_cPa15_cPa15-unknown,6_1_1_1_9_1,102,39
chr5-2296055_2296157,cPa363,0.222222222222222,8,2296149,2296054,cPa176_cPa223-cPa62-hybrid_cPa327_cPa363_cPa363-cPa446-hybrid_cPa424-cPa62-hybrid_cPa446_cPa452,1_1_1_2_1_1_1_1,102,95
chr5-23178647_23178749,cPa118_cPa15,0.444444444444444,4,23178716,23178650,cPa118_cPa15_cPa248-unknown_cPa268-cPa118-hybrid,8_8_1_1,102,66
chr5-2320714_2320816,cPa62,0.888888888888889,2,2320770,2320746,cPa419_cPa62,1_8,102,24
chr5-23624109_23624211,cPa117-cPa62-hybrid_cPa62,0.5,2,23624169,23624159,cPa117-cPa62-hybrid_cPa62,1_1,102,10
chr5-2365962_2366064,HIV1_NC001802,0.470588235294118,3,2366049,2365964,cPa223-HIV1_NC001802-hybrid_cPa223-unknown_HIV1_NC001802,2_7_8,102,85
chr5-24370114_24370216,cPa62,0.888888888888889,2,24370177,24370161,cPa62_cPa62-unknown,8_1,102,16
chr5-24911631_24911733,cPa163_cPa224,0.4,3,24911693,24911681,cPa163_cPa182_cPa224,2_1_2,102,12
chr5-25103389_25103491,cPa15,0.833333333333333,2,25103450,25103428,cPa15_cPa268,5_1,102,22
chr5-25279472_25279574,cPa62,1,1,25279522,25279522,cPa62,1,102,0
chr5-25330617_25330719,cPa75-SMRV_NC001514-hybrid,1,1,25330667,25330667,cPa75-SMRV_NC001514-hybrid,1,102,0
chr5-2562751_2562930,cPa553,0.666666666666667,2,2562878,2562801,cPa199_cPa553,1_2,179,77
chr5-25651028_25651130,cPa363_cPa452-cPa587-hybrid,0.5,2,25651122,25651078,cPa363_cPa452-cPa587-hybrid,1_1,102,44
chr5-2609641_2609747,cPa356,0.941176470588235,3,2609707,2609645,cPa293-cPa356-hybrid_cPa356_cPa356-unknown,1_48_2,106,62
chr5-26194770_26194973,cPa75,0.833333333333333,4,26194921,26194820,cPa363_cPa587_cPa587-cPa75-hybrid_cPa75,1_2_1_20,203,101
chr5-26195131_26195233,cPa363,1,1,26195190,26195181,cPa363,2,102,9
chr5-26195913_26196033,cPa75,0.818181818181818,2,26195984,26195963,cPa363-cPa75-hybrid_cPa75,2_9,120,21
chr5-2625316_2625418,cPa456,0.508196721311475,8,2625412,2625335,cPa363_cPa363-cPa117-hybrid_cPa363-cPa452-hybrid_cPa456_cPa456-cPa117-hybrid_cPa456-cPa452-hybrid_cPa587-cPa117-hybrid_cPa587-cPa452-hybrid,12_6_4_31_1_2_4_1,102,77
chr5-26567503_26567605,cPa452,0.522388059701492,5,26567566,26567533,cPa363_cPa452_cPa452-cPa176-hybrid_cPa71_cPa71-cPa363-hybrid,19_35_1_11_1,102,33
chr5-26853753_26853855,cPa75,0.6,3,26853809,26853758,cPa260_cPa75_cPa75-unknown,1_3_1,102,51
chr5-26854192_26854294,cPa71_cPa75,0.285714285714286,5,26854275,26854193,cPa62-unknown_cPa71_cPa71-HERV-W_repbase_HERV17_LTR17-hybrid_cPa75_cPa75-HERV-W_repbase_HERV17_LTR17-hybrid,1_2_1_2_1,102,82
chr5-26854457_26854675,cPa62-unknown,0.666666666666667,3,26854623,26854507,cPa113_cPa62-unknown_cPa75,1_4_1,218,116
chr5-27561366_27561468,cPa62,0.905660377358491,5,27561447,27561368,cPa285-unknown_cPa293_cPa419_cPa62_cPa62-unknown,1_1_1_48_2,102,79
chr5-28393798_28393907,cPa62,0.470588235294118,8,28393886,28393847,cPa254_cPa254-cPa285-hybrid_cPa254-cPa62-hybrid_cPa254-unknown_cPa285_cPa419_cPa62_cPa62-cPa254-hybrid,5_1_1_1_8_1_16_1,109,39
chr5-28537931_28538044,cPa15,0.5,3,28537995,28537981,cPa118_cPa15_cPa248-cPa516-hybrid,2_3_1,113,14
chr5-2903725_2903970,cPa75,0.387096774193548,8,2903949,2903774,cPa260_cPa260-cPa285-hybrid_cPa260-cPa62-hybrid_cPa260-cPa75-hybrid_cPa260-unknown_cPa285_cPa293_cPa75,2_1_4_6_4_1_1_12,245,175
chr5-29065863_29065977,cPa15,0.6875,2,29065929,29065893,cPa15_cPa268,11_5,114,36
chr5-29366282_29366384,cPa456,0.452380952380952,6,29366359,29366286,cPa363_cPa452_cPa456_cPa456-cPa117-hybrid_cPa456-cPa452-hybrid_cPa587-cPa452-hybrid,9_3_19_6_4_1,102,73
chr5-2942577_2942679,cPa542,0.6,2,2942650,2942595,cPa145_cPa542,2_3,102,55
chr5-29544843_29544945,cPa363,0.5,3,29544896,29544853,cPa363_cPa456_cPa587-cPa452-hybrid,3_2_1,102,43
chr5-30010818_30011012,cPa75-unknown,0.5,3,30010972,30010868,cPa75_cPa75-unknown_HERV-W_repbase_HERV17_LTR17,1_2_1,194,104
chr5-30110712_30110825,WDSV_NC001867,0.59375,5,30110799,30110742,cPa62_cPa62-cPa254-hybrid_cPa62-unknown_cPa62-WDSV_NC001867-hybrid_WDSV_NC001867,5_1_3_4_19,113,57
chr5-30188626_30188764,cPa75-unknown,1,1,30188717,30188676,cPa75-unknown,4,138,41
chr5-31428469_31428571,cPa62,0.866666666666667,2,31428519,31428493,cPa254_cPa62,2_13,102,26
chr5-31588232_31588371,cPa75,0.857142857142857,2,31588319,31588282,cPa62-cPa75-hybrid_cPa75,1_6,139,37
chr5-31589046_31589150,cPa75,1,1,31589098,31589096,cPa75,2,104,2
chr5-31589822_31589924,cPa75,1,1,31589872,31589872,cPa75,1,102,0
chr5-31591163_31591278,cPa62,1,1,31591227,31591210,cPa62,23,115,17
chr5-3159545_3159647,cPa62,1,1,3159595,3159595,cPa62,1,102,0
chr5-32562550_32562695,cPa62,0.604166666666667,5,32562661,32562586,cPa285_cPa293_cPa62_cPa62-cPa285-hybrid_cPa62-unknown,13_2_29_3_1,145,75
chr5-3262149_3262251,cPa75,1,1,3262199,3262190,cPa75,2,102,9
chr5-32658548_32658662,cPa157_cPa183_cPa193_cPa229_cPa500,0.2,5,32658610,32658598,cPa157_cPa183_cPa193_cPa229_cPa500,1_1_1_1_1,114,12
chr5-32718870_32718982,cPa199_cPa450,0.4,3,32718930,32718920,cPa199_cPa273-cPa227-hybrid_cPa450,2_1_2,112,10
chr5-32777887_32777989,cPa392,1,1,32777937,32777889,cPa392,2,102,48
chr5-32778194_32778296,cPa392,1,1,32778261,32778196,cPa392,6,102,65
chr5-32796972_32797081,cPa246,0.8,3,32797035,32797019,cPa150-cPa478-hybrid_cPa150-unknown_cPa246,1_1_8,109,16
chr5-32820172_32820274,cPa15,1,1,32820222,32820214,cPa15,2,102,8
chr5-32843053_32843161,cPa404-cPa174-hybrid_cPa425_cPa47,0.333333333333333,3,32843113,32843103,cPa404-cPa174-hybrid_cPa425_cPa47,1_1_1,108,10
chr5-32997416_32997518,cPa62,1,1,32997471,32997453,cPa62,18,102,18
chr5-33062450_33062656,cPa541,0.451612903225806,6,33062621,33062500,cPa14_cPa4_cPa4-cPa14-hybrid_cPa541_cPa541-cPa4-hybrid_cPa541-unknown,9_5_1_14_1_1,206,121
chr5-33128774_33128891,cPa104_cPa190_cPa219_cPa220_cPa258,0.2,5,33128839,33128824,cPa104_cPa190_cPa219_cPa220_cPa258,1_1_1_1_1,117,15
chr5-33469065_33469177,cPa75,1,1,33469125,33469102,cPa75,9,112,23
chr5-33494675_33494786,cPa104-cPa131-hybrid_cPa302_cPa478,0.333333333333333,3,33494734,33494725,cPa104-cPa131-hybrid_cPa302_cPa478,1_1_1,111,9
chr5-33608047_33608149,cPa541_cPa545,0.3,5,33608097,33608084,cPa14-cPa247-hybrid_cPa541_cPa545_cPa95_cPa95-cPa247-hybrid,1_3_3_2_1,102,13
chr5-33658927_33659029,cPa363_cPa452-unknown_cPa456,0.333333333333333,3,33658977,33658933,cPa363_cPa452-unknown_cPa456,2_2_2,102,44
chr5-33931884_33931989,cPa95,0.333333333333333,6,33931938,33931927,cPa247_cPa247-cPa14-hybrid_cPa529-cPa14-hybrid_cPa529-cPa541-hybrid_cPa545_cPa95,1_1_1_2_1_3,105,11
chr5-33942264_33942377,cPa62,0.96551724137931,2,33942325,33942287,cPa254-cPa293-hybrid_cPa62,1_28,113,38
chr5-3412170_3412380,cPa456-cPa363-hybrid,0.555555555555556,5,3412378,3412220,cPa117-cPa308-hybrid_cPa456_cPa456-cPa363-hybrid_cPa456-cPa587-hybrid_cPa456-cPa75-hybrid,1_1_5_1_1,210,158
chr5-3412416_3412634,cPa456,0.416666666666667,6,3412600,3412418,cPa363_cPa456_cPa456-cPa308-hybrid_cPa456-cPa363-hybrid_cPa456-cPa587-hybrid_cPa587,1_5_1_3_1_1,218,182
chr5-34584892_34584994,cPa254,0.230088495575221,13,34584958,34584893,cPa174_cPa254_cPa254-cPa174-hybrid_cPa404_cPa404-cPa174-hybrid_cPa425_cPa425-cPa174-hybrid_cPa425-cPa254-hybrid_cPa47_cPa47-cPa174-hybrid_cPa47-cPa254-hybrid_cPa47-cPa404-hybrid_cPa47-unknown,5_26_1_18_3_16_1_1_25_14_1_1_1,102,65
chr5-34612943_34613050,cPa104_cPa190_cPa220,0.333333333333333,3,34612998,34612993,cPa104_cPa190_cPa220,1_1_1,107,5
chr5-34643257_34643372,cPa15,0.540540540540541,3,34643320,34643257,cPa118_cPa118-cPa268-hybrid_cPa15,15_2_20,115,63
chr5-35135058_35135160,cPa174_cPa254_cPa404-unknown_cPa425_cPa47,0.2,5,35135108,35135108,cPa174_cPa254_cPa404-unknown_cPa425_cPa47,1_1_1_1_1,102,0
chr5-35507696_35507798,cPa363_cPa452,0.333333333333333,5,35507758,35507746,cPa16-cPa71-hybrid_cPa176_cPa363_cPa452_cPa71,1_1_3_3_1,102,12
chr5-356862_357240,cPa419,0.260869565217391,11,357188,356888,cPa199_cPa223_cPa227_cPa273_cPa356-cPa62-hybrid_cPa419_cPa428_cPa450_cPa542_cPa542-cPa273-hybrid_cPa553,2_5_1_2_1_6_1_1_1_1_2,378,300
chr5-35931392_35931494,cPa223-unknown,1,1,35931442,35931442,cPa223-unknown,1,102,0
chr5-36146863_36146965,cPa419,1,1,36146913,36146913,cPa419,1,102,0
chr5-36420862_36420964,cPa199,0.888888888888889,2,36420924,36420912,cPa199_cPa199-unknown,8_1,102,12
chr5-3648445_3648547,cPa360-unknown,0.3,10,3648495,3648448,ALVJ_Z46390_cPa163_cPa163-cPa492-hybrid_cPa182-ALVJ_Z46390-hybrid_cPa182-cPa163-hybrid_cPa182-cPa492-hybrid_cPa182-unknown_cPa360-cPa492-hybrid_cPa360-unknown_cPa492,2_3_1_1_1_1_2_1_6_2,102,47
chr5-36554957_36555059,cPa241-cPa515-hybrid,0.571428571428571,4,36555012,36554997,cPa127_cPa241-cPa127-hybrid_cPa241-cPa515-hybrid_cPa530-cPa515-hybrid,1_1_4_1,102,15
chr5-36814119_36814221,cPa62_cPa75,0.5,2,36814172,36814169,cPa62_cPa75,1_1,102,3
chr5-371920_372022,cPa419,1,1,372010,371970,cPa419,2,102,40
chr5-37317116_37317218,cPa62,1,1,37317213,37317165,cPa62,35,102,48
chr5-37364947_37365052,cPa363,0.22972972972973,35,37365052,37364961,cPa183_cPa183-cPa199-hybrid_cPa183-cPa363-hybrid_cPa183-cPa424-hybrid_cPa183-cPa62-hybrid_cPa183-cPa71-hybrid_cPa223_cPa223-cPa199-hybrid_cPa223-cPa424-hybrid_cPa223-cPa71-hybrid_cPa327_cPa327-cPa62-hybrid_cPa327-cPa71-hybrid_cPa363_cPa363-cPa16-hybrid_cPa363-cPa339-hybrid_cPa379_cPa379-cPa199-hybrid_cPa379-cPa339-hybrid_cPa379-cPa424-hybrid_cPa379-cPa62-hybrid_cPa379-cPa71-hybrid_cPa391-cPa199-hybrid_cPa419_cPa424_cPa446-cPa199-hybrid_cPa446-cPa339-hybrid_cPa446-cPa363-hybrid_cPa446-cPa424-hybrid_cPa452_cPa452-cPa199-hybrid_cPa452-cPa339-hybrid_cPa452-cPa363-hybrid_cPa452-cPa424-hybrid_cPa452-cPa71-hybrid,1_10_1_1_1_2_33_10_3_2_1_1_1_34_1_1_3_4_1_1_1_2_2_1_3_3_1_3_5_7_2_1_1_3_1,105,91
chr5-37367229_37367331,cPa391,1,1,37367279,37367279,cPa391,1,102,0
chr5-3755080_3755182,cPa450,0.636363636363636,5,3755143,3755107,cPa223-cPa227-hybrid_cPa223-cPa273-hybrid_cPa223-cPa450-hybrid_cPa450_cPa553-cPa273-hybrid,1_1_1_7_1,102,36
chr5-37888084_37888201,WDSV_NC001867,0.75,3,37888166,37888124,EIAV_NC001450-unknown_EIAV_NC001450-WDSV_NC001867-hybrid_WDSV_NC001867,1_1_6,117,42
chr5-37951508_37951610,cPa74,1,1,37951558,37951558,cPa74,1,102,0
chr5-37977260_37977365,cPa450,0.337748344370861,16,37977353,37977283,cPa199_cPa199-cPa227-hybrid_cPa199-cPa273-hybrid_cPa199-cPa450-hybrid_cPa199-cPa542-hybrid_cPa199-cPa553-hybrid_cPa199-unknown_cPa227_cPa273_cPa273-cPa553-hybrid_cPa450_cPa450-cPa273-hybrid_cPa450-cPa542-hybrid_cPa450-cPa553-hybrid_cPa542_cPa553,8_5_19_4_9_9_11_8_6_1_51_1_1_2_11_5,105,70
chr5-38117439_38117541,cPa345,1,1,38117489,38117485,cPa345,2,102,4
chr5-40152761_40152863,cPa62,0.857142857142857,3,40152817,40152790,cPa293_cPa62_cPa62-unknown,1_12_1,102,27
chr5-40292663_40292765,cPa555-cPa257-hybrid,1,1,40292713,40292702,cPa555-cPa257-hybrid,2,102,11
chr5-4078713_4078815,cPa75-cPa62-hybrid,0.666666666666667,3,4078810,4078763,cPa62_cPa75_cPa75-cPa62-hybrid,1_5_12,102,47
chr5-41051005_41051107,cPa419,1,1,41051055,41051055,cPa419,1,102,0
chr5-41244011_41244113,cPa113_cPa113-unknown,0.5,2,41244061,41244022,cPa113_cPa113-unknown,2_2,102,39
chr5-41244342_41244444,cPa113-cPa75-hybrid,1,1,41244392,41244392,cPa113-cPa75-hybrid,1,102,0
chr5-41675221_41675323,cPa425,0.5,4,41675281,41675261,cPa174_cPa404_cPa425_cPa47,3_4_10_3,102,20
chr5-41675478_41675580,cPa425,0.611111111111111,6,41675578,41675495,cPa174_cPa223-cPa254-hybrid_cPa404_cPa425_cPa47_cPa47-cPa425-hybrid,1_1_2_11_2_1,102,83
chr5-41675710_41675812,cPa425,0.571428571428571,4,41675790,41675758,cPa174_cPa174-cPa425-hybrid_cPa425_cPa47,1_1_4_1,102,32
chr5-41890282_41890396,cPa18_cPa541,0.4,3,41890353,41890332,cPa14_cPa18_cPa541,1_2_2,114,21
chr5-42125975_42126077,ALV_NC001408,1,1,42126025,42126025,ALV_NC001408,1,102,0
chr5-42222315_42222417,cPa220,0.388888888888889,5,42222406,42222362,cPa104_cPa104-cPa219-hybrid_cPa190_cPa190-cPa419-hybrid_cPa220,4_1_5_1_7,102,44
chr5-42283499_42283601,cPa75,0.375,4,42283572,42283498,cPa62_cPa62-cPa75-hybrid_cPa62-unknown_cPa75,14_2_9_15,102,74
chr5-42283650_42283764,cPa62,0.432432432432432,4,42283763,42283688,cPa62_cPa62-cPa75-hybrid_cPa62-unknown_cPa75,16_4_5_12,114,75
chr5-42291164_42291266,cPa62_cPa62-unknown,0.5,2,42291214,42291171,cPa62_cPa62-unknown,1_1,102,43
chr5-42291426_42291554,cPa75,0.333333333333333,4,42291526,42291433,cPa62-cPa293-hybrid_cPa62-cPa75-hybrid_cPa62-unknown_cPa75,2_4_4_5,128,93
chr5-42443320_42443422,FeFV_NC001871-cPa62-hybrid,1,1,42443370,42443370,FeFV_NC001871-cPa62-hybrid,1,102,0
chr5-42472290_42472400,cPa131-cPa190-hybrid_cPa131-cPa258-hybrid_cPa150_cPa255_cPa255-cPa150-hybrid_cPa255-cPa258-hybrid_cPa479,0.142857142857143,7,42472353,42472340,cPa131-cPa190-hybrid_cPa131-cPa258-hybrid_cPa150_cPa255_cPa255-cPa150-hybrid_cPa255-cPa258-hybrid_cPa479,1_1_1_1_1_1_1,110,13
chr5-42527982_42528084,cPa220,0.454545454545455,10,42528034,42528003,cPa104-cPa190-hybrid_cPa104-cPa220-hybrid_cPa18-cPa190-hybrid_cPa18-cPa220-hybrid_cPa18-unknown_cPa190_cPa219-cPa190-hybrid_cPa219-unknown_cPa220_cPa258-cPa190-hybrid,1_1_5_2_3_7_2_2_20_1,102,31
chr5-42670525_42670628,cPa255_cPa526-cPa478-hybrid,0.333333333333333,4,42670576,42670575,cPa255_cPa255-cPa438-hybrid_cPa255-cPa478-hybrid_cPa526-cPa478-hybrid,2_1_1_2,103,1
chr5-42699143_42699264,cPa118_cPa15,0.428571428571429,3,42699212,42699173,cPa118_cPa15_cPa268-cPa62-hybrid,3_3_1,121,39
chr5-42804623_42804788,cPa434,1,1,42804753,42804623,cPa434,38,165,130
chr5-42805108_42805210,cPa434,1,1,42805160,42805158,cPa434,2,102,2
chr5-42912262_42912364,cPa529,0.666666666666667,2,42912312,42912300,cPa247_cPa529,1_2,102,12
chr5-429460_429659,cPa62,0.363636363636364,11,429616,429469,Cer1_U15406-cPa285-hybrid_cPa285_cPa293_cPa293-cPa125-hybrid_cPa363-cPa75-hybrid_cPa410_cPa410-cPa419-hybrid_cPa419_cPa552-cPa285-hybrid_cPa62_cPa75,1_1_1_1_1_2_1_4_1_8_1,199,147
chr5-43020232_43020334,RELIK_ERVK-HERV-W_repbase_HERV17_LTR17-hybrid,1,1,43020282,43020282,RELIK_ERVK-HERV-W_repbase_HERV17_LTR17-hybrid,1,102,0
chr5-43029849_43029951,cPa450,0.4,6,43029899,43029856,cPa199_cPa199-cPa273-hybrid_cPa254-cPa345-hybrid_cPa345-cPa542-hybrid_cPa450_cPa553,2_1_1_2_6_3,102,43
chr5-432279_432484,cPa285,0.333333333333333,8,432432,432289,cPa285_cPa293_cPa293-cPa285-hybrid_cPa419_cPa428_cPa62_cPa75_cPa75-cPa285-hybrid,6_2_1_4_1_1_1_2,205,143
chr5-43287954_43288077,cPa75,0.235294117647059,9,43288058,43287963,cPa113_cPa285-cPa113-hybrid_cPa62_cPa62-cPa113-hybrid_cPa62-cPa75-hybrid_cPa62-PERVC_HM159246-hybrid_cPa62-unknown_cPa75_cPa75-PERVA_AY099323-hybrid,3_1_1_1_2_1_3_4_1,123,95
chr5-43322298_43322400,MLV_Xmv43-cPa62-hybrid,0.5,4,43322351,43322342,cPa200-cPa62-hybrid_MLV_Xmv43-cPa482-hybrid_MLV_Xmv43-cPa62-hybrid_MLV_Xmv43-unknown,1_4_6_1,102,9
chr5-43331401_43331537,cPa216-cPa131-hybrid_cPa216-cPa255-hybrid,0.25,6,43331526,43331451,cPa216_cPa216-cPa131-hybrid_cPa216-cPa255-hybrid_cPa518-cPa131-hybrid_cPa549-cPa131-hybrid_cPa549-cPa255-hybrid,1_2_2_1_1_1,136,75
chr5-43401123_43401225,cPa219,0.4,4,43401173,43401161,cPa18-cPa104-hybrid_cPa219_cPa220-cPa104-hybrid_cPa220-unknown,1_2_1_1,102,12
chr5-43422234_43422336,cPa62-unknown,0.75,2,43422336,43422284,cPa62-unknown_cPa75,3_1,102,52
chr5-43422406_43422508,cPa62-unknown,0.5625,4,43422490,43422412,cPa62_cPa62-unknown_cPa75_cPa75-unknown,1_9_5_1,102,78
chr5-435294_435550,cPa75,1,1,435524,435298,cPa75,31,256,226
chr5-435579_435797,cPa75,1,1,435751,435579,cPa75,32,218,172
chr5-435853_435955,cPa75,1,1,435903,435903,cPa75,1,102,0
chr5-43822771_43822873,cPa62,1,1,43822821,43822821,cPa62,1,102,0
chr5-43958909_43959042,cPa363_cPa456,0.4,3,43958990,43958948,cPa363_cPa456_cPa456-cPa363-hybrid,2_2_1,133,42
chr5-43981500_43981602,cPa456,0.420560747663551,8,43981599,43981500,cPa363_cPa363-BLV_NC001414-hybrid_cPa363-cPa117-hybrid_cPa456_cPa456-BLV_NC001414-hybrid_cPa456-cPa117-hybrid_cPa587-BLV_NC001414-hybrid_SIV_NC001549-BLV_NC001414-hybrid,27_9_2_45_15_2_6_1,102,99
chr5-44007325_44007437,cPa15,0.375,5,44007386,44007375,cPa118_cPa118-cPa268-hybrid_cPa15_cPa443_cPa443-cPa268-hybrid,2_1_3_1_1,112,11
chr5-44069677_44069779,cPa62,0.909090909090909,2,44069754,44069726,cPa402-unknown_cPa62,1_10,102,28
chr5-44177673_44177775,cPa452_cPa71,0.5,2,44177723,44177722,cPa452_cPa71,1_1,102,1
chr5-442921_443048,cPa223,0.840909090909091,13,443047,442971,cPa199_cPa223_cPa223-cPa199-hybrid_cPa223-cPa345-hybrid_cPa223-cPa450-hybrid_cPa273_cPa273-cPa199-hybrid_cPa419_cPa419-cPa223-hybrid_cPa450_cPa542_cPa553_cPa62-cPa199-hybrid,3_111_5_1_1_1_2_2_1_2_1_1_1,127,76
chr5-44426692_44426794,cPa118_cPa15,0.5,2,44426766,44426742,cPa118_cPa15,1_1,102,24
chr5-44440014_44440174,cPa363_cPa452,0.333333333333333,6,44440122,44440019,cPa176_cPa363_cPa363-cPa71-hybrid_cPa363-unknown_cPa452_cPa71,1_4_1_1_4_1,160,103
chr5-44606054_44606156,cPa62,0.5,3,44606130,44606099,cPa581_cPa62_cPa71,1_2_1,102,31
chr5-44812625_44812727,cPa75,0.545454545454545,6,44812706,44812627,cPa293-cPa62-hybrid_cPa293-cPa71-hybrid_cPa62_cPa71-cPa113-hybrid_cPa75_cPa75-unknown,1_1_1_1_6_1,102,79
chr5-44812821_44812943,cPa75,0.459459459459459,12,44812912,44812841,cPa113_cPa293_cPa293-cPa113-hybrid_cPa413-cPa113-hybrid_cPa413-unknown_cPa62_cPa71-cPa113-hybrid_cPa75_cPa75-cPa113-hybrid_cPa75-cPa62-hybrid_cPa75-unknown_PERVC_HM159246,1_1_3_1_1_4_1_17_1_1_5_1,122,71
chr5-45043661_45043763,cPa452,0.525423728813559,5,45043763,45043701,cPa363_cPa452_cPa452-cPa71-hybrid_cPa452-unknown_cPa71,20_31_1_1_6,102,62
chr5-45084078_45084180,cPa339_cPa444,0.333333333333333,4,45084128,45084116,cPa339_cPa444_cPa447_cPa447-unknown,2_2_1_1,102,12
chr5-4514313_4514496,cPa390,0.373737373737374,14,4514456,4514314,cPa205_cPa205-cPa339-hybrid_cPa339_cPa339-unknown_cPa390_cPa390-cPa339-hybrid_cPa390-cPa447-hybrid_cPa444_cPa444-unknown_cPa447_cPa447-cPa339-hybrid_cPa447-cPa390-hybrid_cPa447-cPa444-hybrid_cPa447-unknown,1_1_29_1_37_3_2_2_1_15_4_1_1_1,183,142
chr5-4532695_4532797,cPa62,0.9375,2,4532746,4532729,cPa254-cPa62-hybrid_cPa62,1_15,102,17
chr5-45739840_45739942,cPa419,1,1,45739890,45739890,cPa419,1,102,0
chr5-46218322_46218424,cPa62,1,1,46218372,46218372,cPa62,1,102,0
chr5-46582911_46583013,cPa75-unknown,1,1,46582961,46582929,cPa75-unknown,4,102,32
chr5-46588344_46588500,cPa434,1,1,46588448,46588384,cPa434,4,156,64
chr5-46588608_46588710,cPa434,1,1,46588658,46588658,cPa434,1,102,0
chr5-4664120_4664238,cPa62,0.884615384615385,2,4664198,4664166,cPa62_cPa62-unknown,23_3,118,32
chr5-46823032_46823142,cPa450,0.496503496503497,22,46823125,46823037,cPa199_cPa227_cPa227-cPa482-hybrid_cPa273_cPa273-cPa199-hybrid_cPa273-cPa223-hybrid_cPa273-cPa345-hybrid_cPa273-cPa482-hybrid_cPa345_cPa450_cPa450-cPa199-hybrid_cPa450-cPa345-hybrid_cPa450-cPa482-hybrid_cPa482_cPa542-cPa199-hybrid_cPa542-cPa223-hybrid_cPa553_cPa553-cPa199-hybrid_cPa553-cPa223-hybrid_cPa553-cPa345-hybrid_cPa553-cPa450-hybrid_cPa553-cPa482-hybrid,4_3_1_2_7_6_3_4_1_71_1_2_2_1_6_1_14_5_2_5_1_1,110,88
chr5-46908137_46908249,cPa62,0.967741935483871,2,46908225,46908140,cPa62_cPa62-unknown,30_1,112,85
chr5-47003044_47003146,cPa75-unknown,0.5,3,47003112,47003062,cPa62-unknown_cPa75_cPa75-unknown,1_1_2,102,50
chr5-47003174_47003276,cPa62-cPa260-hybrid,0.277777777777778,9,47003271,47003198,cPa62-cPa260-hybrid_cPa62-unknown_cPa75_cPa75-cPa260-hybrid_cPa75-unknown_KWERV_GQ222416-cPa42-hybrid_PERV_AJ293656_PERV_AJ293656-cPa75-hybrid_PERVC_HM159246,5_1_2_2_4_1_1_1_1,102,73
chr5-47293258_47293360,cPa15,0.375,7,47293327,47293299,cPa118_cPa15_cPa248-cPa118-hybrid_cPa248-unknown_cPa264_cPa268-cPa443-hybrid_cPa443,7_9_1_2_1_1_3,102,28
chr5-474896_475058,cPa419,0.294117647058824,12,475031,474946,cPa199_cPa387-cPa199-hybrid_cPa413_cPa419_cPa428_cPa482_cPa505-cPa201-hybrid_cPa505-PRIMA41_repbase_PRIMA41_MER41A-hybrid_cPa539_cPa539-cPa201-hybrid_cPa539-PRIMA41_repbase_PRIMA41_MER41A-hybrid_cPa62,1_1_1_5_1_1_1_1_2_1_1_1,162,85
chr5-48288208_48288310,cPa75,0.666666666666667,2,48288258,48288219,cPa75_HERV-W_repbase_HERV17_LTR17-cPa62-hybrid,2_1,102,39
chr5-48288351_48288504,cPa75,0.466666666666667,3,48288454,48288364,cPa75_cPa75-cPa62-hybrid_HERV-W_repbase_HERV17_LTR17,7_4_4,153,90
chr5-48623569_48623681,cPa62,0.984375,2,48623669,48623572,cPa62_cPa62-unknown,63_1,112,97
chr5-48640412_48640514,cPa62,0.95,3,48640464,48640430,cPa285_cPa62_cPa75-cPa62-hybrid,1_38_1,102,34
chr5-48726311_48726413,HERV-W_repbase_HERV17_LTR17-cPa75-hybrid_HERV-W_repbase_HERV17_LTR17-unknown,0.5,2,48726361,48726351,HERV-W_repbase_HERV17_LTR17-cPa75-hybrid_HERV-W_repbase_HERV17_LTR17-unknown,1_1,102,10
chr5-48726620_48726802,cPa75,0.5,3,48726750,48726670,cPa62-cPa75-hybrid_cPa75_HERV-W_repbase_HERV17_LTR17,2_3_1,182,80
chr5-48726805_48726957,cPa62-cPa75-hybrid_cPa62-unknown_cPa75_KWERV_GQ222416,0.25,4,48726905,48726823,cPa62-cPa75-hybrid_cPa62-unknown_cPa75_KWERV_GQ222416,1_1_1_1,152,82
chr5-48726963_48727065,cPa75,1,1,48727013,48727013,cPa75,1,102,0
chr5-48737789_48737891,cPa456,0.428571428571429,4,48737851,48737839,cPa117-cPa587-hybrid_cPa363_cPa452-cPa363-hybrid_cPa456,1_2_1_3,102,12
chr5-4878116_4878218,cPa452,1,1,4878166,4878166,cPa452,1,102,0
chr5-48791943_48792052,cPa456,0.363636363636364,5,48792036,48791984,cPa363_cPa363-cPa452-hybrid_cPa456_cPa456-cPa117-hybrid_cPa587-cPa117-hybrid,3_1_4_2_1,109,52
chr5-49092586_49092689,cPa62-unknown,0.3,5,49092651,49092595,cPa62_cPa62-cPa75-hybrid_cPa62-HERV-W_repbase_HERV17_LTR17-hybrid_cPa62-unknown_cPa75,2_2_2_3_1,103,56
chr5-49126026_49126128,cPa75_HERV-W_repbase_HERV17_LTR17,0.5,2,49126076,49126051,cPa75_HERV-W_repbase_HERV17_LTR17,1_1,102,25
chr5-49361013_49361115,cPa419,1,1,49361063,49361063,cPa419,1,102,0
chr5-49545452_49545554,cPa62,1,1,49545519,49545498,cPa62,41,102,21
chr5-49613418_49613647,cPa117,1,1,49613595,49613447,cPa117,16,229,148
chr5-49613669_49613771,cPa117,1,1,49613719,49613719,cPa117,1,102,0
chr5-49613840_49613942,cPa117,1,1,49613890,49613859,cPa117,2,102,31
chr5-4996161_4996300,cPa260-cPa62-hybrid,0.571428571428571,2,4996248,4996197,cPa260-cPa62-hybrid_cPa260-cPa75-hybrid,4_3,139,51
chr5-50012944_50013046,cPa452_cPa71,0.3,6,50013007,50012991,cPa183-cPa16-hybrid_cPa327-cPa16-hybrid_cPa363_cPa363-cPa16-hybrid_cPa452_cPa71,1_1_1_1_3_3,102,16
chr5-50169210_50169312,HERV-W_repbase_HERV17_LTR17,0.666666666666667,3,50169264,50169235,cPa419-HERV-W_repbase_HERV17_LTR17-hybrid_cPa75_HERV-W_repbase_HERV17_LTR17,1_1_4,102,29
chr5-50365015_50365144,cPa62,0.785714285714286,3,50365101,50365043,cPa16_cPa293_cPa62,1_2_11,129,58
chr5-50501786_50502146,HERV-W_repbase_HERV17_LTR17,0.914893617021277,4,50502132,50501824,cPa75_HERV-W_repbase_HERV17_LTR17_HERV-W_repbase_HERV17_LTR17-unknown_PERV_AJ293656,1_43_2_1,360,308
chr5-50502168_50502270,HERV-W_repbase_HERV17_LTR17,0.909090909090909,2,50502266,50502168,HERV-W_repbase_HERV17_LTR17_HERV-W_repbase_HERV17_LTR17-unknown,10_1,102,98
chr5-50549536_50549694,cPa529,0.714285714285714,7,50549645,50549559,cPa247_cPa529_cPa545-cPa529-hybrid_cPa545-unknown_cPa95_cPa95-cPa247-hybrid_cPa95-unknown,4_25_1_2_1_1_1,158,86
chr5-50782694_50782796,cPa62,0.935483870967742,2,50782754,50782733,cPa62_cPa62-unknown,29_2,102,21
chr5-51111557_51111659,cPa419,1,1,51111607,51111607,cPa419,1,102,0
chr5-51559500_51559604,cPa293-cPa426-hybrid_cPa391_cPa392-cPa426-hybrid,0.333333333333333,3,51559578,51559550,cPa293-cPa426-hybrid_cPa391_cPa392-cPa426-hybrid,1_1_1,104,28
chr5-51561923_51562025,cPa392,1,1,51561973,51561973,cPa392,1,102,0
chr5-51562192_51562294,cPa392,1,1,51562262,51562223,cPa392,4,102,39
chr5-51562410_51562617,cPa392,0.923076923076923,3,51562589,51562421,cPa229_cPa392_cPa419,1_24_1,207,168
chr5-51562657_51563073,cPa392,0.970149253731343,3,51563028,51562663,cPa229_cPa392_cPa456-cPa392-hybrid,1_65_1,416,365
chr5-51865878_51865980,cPa583,1,1,51865928,51865926,cPa583,2,102,2
chr5-51939978_51940092,cPa323_cPa323-cPa568-hybrid_cPa371-cPa333-hybrid,0.333333333333333,3,51940068,51940028,cPa323_cPa323-cPa568-hybrid_cPa371-cPa333-hybrid,1_1_1,114,40
chr5-52194986_52195088,cPa425,0.285714285714286,6,52195054,52195036,cPa254_cPa254-cPa174-hybrid_cPa254-cPa404-hybrid_cPa425_cPa425-cPa404-hybrid_cPa47,1_1_1_2_1_1,102,18
chr5-52368212_52368314,cPa62,1,1,52368262,52368254,cPa62,2,102,8
chr5-525018_525120,cPa419,1,1,525086,525068,cPa419,3,102,18
chr5-52658939_52659132,cPa75,0.333333333333333,5,52659080,52658964,cPa452_cPa452-cPa456-hybrid_cPa452-unknown_cPa456_cPa75,2_1_1_2_3,193,116
chr5-52772571_52772677,cPa254,0.291666666666667,10,52772645,52772581,cPa174_cPa174-cPa392-hybrid_cPa174-cPa404-hybrid_cPa174-unknown_cPa254_cPa254-cPa392-hybrid_cPa254-cPa47-hybrid_cPa425_cPa425-cPa392-hybrid_cPa47,2_1_2_1_7_1_1_3_1_5,106,64
chr5-5294958_5295077,HERV-W_repbase_HERV17_LTR17-cPa62-hybrid,0.170731707317073,13,5295076,5294977,cPa113-cPa260-hybrid_cPa62_cPa62-cPa543-hybrid_cPa62-cPa71-hybrid_cPa75_cPa75-cPa425-hybrid_cPa75-cPa543-hybrid_cPa75-cPa71-hybrid_HERV-W_repbase_HERV17_LTR17-cPa482-hybrid_HERV-W_repbase_HERV17_LTR17-cPa62-hybrid_HERV-W_repbase_HERV17_LTR17-cPa71-hybrid_HERV-W_repbase_HERV17_LTR17-cPa75-hybrid_KoRV_AF151794-cPa71-hybrid,1_1_6_4_5_2_5_3_1_7_4_1_1,119,99
chr5-5295193_5295295,cPa75,1,1,5295243,5295243,cPa75,1,102,0
chr5-5295332_5295447,cPa75,0.357142857142857,7,5295395,5295382,cPa62-cPa71-hybrid_cPa75_cPa75-cPa356-hybrid_cPa75-cPa543-hybrid_HERV-W_repbase_HERV17_LTR17-cPa543-hybrid_HERV-W_repbase_HERV17_LTR17-cPa62-hybrid_HERV-W_repbase_HERV17_LTR17-cPa71-hybrid,2_5_1_3_1_1_1,115,13
chr5-5295473_5295575,cPa62-cPa543-hybrid_cPa75-cPa425-hybrid,0.5,2,5295523,5295523,cPa62-cPa543-hybrid_cPa75-cPa425-hybrid,1_1,102,0
chr5-5295788_5295918,HERV-W_repbase_HERV17_LTR17-cPa71-hybrid,0.333333333333333,5,5295905,5295838,cPa62_cPa75-cPa543-hybrid_HERV-W_repbase_HERV17_LTR17-cPa356-hybrid_HERV-W_repbase_HERV17_LTR17-cPa71-hybrid_HERV-W_repbase_HERV17_LTR17-cPa75-hybrid,1_1_1_2_1,130,67
chr5-529620_529871,cPa62,0.448275862068966,6,529863,529639,cPa254_cPa254-unknown_cPa482_cPa482-unknown_cPa62_cPa62-unknown,1_1_11_2_13_1,251,224
chr5-53106123_53106225,cPa62,1,1,53106208,53106138,cPa62,3,102,70
chr5-5347083_5347199,cPa413,0.545454545454545,3,5347163,5347111,cPa273_cPa345_cPa413,1_4_6,116,52
chr5-5347256_5347358,cPa413,1,1,5347331,5347291,cPa413,3,102,40
chr5-53595694_53595796,cPa553-unknown,1,1,53595744,53595744,cPa553-unknown,1,102,0
chr5-53716611_53716838,cPa75,0.333333333333333,7,53716806,53716643,cPa419_cPa62_cPa62-cPa75-hybrid_cPa62-HERV-W_repbase_HERV17_LTR17-hybrid_cPa62-unknown_cPa75_cPa75-unknown,1_1_10_7_8_14_1,227,163
chr5-53758231_53758333,cPa15,0.6,3,53758284,53758281,cPa118_cPa15_cPa248-cPa118-hybrid,1_3_1,102,3
chr5-5379865_5379967,cPa357-cPa190-hybrid,1,1,5379915,5379915,cPa357-cPa190-hybrid,1,102,0
chr5-53992923_53993121,cPa456,0.641025641025641,8,53993091,53992932,cPa363_cPa363-cPa452-hybrid_cPa452_cPa456_cPa456-cPa117-hybrid_cPa456-cPa452-hybrid_cPa587-cPa452-hybrid_REV_NC006934-cPa452-hybrid,5_5_1_50_1_7_1_8,198,159
chr5-54262972_54263074,cPa456,0.380952380952381,7,54263057,54262984,cPa363_cPa456_cPa456-cPa117-hybrid_cPa456-cPa452-hybrid_cPa587-cPa117-hybrid_cPa587-cPa119-hybrid_cPa75-cPa117-hybrid,6_8_1_2_2_1_1,102,73
chr5-5441925_5442046,cPa452,0.5,3,5441994,5441942,cPa363_cPa452_cPa456,3_4_1,121,52
chr5-5442121_5442223,cPa452-unknown_cPa456-cPa452-hybrid,0.5,2,5442223,5442171,cPa452-unknown_cPa456-cPa452-hybrid,1_1,102,52
chr5-54564421_54564523,cPa62,0.909090909090909,2,54564490,54564423,cPa62_cPa62-unknown,10_1,102,67
chr5-54722236_54722341,cPa62-cPa75-hybrid,0.6,2,54722291,54722286,cPa62_cPa62-cPa75-hybrid,4_6,105,5
chr5-54771088_54771190,cPa523-unknown,0.6,3,54771149,54771138,cPa523-cPa450-hybrid_cPa523-EIAV_NC001450-hybrid_cPa523-unknown,1_1_3,102,11
chr5-5477521_5477702,HERV-W_repbase_HERV17_LTR17,0.833333333333333,4,5477662,5477571,HERV-W_repbase_HERV17_LTR17_HERV-W_repbase_HERV17_LTR17-unknown_KoRV_AF151794_PERV_AJ293656,20_1_1_2,181,91
chr5-5499629_5499854,cPa539,0.951219512195122,2,5499805,5499679,cPa539_cPa539-unknown,39_2,225,126
chr5-5510440_5510542,cPa456-cPa117-hybrid,1,1,5510490,5510490,cPa456-cPa117-hybrid,1,102,0
chr5-5513194_5513451,HERV-XA34_repbase_HERVFH21I_LTR21A-cPa75-hybrid,0.571428571428571,3,5513399,5513198,cPa227_cPa419_HERV-XA34_repbase_HERVFH21I_LTR21A-cPa75-hybrid,1_2_4,257,201
chr5-5514265_5514367,cPa419,0.625,3,5514342,5514284,cPa419_cPa456_cPa456-cPa452-hybrid,5_1_2,102,58
chr5-5519125_5519227,cPa419,0.333333333333333,7,5519217,5519126,cPa327-cPa419-hybrid_cPa327-cPa585-hybrid_cPa363_cPa363-cPa254-hybrid_cPa363-cPa419-hybrid_cPa379-cPa358-hybrid_cPa419,1_1_1_1_1_1_3,102,91
chr5-5519287_5519393,cPa452,0.407407407407407,12,5519383,5519312,cPa183-unknown_cPa327_cPa327-cPa363-hybrid_cPa327-unknown_cPa363_cPa363-unknown_cPa379_cPa379-unknown_cPa424-unknown_cPa452_cPa71_cPa71-unknown,3_3_1_6_37_2_5_1_1_44_3_2,106,71
chr5-5519436_5519646,cPa452,0.300500834724541,36,5519594,5519485,cPa16-cPa176-hybrid_cPa16-cPa446-hybrid_cPa176_cPa176-cPa379-hybrid_cPa183-cPa176-hybrid_cPa183-cPa379-hybrid_cPa183-cPa446-hybrid_cPa183-cPa71-hybrid_cPa183-unknown_cPa315-cPa358-hybrid_cPa327_cPa327-cPa176-hybrid_cPa327-cPa363-hybrid_cPa327-cPa446-hybrid_cPa363_cPa363-cPa176-hybrid_cPa363-cPa446-hybrid_cPa363-cPa71-hybrid_cPa363-unknown_cPa379_cPa379-cPa176-hybrid_cPa379-cPa446-hybrid_cPa379-unknown_cPa419_cPa419-cPa176-hybrid_cPa424-cPa176-hybrid_cPa424-unknown_cPa446_cPa446-cPa176-hybrid_cPa452_cPa452-cPa176-hybrid_cPa71_cPa71-cPa176-hybrid_cPa71-cPa379-hybrid_cPa71-unknown_MSFV_NC010819-unknown,5_1_18_1_22_2_2_1_6_1_1_4_1_1_152_3_1_1_1_74_2_4_2_8_1_4_1_18_2_180_1_71_3_1_2_1,210,109
chr5-5519679_5519994,cPa452,0.288014311270125,30,5519974,5519708,cPa16-cPa176-hybrid_cPa176_cPa176-cPa446-hybrid_cPa183-cPa176-hybrid_cPa183-cPa446-hybrid_cPa254-cPa176-hybrid_cPa285-cPa446-hybrid_cPa315-cPa176-hybrid_cPa315-cPa379-hybrid_cPa315-cPa446-hybrid_cPa327-cPa176-hybrid_cPa363_cPa379_cPa379-cPa176-hybrid_cPa379-cPa446-hybrid_cPa379-unknown_cPa419_cPa424-cPa446-hybrid_cPa446_cPa446-unknown_cPa452_cPa452-unknown_cPa71_cPa71-cPa176-hybrid_cPa75-cPa176-hybrid_cPa75-cPa446-hybrid_HERV-W_repbase_HERV17_LTR17-cPa446-hybrid_HML2_Pheonix-cPa176-hybrid_MSFV_NC010819-cPa176-hybrid_PyERV_AF500296,1_76_3_5_2_2_1_8_1_5_1_88_58_1_3_1_1_2_70_2_161_1_54_6_1_1_1_1_1_1,315,266
chr5-5520999_5521183,cPa315-unknown_cPa419,0.5,2,5521131,5520999,cPa315-unknown_cPa419,2_2,184,132
chr5-55288064_55288166,cPa113,0.666666666666667,8,55288145,55288063,cPa113_cPa113-cPa62-hybrid_cPa113-cPa75-hybrid_cPa113-unknown_cPa67_cPa67-cPa75-hybrid_HERV-W_repbase_HERV17_LTR17_SIV_NC001549,36_1_4_2_1_1_8_1,102,82
chr5-55628067_55628169,cPa62,1,1,55628117,55628095,cPa62,4,102,22
chr5-55669035_55669308,cPa62,0.807692307692308,6,55669256,55669073,cPa285_cPa285-cPa419-hybrid_cPa293_cPa345-cPa125-hybrid_cPa62_cPa62-unknown,2_1_3_1_42_3,273,183
chr5-56108365_56108467,cPa339-cPa357-hybrid_cPa56-cPa357-hybrid,0.5,2,56108465,56108415,cPa339-cPa357-hybrid_cPa56-cPa357-hybrid,1_1,102,50
chr5-56309642_56309755,cPa62,1,1,56309704,56309645,cPa62,20,113,59
chr5-56317305_56317407,cPa113,1,1,56317355,56317355,cPa113,1,102,0
chr5-56410695_56410797,cPa15,0.466666666666667,10,56410768,56410698,cPa118_cPa118-cPa140-hybrid_cPa118-cPa516-hybrid_cPa118-unknown_cPa15_cPa15-unknown_cPa268_cPa443_cPa516_cPa61,5_1_1_1_14_1_2_1_1_3,102,70
chr5-56633259_56633361,cPa62-unknown,1,1,56633309,56633309,cPa62-unknown,1,102,0
chr5-5668686_5668839,cPa345,0.3,7,5668791,5668736,cPa199_cPa223_cPa227_cPa273_cPa345_cPa450_cPa553,4_1_2_3_6_1_3,153,55
chr5-5668868_5668970,cPa199_cPa345,0.25,6,5668918,5668867,cPa199_cPa223_cPa273_cPa345_cPa450_cPa553,2_1_1_2_1_1,102,51
chr5-56843496_56843598,cPa482-cPa505-hybrid_cPa505,0.5,2,56843546,56843533,cPa482-cPa505-hybrid_cPa505,1_1,102,13
chr5-56992556_56992687,cPa62-cPa75-hybrid,0.5,4,56992647,56992605,cPa62_cPa62-cPa118-hybrid_cPa62-cPa15-hybrid_cPa62-cPa75-hybrid,3_1_1_5,131,42
chr5-56993699_56993902,cPa15,0.384615384615385,9,56993902,56993704,cPa140_cPa140-cPa75-hybrid_cPa15_cPa268_cPa268-cPa75-hybrid_cPa516-cPa118-hybrid_cPa516-cPa75-hybrid_cPa61_cPa62-cPa75-hybrid,1_1_5_1_1_1_1_1_1,203,198
chr5-57058589_57058691,cPa62,1,1,57058639,57058609,cPa62,3,102,30
chr5-57069827_57069990,HERV-W_repbase_HERV17_LTR17,0.647058823529412,4,57069970,57069847,cPa75_cPa75-cPa113-hybrid_HERV-W_repbase_HERV17_LTR17_PERV_AJ293656,4_1_11_1,163,123
chr5-57099596_57099717,cPa75-cPa62-hybrid,0.428571428571429,4,57099669,57099625,cPa260-cPa62-hybrid_cPa260-cPa75-hybrid_cPa62_cPa75-cPa62-hybrid,5_1_2_6,121,44
chr5-57099895_57100035,cPa260-cPa75-hybrid_cPa293-cPa62-hybrid_cPa413-cPa62-hybrid_cPa62_cPa75,0.2,5,57100011,57099900,cPa260-cPa75-hybrid_cPa293-cPa62-hybrid_cPa413-cPa62-hybrid_cPa62_cPa75,1_1_1_1_1,140,111
chr5-5725984_5726086,cPa15,1,1,5726034,5726034,cPa15,1,102,0
chr5-5726158_5726260,cPa15,1,1,5726208,5726208,cPa15,1,102,0
chr5-57432726_57432828,WDSV_NC001867,0.666666666666667,3,57432801,57432738,cPa62-unknown_cPa62-WDSV_NC001867-hybrid_WDSV_NC001867,9_3_24,102,63
chr5-5749895_5750088,cPa553,0.296296296296296,10,5750068,5749906,cPa199_cPa199-cPa273-hybrid_cPa199-cPa542-hybrid_cPa273_cPa345_cPa450_cPa542_cPa542-cPa450-hybrid_cPa553_cPa553-cPa199-hybrid,2_1_1_5_4_1_2_1_8_2,193,162
chr5-57666547_57666649,cPa62-cPa75-hybrid,1,1,57666597,57666597,cPa62-cPa75-hybrid,1,102,0
chr5-5768836_5769036,HERV-W_repbase_HERV17_LTR17,0.454545454545455,7,5769021,5768843,cPa419_cPa587_cPa75_HERV-W_repbase_HERV17_LTR17_KoRV_AF151794_KoRV_AF151794-cPa75-hybrid_S71_repbase_HERVS71_LTR6A,1_1_4_10_3_1_2,200,178
chr5-57781464_57781644,cPa75,0.6,3,57781602,57781514,cPa113_cPa75_cPa75-cPa260-hybrid,1_3_1,180,88
chr5-57781807_57781909,cPa75,1,1,57781908,57781857,cPa75,7,102,51
chr5-57783635_57783737,cPa62,1,1,57783735,57783685,cPa62,4,102,50
chr5-57822708_57823171,HERV-W_repbase_HERV17_LTR17,0.818181818181818,7,57823119,57822758,cPa75_cPa75-HERV-W_repbase_HERV17_LTR17-hybrid_cPa75-unknown_HERV-W_repbase_HERV17_LTR17_HERV-W_repbase_HERV17_LTR17-unknown_KoRV_AF151794-unknown_PERV_AJ293656-unknown,2_1_2_54_5_1_1,463,361
chr5-57833435_57833565,cPa273-unknown,0.6,3,57833513,57833479,cPa273-cPa482-hybrid_cPa273-unknown_cPa539,1_3_1,130,34
chr5-57993033_57993146,cPa15,0.4,4,57993094,57993081,cPa118_cPa118-cPa248-hybrid_cPa15_cPa62,1_1_2_1,113,13
chr5-58055710_58055812,cPa62,0.9375,2,58055778,58055713,cPa62_cPa62-cPa482-hybrid,15_1,102,65
chr5-58056989_58057091,cPa482,0.8,3,58057044,58056989,cPa360_cPa482_cPa482-unknown,1_8_1,102,55
chr5-58094459_58094561,cPa434_cPa566,0.25,6,58094509,58094458,cPa260_cPa434_cPa434-unknown_cPa566_cPa566-cPa125-hybrid_cPa566-unknown,1_2_1_2_1_1,102,51
chr5-58094721_58094825,cPa434,0.347826086956522,7,58094825,58094723,cPa260_cPa434_cPa434-unknown_cPa566_cPa566-cPa434-hybrid_cPa566-unknown_FIV_NC001482-unknown,2_8_3_6_1_2_1,104,102
chr5-58094933_58095035,cPa566,0.55,6,58095021,58094944,cPa434_cPa452-cPa260-hybrid_cPa566_cPa566-cPa260-hybrid_cPa566-cPa410-hybrid_cPa566-cPa443-hybrid,5_1_11_1_1_1,102,77
chr5-58179759_58179906,cPa75,0.5,4,58179854,58179803,cPa62-cPa75-hybrid_cPa75_HERV-W_repbase_HERV17_LTR17_HERV-W_repbase_HERV17_LTR17-cPa75-hybrid,1_4_2_1,147,51
chr5-58180131_58180255,HERV-W_repbase_HERV17_LTR17,0.4375,4,58180203,58180163,cPa62-cPa75-hybrid_cPa62-HERV-W_repbase_HERV17_LTR17-hybrid_cPa75_HERV-W_repbase_HERV17_LTR17,3_1_5_7,124,40
chr5-58180462_58180565,HERV-W_repbase_HERV17_LTR17,0.416666666666667,4,58180515,58180492,cPa62-cPa75-hybrid_cPa75_HERV-W_repbase_HERV17_LTR17_HERV-W_repbase_HERV17_LTR17-cPa75-hybrid,1_9_10_4,103,23
chr5-58243279_58243381,cPa62-cPa75-hybrid,0.3,6,58243371,58243329,cPa62_cPa62-cPa109-hybrid_cPa62-cPa402-hybrid_cPa62-cPa75-hybrid_cPa62-unknown_cPa75,2_1_1_3_2_1,102,42
chr5-58248056_58248158,cPa118,0.294117647058824,11,58248148,58248082,cPa118_cPa118-cPa248-hybrid_cPa118-cPa443-hybrid_cPa15_cPa15-cPa248-hybrid_cPa248_cPa264_cPa264-cPa248-hybrid_cPa264-cPa443-hybrid_cPa443_cPa61-cPa443-hybrid,15_4_3_6_6_4_5_2_2_2_2,102,66
chr5-58248236_58248338,cPa118_cPa248,0.25,6,58248322,58248286,cPa118_cPa118-cPa248-hybrid_cPa15-cPa248-hybrid_cPa248_cPa264_cPa443,2_1_1_2_1_1,102,36
chr5-5826_6118,cPa75,0.434782608695652,11,6110,5854,cPa254-cPa75-hybrid_cPa257_cPa293-cPa450-hybrid_cPa356_cPa419_cPa428_cPa482_cPa516-cPa581-hybrid_cPa583-cPa75-hybrid_cPa75_cPa75-cPa285-hybrid,1_1_1_1_4_1_1_1_1_10_1,292,256
chr5-58321219_58321321,cPa16_SIV_NC001549,0.5,2,58321269,58321269,cPa16_SIV_NC001549,1_1,102,0
chr5-5842850_5842952,WDSV_NC001867-cPa260-hybrid,1,1,5842900,5842900,WDSV_NC001867-cPa260-hybrid,1,102,0
chr5-58966049_58966151,HERVHcons_HERVHcons-unknown,0.5,2,58966136,58966099,HERVHcons_HERVHcons-unknown,1_1,102,37
chr5-59101536_59101650,MLV_Mpmv5,0.833333333333333,3,59101613,59101565,cPa419_MLV_Mpmv5_MLV_Mpmv5-cPa260-hybrid,1_10_1,114,48
chr5-59153225_59153327,cPa62,1,1,59153318,59153244,cPa62,15,102,74
chr5-59178502_59178604,cPa227_cPa553,0.5,2,59178552,59178552,cPa227_cPa553,1_1,102,0
chr5-59198296_59198428,cPa260_cPa543_cPa566,0.333333333333333,3,59198376,59198346,cPa260_cPa543_cPa566,1_1_1,132,30
chr5-59219344_59219780,cPa75_cPa75-cPa62-hybrid,0.378378378378378,10,59219774,59219344,cPa113_cPa113-cPa62-hybrid_cPa285_cPa402-cPa62-hybrid_cPa539-cPa62-hybrid_cPa75_cPa75-cPa285-hybrid_cPa75-cPa62-hybrid_cPa75-unknown_GaLV_M26927-cPa62-hybrid,4_5_1_2_1_28_2_28_2_1,436,430
chr5-59274101_59274203,cPa75-unknown,1,1,59274151,59274150,cPa75-unknown,2,102,1
chr5-59393278_59393408,cPa118,0.714285714285714,3,59393365,59393313,cPa118_cPa443-cPa75-hybrid_cPa516-cPa75-hybrid,5_1_1,130,52
chr5-59405743_59405860,cPa260,0.65625,7,59405815,59405771,cPa106_cPa260_cPa260-cPa106-hybrid_cPa260-HERVHcons-hybrid_cPa260-unknown_HERVHcons_HERVHcons-unknown,2_21_1_1_3_3_1,117,44
chr5-59420305_59420429,cPa75-unknown,0.5,5,59420401,59420355,cPa62-cPa260-hybrid_cPa62-cPa438-hybrid_cPa75_cPa75-cPa438-hybrid_cPa75-unknown,1_1_1_1_4,124,46
chr5-59420543_59420645,cPa62-cPa260-hybrid,0.75,2,59420645,59420593,cPa62-cPa260-hybrid_cPa62-cPa438-hybrid,3_1,102,52
chr5-59420997_59421099,cPa75-cPa438-hybrid,1,1,59421047,59421047,cPa75-cPa438-hybrid,1,102,0
chr5-59421372_59421574,cPa260,0.782608695652174,4,59421537,59421376,cPa260_cPa438_cPa75-cPa260-hybrid_cPa75-cPa438-hybrid,18_3_1_1,202,161
chr5-59490571_59490753,cPa176,1,1,59490701,59490621,cPa176,2,182,80
chr5-59490763_59490940,cPa176,1,1,59490888,59490813,cPa176,4,177,75
chr5-59491645_59491747,cPa293,1,1,59491695,59491695,cPa293,1,102,0
chr5-59504079_59504181,cPa333,1,1,59504129,59504129,cPa333,1,102,0
chr5-59524083_59524185,cPa199,0.857142857142857,2,59524185,59524100,cPa199_cPa505-cPa539-hybrid,6_1,102,85
chr5-59575276_59575459,cPa199,0.533333333333333,5,59575456,59575283,cPa199_cPa201_cPa505-cPa113-hybrid_cPa75-cPa199-hybrid_cPa75-cPa505-hybrid,8_1_1_4_1,183,173
chr5-59624728_59624897,cPa15,0.423076923076923,8,59624893,59624760,cPa118_cPa118-cPa194-hybrid_cPa118-cPa260-hybrid_cPa118-cPa516-hybrid_cPa118-unknown_cPa15_cPa268_cPa371-cPa15-hybrid,3_1_1_1_1_11_7_1,169,133
chr5-59626021_59626123,cPa118-cPa260-hybrid_cPa50-cPa268-hybrid,0.5,2,59626071,59626028,cPa118-cPa260-hybrid_cPa50-cPa268-hybrid,1_1,102,43
chr5-59627180_59627284,cPa323_cPa323-unknown_cPa371,0.333333333333333,3,59627239,59627230,cPa323_cPa323-unknown_cPa371,1_1_1,104,9
chr5-59627299_59628008,cPa323,0.513888888888889,9,59628007,59627349,BFV_NC001831-cPa371-hybrid_cPa158-cPa371-hybrid_cPa223-cPa371-hybrid_cPa323_cPa323-cPa371-hybrid_cPa333-cPa323-hybrid_cPa371_cPa50-cPa371-hybrid_cPa50-unknown,1_1_1_37_3_1_24_2_2,709,658
chr5-59658205_59658307,cPa118_PtERV1_AC142352,0.5,2,59658255,59658209,cPa118_PtERV1_AC142352,1_1,102,46
chr5-59664086_59664192,cPa199,0.473684210526316,3,59664140,59664133,cPa199_cPa482_SIV_NC001870,9_3_7,106,7
chr5-59679071_59679173,cPa15_cPa248-cPa118-hybrid,0.5,2,59679121,59679121,cPa15_cPa248-cPa118-hybrid,1_1,102,0
chr5-59680882_59680984,HERVHcons,0.5,3,59680947,59680925,cPa482-cPa260-hybrid_HERVHcons_HERVHcons-cPa199-hybrid,1_2_1,102,22
chr5-59700166_59700290,cPa443,0.666666666666667,2,59700247,59700216,cPa118_cPa443,1_2,124,31
chr5-59721370_59721472,cPa75,1,1,59721420,59721420,cPa75,1,102,0
chr5-59721773_59722234,cPa75,1,1,59722229,59721823,cPa75,21,461,406
chr5-59779086_59779255,cPa228,0.363636363636364,6,59779203,59779093,cPa228_cPa260_cPa323_cPa323-unknown_HERV30_repbase_HERV30I_LTR30-unknown_HML2_Pheonix,4_2_2_1_1_1,169,110
chr5-59836876_59836990,cPa438-cPa260-hybrid,0.6,3,59836938,59836924,cPa438-cPa260-hybrid_cPa544-cPa260-hybrid_cPa75-cPa260-hybrid,3_1_1,114,14
chr5-59855955_59856062,cPa450,0.72,3,59856018,59856005,cPa228_cPa260_cPa450,4_3_18,107,13
chr5-60137963_60138128,cPa62_cPa62-unknown,0.5,2,60138076,60138013,cPa62_cPa62-unknown,1_1,165,63
chr5-60161421_60161771,cPa199,0.678571428571429,5,60161764,60161470,cPa127-unknown_cPa199_cPa199-cPa530-hybrid_cPa199-unknown_cPa539-cPa505-hybrid,1_19_2_5_1,350,294
chr5-60337356_60337459,cPa62,1,1,60337421,60337406,cPa62,3,103,15
chr5-60337487_60337604,cPa62,1,1,60337561,60337537,cPa62,27,117,24
chr5-60709991_60710162,cPa438,0.6,3,60710152,60710010,cPa260_cPa438_cPa539-cPa260-hybrid,5_9_1,171,142
chr5-60719959_60720061,cPa71,0.5,3,60720055,60719963,cPa16-unknown_cPa379_cPa71,2_1_3,102,92
chr5-60720198_60720300,cPa16-unknown_cPa71-unknown,0.5,2,60720285,60720248,cPa16-unknown_cPa71-unknown,1_1,102,37
chr5-60732890_60732992,cPa260,0.941176470588235,2,60732988,60732896,cPa260_cPa438,16_1,102,92
chr5-60757437_60757539,cPa260,1,1,60757487,60757487,cPa260,1,102,0
chr5-60823905_60824079,cPa260,0.58974358974359,7,60824079,60823919,cPa106_cPa106-cPa268-hybrid_cPa256_cPa260_cPa260-unknown_HERVHcons_HERVHcons-cPa118-hybrid,1_1_1_23_3_9_1,174,160
chr5-60848939_60849041,HERVHcons-cPa62-hybrid,0.5,3,60848994,60848980,cPa260_HERVHcons-cPa62-hybrid_WDSV_NC001867-cPa62-hybrid,1_2_1,102,14
chr5-60858222_60858324,cPa15-cPa260-hybrid_cPa260_cPa75-unknown,0.333333333333333,3,60858320,60858272,cPa15-cPa260-hybrid_cPa260_cPa75-unknown,1_1_1,102,48
chr5-60888667_60888769,cPa62,1,1,60888717,60888679,cPa62,5,102,38
chr5-60950029_60950131,cPa75,1,1,60950079,60950079,cPa75,1,102,0
chr5-60950195_60950297,cPa75,1,1,60950245,60950245,cPa75,1,102,0
chr5-60950455_60950596,cPa75,1,1,60950544,60950505,cPa75,2,141,39
chr5-60958313_60958723,HERV-W_repbase_HERV17_LTR17,0.966666666666667,2,60958689,60958321,HERV-W_repbase_HERV17_LTR17_HERV-W_repbase_HERV17_LTR17-unknown,58_2,410,368
chr5-60958734_60959098,HERV-W_repbase_HERV17_LTR17,0.96551724137931,2,60959046,60958751,HERV-W_repbase_HERV17_LTR17_PERV_AJ293656-HERV-W_repbase_HERV17_LTR17-hybrid,28_1,364,295
chr5-60959132_60959244,HERV-W_repbase_HERV17_LTR17,1,1,60959238,60959168,HERV-W_repbase_HERV17_LTR17,5,112,70
chr5-60959291_60959419,HERV-W_repbase_HERV17_LTR17,1,1,60959402,60959315,HERV-W_repbase_HERV17_LTR17,10,128,87
chr5-60964598_60964700,cPa75,0.545454545454545,4,60964693,60964631,cPa62_cPa75_cPa75-cPa293-hybrid_cPa75-unknown,1_6_1_3,102,62
chr5-60964787_60964889,cPa75,0.8,3,60964879,60964819,cPa293_cPa75_cPa75-cPa62-hybrid,1_8_1,102,60
chr5-60971936_60972038,cPa308_cPa75-cPa410-hybrid,0.5,2,60972013,60971986,cPa308_cPa75-cPa410-hybrid,1_1,102,27
chr5-60989766_60989874,cPa260,0.714285714285714,3,60989856,60989804,cPa260_cPa438_cPa438-unknown,15_5_1,108,52
chr5-61078239_61078341,cPa260,0.880952380952381,4,61078338,61078255,cPa106_cPa260_HERVHcons_HERVHcons-cPa260-hybrid,3_37_1_1,102,83
chr5-61121617_61121719,cPa75,1,1,61121667,61121667,cPa75,1,102,0
chr5-61128765_61128907,cPa251,0.5,5,61128907,61128791,cPa251_cPa358_cPa449-cPa251-hybrid_cPa449-cPa358-hybrid_cPa502,12_9_1_1_1,142,116
chr5-61133301_61133403,cPa482-cPa452-hybrid,1,1,61133351,61133351,cPa482-cPa452-hybrid,1,102,0
chr5-61133441_61133543,cPa199,0.5,4,61133491,61133483,cPa199_cPa273_cPa345_cPa553,3_1_1_1,102,8
chr5-61137373_61137475,cPa260,1,1,61137458,61137394,cPa260,3,102,64
chr5-61177078_61177180,cPa118_cPa125_cPa516,0.333333333333333,3,61177128,61177111,cPa118_cPa125_cPa516,1_1_1,102,17
chr5-61177204_61177306,cPa118-cPa268-hybrid_cPa516,0.5,2,61177254,61177254,cPa118-cPa268-hybrid_cPa516,1_1,102,0
chr5-61213240_61213396,cPa71,0.884615384615385,5,61213392,61213275,cPa71_cPa71-cPa62-hybrid_cPa71-cPa75-hybrid_cPa71-unknown_cPa75,46_2_1_2_1,156,117
chr5-61221491_61221593,cPa327_cPa452,0.5,2,61221541,61221541,cPa327_cPa452,1_1,102,0
chr5-61268832_61268934,cPa446,1,1,61268882,61268882,cPa446,1,102,0
chr5-61344182_61344371,cPa463_MLV_Pmv4,0.366666666666667,8,61344334,61344210,cPa260-cPa526-hybrid_cPa308_cPa308-cPa526-hybrid_cPa463_cPa463-MLV_Pmv4-hybrid_cPa463-unknown_cPa62-cPa526-hybrid_MLV_Pmv4,1_3_1_11_1_1_1_11,189,124
chr5-61353587_61353689,cPa75,1,1,61353637,61353637,cPa75,1,102,0
chr5-61353702_61353874,cPa75,1,1,61353822,61353752,cPa75,3,172,70
chr5-61360646_61360748,cPa223,0.75,2,61360733,61360696,cPa223_cPa223-cPa62-hybrid,3_1,102,37
chr5-61362020_61362122,cPa223-cPa75-hybrid,1,1,61362070,61362070,cPa223-cPa75-hybrid,1,102,0
chr5-61362149_61362251,cPa223-cPa75-hybrid,1,1,61362231,61362199,cPa223-cPa75-hybrid,2,102,32
chr5-61419162_61419264,cPa75,1,1,61419212,61419212,cPa75,1,102,0
chr5-61421121_61421223,cPa75,1,1,61421171,61421171,cPa75,1,102,0
chr5-61483577_61483679,cPa260-cPa75-hybrid,1,1,61483627,61483627,cPa260-cPa75-hybrid,1,102,0
chr5-61507942_61508121,cPa199,1,1,61508114,61507982,cPa199,7,179,132
chr5-61515245_61515347,cPa492_cPa492-cPa542-hybrid,0.5,2,61515334,61515295,cPa492_cPa492-cPa542-hybrid,1_1,102,39
chr5-61566579_61566681,cPa118,0.346153846153846,10,61566659,61566606,cPa118_cPa118-cPa443-hybrid_cPa118-unknown_cPa15_cPa15-cPa118-hybrid_cPa15-cPa345-hybrid_cPa15-unknown_cPa248_cPa268-cPa118-hybrid_cPa443,9_1_1_3_3_1_1_1_1_5,102,53
chr5-61566772_61566893,cPa118,0.444444444444444,6,61566841,61566803,cPa118_cPa140_cPa15-cPa273-hybrid_cPa443_cPa443-cPa516-hybrid_cPa443-unknown,4_1_1_1_1_1,121,38
chr5-61566929_61567031,cPa118,0.642857142857143,6,61567021,61566957,cPa118_cPa140_cPa15_cPa15-cPa273-hybrid_cPa15-cPa516-hybrid_cPa443,9_1_1_1_1_1,102,64
chr5-61571278_61571500,HERVHcons,0.947368421052632,3,61571448,61571277,cPa106_HERVHcons_HERVHcons-unknown,1_36_1,222,171
chr5-61578909_61579011,cPa260,1,1,61578997,61578959,cPa260,5,102,38
chr5-61584300_61584402,cPa363-cPa75-hybrid,1,1,61584350,61584330,cPa363-cPa75-hybrid,2,102,20
chr5-61598138_61598240,cPa260_cPa75-cPa223-hybrid_cPa75-unknown,0.333333333333333,3,61598208,61598180,cPa260_cPa75-cPa223-hybrid_cPa75-unknown,1_1_1,102,28
chr5-61607515_61607674,cPa75-unknown,0.666666666666667,2,61607622,61607565,cPa75-cPa425-hybrid_cPa75-unknown,1_2,159,57
chr5-61609356_61609458,cPa223,1,1,61609450,61609370,cPa223,5,102,80
chr5-61629780_61629882,cPa260,1,1,61629841,61629830,cPa260,2,102,11
chr5-61642678_61642780,cPa183_cPa183-cPa452-hybrid_cPa327_cPa452,0.25,4,61642761,61642717,cPa183_cPa183-cPa452-hybrid_cPa327_cPa452,1_1_1_1,102,44
chr5-61647457_61647559,cPa75,1,1,61647507,61647507,cPa75,1,102,0
chr5-61650918_61651020,cPa118_cPa15,0.5,2,61650968,61650968,cPa118_cPa15,1_1,102,0
chr5-61654077_61654179,cPa199-unknown,1,1,61654127,61654127,cPa199-unknown,1,102,0
chr5-61712705_61712921,cPa553,0.666666666666667,5,61712869,61712722,cPa199_cPa223_cPa450_cPa542_cPa553,1_2_3_1_14,216,147
chr5-61712964_61713066,cPa450-unknown,1,1,61713014,61713014,cPa450-unknown,1,102,0
chr5-61734138_61734301,cPa75-unknown,0.833333333333333,2,61734249,61734184,cPa75_cPa75-unknown,1_5,163,65
chr5-61754708_61754810,cPa450,1,1,61754758,61754758,cPa450,1,102,0
chr5-61849764_61849866,cPa193_cPa229,0.5,2,61849817,61849814,cPa193_cPa229,1_1,102,3
chr5-61857741_61857843,cPa452,0.333333333333333,6,61857843,61857740,cPa363_cPa363-cPa379-hybrid_cPa363-unknown_cPa379_cPa446_cPa452,4_1_1_5_1_6,102,103
chr5-619056_619158,cPa118_cPa264-cPa118-hybrid_cPa264-cPa15-hybrid,0.333333333333333,3,619106,619095,cPa118_cPa264-cPa118-hybrid_cPa264-cPa15-hybrid,1_1_1,102,11
chr5-61918858_61919092,cPa223,1,1,61919040,61918881,cPa223,9,234,159
chr5-61955115_61955217,cPa363,0.6,2,61955165,61955165,cPa363_cPa452,3_2,102,0
chr5-6243_6345,cPa75,1,1,6293,6293,cPa75,1,102,0
chr5-6303399_6303501,cPa450,0.4,4,6303449,6303428,cPa199_cPa199-cPa273-hybrid_cPa450_cPa482-cPa273-hybrid,1_1_2_1,102,21
chr5-638954_639056,cPa285,1,1,639009,639004,cPa285,2,102,5
chr5-6430076_6430190,cPa363_cPa456_cPa456-cPa117-hybrid_cPa456-cPa363-hybrid_cPa563-cPa117-hybrid_cPa563-cPa452-hybrid,0.166666666666667,6,6430141,6430113,cPa363_cPa456_cPa456-cPa117-hybrid_cPa456-cPa363-hybrid_cPa563-cPa117-hybrid_cPa563-cPa452-hybrid,1_1_1_1_1_1,114,28
chr5-6892820_6892922,cPa62,0.916666666666667,2,6892898,6892820,cPa254_cPa62,1_11,102,78
chr5-6934713_6934818,cPa15,0.476190476190476,5,6934798,6934754,cPa118_cPa15_cPa15-cPa118-hybrid_cPa268_cPa268-cPa118-hybrid,1_10_1_7_2,105,44
chr5-6947457_6947559,cPa62,1,1,6947555,6947472,cPa62,8,102,83
chr5-6947573_6948336,cPa62,0.625,9,6948284,6947589,cPa293_cPa293-cPa285-hybrid_cPa293-cPa75-hybrid_cPa62_cPa62-cPa285-hybrid_cPa62-cPa75-hybrid_cPa75_cPa75-cPa62-hybrid_GaLV_M26927-cPa293-hybrid,4_1_1_65_3_3_25_1_1,763,695
chr5-6948337_6948447,cPa62,0.75,2,6948445,6948353,cPa62_cPa75,3_1,110,92
chr5-6948460_6948652,cPa62,0.626865671641791,4,6948634,6948494,cPa62_cPa62-cPa285-hybrid_cPa62-cPa75-hybrid_cPa75,42_1_1_23,192,140
chr5-7187231_7187333,cPa75,1,1,7187281,7187269,cPa75,2,102,12
chr5-7451_7553,cPa75,0.44,8,7521,7453,Cer1_U15406_cPa109-cPa581-hybrid_cPa247_cPa247-cPa581-hybrid_cPa285-cPa75-hybrid_cPa419_cPa62-cPa293-hybrid_cPa75,1_1_4_1_1_5_1_11,102,68
chr5-8022665_8022767,cPa363,0.428571428571429,5,8022734,8022714,cPa363_cPa452_cPa452-cPa363-hybrid_cPa452-unknown_cPa71,6_5_1_1_1,102,20
chr5-834416_834553,cPa75,0.666666666666667,2,834501,834466,cPa75_cPa75-unknown,2_1,137,35
chr5-837251_837359,cPa428,0.583333333333333,2,837307,837258,cPa356_cPa428,5_7,108,49
chr5-8376921_8377023,cPa290-cPa438-hybrid_cPa581-cPa438-hybrid,0.458333333333333,3,8376998,8376943,cPa290-cPa438-hybrid_cPa539-cPa438-hybrid_cPa581-cPa438-hybrid,11_2_11,102,55
chr5-838527_838629,cPa356,0.571428571428571,2,838582,838557,cPa356_cPa428,4_3,102,25
chr5-838790_838892,cPa428,0.6,2,838845,838828,cPa356_cPa428,6_9,102,17
chr5-8391111_8391213,cPa75,1,1,8391161,8391161,cPa75,1,102,0
chr5-839766_839897,cPa428,0.764705882352941,2,839891,839800,cPa356_cPa428,4_13,131,91
chr5-8493139_8493241,cPa196-cPa539-hybrid,0.75,2,8493189,8493162,cPa196-cPa539-hybrid_HFV_NC001736-cPa539-hybrid,3_1,102,27
chr5-8493389_8493491,cPa196-cPa539-hybrid,0.743589743589744,5,8493439,8493437,cPa196-cPa200-hybrid_cPa196-cPa539-hybrid_cPa196-unknown_cPa356-cPa539-hybrid_HFV_NC001736-cPa539-hybrid,4_29_1_1_4,102,2
chr5-8495696_8495798,cPa419,1,1,8495746,8495746,cPa419,1,102,0
chr5-880952_881054,cPa419,1,1,881052,881002,cPa419,23,102,50
chr5-881084_881534,cPa419,1,1,881482,881083,cPa419,118,450,399
chr5-8897431_8897533,cPa75,0.6,3,8897531,8897459,cPa62_cPa75_cPa75-cPa62-hybrid,1_3_1,102,72
chr5-8946347_8946449,cPa75,1,1,8946397,8946375,cPa75,15,102,22
chr5-8946765_8946943,cPa75,1,1,8946891,8946785,cPa75,5,178,106
chr5-9061883_9061985,cPa424-cPa75-hybrid,1,1,9061933,9061933,cPa424-cPa75-hybrid,1,102,0
chr5-9140853_9140959,cPa428,0.666666666666667,2,9140959,9140896,cPa356_cPa428,3_6,106,63
chr5-9141455_9141580,cPa356,0.51063829787234,2,9141578,9141462,cPa356_cPa428,24_23,125,116
chr5-9141609_9141795,cPa356,0.567901234567901,2,9141743,9141659,cPa356_cPa428,46_35,186,84
chr5-9141854_9141956,cPa428,0.666666666666667,2,9141904,9141883,cPa356_cPa428,2_4,102,21
chr5-9141980_9142224,cPa428,0.525,2,9142185,9141979,cPa356_cPa428,19_21,244,206
chr5-9142431_9142771,cPa356,0.525423728813559,3,9142767,9142448,cPa356_cPa356-unknown_cPa428,31_1_27,340,319
chr5-9505196_9505298,cPa118,0.666666666666667,2,9505272,9505246,cPa118_cPa15,2_1,102,26
chr5-9608720_9608834,cPa75,1,1,9608782,9608768,cPa75,8,114,14
chr5-9629285_9629387,cPa75,1,1,9629335,9629335,cPa75,1,102,0
chr5-9666755_9666857,cPa75,1,1,9666805,9666800,cPa75,3,102,5
chr6-10862600_10862711,cPa15,0.857142857142857,2,10862669,10862624,cPa118_cPa15,1_6,111,45
chr6-11036451_11036565,cPa118-cPa248-hybrid_cPa15,0.4,3,11036514,11036492,cPa118_cPa118-cPa248-hybrid_cPa15,1_2_2,114,22
chr6-11280363_11280465,cPa62-cPa380-hybrid,1,1,11280413,11280413,cPa62-cPa380-hybrid,1,102,0
chr6-1130887_1131070,cPa199,0.5,3,1131018,1130937,cPa199_cPa199-cPa553-hybrid_cPa223,4_1_3,183,81
chr6-1131573_1131851,cPa223,0.5,3,1131799,1131623,cPa199_cPa223_cPa482,3_4_1,278,176
chr6-1131863_1132076,cPa199,0.555555555555556,3,1132024,1131895,cPa199_cPa223_cPa450,5_3_1,213,129
chr6-1132245_1132347,cPa199_cPa223,0.5,2,1132295,1132281,cPa199_cPa223,1_1,102,14
chr6-1132423_1132778,cPa199_cPa223,0.363636363636364,5,1132726,1132473,cPa199_cPa199-cPa482-hybrid_cPa223_cPa223-cPa199-hybrid_cPa227,4_1_4_1_1,355,253
chr6-11534148_11534250,cPa419,1,1,11534198,11534198,cPa419,1,102,0
chr6-11891383_11891485,cPa285-cPa194-hybrid,0.714285714285714,3,11891433,11891384,cPa194_cPa285-cPa194-hybrid_cPa285-unknown,1_5_1,102,49
chr6-1198047_1198149,cPa62,0.96,2,1198112,1198080,cPa62_cPa62-unknown,24_1,102,32
chr6-12198623_12198725,cPa62,0.9,2,12198700,12198649,cPa293_cPa62,1_9,102,51
chr6-12711850_12711952,cPa118_cPa15,0.5,2,12711900,12711898,cPa118_cPa15,2_2,102,2
chr6-131652_131754,cPa363,1,1,131702,131702,cPa363,1,102,0
chr6-13706_13821,cPa61,0.571428571428571,4,13769,13710,cPa205_cPa465-cPa450-hybrid_cPa61_cPa61-cPa168-hybrid,1_1_4_1,115,59
chr6-14049560_14049662,cPa62,1,1,14049610,14049587,cPa62,32,102,23
chr6-1418336_1418438,cPa419,1,1,1418386,1418386,cPa419,1,102,0
chr6-14226344_14226562,cPa75,0.708333333333333,5,14226522,14226394,cPa62-cPa260-hybrid_cPa62-cPa75-hybrid_cPa75_cPa75-cPa260-hybrid_PERVA_AY099323-cPa75-hybrid,2_3_17_1_1,218,128
chr6-14226622_14226918,cPa75,0.615384615384615,6,14226874,14226672,cPa419_cPa62_cPa62-cPa75-hybrid_cPa75_cPa75-unknown_HERV-W_repbase_HERV17_LTR17,1_3_7_24_2_2,296,202
chr6-14227018_14227120,cPa75,1,1,14227068,14227029,cPa75,2,102,39
chr6-145429_145531,cPa15,0.507692307692308,9,145493,145428,cPa118_cPa118-cPa443-hybrid_cPa119_cPa125-cPa119-hybrid_cPa15_cPa15-cPa118-hybrid_cPa15-unknown_cPa268_cPa443,22_1_1_1_33_1_3_1_2,102,65
chr6-145565_145667,cPa15,0.413793103448276,9,145643,145570,cPa118_cPa118-cPa339-hybrid_cPa119_cPa125_cPa140_cPa15_cPa15-cPa339-hybrid_cPa443_cPa443-cPa119-hybrid,10_1_1_1_1_12_1_1_1,102,73
chr6-14580101_14580203,cPa391,0.6,3,14580151,14580134,cPa391_cPa426-cPa293-hybrid_cPa426-unknown,3_1_1,102,17
chr6-145888_145990,cPa15,0.409836065573771,11,145987,145928,cPa118_cPa118-unknown_cPa119_cPa125-cPa339-hybrid_cPa140_cPa15_cPa15-unknown_cPa419_cPa443-cPa268-hybrid_cPa443-cPa339-hybrid_cPa443-unknown,24_2_1_1_1_25_1_1_1_3_1,102,59
chr6-1507228_1507548,HERV-W_repbase_HERV17_LTR17,0.962264150943396,2,1507527,1507278,HERV-W_repbase_HERV17_LTR17_HERV-W_repbase_HERV17_LTR17-unknown,51_2,320,249
chr6-15323288_15323575,cPa75,0.444444444444444,11,15323572,15323320,cPa199-cPa62-hybrid_cPa199-unknown_cPa227-cPa62-hybrid_cPa293_cPa293-cPa62-hybrid_cPa345-cPa62-hybrid_cPa413-cPa62-hybrid_cPa62_cPa75_cPa75-cPa62-hybrid_PERVC_HM159246,10_2_1_1_4_2_1_9_32_9_1,287,252
chr6-1552231_1552333,cPa194_cPa67,0.5,2,1552281,1552251,cPa194_cPa67,1_1,102,30
chr6-1559676_1559778,cPa75-cPa456-hybrid,1,1,1559726,1559726,cPa75-cPa456-hybrid,1,102,0
chr6-1562217_1562319,cPa482-cPa201-hybrid_cPa482-cPa505-hybrid,0.5,2,1562267,1562250,cPa482-cPa201-hybrid_cPa482-cPa505-hybrid,1_1,102,17
chr6-1562370_1562472,cPa505,1,1,1562420,1562420,cPa505,1,102,0
chr6-16184505_16184608,cPa452,0.5,3,16184560,16184545,cPa363_cPa452_cPa71,2_3_1,103,15
chr6-1643649_1643751,cPa62-cPa293-hybrid_cPa62-unknown_cPa75,0.333333333333333,3,1643726,1643675,cPa62-cPa293-hybrid_cPa62-unknown_cPa75,1_1_1,102,51
chr6-1643913_1644015,cPa62-unknown,1,1,1643963,1643963,cPa62-unknown,1,102,0
chr6-16517168_16517286,cPa75,1,1,16517234,16517201,cPa75,33,118,33
chr6-16520410_16520512,cPa260_cPa260-cPa75-hybrid_cPa425-cPa260-hybrid_cPa425-unknown_cPa543-cPa75-hybrid,0.181818181818182,6,16520479,16520429,cPa260_cPa260-cPa75-hybrid_cPa425-cPa260-hybrid_cPa425-unknown_cPa543-cPa75-hybrid_cPa75,2_2_2_2_2_1,102,50
chr6-16536401_16536503,cPa62,1,1,16536476,16536427,cPa62,10,102,49
chr6-16546716_16546825,cPa15_cPa268,0.5,2,16546773,16546766,cPa15_cPa268,1_1,109,7
chr6-16808207_16808309,cPa363,0.384615384615385,5,16808283,16808244,cPa363_cPa452_cPa71_cPa71-cPa363-hybrid_cPa71-cPa452-hybrid,10_8_5_1_2,102,39
chr6-1699156_1699258,cPa323,1,1,1699206,1699206,cPa323,2,102,0
chr6-1699315_1699491,cPa323,0.714285714285714,3,1699484,1699325,cPa323_cPa323-cPa371-hybrid_cPa371,10_1_3,176,159
chr6-1699492_1699594,cPa323,1,1,1699566,1699542,cPa323,2,102,24
chr6-1699611_1699896,cPa323,0.761904761904762,2,1699884,1699661,cPa323_cPa371,16_5,285,223
chr6-1702169_1702350,cPa323,0.75,3,1702348,1702169,cPa323_cPa371_cPa75-cPa371-hybrid,12_3_1,181,179
chr6-1702361_1702547,cPa323,0.642857142857143,4,1702530,1702364,cPa323_cPa371_cPa512_cPa75-cPa371-hybrid,27_11_1_3,186,166
chr6-1782221_1782323,cPa75,1,1,1782271,1782271,cPa75,1,102,0
chr6-1782461_1782713,HERV-W_repbase_HERV17_LTR17,0.4,6,1782713,1782511,cPa62_cPa62-HERV-W_repbase_HERV17_LTR17-hybrid_cPa71_cPa75_cPa75-HERV-W_repbase_HERV17_LTR17-hybrid_HERV-W_repbase_HERV17_LTR17,4_1_1_2_1_6,252,202
chr6-18056934_18057036,cPa241_cPa515,0.5,2,18056984,18056984,cPa241_cPa515,1_1,102,0
chr6-18771900_18772002,cPa452,1,1,18771950,18771915,cPa452,2,102,35
chr6-18887885_18887987,cPa75-cPa62-hybrid,0.6,4,18887979,18887891,cPa293-cPa62-hybrid_cPa62_cPa75_cPa75-cPa62-hybrid,1_6_3_15,102,88
chr6-19162112_19162214,cPa392,1,1,19162162,19162162,cPa392,1,102,0
chr6-19162460_19162562,cPa15,0.5,3,19162528,19162492,cPa15_cPa248-cPa392-hybrid_cPa443-cPa118-hybrid,2_1_1,102,36
chr6-19940358_19940482,cPa456,0.416666666666667,11,19940475,19940363,cPa363_cPa363-cPa117-hybrid_cPa452_cPa456_cPa456-cPa117-hybrid_cPa456-cPa452-hybrid_cPa456-unknown_cPa587-cPa117-hybrid_cPa587-cPa363-hybrid_cPa587-cPa452-hybrid_REV_NC006934-cPa117-hybrid,23_2_2_30_3_1_1_7_1_1_1,124,112
chr6-19971714_19971853,HTLV1_NC001436-unknown,1,1,19971822,19971764,HTLV1_NC001436-unknown,14,139,58
chr6-2011927_2012211,cPa260-cPa75-hybrid,0.538461538461538,5,2012159,2011958,cPa260_cPa260-cPa75-hybrid_cPa260-unknown_cPa482-cPa75-hybrid_cPa75,2_7_1_2_1,284,201
chr6-2022701_2022803,cPa15,0.8,2,2022763,2022739,cPa15_cPa268,4_1,102,24
chr6-20250237_20250339,cPa75,1,1,20250289,20250246,cPa75,9,102,43
chr6-20571016_20571205,cPa363_cPa452_cPa71,0.3,4,20571153,20571056,cPa363_cPa452_cPa62_cPa71,3_3_1_3,189,97
chr6-20578511_20578613,PERVE_NC003059,1,1,20578561,20578561,PERVE_NC003059,1,102,0
chr6-20727892_20727997,cPa150_cPa302,0.333333333333333,4,20727961,20727942,cPa150_cPa255-cPa246-hybrid_cPa302_cPa438-cPa246-hybrid,2_1_2_1,105,19
chr6-21513982_21514084,cPa75,1,1,21514038,21514030,cPa75,3,102,8
chr6-217466_217568,cPa425_cPa47_cPa47-cPa174-hybrid,0.25,6,217528,217480,cPa254_cPa254-cPa174-hybrid_cPa425_cPa47_cPa47-cPa174-hybrid_cPa47-unknown,1_1_3_3_3_1,102,48
chr6-21947_22239,HERV-W_repbase_HERV17_LTR17,0.625,5,22197,21997,cPa62_cPa62-HERV-W_repbase_HERV17_LTR17-hybrid_cPa62-unknown_HERV-W_repbase_HERV17_LTR17_KoRV_AF151794,1_3_4_15_1,292,200
chr6-22068737_22068839,cPa47,0.4,4,22068789,22068787,cPa174_cPa254_cPa425_cPa47,1_1_1_2,102,2
chr6-22177888_22177995,cPa15_cPa268_cPa443-unknown,0.333333333333333,3,22177943,22177938,cPa15_cPa268_cPa443-unknown,1_1_1,107,5
chr6-2256628_2256807,cPa113,0.266666666666667,8,2256791,2256627,cPa113_cPa199-cPa113-hybrid_cPa67_cPa75-cPa113-hybrid_cPa75-cPa199-hybrid_cPa75-cPa227-hybrid_cPa75-cPa345-hybrid_cPa75-cPa450-hybrid,4_2_2_2_1_2_1_1,179,164
chr6-2256830_2256932,cPa113,0.285714285714286,6,2256888,2256836,cPa113_cPa450-cPa113-hybrid_cPa62-cPa113-hybrid_cPa67_cPa75-cPa113-hybrid_cPa75-unknown,2_1_1_1_1_1,102,52
chr6-22865884_22865986,cPa118_cPa15,0.4,3,22865934,22865920,cPa118_cPa15_cPa268,2_2_1,102,14
chr6-234823_234940,cPa118_cPa363_cPa452,0.333333333333333,3,234888,234873,cPa118_cPa363_cPa452,1_1_1,117,15
chr6-235033_235143,cPa118_cPa15,0.4,3,235123,235083,cPa118_cPa15_cPa75-cPa15-hybrid,2_2_1,110,40
chr6-23608722_23608824,cPa150,0.666666666666667,2,23608772,23608769,cPa150_cPa438-cPa246-hybrid,2_1,102,3
chr6-23961056_23961158,cPa452,0.5,3,23961118,23961106,cPa363_cPa452_cPa71,4_8_4,102,12
chr6-24299882_24299984,cPa540,0.5,3,24299938,24299927,cPa127_cPa530-unknown_cPa540,1_1_2,102,11
chr6-2444071_2444173,cPa450,0.48,5,2444173,2444098,cPa223_cPa223-cPa345-hybrid_cPa273_cPa345-cPa223-hybrid_cPa450,7_1_4_1_12,102,75
chr6-2472079_2472181,cPa67,0.583333333333333,8,2472155,2472114,cPa194_cPa194-cPa541-hybrid_cPa541_cPa541-cPa67-hybrid_cPa541-unknown_cPa542_cPa67_cPa67-unknown,3_1_11_1_2_1_28_1,102,41
chr6-25419692_25419794,cPa75,1,1,25419742,25419742,cPa75,1,102,0
chr6-2542403_2542589,cPa75-unknown,1,1,2542537,2542453,cPa75-unknown,2,186,84
chr6-2542627_2542729,cPa75-cPa199-hybrid_cPa75-unknown_HERV-F_repbase_HERVFH19I_LTR19A-cPa260-hybrid,0.333333333333333,3,2542696,2542677,cPa75-cPa199-hybrid_cPa75-unknown_HERV-F_repbase_HERVFH19I_LTR19A-cPa260-hybrid,1_1_1,102,19
chr6-2611042_2611144,HERV-W_repbase_HERV17_LTR17,0.971428571428571,2,2611121,2611045,HERV-W_repbase_HERV17_LTR17_HERV-W_repbase_HERV17_LTR17-unknown,34_1,102,76
chr6-26234524_26234626,cPa67-unknown,1,1,26234574,26234574,cPa67-unknown,1,102,0
chr6-2625582_2625692,cPa118-cPa140-hybrid_cPa15_cPa419-cPa443-hybrid,0.333333333333333,3,2625646,2625632,cPa118-cPa140-hybrid_cPa15_cPa419-cPa443-hybrid,1_1_1,110,14
chr6-26459299_26459401,cPa62,0.962962962962963,2,26459392,26459312,cPa293_cPa62,1_26,102,80
chr6-26462565_26462667,WDSV_NC001867,0.533333333333333,5,26462646,26462611,cPa260_cPa260-unknown_EIAV_NC001450-unknown_VISNA_S55323-unknown_WDSV_NC001867,3_2_1_1_8,102,35
chr6-2653089_2653191,cPa339-cPa356-hybrid,1,1,2653139,2653139,cPa339-cPa356-hybrid,1,102,0
chr6-2657372_2657474,cPa428,1,1,2657422,2657422,cPa428,1,102,0
chr6-2657667_2657780,cPa428,1,1,2657728,2657717,cPa428,3,113,11
chr6-2658037_2658139,cPa356,1,1,2658087,2658087,cPa356,1,102,0
chr6-2661558_2661660,cPa356,0.571428571428571,2,2661614,2661602,cPa356_cPa428,4_3,102,12
chr6-2661868_2661970,cPa356,1,1,2661918,2661918,cPa356,1,102,0
chr6-2662064_2662203,cPa356,0.5,3,2662192,2662114,cPa356_cPa356-unknown_cPa428,46_1_45,139,78
chr6-2662497_2662638,cPa356,0.518518518518518,2,2662630,2662523,cPa356_cPa428,14_13,141,107
chr6-2662841_2663141,cPa356,0.560975609756098,2,2663089,2662842,cPa356_cPa428,23_18,300,247
chr6-2663280_2663382,cPa356_cPa428,0.5,2,2663380,2663309,cPa356_cPa428,5_5,102,71
chr6-2663527_2663629,cPa428,0.75,2,2663597,2663544,cPa356_cPa428,1_3,102,53
chr6-2674029_2674167,cPa428,0.75,2,2674159,2674079,cPa356_cPa428,1_3,138,80
chr6-2674219_2674426,cPa428,0.571428571428571,2,2674406,2674246,cPa356_cPa428,24_32,207,160
chr6-26746677_26746787,cPa75,1,1,26746735,26746725,cPa75,7,110,10
chr6-2674919_2675021,cPa428,1,1,2674969,2674969,cPa428,1,102,0
chr6-2675158_2675260,cPa356_cPa428,0.5,2,2675235,2675177,cPa356_cPa428,5_5,102,58
chr6-2675269_2675452,cPa428,0.504672897196262,2,2675442,2675297,cPa356_cPa428,53_54,183,145
chr6-2675487_2675763,cPa428,0.50761421319797,2,2675760,2675500,cPa356_cPa428,97_100,276,260
chr6-2676058_2676160,cPa428,0.56,2,2676136,2676061,cPa356_cPa428,11_14,102,75
chr6-2706170_2706272,cPa413-cPa357-hybrid_cPa419,0.5,2,2706255,2706220,cPa413-cPa357-hybrid_cPa419,1_1,102,35
chr6-2709735_2709837,cPa575-cPa130-hybrid,1,1,2709785,2709785,cPa575-cPa130-hybrid,1,102,0
chr6-27143859_27143961,cPa75,1,1,27143909,27143909,cPa75,1,102,0
chr6-27143974_27144076,cPa75,1,1,27144024,27144024,cPa75,1,102,0
chr6-27182518_27182620,cPa199_cPa223_cPa345,0.214285714285714,7,27182617,27182568,cPa199_cPa223_cPa345_cPa450_cPa542_cPa542-cPa199-hybrid_cPa553,3_3_3_1_1_1_2,102,49
chr6-2723620_2723722,cPa390,1,1,2723670,2723670,cPa390,1,102,0
chr6-2726721_2726823,cPa465-cPa434-hybrid,1,1,2726771,2726771,cPa465-cPa434-hybrid,1,102,0
chr6-2742617_2742719,cPa410,1,1,2742693,2742667,cPa410,2,102,26
chr6-2742721_2742872,cPa268_cPa61-unknown_cPa75_HERVFc2_repbase,0.25,4,2742820,2742724,cPa268_cPa61-unknown_cPa75_HERVFc2_repbase,1_1_1_1,151,96
chr6-2748032_2748155,cPa75,0.5,3,2748129,2748061,cPa402_cPa419_cPa75,6_1_7,123,68
chr6-2748319_2748421,cPa402_cPa75,0.5,2,2748373,2748369,cPa402_cPa75,1_1,102,4
chr6-278929_279031,cPa246-cPa75-hybrid,1,1,278979,278979,cPa246-cPa75-hybrid,1,102,0
chr6-28055701_28055803,cPa15,0.565217391304348,6,28055798,28055714,cPa118_cPa15_cPa248-cPa118-hybrid_cPa248-unknown_cPa443-cPa118-hybrid_cPa443-unknown,16_26_1_1_1_1,102,84
chr6-28119428_28119691,cPa62,0.633333333333333,5,28119643,28119446,cPa285_cPa285-cPa293-hybrid_cPa285-cPa62-hybrid_cPa293_cPa62,5_1_2_3_19,263,197
chr6-28547476_28547578,cPa15,0.545454545454545,3,28547543,28547486,cPa118_cPa15_cPa248-unknown,4_6_1,102,57
chr6-28550864_28550974,cPa118_cPa15,0.5,2,28550922,28550914,cPa118_cPa15,1_1,110,8
chr6-28797841_28797963,cPa62-cPa75-hybrid,1,1,28797950,28797891,cPa62-cPa75-hybrid,3,122,59
chr6-28797978_28798170,cPa62-cPa75-hybrid_HERV-W_repbase_HERV17_LTR17,0.5,2,28798118,28798028,cPa62-cPa75-hybrid_HERV-W_repbase_HERV17_LTR17,1_1,192,90
chr6-28940704_28940806,cPa392,1,1,28940754,28940738,cPa392,3,102,16
chr6-28998368_28998470,cPa254-unknown_cPa62,0.5,2,28998418,28998405,cPa254-unknown_cPa62,1_1,102,13
chr6-29008854_29008956,cPa62,0.928571428571429,2,29008912,29008853,cPa62_cPa62-unknown,13_1,102,59
chr6-29722084_29722186,cPa315,1,1,29722134,29722134,cPa315,1,102,0
chr6-29804197_29804312,cPa130-cPa257-hybrid_cPa285-cPa257-hybrid_cPa555,0.333333333333333,3,29804260,29804247,cPa130-cPa257-hybrid_cPa285-cPa257-hybrid_cPa555,1_1_1,115,13
chr6-30195962_30196095,cPa62,1,1,30196090,30196012,cPa62,12,133,78
chr6-30262799_30262906,cPa62,0.952380952380952,3,30262858,30262839,cPa254-unknown_cPa62_cPa62-unknown,1_40_1,107,19
chr6-30367832_30367934,cPa419,1,1,30367882,30367882,cPa419,1,102,0
chr6-30375681_30375818,cPa285_cPa62,0.44,5,30375804,30375680,cPa285_cPa293_cPa62_cPa62-cPa285-hybrid_cPa62-unknown,11_1_11_1_1,137,124
chr6-30601668_30601770,cPa118_cPa15_cPa248-unknown,0.333333333333333,3,30601718,30601718,cPa118_cPa15_cPa248-unknown,1_1_1,102,0
chr6-30767606_30767708,cPa62-unknown,0.6,2,30767672,30767609,cPa293_cPa62-unknown,2_3,102,63
chr6-30767795_30767897,cPa75,0.5,4,30767887,30767804,cPa293_cPa62-cPa293-hybrid_cPa62-unknown_cPa75,1_1_1_3,102,83
chr6-30777661_30777763,cPa260,0.666666666666667,3,30777762,30777661,cPa106_cPa260_cPa260-cPa363-hybrid,1_4_1,102,101
chr6-30778859_30778961,cPa446,0.380952380952381,5,30778921,30778866,cPa363_cPa379_cPa446_cPa446-unknown_cPa452,6_2_8_1_4,102,55
chr6-3096069_3096171,cPa75-cPa285-hybrid,1,1,3096119,3096119,cPa75-cPa285-hybrid,1,102,0
chr6-31090670_31090772,cPa75,0.615384615384615,6,31090755,31090689,cPa260_cPa285-unknown_cPa293_cPa293-unknown_cPa75_cPa75-unknown,1_1_3_11_32_4,102,66
chr6-31090837_31090939,cPa75,0.666666666666667,3,31090913,31090861,cPa293-cPa75-hybrid_cPa293-unknown_cPa75,1_1_4,102,52
chr6-3112443_3112545,cPa199,1,1,3112493,3112493,cPa199,1,102,0
chr6-3124774_3124939,cPa539,0.428571428571429,5,3124887,3124803,cPa486-cPa539-hybrid_cPa486-unknown_cPa492_cPa492-unknown_cPa539,3_2_2_1_6,165,84
chr6-31283078_31283191,cPa492,0.5,7,31283160,31283091,cPa482_cPa482-cPa505-hybrid_cPa482-cPa75-hybrid_cPa482-unknown_cPa492_cPa492-unknown_cPa505,2_1_1_1_13_1_7,113,69
chr6-3161174_3161354,cPa113,0.75,4,3161302,3161220,cPa113_cPa113-cPa62-hybrid_cPa113-cPa75-hybrid_GaLV_M26927-cPa75-hybrid,9_1_1_1,180,82
chr6-3161491_3161593,cPa113,0.375,4,3161541,3161513,cPa113_cPa113-cPa75-hybrid_cPa75_MDEV_AF053745-KoRV_AF151794-hybrid,3_2_2_1,102,28
chr6-31720779_31720881,cPa223,0.666666666666667,3,31720876,31720783,cPa223_cPa273_cPa542,4_1_1,102,93
chr6-31901849_31901963,cPa502,0.553191489361702,4,31901957,31901874,cPa339_cPa339-cPa502-hybrid_cPa339-unknown_cPa502,14_1_6_26,114,83
chr6-31901971_31902073,cPa502,0.575757575757576,3,31902030,31901971,cPa339_cPa339-unknown_cPa502,13_1_19,102,59
chr6-3195621_3195723,cPa443,0.466666666666667,5,3195695,3195621,cPa118_cPa15_cPa15-cPa118-hybrid_cPa264_cPa443,1_2_1_4_7,102,74
chr6-32103909_32104011,cPa223-cPa434-hybrid,1,1,32103959,32103959,cPa223-cPa434-hybrid,1,102,0
chr6-32261155_32261257,cPa505-cPa492-hybrid,1,1,32261205,32261205,cPa505-cPa492-hybrid,1,102,0
chr6-32291390_32291511,cPa74,0.75,2,32291466,32291440,cPa74_cPa74-unknown,3_1,121,26
chr6-32293503_32293751,WDSV_NC001867,0.425925925925926,5,32293711,32293553,cPa486-cPa62-hybrid_cPa62_WDSV_NC001867_WDSV_NC001867-cPa62-hybrid_WDSV_NC001867-unknown,7_2_23_20_2,248,158
chr6-32345844_32346088,cPa75,0.777777777777778,3,32346088,32345876,cPa75_cPa75-cPa62-hybrid_cPa75-unknown,28_2_6,244,212
chr6-3240289_3240391,cPa15-cPa176-hybrid_cPa444-cPa419-hybrid,0.5,2,3240378,3240339,cPa15-cPa176-hybrid_cPa444-cPa419-hybrid,1_1,102,39
chr6-3240904_3241341,cPa452,0.316831683168317,35,3241336,3240932,cPa131-cPa176-hybrid_cPa131-cPa452-hybrid_cPa16_cPa16-cPa176-hybrid_cPa16-cPa327-hybrid_cPa16-cPa363-hybrid_cPa16-unknown_cPa176_cPa176-cPa327-hybrid_cPa176-cPa424-hybrid_cPa339_cPa363_cPa363-cPa176-hybrid_cPa363-cPa327-hybrid_cPa419_cPa444-cPa176-hybrid_cPa444-cPa327-hybrid_cPa444-cPa353-hybrid_cPa444-cPa363-hybrid_cPa444-cPa419-hybrid_cPa444-cPa424-hybrid_cPa444-cPa447-hybrid_cPa444-cPa452-hybrid_cPa444-unknown_cPa447_cPa452_cPa452-cPa363-hybrid_cPa463-cPa176-hybrid_cPa463-cPa327-hybrid_cPa463-cPa424-hybrid_cPa572-cPa176-hybrid_cPa71-cPa16-hybrid_cPa71-cPa176-hybrid_cPa71-cPa327-hybrid_cPa71-cPa363-hybrid,4_1_7_3_6_1_1_18_2_1_13_37_2_1_2_13_3_1_1_1_1_2_1_1_2_64_1_1_1_1_1_1_5_1_1,437,404
chr6-32420882_32420984,cPa260,0.666666666666667,2,32420932,32420902,cPa260_cPa260-unknown,2_1,102,30
chr6-3243143_3243245,cPa363,1,1,3243193,3243193,cPa363,1,102,0
chr6-32432284_32432391,SIV_NC001870,0.975,2,32432351,32432331,SIV_NC001870_SIV_NC001870-unknown,39_1,107,20
chr6-3253679_3253781,cPa163-unknown,1,1,3253729,3253729,cPa163-unknown,1,102,0
chr6-32578688_32578790,cPa260,0.916666666666667,2,32578770,32578696,cPa260_cPa260-unknown,11_1,102,74
chr6-32578949_32579082,cPa260,0.939393939393939,3,32579080,32578998,cPa260_cPa260-HERV-W_repbase_HERV17_LTR17-hybrid_cPa260-unknown,31_1_1,133,82
chr6-3258338_3258440,cPa360,0.666666666666667,4,3258414,3258341,cPa15_cPa163_cPa264-cPa224-hybrid_cPa360,2_2_1_10,102,73
chr6-3258628_3258734,cPa118_cPa15_cPa360,0.333333333333333,3,3258682,3258678,cPa118_cPa15_cPa360,1_1_1,106,4
chr6-32741668_32741773,HERVHcons,0.8,2,32741752,32741711,cPa106_HERVHcons,1_4,105,41
chr6-32802333_32802533,cPa62,0.761904761904762,6,32802524,32802360,cPa119_cPa356-cPa61-hybrid_cPa62_cPa62-cPa443-hybrid_cPa62-cPa61-hybrid_cPa62-unknown,1_1_16_1_1_1,200,164
chr6-32803476_32803578,cPa434_cPa566-unknown_cPa62-cPa264-hybrid,0.333333333333333,3,32803527,32803484,cPa434_cPa566-unknown_cPa62-cPa264-hybrid,1_1_1,102,43
chr6-32812546_32812648,cPa400,1,1,32812640,32812584,cPa400,11,102,56
chr6-32995532_32995634,cPa260,0.75,2,32995634,32995559,cPa260_HERVHcons,3_1,102,75
chr6-32995665_32995767,cPa106_cPa260_cPa260-cPa75-hybrid,0.333333333333333,3,32995758,32995715,cPa106_cPa260_cPa260-cPa75-hybrid,1_1_1,102,43
chr6-33026747_33026894,cPa260,0.538461538461538,3,33026886,33026751,cPa106_cPa260_cPa260-unknown,5_7_1,147,135
chr6-33034645_33034783,cPa62,0.428571428571429,6,33034744,33034676,cPa106_cPa106-cPa260-hybrid_cPa106-unknown_cPa62_cPa62-cPa106-hybrid_cPa62-cPa260-hybrid,1_1_1_6_1_4,138,68
chr6-33034811_33034944,HERVHcons,0.25,10,33034944,33034858,cPa106_cPa106-cPa260-hybrid_cPa106-unknown_cPa260_cPa62-cPa106-hybrid_cPa62-cPa260-hybrid_cPa75-cPa260-hybrid_HERVHcons_HERVHcons-cPa106-hybrid_HERVHcons-cPa260-hybrid,7_1_1_6_1_2_1_8_1_4,133,86
chr6-33086232_33086386,cPa260,1,1,33086368,33086254,cPa260,9,154,114
chr6-33138839_33138941,cPa62,1,1,33138889,33138889,cPa62,1,102,0
chr6-33374715_33374817,cPa62,0.8,2,33374773,33374745,cPa62_cPa62-unknown,4_1,102,28
chr6-33441413_33441515,WDSV_NC001867,1,1,33441510,33441439,WDSV_NC001867,9,102,71
chr6-33763898_33764000,cPa71,0.571428571428571,4,33763948,33763904,cPa16_cPa379_cPa387-cPa16-hybrid_cPa71,1_1_1_4,102,44
chr6-33800602_33800704,cPa62,1,1,33800659,33800652,cPa62,2,102,7
chr6-33843390_33843561,cPa62,0.407407407407407,5,33843552,33843403,cPa293_cPa62_cPa62-unknown_cPa75_cPa75-unknown,1_11_4_10_1,171,149
chr6-33924690_33924893,cPa113,0.233333333333333,10,33924877,33924740,cPa113_cPa113-cPa293-hybrid_cPa113-cPa62-hybrid_cPa113-cPa75-hybrid_cPa113-unknown_cPa419_cPa572_cPa67-cPa75-hybrid_cPa67-unknown_cPa75,7_1_1_5_6_1_3_1_1_4,203,137
chr6-33962885_33962987,HERV-W_repbase_HERV17_LTR17,0.58252427184466,13,33962987,33962903,cPa113_cPa62_cPa71_cPa71-unknown_cPa75_cPa75-cPa113-hybrid_cPa75-unknown_HERV-W_repbase_HERV17_LTR17_HERV-W_repbase_HERV17_LTR17-cPa75-hybrid_HERV-W_repbase_HERV17_LTR17-unknown_KoRV_AF151794_PERV_AJ293656_PERV_AJ293656-cPa113-hybrid,5_1_1_2_16_8_4_60_1_2_1_1_1,102,84
chr6-33991561_33991708,cPa260,0.7,3,33991656,33991578,cPa260_cPa260-cPa106-hybrid_cPa260-unknown,7_1_2,147,78
chr6-33991767_33991914,cPa260,1,1,33991862,33991789,cPa260,4,147,73
chr6-33999461_33999563,cPa228,1,1,33999561,33999472,cPa228,10,102,89
chr6-34005823_34005925,cPa106,1,1,34005873,34005873,cPa106,1,102,0
chr6-34006064_34006166,cPa260,0.5,3,34006143,34006114,cPa106_cPa260_HERVHcons,1_2_1,102,29
chr6-34007885_34007989,cPa260,0.904761904761905,3,34007989,34007887,cPa228_cPa260_cPa260-unknown,1_19_1,104,102
chr6-34008140_34008242,cPa260,1,1,34008190,34008147,cPa260,3,102,43
chr6-34073706_34073988,cPa106,0.272727272727273,5,34073936,34073720,cPa106_cPa260_cPa260-HERVHcons-hybrid_cPa260-unknown_HERVHcons,3_2_2_2_2,282,216
chr6-34186549_34186651,cPa492,1,1,34186627,34186588,cPa492,3,102,39
chr6-3425320_3425490,cPa75-cPa62-hybrid,0.41025641025641,6,3425438,3425339,cPa62_cPa75_cPa75-cPa62-hybrid_cPa75-KoRV_AF151794-hybrid_HERV-W_repbase_HERV17_LTR17_HERV-W_repbase_HERV17_LTR17-cPa62-hybrid,3_12_16_1_6_1,170,99
chr6-3425676_3425778,cPa75_cPa75-cPa62-hybrid,0.5,2,3425734,3425726,cPa75_cPa75-cPa62-hybrid,1_1,102,8
chr6-34288344_34288497,cPa106,1,1,34288445,34288394,cPa106,2,153,51
chr6-34311739_34311841,HERVHcons-cPa260-hybrid,1,1,34311789,34311789,HERVHcons-cPa260-hybrid,1,102,0
chr6-343482_343586,cPa585-unknown,1,1,343534,343523,cPa585-unknown,47,104,11
chr6-34365533_34365687,cPa260,1,1,34365635,34365583,cPa260,3,154,52
chr6-34365728_34365830,cPa260,1,1,34365804,34365778,cPa260,2,102,26
chr6-34394981_34395092,cPa75,0.666666666666667,2,34395057,34395031,cPa400-unknown_cPa75,1_2,111,26
chr6-34413878_34414039,cPa75,1,1,34413987,34413925,cPa75,3,161,62
chr6-34414171_34414500,cPa75,1,1,34414448,34414221,cPa75,9,329,227
chr6-34427871_34427973,cPa260,1,1,34427961,34427870,cPa260,30,102,91
chr6-34430285_34430387,cPa223,0.238095238095238,13,34430349,34430291,cPa199_cPa199-cPa75-hybrid_cPa223_cPa223-cPa62-hybrid_cPa223-cPa75-hybrid_cPa223-unknown_cPa260_cPa260-cPa75-hybrid_cPa260-unknown_cPa450_cPa450-cPa62-hybrid_cPa450-cPa75-hybrid_cPa62,2_2_10_2_5_6_8_1_1_2_1_1_1,102,58
chr6-34459314_34459416,cPa363,0.4,6,34459381,34459331,cPa223-FeFV_NC001871-hybrid_cPa363_cPa363-cPa260-hybrid_cPa452_cPa71_FeFV_NC001871-cPa260-hybrid,1_6_1_5_1_1,102,50
chr6-34459570_34459672,cPa273-cPa260-hybrid_cPa363-unknown_cPa553-cPa260-hybrid_cPa61-cPa228-hybrid_cPa61-cPa581-hybrid_FeFV_NC001871-cPa260-hybrid_FeFV_NC001871-cPa345-hybrid_FeFV_NC001871-unknown,0.125,8,34459652,34459605,cPa273-cPa260-hybrid_cPa363-unknown_cPa553-cPa260-hybrid_cPa61-cPa228-hybrid_cPa61-cPa581-hybrid_FeFV_NC001871-cPa260-hybrid_FeFV_NC001871-cPa345-hybrid_FeFV_NC001871-unknown,1_1_1_1_1_1_1_1,102,47
chr6-34470438_34470540,cPa75-cPa505-hybrid,1,1,34470488,34470488,cPa75-cPa505-hybrid,1,102,0
chr6-34470700_34470802,cPa75-cPa505-hybrid_cPa75-unknown,0.5,2,34470768,34470750,cPa75-cPa505-hybrid_cPa75-unknown,1_1,102,18
chr6-34495477_34495579,cPa199,0.217391304347826,10,34495576,34495511,cPa199_cPa223_cPa227_cPa273_cPa273-unknown_cPa419_cPa450_cPa542_cPa553_cPa553-cPa273-hybrid,5_2_1_2_1_1_4_3_3_1,102,65
chr6-34510611_34510979,cPa223,0.939393939393939,2,34510977,34510661,cPa223_cPa61,31_2,368,316
chr6-34511016_34511128,cPa223,0.9,2,34511108,34511060,cPa223_cPa61,9_1,112,48
chr6-34511236_34511341,cPa223,0.666666666666667,2,34511308,34511286,cPa223_cPa61,4_2,105,22
chr6-34511345_34511546,cPa223,1,1,34511494,34511395,cPa223,4,201,99
chr6-3451165_3451267,cPa505-cPa539-hybrid,1,1,3451215,3451215,cPa505-cPa539-hybrid,1,102,0
chr6-34546250_34546352,cPa111-cPa345-hybrid_cPa67,0.5,2,34546314,34546300,cPa111-cPa345-hybrid_cPa67,1_1,102,14
chr6-34546636_34546738,cPa194,1,1,34546686,34546659,cPa194,3,102,27
chr6-3462394_3462496,WDSV_NC001867,1,1,3462444,3462444,WDSV_NC001867,1,102,0
chr6-34649656_34649785,cPa223_cPa553,0.416666666666667,4,34649749,34649706,cPa199_cPa223_cPa227_cPa553,1_5_1_5,129,43
chr6-34653177_34653502,cPa62,0.5,7,34653450,34653227,cPa285_cPa285-cPa293-hybrid_cPa285-HERV30_repbase_HERV30I_LTR30-hybrid_cPa293_cPa293-cPa402-hybrid_cPa62_cPa62-cPa285-hybrid,3_3_2_4_1_14_1,325,223
chr6-34653534_34653725,cPa62,0.7,3,34653725,34653584,cPa285_cPa285-HERV30_repbase_HERV30I_LTR30-hybrid_cPa62,2_1_7,191,141
chr6-34653872_34653974,cPa285_cPa293_cPa62,0.333333333333333,3,34653922,34653881,cPa285_cPa293_cPa62,1_1_1,102,41
chr6-34659020_34659129,cPa205,1,1,34659077,34659070,cPa205,3,109,7
chr6-34673189_34673291,cPa75,1,1,34673239,34673239,cPa75,1,102,0
chr6-34695125_34695227,cPa345,0.428571428571429,4,34695209,34695124,cPa194_cPa345_cPa345-unknown_cPa67,1_3_1_2,102,85
chr6-34716783_34716885,cPa106,0.666666666666667,2,34716875,34716802,cPa106_cPa106-cPa260-hybrid,2_1,102,73
chr6-34717834_34717955,cPa158,0.647058823529412,7,34717903,34717878,cPa106-cPa158-hybrid_cPa106-cPa333-hybrid_cPa158_cPa158-unknown_cPa260_cPa260-cPa158-hybrid_cPa333,1_1_11_1_1_1_1,121,25
chr6-34717960_34718202,cPa158,0.645833333333333,10,34718150,34717964,cPa158_cPa158-cPa260-hybrid_cPa158-cPa333-hybrid_cPa158-unknown_cPa260_cPa260-cPa158-hybrid_cPa260-cPa333-hybrid_cPa333_cPa333-cPa158-hybrid_HERVHcons-cPa158-hybrid,31_1_2_2_2_1_1_6_1_1,242,186
chr6-34785234_34785599,cPa106_cPa260,0.384615384615385,4,34785576,34785245,cPa106_cPa106-cPa260-hybrid_cPa260_HERVHcons-unknown,10_5_10_1,365,331
chr6-34879383_34879485,cPa482-cPa75-hybrid_cPa482-unknown,0.5,2,34879442,34879433,cPa482-cPa75-hybrid_cPa482-unknown,1_1,102,9
chr6-34882109_34882211,cPa75,1,1,34882159,34882159,cPa75,1,102,0
chr6-34984645_34984747,cPa75,1,1,34984695,34984695,cPa75,1,102,0
chr6-34985790_34985892,cPa75,1,1,34985840,34985840,cPa75,1,102,0
chr6-34992456_34992558,cPa75,1,1,34992506,34992506,cPa75,1,102,0
chr6-34995333_34995435,cPa452,0.384615384615385,5,34995430,34995355,cPa363_cPa452_cPa452-cPa363-hybrid_cPa452-unknown_cPa71,9_10_1_1_5,102,75
chr6-3507538_3507640,cPa228,1,1,3507588,3507588,cPa228,1,102,0
chr6-3596982_3597135,cPa260,0.310344827586207,9,3597114,3597017,cPa228_cPa228-cPa260-hybrid_cPa228-cPa75-hybrid_cPa228-unknown_cPa260_cPa260-cPa75-hybrid_cPa260-unknown_cPa75_HERV30_repbase_HERV30I_LTR30,2_3_1_4_9_1_1_7_1,153,97
chr6-3904642_3904749,cPa228,0.6,2,3904742,3904684,cPa228_HTLV2_M10060-cPa228-hybrid,3_2,107,58
chr6-4037444_4037546,cPa260,0.833333333333333,2,4037542,4037494,cPa228_cPa260,1_5,102,48
chr6-4054352_4054454,cPa425_cPa47,0.25,7,4054412,4054386,cPa254_cPa260-cPa174-hybrid_cPa425_cPa47_cPa47-cPa174-hybrid_cPa47-cPa254-hybrid_cPa47-unknown,2_1_3_3_1_1_1,102,26
chr6-4232835_4232942,cPa75,1,1,4232890,4232885,cPa75,2,107,5
chr6-4241110_4241212,cPa75,1,1,4241160,4241160,cPa75,1,102,0
chr6-4241351_4241453,cPa75,1,1,4241401,4241401,cPa75,1,102,0
chr6-427267_427369,cPa545,0.375,5,427317,427316,cPa14_cPa14-cPa95-hybrid_cPa4_cPa545_cPa95,1_1_1_3_2,102,1
chr6-4373045_4373178,cPa75-unknown,0.75,2,4373126,4373095,cPa75-HERV-W_repbase_HERV17_LTR17-hybrid_cPa75-unknown,1_3,133,31
chr6-4592107_4592209,cPa62,0.944444444444444,3,4592206,4592114,cPa285_cPa62_cPa62-unknown,1_34_1,102,92
chr6-4674992_4675094,cPa419-cPa260-hybrid_cPa555,0.5,2,4675042,4675039,cPa419-cPa260-hybrid_cPa555,1_1,102,3
chr6-4734197_4734299,HML5_repbase_HERVK22I_LTR22,0.666666666666667,2,4734255,4734247,cPa419_HML5_repbase_HERVK22I_LTR22,1_2,102,8
chr6-4747914_4748104,cPa199,1,1,4748052,4747964,cPa199,3,190,88
chr6-4773610_4773712,cPa542,0.5,3,4773660,4773648,cPa273-cPa199-hybrid_cPa542_cPa553,1_2_1,102,12
chr6-4779801_4779903,cPa62,0.8,2,4779856,4779822,cPa62_cPa62-unknown,4_1,102,34
chr6-4780651_4780753,cPa62,0.875,2,4780708,4780680,cPa228_cPa62,1_7,102,28
chr6-485412_485664,cPa34,0.441176470588235,7,485661,485417,cPa121_cPa183_cPa183-cPa121-hybrid_cPa183-cPa188-hybrid_cPa188_cPa34_cPa500,6_3_1_1_23_30_4,252,244
chr6-486498_486715,cPa34,0.335483870967742,11,486693,486504,cPa121_cPa121-cPa188-hybrid_cPa121-cPa500-hybrid_cPa183_cPa183-cPa188-hybrid_cPa188_cPa34_cPa34-cPa183-hybrid_cPa358_cPa500_cPa500-cPa345-hybrid,43_2_1_15_6_28_52_1_1_5_1,217,189
chr6-486813_486966,cPa188,0.545454545454545,7,486914,486822,cPa121-unknown_cPa183-cPa188-hybrid_cPa183-HFV_NC001736-hybrid_cPa188_cPa34_cPa500_cPa500-unknown,1_1_1_12_5_1_1,153,92
chr6-5061221_5061323,cPa15,1,1,5061274,5061271,cPa15,2,102,3
chr6-5236378_5236480,cPa254_cPa425_cPa47,0.333333333333333,3,5236428,5236428,cPa254_cPa425_cPa47,1_1_1,102,0
chr6-5366059_5366161,cPa444-unknown,1,1,5366109,5366109,cPa444-unknown,1,102,0
chr6-5366277_5366387,cPa444-cPa447-hybrid,0.224719101123595,11,5366382,5366303,cPa339_cPa339-cPa390-hybrid_cPa339-cPa447-hybrid_cPa353-cPa339-hybrid_cPa353-cPa447-hybrid_cPa444-cPa339-hybrid_cPa444-cPa390-hybrid_cPa444-cPa447-hybrid_cPa444-cPa62-hybrid_cPa444-unknown_cPa447,28_6_6_3_7_15_19_40_5_14_35,110,79
chr6-5475130_5475232,cPa360,0.390287769784173,10,5475211,5475130,cPa163_cPa163-unknown_cPa224_cPa229-cPa224-hybrid_cPa360_cPa419_cPa425_cPa425-cPa224-hybrid_cPa447-cPa224-hybrid_cPa74-cPa224-hybrid,170_1_159_1_217_4_1_1_1_1,102,81
chr6-592218_592320,cPa118_cPa15,0.5,2,592268,592268,cPa118_cPa15,1_1,102,0
chr6-652124_652226,cPa260,0.625,2,652193,652147,cPa260_cPa75-unknown,5_3,102,46
chr6-6572524_6572626,cPa447,0.391812865497076,9,6572593,6572531,cPa339_cPa390_cPa390-cPa339-hybrid_cPa390-cPa447-hybrid_cPa390-cPa62-hybrid_cPa447_cPa62_cPa62-cPa339-hybrid_cPa62-cPa447-hybrid,29_30_3_2_3_67_34_2_1,102,62
chr6-6599165_6599279,cPa118_cPa15,0.5,2,6599227,6599215,cPa118_cPa15,1_1,114,12
chr6-69045_69147,cPa273,0.666666666666667,2,69102,69058,cPa227_cPa273,1_2,102,44
chr6-69617_69816,cPa273,0.3,7,69812,69631,cPa168_cPa273_cPa357_cPa450-cPa15-hybrid_cPa469_cPa475_GaLV_M26927-cPa15-hybrid,2_3_1_1_1_1_1,199,181
chr6-7815158_7815284,cPa285,1,1,7815232,7815208,cPa285,2,126,24
chr6-7826035_7826137,cPa419_cPa552-cPa255-hybrid_cPa552-unknown,0.333333333333333,3,7826113,7826085,cPa419_cPa552-cPa255-hybrid_cPa552-unknown,1_1_1,102,28
chr6-8001003_8001105,cPa62,0.952380952380952,3,8001086,8001019,cPa254-cPa62-hybrid_cPa62_cPa62-unknown,1_40_1,102,67
chr6-8051106_8051208,cPa62,1,1,8051163,8051156,cPa62,2,102,7
chr6-8338194_8338296,cPa174-cPa47-hybrid,1,1,8338244,8338244,cPa174-cPa47-hybrid,1,102,0
chr6-8447325_8447427,HML5_repbase_HERVK22I_LTR22,1,1,8447375,8447375,HML5_repbase_HERVK22I_LTR22,1,102,0
chr6-8588081_8588183,cPa62,1,1,8588131,8588131,cPa62,1,102,0
chr7-10062570_10062672,cPa62,0.96969696969697,2,10062667,10062590,cPa62_cPa62-unknown,32_1,102,77
chr7-1036082_1036184,cPa118_cPa15_cPa443,0.333333333333333,3,1036132,1036121,cPa118_cPa15_cPa443,1_1_1,102,11
chr7-10620527_10620636,cPa450,0.465648854961832,24,10620633,10620526,cPa199_cPa227_cPa227-cPa345-hybrid_cPa227-cPa553-hybrid_cPa273-cPa199-hybrid_cPa273-cPa223-hybrid_cPa273-cPa345-hybrid_cPa273-cPa482-hybrid_cPa273-cPa553-hybrid_cPa450_cPa450-cPa199-hybrid_cPa450-cPa223-hybrid_cPa450-cPa482-hybrid_cPa450-cPa553-hybrid_cPa542-cPa199-hybrid_cPa542-cPa223-hybrid_cPa542-cPa345-hybrid_cPa542-unknown_cPa553_cPa553-cPa199-hybrid_cPa553-cPa223-hybrid_cPa553-cPa227-hybrid_cPa553-cPa482-hybrid_cPa553-unknown,2_2_1_1_2_1_1_1_1_61_2_3_4_1_3_2_1_1_18_5_6_1_9_2,109,107
chr7-10626902_10627013,cPa118-cPa15-hybrid_cPa118-unknown_cPa15_cPa268_cPa419,0.2,5,10626962,10626952,cPa118-cPa15-hybrid_cPa118-unknown_cPa15_cPa268_cPa419,1_1_1_1_1,111,10
chr7-111067_111215,cPa75,0.357142857142857,6,111174,111117,cPa113-cPa260-hybrid_cPa293-cPa260-hybrid_cPa62-cPa260-hybrid_cPa62-cPa75-hybrid_cPa62-unknown_cPa75,1_1_3_3_1_5,148,57
chr7-111250_111375,cPa75,0.422222222222222,9,111331,111252,cPa260_cPa62_cPa62-cPa260-hybrid_cPa62-cPa293-hybrid_cPa62-cPa75-hybrid_cPa62-unknown_cPa75_cPa75-cPa260-hybrid_cPa75-unknown,1_5_21_4_4_13_38_3_1,125,79
chr7-111409_111511,cPa75,0.4,4,111492,111445,cPa113_cPa260_cPa62-cPa75-hybrid_cPa75,1_1_1_2,102,47
chr7-11141280_11141382,cPa131,0.588235294117647,4,11141359,11141295,cPa131_cPa131-cPa479-hybrid_cPa255_cPa255-cPa479-hybrid,10_1_2_4,102,64
chr7-11368046_11368159,cPa452,0.375,4,11368107,11368091,cPa176-unknown_cPa363_cPa452_cPa71,1_2_3_2,113,16
chr7-11389375_11389477,cPa363,0.333333333333333,5,11389426,11389414,cPa363_cPa456_cPa456-cPa452-hybrid_cPa587-cPa117-hybrid_cPa587-cPa452-hybrid,2_1_1_1_1,102,12
chr7-1146848_1146950,cPa285,0.666666666666667,2,1146905,1146893,cPa285_cPa285-unknown,2_1,102,12
chr7-1146960_1147090,cPa285_cPa285-unknown_cPa293,0.333333333333333,3,1147038,1147010,cPa285_cPa285-unknown_cPa293,1_1_1,130,28
chr7-1147093_1147195,cPa293_cPa62-unknown,0.5,2,1147143,1147143,cPa293_cPa62-unknown,1_1,102,0
chr7-11486487_11486589,cPa118,1,1,11486537,11486537,cPa118,1,102,0
chr7-1162910_1163012,cPa260,1,1,1162960,1162920,cPa260,5,102,40
chr7-1188435_1188537,cPa62,1,1,1188485,1188452,cPa62,3,102,33
chr7-1188555_1189578,cPa62,0.707547169811321,9,1189526,1188597,cPa285_cPa62_cPa62-cPa285-hybrid_cPa62-cPa293-hybrid_cPa62-cPa75-hybrid_cPa62-unknown_cPa75_cPa75-cPa285-hybrid_cPa75-unknown,4_75_3_1_2_6_12_2_1,1023,929
chr7-12243079_12243181,cPa391,0.72,6,12243175,12243081,cPa182_cPa182-cPa111-hybrid_cPa182-unknown_cPa391_cPa404-cPa273-hybrid_cPa450-cPa308-hybrid,3_1_1_18_1_1,102,94
chr7-12243526_12243628,cPa391,0.384615384615385,7,12243627,12243525,cPa16-cPa308-hybrid_cPa182_cPa379-cPa308-hybrid_cPa391_cPa404-cPa308-hybrid_cPa446-cPa308-hybrid_RELIK_ERVK-cPa308-hybrid,1_7_2_10_3_2_1,102,102
chr7-1278168_1278270,cPa62,1,1,1278227,1278199,cPa62,11,102,28
chr7-14230770_14230872,cPa260,1,1,14230820,14230820,cPa260,1,102,0
chr7-1426013_1426115,cPa15,1,1,1426063,1426063,cPa15,1,102,0
chr7-14298157_14298392,cPa475-cPa323-hybrid,0.8,2,14298340,14298207,cPa475-cPa323-hybrid_cPa475-cPa62-hybrid,4_1,235,133
chr7-14298407_14298509,cPa475-cPa323-hybrid,1,1,14298457,14298457,cPa475-cPa323-hybrid,1,102,0
chr7-14298524_14298829,cPa475-cPa323-hybrid,0.969230769230769,3,14298777,14298574,cPa285-cPa323-hybrid_cPa419_cPa475-cPa323-hybrid,1_1_63,305,203
chr7-14298971_14299073,cPa475-cPa323-hybrid,1,1,14299021,14299021,cPa475-cPa323-hybrid,1,102,0
chr7-1452287_1452400,cPa62,0.952380952380952,2,1452349,1452287,cPa285-cPa62-hybrid_cPa62,1_20,113,62
chr7-14773733_14773835,cPa118,0.333333333333333,6,14773788,14773777,cPa118_cPa125-cPa15-hybrid_cPa15_cPa248-cPa118-hybrid_cPa248-cPa15-hybrid_cPa248-unknown,3_1_2_1_1_1,102,11
chr7-1480355_1480465,cPa285,0.625,4,1480413,1480396,cPa285_cPa285-cPa62-hybrid_cPa293_cPa62-unknown,5_1_1_1,110,17
chr7-1510238_1510340,cPa60,1,1,1510288,1510288,cPa60,1,102,0
chr7-1518828_1518930,cPa106-unknown_cPa419,0.5,2,1518886,1518878,cPa106-unknown_cPa419,1_1,102,8
chr7-1520803_1521011,cPa308,1,1,1520959,1520823,cPa308,44,208,136
chr7-1521167_1521364,cPa308,1,1,1521312,1521214,cPa308,8,197,98
chr7-1521540_1521812,cPa308_cPa387,0.285714285714286,6,1521763,1521590,cPa308_cPa308-cPa387-hybrid_cPa308-cPa563-hybrid_cPa387_cPa419_cPa419-cPa379-hybrid,4_1_1_4_3_1,272,173
chr7-1521836_1521938,cPa387,0.666666666666667,2,1521929,1521858,cPa163-cPa387-hybrid_cPa387,1_2,102,71
chr7-1524704_1524844,cPa133-cPa356-hybrid_cPa419,0.333333333333333,5,1524806,1524735,cPa119-cPa391-hybrid_cPa133_cPa133-cPa119-hybrid_cPa133-cPa356-hybrid_cPa419,1_1_1_3_3,140,71
chr7-1532496_1532598,cPa356_cPa428,0.5,2,1532597,1532546,cPa356_cPa428,1_1,102,51
chr7-1537337_1537439,cPa308,1,1,1537387,1537354,cPa308,2,102,33
chr7-1537719_1537863,cPa308-cPa75-hybrid,1,1,1537863,1537769,cPa308-cPa75-hybrid,9,144,94
chr7-1542418_1542520,cPa363,0.666666666666667,2,1542481,1542425,cPa363_cPa472-cPa363-hybrid,2_1,102,56
chr7-1542567_1542686,cPa363,0.75,2,1542634,1542577,cPa308_cPa363,1_3,119,57
chr7-1543693_1543795,cPa308,1,1,1543743,1543743,cPa308,1,102,0
chr7-1559823_1559963,PERVE_NC003059-cPa199-hybrid,1,1,1559949,1559873,PERVE_NC003059-cPa199-hybrid,3,140,76
chr7-15974576_15974678,cPa478,0.789473684210526,4,15974640,15974626,cPa419_cPa419-cPa582-hybrid_cPa478_cPa582,1_1_15_2,102,14
chr7-16221561_16221801,cPa75,0.633333333333333,7,16221767,16221600,cPa419_cPa62_cPa75_HERV-W_repbase_HERV17_LTR17_HERV-W_repbase_HERV17_LTR17-cPa62-hybrid_HERV-W_repbase_HERV17_LTR17-cPa75-hybrid_HERV-W_repbase_HERV17_LTR17-unknown,1_1_19_1_2_3_3,240,167
chr7-16221847_16222215,cPa75,0.769230769230769,4,16222163,16221897,cPa71-cPa542-hybrid_cPa75_HERV-W_repbase_HERV17_LTR17-cPa62-hybrid_HERV-W_repbase_HERV17_LTR17-cPa75-hybrid,1_10_1_1,368,266
chr7-1637107_1637209,cPa62,0.92,2,1637170,1637131,cPa285-cPa62-hybrid_cPa62,2_23,102,39
chr7-16644727_16644841,cPa450,0.384615384615385,8,16644794,16644750,cPa199_cPa273-cPa199-hybrid_cPa450_cPa450-cPa199-hybrid_cPa542-cPa223-hybrid_cPa553_cPa553-cPa223-hybrid_cPa553-unknown,2_1_5_1_1_1_1_1,114,44
chr7-17371510_17371612,cPa75,1,1,17371560,17371560,cPa75,1,102,0
chr7-17490369_17490480,cPa75-unknown,0.857142857142857,2,17490466,17490408,cPa75-cPa482-hybrid_cPa75-unknown,1_6,111,58
chr7-17490518_17490754,cPa75-unknown,1,1,17490702,17490568,cPa75-unknown,11,236,134
chr7-19068804_19068915,cPa118_cPa15_cPa443,0.333333333333333,3,19068863,19068854,cPa118_cPa15_cPa443,1_1_1,111,9
chr7-19130043_19130148,cPa15,0.5,3,19130108,19130082,cPa118_cPa15_cPa443-cPa118-hybrid,3_4_1,105,26
chr7-19265860_19265962,cPa62,0.5,3,19265955,19265867,cPa285-unknown_cPa293_cPa62,1_1_2,102,88
chr7-2025717_2025819,cPa62,0.931034482758621,2,2025801,2025717,cPa62_cPa62-unknown,27_2,102,84
chr7-2046875_2046977,cPa482,0.309090909090909,7,2046965,2046892,cPa199-cPa413-hybrid_cPa199-HTLV1_NC001436-hybrid_cPa273-cPa413-hybrid_cPa482_cPa482-cPa413-hybrid_cPa482-unknown_HTLV1_NC001436-cPa413-hybrid,11_1_1_17_9_10_6,102,73
chr7-20574907_20575009,cPa529,1,1,20574965,20574957,cPa529,2,102,8
chr7-20958456_20958570,HERV-W_repbase_HERV17_LTR17,0.793103448275862,7,20958556,20958468,cPa62_cPa62-cPa75-hybrid_cPa62-HERV-W_repbase_HERV17_LTR17-hybrid_cPa75_cPa75-unknown_HERV-W_repbase_HERV17_LTR17_S71_repbase_HERVS71_LTR6A,1_1_1_1_1_23_1,114,88
chr7-21495685_21495799,cPa62,0.96,2,21495748,21495731,cPa62_cPa62-unknown,48_2,114,17
chr7-21564237_21564450,cPa75-cPa62-hybrid,0.423728813559322,5,21564449,21564238,cPa62_cPa75_cPa75-cPa62-hybrid_cPa75-unknown_KWERV_GQ222416,7_22_25_4_1,213,211
chr7-21656656_21656758,cPa583,0.578947368421053,4,21656745,21656673,cPa251_cPa358_cPa358-unknown_cPa583,1_5_2_11,102,72
chr7-21778685_21778787,cPa62,0.923076923076923,3,21778735,21778721,cPa254_cPa254-unknown_cPa62,1_1_24,102,14
chr7-2220542_2220778,cPa482,0.526315789473684,6,2220750,2220592,cPa227_cPa450_cPa450-cPa345-hybrid_cPa482_cPa482-cPa227-hybrid_cPa482-cPa345-hybrid,1_5_1_10_1_1,236,158
chr7-2247883_2248000,cPa75,0.727272727272727,4,2247948,2247890,CAEV_NC001463-cPa75-hybrid_cPa260-cPa75-hybrid_cPa75_HERV-W_repbase_HERV17_LTR17-cPa543-hybrid,1_1_8_1,117,58
chr7-2248037_2248159,cPa75,0.625,3,2248154,2248087,cPa260-cPa75-hybrid_cPa572_cPa75,2_1_5,122,67
chr7-2265684_2265786,cPa381,0.363636363636364,7,2265783,2265703,cPa268_cPa268-cPa353-hybrid_cPa308-cPa381-hybrid_cPa381_cPa419_cPa486_cPa486-cPa287-hybrid,2_1_1_4_1_1_1,102,80
chr7-2298889_2299047,cPa62,0.793103448275862,5,2298996,2298900,cPa285-cPa62-hybrid_cPa293_cPa62_cPa62-cPa75-hybrid_cPa75,1_1_23_1_3,158,96
chr7-2299056_2299284,cPa62,0.828571428571429,4,2299232,2299106,cPa285-cPa62-hybrid_cPa62_cPa62-cPa75-hybrid_cPa75,1_29_1_4,228,126
chr7-2299669_2299949,cPa62,0.791666666666667,4,2299897,2299686,cPa285_cPa62_cPa62-cPa293-hybrid_cPa75,1_38_1_8,280,211
chr7-2300394_2300496,cPa62,1,1,2300465,2300442,cPa62,3,102,23
chr7-23071586_23071774,cPa75-unknown,1,1,23071767,23071636,cPa75-unknown,8,188,131
chr7-23399512_23399614,cPa62,1,1,23399562,23399562,cPa62,1,102,0
chr7-2351081_2351183,cPa308,1,1,2351131,2351131,cPa308,1,102,0
chr7-238328_238453,cPa62,0.449275362318841,9,238448,238341,cPa285_cPa62_cPa62-cPa201-hybrid_cPa62-cPa285-hybrid_cPa62-cPa75-hybrid_cPa62-unknown_cPa71-cPa285-hybrid_cPa75_PERVA_AY099323,7_31_1_17_3_2_1_6_1,125,107
chr7-24298734_24298836,cPa118_cPa15,0.5,2,24298799,24298784,cPa118_cPa15,2_2,102,15
chr7-245210_245312,cPa419,1,1,245260,245260,cPa419,1,102,0
chr7-24667996_24668098,cPa62,1,1,24668057,24668021,cPa62,48,102,36
chr7-24706100_24706202,cPa293_cPa387-cPa75-hybrid,0.5,2,24706180,24706150,cPa293_cPa387-cPa75-hybrid,1_1,102,30
chr7-25251162_25251264,cPa62,1,1,25251222,25251200,cPa62,14,102,22
chr7-26336108_26336210,cPa15,0.583333333333333,6,26336158,26336147,cPa118_cPa118-cPa15-hybrid_cPa118-cPa268-hybrid_cPa118-unknown_cPa15_cPa268,1_1_1_1_7_1,102,11
chr7-26515795_26516009,HERV-W_repbase_HERV17_LTR17,0.6,3,26516008,26515807,HERV-W_repbase_HERV17_LTR17_HERV-W_repbase_HERV17_LTR17-cPa75-hybrid_HERV-W_repbase_HERV17_LTR17-unknown,9_1_5,214,201
chr7-26516022_26516244,HERV-W_repbase_HERV17_LTR17,0.666666666666667,7,26516239,26516054,cPa572_cPa62-cPa75-hybrid_cPa62-HERV-W_repbase_HERV17_LTR17-hybrid_cPa62-unknown_cPa75_HERV-W_repbase_HERV17_LTR17_HERV-W_repbase_HERV17_LTR17-unknown,1_2_1_2_3_36_9,222,185
chr7-26742279_26742381,cPa456,0.416666666666667,6,26742355,26742302,cPa363_cPa363-BLV_NC001414-hybrid_cPa419_cPa452_cPa456_cPa75,1_3_1_1_5_1,102,53
chr7-27111919_27112053,cPa62,0.666666666666667,5,27112029,27111969,cPa62_cPa75-cPa62-hybrid_FeFV_NC001871-cPa62-hybrid_FeFV_NC001871-cPa75-hybrid_FeFV_NC001871-unknown,8_1_1_1_1,134,60
chr7-27739989_27740120,cPa62,0.9,2,27740113,27740032,cPa254_cPa62,1_9,131,81
chr7-27777133_27777334,cPa62,0.708333333333333,6,27777304,27777169,cPa62_cPa62-cPa254-hybrid_cPa62-cPa290-hybrid_cPa62-cPa75-hybrid_cPa62-unknown_cPa75,34_4_1_4_2_3,201,135
chr7-2825277_2825412,cPa75,0.619047619047619,8,2825401,2825280,cPa260-cPa75-hybrid_cPa260-unknown_cPa293_cPa293-unknown_cPa363_cPa363-cPa75-hybrid_cPa62-cPa75-hybrid_cPa75,1_1_2_1_1_1_1_13,135,121
chr7-283940_284042,cPa529-cPa75-hybrid_cPa75,0.5,2,284036,283990,cPa529-cPa75-hybrid_cPa75,1_1,102,46
chr7-285119_285236,cPa402,0.423076923076923,7,285232,285128,cPa293-cPa224-hybrid_cPa395_cPa402_cPa402-cPa395-hybrid_cPa402-unknown_cPa75_WDSV_NC001867-unknown,1_1_11_1_3_7_2,117,104
chr7-285272_285374,cPa75,1,1,285330,285320,cPa75,6,102,10
chr7-28696967_28697069,cPa62,0.75,2,28697021,28697013,cPa285_cPa62,2_6,102,8
chr7-28931097_28931199,cPa452,0.428571428571429,6,28931195,28931112,cPa157-cPa223-hybrid_cPa16-cPa363-hybrid_cPa363_cPa363-unknown_cPa452_cPa71,1_1_11_1_15_6,102,83
chr7-28994295_28994397,cPa363,0.466666666666667,3,28994345,28994308,cPa363_cPa363-cPa452-hybrid_cPa456,7_2_6,102,37
chr7-2906565_2906738,HERV-W_repbase_HERV17_LTR17,0.666666666666667,2,2906686,2906615,cPa75-PERV_AJ293656-hybrid_HERV-W_repbase_HERV17_LTR17,1_2,173,71
chr7-2906764_2906866,cPa75,1,1,2906814,2906814,cPa75,1,102,0
chr7-29361749_29361851,cPa62,1,1,29361815,29361799,cPa62,13,102,16
chr7-29362086_29362341,cPa62,0.666666666666667,2,29362289,29362136,cPa62_cPa62-cPa75-hybrid,4_2,255,153
chr7-29558242_29558344,cPa62-unknown,1,1,29558292,29558292,cPa62-unknown,1,102,0
chr7-29632464_29632566,cPa293_cPa391_cPa426-unknown,0.333333333333333,3,29632514,29632514,cPa293_cPa391_cPa426-unknown,1_1_1,102,0
chr7-29881280_29881382,cPa62,1,1,29881333,29881325,cPa62,10,102,8
chr7-29940733_29940835,cPa419,1,1,29940783,29940783,cPa419,1,102,0
chr7-29980750_29980861,cPa75_cPa75-cPa450-hybrid_cPa75-unknown,0.333333333333333,3,29980809,29980800,cPa75_cPa75-cPa450-hybrid_cPa75-unknown,1_1_1,111,9
chr7-29980926_29981075,cPa75-cPa472-hybrid,0.454545454545455,3,29981044,29980948,cPa75_cPa75-cPa472-hybrid_cPa75-unknown,2_5_4,149,96
chr7-29981118_29981227,cPa75-cPa273-hybrid,0.333333333333333,5,29981204,29981143,cPa75-cPa273-hybrid_cPa75-cPa450-hybrid_cPa75-cPa472-hybrid_cPa75-cPa542-hybrid_cPa75-unknown,2_1_1_1_1,109,61
chr7-29981685_29981787,cPa75-cPa273-hybrid,0.666666666666667,2,29981735,29981700,cPa75-cPa273-hybrid_cPa75-cPa553-hybrid,2_1,102,35
chr7-29982429_29982616,cPa450,0.392857142857143,10,29982576,29982465,cPa199_cPa199-cPa472-hybrid_cPa223-cPa273-hybrid_cPa223-cPa542-hybrid_cPa227_cPa345-cPa273-hybrid_cPa450_cPa553_cPa75-cPa273-hybrid_cPa75-cPa450-hybrid,1_1_5_1_1_1_11_3_3_1,187,111
chr7-300506_300622,STLV2_NC001815-unknown,0.714285714285714,5,300572,300539,cPa333-cPa254-hybrid_cPa531-cPa413-hybrid_STLV2_NC001815_STLV2_NC001815-cPa413-hybrid_STLV2_NC001815-unknown,1_1_1_1_10,116,33
chr7-30054512_30054630,cPa220-cPa190-hybrid,0.21875,10,30054604,30054531,cPa104_cPa104-cPa190-hybrid_cPa18-cPa104-hybrid_cPa18-unknown_cPa190_cPa219_cPa220_cPa220-cPa104-hybrid_cPa220-cPa190-hybrid_cPa220-unknown,6_2_2_1_4_2_4_3_7_1,118,73
chr7-30128010_30128112,cPa62-cPa75-hybrid_cPa75,0.5,2,30128095,30128040,cPa62-cPa75-hybrid_cPa75,2_2,102,55
chr7-30128266_30128457,cPa62-cPa75-hybrid_cPa75,0.388888888888889,4,30128426,30128293,cPa113-cPa75-hybrid_cPa62-cPa75-hybrid_cPa62-unknown_cPa75,1_7_3_7,191,133
chr7-30542719_30542821,cPa15,0.666666666666667,2,30542769,30542768,cPa118_cPa15,1_2,102,1
chr7-30577618_30577720,cPa419,1,1,30577668,30577668,cPa419,1,102,0
chr7-30578317_30578433,cPa62,0.955555555555556,3,30578389,30578355,cPa419_cPa62_cPa62-unknown,1_43_1,116,34
chr7-31004475_31004577,cPa62,1,1,31004531,31004525,cPa62,4,102,6
chr7-315939_316108,cPa125,0.48936170212766,23,316056,315989,cPa118_cPa118-cPa125-hybrid_cPa118-cPa15-hybrid_cPa118-cPa254-hybrid_cPa118-cPa264-hybrid_cPa118-cPa268-hybrid_cPa118-cPa47-hybrid_cPa118-unknown_cPa125_cPa125-cPa254-hybrid_cPa125-unknown_cPa140_cPa140-cPa264-hybrid_cPa140-cPa308-hybrid_cPa140-unknown_cPa15_cPa15-cPa125-hybrid_cPa15-cPa174-hybrid_cPa15-cPa308-hybrid_cPa15-unknown_cPa174_cPa174-cPa254-hybrid_cPa268,5_1_1_2_2_2_1_7_46_1_2_1_1_1_3_5_1_1_2_2_4_1_2,169,67
chr7-316226_316433,cPa125,0.625,4,316381,316276,cPa125_cPa125-cPa268-hybrid_cPa15_cPa15-unknown,5_1_1_1,207,105
chr7-318136_318238,cPa308,1,1,318186,318186,cPa308,1,102,0
chr7-31976442_31976664,cPa75,0.560975609756098,5,31976624,31976449,cPa62_cPa62-cPa75-hybrid_cPa62-unknown_cPa75_HERV-W_repbase_HERV17_LTR17-cPa75-hybrid,1_13_3_23_1,222,175
chr7-31976673_31977002,cPa75,0.458333333333333,4,31976964,31976723,cPa62-cPa293-hybrid_cPa62-cPa75-hybrid_cPa62-unknown_cPa75,1_21_17_33,329,241
chr7-31977016_31977143,cPa75,0.571428571428571,4,31977135,31977062,cPa62_cPa62-cPa75-hybrid_cPa62-unknown_cPa75,1_1_1_4,127,73
chr7-32405572_32405681,cPa391,0.5,4,32405635,32405610,cPa293_cPa391_cPa426-cPa293-hybrid_cPa426-unknown,1_3_1_1,109,25
chr7-32432935_32433037,cPa75_HERV-W_repbase_HERV17_LTR17,0.5,2,32432985,32432983,cPa75_HERV-W_repbase_HERV17_LTR17,1_1,102,2
chr7-32504475_32504585,cPa117-cPa587-hybrid_cPa363_cPa452-cPa587-hybrid_cPa456,0.25,4,32504533,32504525,cPa117-cPa587-hybrid_cPa363_cPa452-cPa587-hybrid_cPa456,1_1_1_1,110,8
chr7-32703296_32703398,cPa62,0.96,2,32703348,32703320,cPa285_cPa62,1_24,102,28
chr7-32899118_32899220,cPa260,0.75,2,32899178,32899135,cPa260_cPa363-cPa566-hybrid,3_1,102,43
chr7-32963064_32963166,cPa363,0.484848484848485,8,32963164,32963096,cPa117-cPa363-hybrid_cPa117-cPa456-hybrid_cPa117-cPa587-hybrid_cPa117-cPa75-hybrid_cPa117-REV_NC006934-hybrid_cPa363_cPa363-cPa456-hybrid_cPa456,1_2_1_2_2_16_1_8,102,68
chr7-33010752_33010854,cPa260_cPa260-cPa75-hybrid_cPa260-HERV-W_repbase_HERV17_LTR17-hybrid,0.333333333333333,3,33010830,33010802,cPa260_cPa260-cPa75-hybrid_cPa260-HERV-W_repbase_HERV17_LTR17-hybrid,1_1_1,102,28
chr7-33053751_33053853,cPa62,0.9,4,33053819,33053774,cPa285-cPa62-hybrid_cPa285-unknown_cPa62_cPa62-cPa425-hybrid,2_1_36_1,102,45
chr7-33183750_33183852,cPa62,0.956521739130435,3,33183819,33183794,cPa254_cPa62_HERV30_repbase_HERV30I_LTR30-cPa419-hybrid,1_44_1,102,25
chr7-33369390_33369492,cPa62-cPa285-hybrid,1,1,33369440,33369440,cPa62-cPa285-hybrid,1,102,0
chr7-33434611_33434713,cPa62,1,1,33434678,33434661,cPa62,10,102,17
chr7-33558096_33558198,cPa363_cPa363-cPa452-hybrid,0.5,2,33558162,33558146,cPa363_cPa363-cPa452-hybrid,1_1,102,16
chr7-33644387_33644489,cPa62,1,1,33644447,33644432,cPa62,8,102,15
chr7-33761407_33761520,cPa273-cPa199-hybrid,0.375,4,33761468,33761435,cPa273-cPa199-hybrid_cPa450_cPa542_cPa553,3_2_2_1,113,33
chr7-33804300_33804402,cPa285_cPa62,0.5,2,33804350,33804350,cPa285_cPa62,1_1,102,0
chr7-34033822_34033924,cPa62,0.931818181818182,3,34033890,34033832,cPa419_cPa62_cPa62-unknown,1_41_2,102,58
chr7-34288673_34288809,cPa62,1,1,34288791,34288700,cPa62,50,136,91
chr7-34289247_34289356,cPa62,1,1,34289313,34289295,cPa62,11,109,18
chr7-34412159_34412261,cPa62,0.888888888888889,4,34412221,34412200,cPa345-cPa62-hybrid_cPa345-unknown_cPa62_cPa62-unknown,1_1_24_1,102,21
chr7-34483595_34483697,cPa260,0.909090909090909,2,34483681,34483644,cPa260_cPa260-unknown,10_1,102,37
chr7-34658937_34659039,cPa62_cPa62-cPa75-hybrid,0.5,2,34659010,34658987,cPa62_cPa62-cPa75-hybrid,1_1,102,23
chr7-34724653_34724755,cPa62,1,1,34724703,34724685,cPa62,2,102,18
chr7-3488237_3488420,HERV-W_repbase_HERV17_LTR17,0.888888888888889,3,3488400,3488264,cPa62-HERV-W_repbase_HERV17_LTR17-hybrid_HERV-F_repbase_HERVFH19I_LTR19A_HERV-W_repbase_HERV17_LTR17,1_1_16,183,136
chr7-34893225_34893327,cPa62,0.9,2,34893282,34893265,cPa285-cPa62-hybrid_cPa62,1_9,102,17
chr7-35099678_35099780,cPa62,1,1,35099728,35099728,cPa62,1,102,0
chr7-35099937_35100076,cPa62,1,1,35100045,35099987,cPa62,11,139,58
chr7-35157807_35157909,cPa62,1,1,35157866,35157857,cPa62,2,102,9
chr7-35253491_35253593,cPa223,0.545454545454545,4,35253583,35253517,cPa199_cPa199-cPa223-hybrid_cPa223_cPa553,3_1_6_1,102,66
chr7-35501173_35501678,cPa566,0.5,6,35501626,35501223,cPa15-cPa539-hybrid_cPa434_cPa434-unknown_cPa566_cPa566-cPa539-hybrid_cPa566-unknown,1_5_1_24_2_15,505,403
chr7-35523844_35523946,cPa566,1,1,35523927,35523882,cPa566,2,102,45
chr7-35524107_35524209,cPa566,1,1,35524157,35524107,cPa566,3,102,50
chr7-35703253_35703378,cPa260_cPa260-unknown,0.5,2,35703326,35703303,cPa260_cPa260-unknown,1_1,125,23
chr7-35703393_35703672,cPa260-cPa510-hybrid,0.466666666666667,4,35703620,35703406,cPa260-cPa224-hybrid_cPa260-cPa510-hybrid_cPa260-unknown_cPa363-cPa510-hybrid,3_7_4_1,279,214
chr7-35746191_35746293,cPa260-unknown,0.935483870967742,2,35746292,35746210,cPa260_cPa260-unknown,2_29,102,82
chr7-35764317_35764518,cPa62,0.943661971830986,3,35764477,35764316,cPa285_cPa62_cPa62-unknown,3_67_1,201,161
chr7-35813369_35813471,cPa75,0.5,3,35813419,35813372,cPa572-unknown_cPa75_cPa75-cPa113-hybrid,1_2_1,102,47
chr7-35867662_35867953,cPa566,0.774193548387097,6,35867906,35867674,cPa15_cPa434_cPa434-unknown_cPa566_cPa566-cPa434-hybrid_cPa566-unknown,1_1_1_24_1_3,291,232
chr7-35965132_35965234,cPa75,1,1,35965204,35965182,cPa75,2,102,22
chr7-36159830_36159932,EIAV_NC001450,1,1,36159880,36159880,EIAV_NC001450,1,102,0
chr7-36172467_36172569,cPa62-unknown,0.666666666666667,2,36172532,36172517,cPa62_cPa62-unknown,1_2,102,15
chr7-36180106_36180208,WDSV_NC001867,1,1,36180156,36180156,WDSV_NC001867,1,102,0
chr7-36184010_36184112,WDSV_NC001867,1,1,36184070,36184017,WDSV_NC001867,4,102,53
chr7-36184137_36184239,WDSV_NC001867,1,1,36184187,36184184,WDSV_NC001867,2,102,3
chr7-36199154_36199256,cPa293-unknown_cPa75-cPa419-hybrid,0.5,2,36199235,36199204,cPa293-unknown_cPa75-cPa419-hybrid,1_1,102,31
chr7-36280109_36280211,WDSV_NC001867,0.75,3,36280201,36280141,EIAV_NC001450_WDSV_NC001867_WDSV_NC001867-cPa260-hybrid,1_6_1,102,60
chr7-36294692_36294907,cPa183,0.397590361445783,9,36294892,36294706,cPa183_cPa183-cPa223-hybrid_cPa183-unknown_cPa223_cPa379_cPa424_cPa424-cPa223-hybrid_cPa424-unknown_cPa446,33_1_1_16_2_22_5_1_2,215,186
chr7-36326118_36326220,cPa313-unknown,1,1,36326168,36326168,cPa313-unknown,1,102,0
chr7-36332703_36332808,cPa505,0.590909090909091,5,36332796,36332730,cPa109_cPa482_cPa482-cPa505-hybrid_cPa482-unknown_cPa505,4_12_1_1_26,105,66
chr7-36332811_36332913,cPa505,0.6,4,36332907,36332813,cPa109_cPa482_cPa482-unknown_cPa505,3_6_1_15,102,94
chr7-36333119_36333221,cPa199,0.666666666666667,2,36333169,36333132,cPa199_cPa199-unknown,2_1,102,37
chr7-36336030_36336132,cPa285_cPa62,0.5,2,36336080,36336080,cPa285_cPa62,1_1,102,0
chr7-36350036_36350138,cPa75-unknown,1,1,36350086,36350086,cPa75-unknown,1,102,0
chr7-3636534_3636639,cPa539,0.5,3,3636617,3636552,cPa119_cPa539_SIV_NC001870,1_2_1,105,65
chr7-36501082_36501184,CAEV_NC001463,1,1,36501132,36501132,CAEV_NC001463,1,102,0
chr7-36580939_36581041,cPa339,0.311111111111111,9,36580992,36580945,cPa339_cPa339-cPa444-hybrid_cPa390-cPa444-hybrid_cPa444_cPa447-cPa339-hybrid_cPa447-cPa444-hybrid_cPa447-cPa539-hybrid_cPa539-cPa444-hybrid_cPa62-cPa444-hybrid,14_5_4_1_1_9_2_1_8,102,47
chr7-36581416_36581518,cPa539,0.666666666666667,2,36581512,36581415,cPa339-ENTV_NC004994-hybrid_cPa539,1_2,102,97
chr7-36620306_36620408,cPa313,0.75,2,36620401,36620341,cPa313_cPa449-cPa302-hybrid,3_1,102,60
chr7-36620493_36620616,cPa313,0.92,3,36620612,36620492,cPa229-cPa302-hybrid_cPa313_cPa449,1_23_1,123,120
chr7-36620620_36620722,cPa313,0.875,2,36620705,36620626,cPa229-cPa313-hybrid_cPa313,1_7,102,79
chr7-36620943_36621045,cPa302,0.666666666666667,2,36621029,36620993,cPa302_cPa313-cPa302-hybrid,2_1,102,36
chr7-36626373_36626555,cPa566,0.461538461538462,6,36626550,36626423,cPa260-cPa566-hybrid_cPa434_cPa434-cPa566-hybrid_cPa539_cPa539-cPa260-hybrid_cPa566,2_2_1_1_1_6,182,127
chr7-36661500_36661980,cPa62,0.461538461538462,8,36661940,36661512,cPa293_cPa293-cPa285-hybrid_cPa293-cPa62-hybrid_cPa293-unknown_cPa62_cPa75_cPa75-cPa62-hybrid_cPa75-unknown,5_1_5_6_60_25_8_20,480,428
chr7-36854754_36854856,cPa228,0.8,2,36854804,36854778,cPa228_cPa260,4_1,102,26
chr7-36894188_36894362,cPa260,0.666666666666667,2,36894361,36894233,cPa260_cPa260-unknown,4_2,174,128
chr7-36898927_36899086,cPa566,0.497237569060773,7,36899054,36898935,cPa15_cPa15-cPa434-hybrid_cPa15-unknown_cPa434_cPa434-unknown_cPa566_cPa566-unknown,24_4_12_48_1_90_2,159,119
chr7-36899152_36899254,cPa15,1,1,36899202,36899191,cPa15,2,102,11
chr7-36999028_36999130,cPa260,0.818181818181818,2,36999122,36999077,cPa228_cPa260,2_9,102,45
chr7-37023820_37024033,cPa260,0.84,3,37023989,37023870,cPa260_cPa363_cPa363-cPa62-hybrid,21_3_1,213,119
chr7-37024136_37024510,cPa260,0.659574468085106,7,37024468,37024166,cPa260_cPa260-cPa62-hybrid_cPa260-unknown_cPa363_cPa363-cPa260-hybrid_cPa363-cPa62-hybrid_cPa542,31_3_2_5_1_4_1,374,302
chr7-37025566_37025668,cPa75,0.4,5,37025652,37025592,cPa293-cPa62-hybrid_cPa363-cPa62-hybrid_cPa75_cPa75-cPa62-hybrid_PERV_AJ293656-HERVHcons-hybrid,1_2_4_2_1,102,60
chr7-37025805_37025907,cPa75_cPa75-cPa62-hybrid,0.380952380952381,10,37025904,37025806,cPa293_cPa293-cPa62-hybrid_cPa363-cPa62-hybrid_cPa413-cPa62-hybrid_cPa62_cPa75_cPa75-cPa62-hybrid_cPa75-unknown_PERV_AJ293656-cPa62-hybrid_PERVC_HM159246-cPa62-hybrid,1_2_1_1_1_16_16_2_1_1,102,98
chr7-37060873_37060975,cPa260,1,1,37060923,37060923,cPa260,1,102,0
chr7-37098446_37098663,cPa260,0.8,2,37098611,37098496,cPa260_cPa75-cPa260-hybrid,4_1,217,115
chr7-37098681_37098843,cPa260,0.923076923076923,2,37098842,37098731,cPa260_cPa260-unknown,12_1,162,111
chr7-37160313_37160415,cPa260,0.833333333333333,2,37160384,37160320,cPa228_cPa260,1_5,102,64
chr7-37174344_37174446,cPa75,1,1,37174394,37174394,cPa75,1,102,0
chr7-37174473_37174575,cPa75,1,1,37174523,37174488,cPa75,2,102,35
chr7-37174599_37174836,cPa75,0.857142857142857,2,37174784,37174643,cPa75_cPa75-cPa285-hybrid,12_2,237,141
chr7-37176611_37177209,cPa260,0.522727272727273,8,37177157,37176630,cPa168_cPa168-cPa260-hybrid_cPa168-HERVHcons-hybrid_cPa168-unknown_cPa260_cPa260-cPa223-hybrid_cPa260-unknown_HERVHcons,11_2_1_1_23_1_4_1,598,527
chr7-37198590_37199008,cPa260,0.78125,4,37199001,37198638,cPa168_cPa260_FeLV_NC001940_HERVHcons,4_25_1_2,418,363
chr7-37214534_37214636,cPa450-cPa75-hybrid,1,1,37214584,37214584,cPa450-cPa75-hybrid,1,102,0
chr7-37268909_37269020,cPa539,1,1,37268968,37268959,cPa539,2,111,9
chr7-37328945_37329047,cPa260,1,1,37328995,37328995,cPa260,1,102,0
chr7-37436677_37436779,cPa223,1,1,37436727,37436727,cPa223,1,102,0
chr7-37436896_37437005,cPa223,0.6,3,37436953,37436946,cPa223_cPa345_cPa450,3_1_1,109,7
chr7-37440495_37440804,cPa260,0.571428571428571,3,37440752,37440545,cPa260_cPa260-cPa227-hybrid_cPa357,8_1_5,309,207
chr7-37440855_37440957,cPa260,1,1,37440905,37440905,cPa260,1,102,0
chr7-37444857_37444959,cPa492,0.916666666666667,2,37444940,37444862,cPa419_cPa492,1_11,102,78
chr7-37482451_37482718,cPa260,0.818181818181818,5,37482701,37482481,cPa228_cPa260_cPa260-cPa228-hybrid_cPa260-unknown_cPa543,3_27_1_1_1,267,220
chr7-37482827_37482929,cPa260,1,1,37482877,37482850,cPa260,7,102,27
chr7-37550010_37550144,cPa75-unknown,1,1,37550092,37550060,cPa75-unknown,3,134,32
chr7-37550162_37550266,cPa75-unknown,0.75,2,37550214,37550196,cPa75_cPa75-unknown,1_3,104,18
chr7-37572512_37572634,cPa75-cPa492-hybrid,0.666666666666667,3,37572630,37572513,cPa75_cPa75-cPa492-hybrid_cPa75-unknown,1_6_2,122,117
chr7-37573468_37573646,cPa492,0.866666666666667,2,37573594,37573471,cPa492_cPa75-cPa492-hybrid,13_2,178,123
chr7-37625636_37625753,cPa75,0.6,6,37625716,37625636,cPa62_cPa62-cPa113-hybrid_cPa62-cPa260-hybrid_cPa62-cPa75-hybrid_cPa62-unknown_cPa75,2_2_1_2_1_12,117,80
chr7-37625903_37626051,cPa75,0.493506493506494,11,37626045,37625908,cPa113_cPa113-cPa75-hybrid_cPa62_cPa62-cPa113-hybrid_cPa62-cPa260-hybrid_cPa62-cPa323-hybrid_cPa62-cPa75-hybrid_cPa62-unknown_cPa75_cPa75-cPa260-hybrid_PERVC_HM159246,8_1_9_3_1_1_6_8_38_1_1,148,137
chr7-37636732_37636834,cPa260-unknown,1,1,37636782,37636782,cPa260-unknown,1,102,0
chr7-37877864_37877966,HERV-W_repbase_HERV17_LTR17_HERV-W_repbase_HERV17_LTR17-cPa62-hybrid,0.333333333333333,4,37877939,37877880,HERV-W_repbase_HERV17_LTR17_HERV-W_repbase_HERV17_LTR17-cPa62-hybrid_HERV-W_repbase_HERV17_LTR17-cPa75-hybrid_HERV-W_repbase_HERV17_LTR17-unknown,2_2_1_1,102,59
chr7-38039387_38039489,cPa254,0.285714285714286,13,38039456,38039393,cPa174_cPa174-cPa404-hybrid_cPa174-cPa425-hybrid_cPa174-cPa47-hybrid_cPa254_cPa254-cPa404-hybrid_cPa254-cPa47-hybrid_cPa392-cPa254-hybrid_cPa425_cPa425-cPa404-hybrid_cPa425-cPa47-hybrid_cPa425-unknown_cPa47,3_5_1_4_18_2_2_1_5_4_4_1_13,102,63
chr7-3927393_3927499,cPa333,0.979166666666667,2,3927493,3927428,cPa333_cPa333-unknown,47_1,106,65
chr7-399346_399448,cPa174,0.555555555555556,5,399423,399377,cPa118_cPa125-cPa47-hybrid_cPa174_cPa264-cPa47-hybrid_cPa47,1_1_5_1_1,102,46
chr7-399453_399581,cPa174,0.357142857142857,11,399572,399473,cPa118-cPa264-hybrid_cPa125_cPa125-cPa264-hybrid_cPa174_cPa174-cPa125-hybrid_cPa174-cPa47-hybrid_cPa174-unknown_cPa264_cPa425_cPa426-cPa264-hybrid_cPa47,1_1_1_10_1_1_5_3_2_1_2,128,99
chr7-399607_399809,cPa174_cPa47,0.285714285714286,5,399757,399611,cPa125_cPa15_cPa174_cPa268-cPa47-hybrid_cPa47,1_1_2_1_2,202,146
chr7-4010915_4011094,cPa273,0.471698113207547,5,4011094,4010946,cPa199_cPa228_cPa273_cPa273-unknown_cPa553,1_23_25_1_3,179,148
chr7-4113063_4113165,cPa62-unknown,0.545454545454545,2,4113154,4113076,cPa62_cPa62-unknown,5_6,102,78
chr7-412585_412759,cPa308,0.880597014925373,4,412737,412635,cPa125-cPa75-hybrid_cPa15-cPa75-hybrid_cPa308_cPa308-cPa75-hybrid,6_1_59_1,174,102
chr7-418158_418298,cPa308,1,1,418289,418208,cPa308,20,140,81
chr7-418821_418923,cPa308,1,1,418885,418853,cPa308,10,102,32
chr7-418947_419049,cPa308,1,1,419004,418997,cPa308,3,102,7
chr7-428543_428645,cPa308-cPa353-hybrid,1,1,428593,428593,cPa308-cPa353-hybrid,1,102,0
chr7-433422_433941,cPa308,0.675324675324675,5,433889,433472,cPa308_cPa308-cPa15-hybrid_cPa75-cPa196-hybrid_cPa75-cPa459-hybrid_cPa75-unknown,52_1_2_1_21,519,417
chr7-442451_442553,cPa327-cPa196-hybrid,1,1,442501,442501,cPa327-cPa196-hybrid,1,102,0
chr7-4434346_4434452,cPa404_cPa425_cPa47,0.25,5,4434407,4434395,cPa174_cPa254_cPa404_cPa425_cPa47,1_1_2_2_2,106,12
chr7-446763_447001,cPa127,0.522222222222222,12,446952,446767,cPa127_cPa127-cPa216-hybrid_cPa127-cPa438-hybrid_cPa127-cPa530-hybrid_cPa127-unknown_cPa216_cPa258_cPa308_cPa419_cPa438_cPa530_cPa530-unknown,47_4_1_2_4_3_1_1_1_2_22_2,238,185
chr7-447200_447302,cPa127-unknown,0.625,3,447278,447222,cPa127_cPa127-unknown_cPa419,2_5_1,102,56
chr7-448631_448733,cPa127-cPa413-hybrid_cPa413,0.333333333333333,4,448730,448681,cPa127-cPa413-hybrid_cPa413_cPa413-cPa127-hybrid_cPa413-cPa438-hybrid,2_2_1_1,102,49
chr7-4502373_4502546,cPa255-cPa302-hybrid,0.361702127659574,15,4502527,4502423,cPa131-cPa150-hybrid_cPa131-cPa220-hybrid_cPa150_cPa216-cPa220-hybrid_cPa255-cPa150-hybrid_cPa255-cPa190-hybrid_cPa255-cPa220-hybrid_cPa255-cPa302-hybrid_cPa438-cPa150-hybrid_cPa438-cPa220-hybrid_cPa438-cPa302-hybrid_cPa479_cPa479-cPa150-hybrid_cPa479-cPa220-hybrid_cPa479-cPa302-hybrid,2_3_2_1_4_1_1_17_1_1_6_3_1_1_3,173,104
chr7-466725_466827,HERV-W_repbase_HERV17_LTR17-STLV2_NC001815-hybrid,1,1,466775,466775,HERV-W_repbase_HERV17_LTR17-STLV2_NC001815-hybrid,1,102,0
chr7-4892598_4892700,cPa425,0.375,5,4892698,4892646,cPa174_cPa254_cPa392_cPa425_cPa47,1_1_1_3_2,102,52
chr7-499446_499579,cPa14,0.314606741573034,31,499527,499460,cPa133_cPa133-cPa220-hybrid_cPa133-cPa258-hybrid_cPa133-cPa4-hybrid_cPa14_cPa14-cPa258-hybrid_cPa14-cPa4-hybrid_cPa150_cPa18-cPa133-hybrid_cPa18-cPa247-hybrid_cPa216-cPa219-hybrid_cPa247_cPa4_cPa479-cPa220-hybrid_cPa529_cPa529-cPa133-hybrid_cPa529-cPa190-hybrid_cPa529-cPa219-hybrid_cPa529-cPa258-hybrid_cPa529-cPa4-hybrid_cPa545_cPa545-cPa133-hybrid_cPa545-cPa14-hybrid_cPa545-cPa190-hybrid_cPa545-cPa219-hybrid_cPa545-cPa247-hybrid_cPa545-cPa258-hybrid_cPa545-cPa529-hybrid_cPa95_cPa95-cPa220-hybrid_cPa95-cPa258-hybrid,4_1_1_1_28_3_1_2_1_1_1_3_8_1_2_1_1_1_1_1_7_3_3_1_2_1_2_1_4_1_1,133,67
chr7-499909_500205,cPa14,0.236559139784946,53,500158,499949,cPa133_cPa133-cPa104-hybrid_cPa133-cPa18-hybrid_cPa133-cPa190-hybrid_cPa133-cPa247-hybrid_cPa133-cPa258-hybrid_cPa14_cPa14-cPa133-hybrid_cPa14-cPa190-hybrid_cPa14-cPa219-hybrid_cPa14-cPa220-hybrid_cPa14-cPa247-hybrid_cPa14-cPa258-hybrid_cPa14-cPa4-hybrid_cPa14-cPa541-hybrid_cPa18_cPa18-cPa190-hybrid_cPa18-cPa219-hybrid_cPa18-cPa220-hybrid_cPa18-cPa247-hybrid_cPa18-cPa258-hybrid_cPa190_cPa216-cPa131-hybrid_cPa216-cPa190-hybrid_cPa216-cPa219-hybrid_cPa216-cPa258-hybrid_cPa247_cPa4_cPa479-cPa18-hybrid_cPa479-cPa4-hybrid_cPa529_cPa529-cPa104-hybrid_cPa529-cPa133-hybrid_cPa529-cPa190-hybrid_cPa529-cPa219-hybrid_cPa529-cPa220-hybrid_cPa529-cPa247-hybrid_cPa529-cPa258-hybrid_cPa529-cPa541-hybrid_cPa541_cPa545_cPa545-cPa133-hybrid_cPa545-cPa14-hybrid_cPa545-cPa190-hybrid_cPa545-cPa219-hybrid_cPa545-cPa220-hybrid_cPa545-cPa247-hybrid_cPa545-cPa258-hybrid_cPa545-cPa4-hybrid_cPa545-cPa541-hybrid_cPa95_cPa95-cPa258-hybrid_cPa95-cPa529-hybrid,16_2_1_2_2_3_66_1_1_2_1_2_4_1_1_11_3_1_1_1_1_6_1_1_1_1_12_29_1_1_6_3_2_1_3_2_1_7_1_17_18_3_1_2_2_3_2_6_3_1_15_3_1,296,209
chr7-505308_505410,cPa14-cPa75-hybrid,1,1,505358,505358,cPa14-cPa75-hybrid,1,102,0
chr7-505509_505611,cPa308,1,1,505559,505540,cPa308,1,102,19
chr7-505654_505763,cPa308,1,1,505711,505690,cPa308,8,109,21
chr7-505795_505897,cPa95-cPa75-hybrid,1,1,505845,505845,cPa95-cPa75-hybrid,1,102,0
chr7-505974_506165,cPa308,0.517857142857143,9,506161,505984,cPa14-cPa75-hybrid_cPa163-cPa75-hybrid_cPa308_cPa308-cPa75-hybrid_cPa381-cPa75-hybrid_cPa424-cPa308-hybrid_cPa424-cPa75-hybrid_cPa541-cPa75-hybrid_cPa95-cPa75-hybrid,1_1_29_5_1_1_15_1_2,191,177
chr7-5129611_5129876,cPa62,0.86046511627907,3,5129825,5129631,cPa293-cPa285-hybrid_cPa62_cPa62-unknown,1_37_5,265,194
chr7-5391906_5392267,cPa456,0.526315789473684,4,5392215,5391930,cPa142-cPa456-hybrid_cPa256_cPa256-cPa456-hybrid_cPa456,1_5_3_10,361,285
chr7-5501052_5501240,cPa130_cPa223,0.5,2,5501188,5501102,cPa130_cPa223,1_1,188,86
chr7-564840_564987,cPa308,0.930232558139535,4,564935,564868,cPa308_cPa413-HML1b_repbase_HERV-K14I_LTR14A-hybrid_HERVFc2_repbase-cPa526-hybrid_HERVFc2_repbase-cPa60-hybrid,40_1_1_1,147,67
chr7-565148_565250,cPa308,1,1,565198,565191,cPa308,3,102,7
chr7-573379_573653,cPa308,0.96551724137931,2,573650,573416,cPa308_cPa419,28_1,274,234
chr7-573744_573865,cPa308,0.866666666666667,3,573842,573750,cPa138-cPa308-hybrid_cPa308_cPa308-unknown,1_13_1,121,92
chr7-576338_576440,cPa138,1,1,576388,576388,cPa138,1,102,0
chr7-576541_576643,cPa138,0.5,3,576591,576545,cPa138_cPa138-cPa15-hybrid_cPa138-WDSV_NC001867-hybrid,2_1_1,102,46
chr7-579375_579646,cPa308,0.458333333333333,6,579594,579393,cPa308_cPa308-cPa118-hybrid_cPa308-cPa15-hybrid_cPa75-cPa118-hybrid_cPa75-cPa15-hybrid_cPa75-cPa308-hybrid,11_1_1_2_6_3,271,201
chr7-579826_579928,cPa75-cPa15-hybrid,1,1,579876,579876,cPa75-cPa15-hybrid,1,102,0
chr7-580473_580619,cPa75-cPa15-hybrid,1,1,580567,580523,cPa75-cPa15-hybrid,2,146,44
chr7-581345_581501,cPa15,0.416666666666667,4,581449,581395,cPa118_cPa15_cPa75-cPa118-hybrid_cPa75-cPa15-hybrid,1_5_2_4,156,54
chr7-581528_581630,cPa125_cPa15,0.4,3,581594,581550,cPa125_cPa125-cPa118-hybrid_cPa15,2_1_2,102,44
chr7-581892_581994,cPa140-cPa47-hybrid,1,1,581942,581942,cPa140-cPa47-hybrid,1,102,0
chr7-5820653_5820755,cPa62,1,1,5820706,5820700,cPa62,5,102,6
chr7-582068_582170,cPa140-cPa47-hybrid,1,1,582118,582118,cPa140-cPa47-hybrid,1,102,0
chr7-582275_582377,cPa140-cPa425-hybrid,1,1,582325,582325,cPa140-cPa425-hybrid,1,102,0
chr7-582379_582481,cPa47,1,1,582429,582429,cPa47,1,102,0
chr7-582810_582912,cPa174,1,1,582860,582860,cPa174,1,102,0
chr7-583071_583173,cPa47,1,1,583121,583121,cPa47,1,102,0
chr7-6111183_6111285,cPa15,0.666666666666667,2,6111233,6111232,cPa118_cPa15,1_2,102,1
chr7-6229779_6229881,cPa260,0.5,3,6229858,6229829,cPa260_cPa260-FrMuLV_NC001362-hybrid_cPa469,2_1_1,102,29
chr7-6229966_6230068,cPa469-cPa254-hybrid,1,1,6230016,6230016,cPa469-cPa254-hybrid,1,102,0
chr7-643349_643460,cPa381,0.722222222222222,5,643435,643362,cPa268_cPa353-cPa268-hybrid_cPa353-unknown_cPa381_cPa486,11_2_2_65_10,111,73
chr7-643555_643657,cPa381,0.4,4,643618,643595,cPa268_cPa381_cPa381-unknown_cPa486,1_2_1_1,102,23
chr7-698195_698297,HERV-W_repbase_HERV17_LTR17,0.384615384615385,6,698246,698222,cPa62_cPa62-cPa75-hybrid_cPa62-HERV-W_repbase_HERV17_LTR17-hybrid_cPa75_HERV-W_repbase_HERV17_LTR17_HERV-W_repbase_HERV17_LTR17-cPa75-hybrid,1_1_2_3_5_1,102,24
chr7-698449_698580,cPa75,0.3125,13,698572,698478,cPa15-cPa75-hybrid_cPa194-HERV-F_repbase_HERVFH19I_LTR19A-hybrid_cPa62_cPa62-cPa71-hybrid_cPa62-cPa75-hybrid_cPa62-HERV-W_repbase_HERV17_LTR17-hybrid_cPa62-unknown_cPa67_cPa75_cPa75-KWERV_GQ222416-hybrid_HERV-W_repbase_HERV17_LTR17_HERV-W_repbase_HERV17_LTR17-cPa71-hybrid_HERV-W_repbase_HERV17_LTR17-cPa75-hybrid,1_1_1_1_6_2_2_1_15_1_10_1_6,131,94
chr7-703185_703287,cPa75,0.666666666666667,3,703270,703235,cPa113-unknown_cPa75_PERVC_HM159246-cPa75-hybrid,1_6_2,102,35
chr7-703445_703596,cPa75,0.538461538461538,4,703563,703485,cPa113-unknown_cPa75_cPa75-unknown_PERVC_HM159246-cPa75-hybrid,2_7_3_1,151,78
chr7-724218_724320,cPa75,1,1,724268,724268,cPa75,1,102,0
chr7-724387_724489,cPa75-unknown,1,1,724437,724437,cPa75-unknown,1,102,0
chr7-762424_762526,cPa248-cPa75-hybrid_cPa75,0.4,3,762482,762448,cPa118_cPa248-cPa75-hybrid_cPa75,1_2_2,102,34
chr7-835835_835937,cPa260,0.945945945945946,3,835886,835840,cPa260_cPa260-cPa75-hybrid_cPa260-unknown,35_1_1,102,46
chr7-8411934_8412082,cPa138_cPa260_cPa75-unknown,0.333333333333333,3,8412030,8411984,cPa138_cPa260_cPa75-unknown,1_1_1,148,46
chr7-8528246_8528348,cPa61,0.363636363636364,4,8528303,8528260,cPa205_cPa205-cPa465-hybrid_cPa61_cPa61-cPa465-hybrid,3_3_4_1,102,43
chr7-9106142_9106244,cPa268-cPa452-hybrid,0.164179104477612,36,9106242,9106187,cPa118-cPa117-hybrid_cPa118-cPa254-hybrid_cPa118-cPa402-hybrid_cPa118-cPa452-hybrid_cPa15-cPa254-hybrid_cPa15-cPa452-hybrid_cPa15-REV_NC006934-hybrid_cPa208_cPa208-cPa117-hybrid_cPa254_cPa268-cPa117-hybrid_cPa268-cPa254-hybrid_cPa268-cPa293-hybrid_cPa268-cPa452-hybrid_cPa308-cPa117-hybrid_cPa308-cPa254-hybrid_cPa308-cPa293-hybrid_cPa308-cPa363-hybrid_cPa308-cPa452-hybrid_cPa308-REV_NC006934-hybrid_cPa339-cPa117-hybrid_cPa339-cPa47-hybrid_cPa339-REV_NC006934-hybrid_cPa353-cPa117-hybrid_cPa353-cPa254-hybrid_cPa381-cPa117-hybrid_cPa381-cPa254-hybrid_cPa381-cPa452-hybrid_cPa419_cPa419-cPa392-hybrid_cPa443-cPa254-hybrid_cPa443-cPa452-hybrid_cPa486-cPa117-hybrid_cPa486-cPa254-hybrid_cPa516-cPa174-hybrid_cPa516-cPa452-hybrid,3_3_1_1_2_1_1_2_1_1_1_7_1_11_1_1_1_2_2_2_1_1_1_1_1_1_2_3_2_1_2_2_1_1_1_1,102,55
chr7-9126836_9126948,cPa201-cPa308-hybrid,0.28125,17,9126945,9126886,cPa201_cPa201-cPa268-hybrid_cPa201-cPa308-hybrid_cPa201-cPa339-hybrid_cPa379-cPa353-hybrid_cPa419_cPa419-PtERV1_AC142352-hybrid_cPa428-PtERV1_AC142352-hybrid_cPa62-cPa268-hybrid_cPa62-cPa308-hybrid_cPa62-cPa353-hybrid_cPa62-cPa390-hybrid_cPa62-cPa444-hybrid_cPa62-cPa486-hybrid_HERV30_repbase_HERV30I_LTR30-cPa339-hybrid_VISNA_S55323-cPa308-hybrid_VISNA_S55323-PtERV1_AC142352-hybrid,3_1_9_1_1_3_1_1_1_2_3_1_1_1_1_1_1,112,59
chr7-9218631_9218733,cPa62,0.75,2,9218700,9218677,cPa285_cPa62,1_3,102,23
chr7-9263691_9263793,cPa539,1,1,9263741,9263741,cPa539,2,102,0
chr7-9528851_9528953,cPa62,1,1,9528914,9528898,cPa62,7,102,16
chr8-1012574_1012676,cPa260,0.666666666666667,2,1012624,1012597,cPa260_cPa357,2_1,102,27
chr8-10297370_10297472,cPa16_cPa419,0.5,2,10297420,10297420,cPa16_cPa419,1_1,102,0
chr8-11395520_11395684,HERV-W_repbase_HERV17_LTR17,0.771428571428571,6,11395680,11395527,cPa62_cPa62-cPa75-hybrid_cPa75_cPa75-HERV-W_repbase_HERV17_LTR17-hybrid_HERV-W_repbase_HERV17_LTR17_HERV-W_repbase_HERV17_LTR17-cPa75-hybrid,1_4_9_1_54_1,164,153
chr8-11395820_11396618,HERV-W_repbase_HERV17_LTR17,0.686131386861314,9,11396592,11395870,cPa62_cPa62-cPa293-hybrid_cPa62-cPa75-hybrid_cPa62-HERV-W_repbase_HERV17_LTR17-hybrid_cPa75_cPa75-HERV-W_repbase_HERV17_LTR17-hybrid_HERV-W_repbase_HERV17_LTR17_HERV-W_repbase_HERV17_LTR17-cPa75-hybrid_KoRV_AF151794,2_1_10_4_22_1_94_1_2,798,722
chr8-1172814_1172916,cPa260,0.882352941176471,3,1172915,1172820,cPa228_cPa260_cPa260-unknown,1_15_1,102,95
chr8-12013227_12013329,cPa62,0.909090909090909,2,12013323,12013277,cPa345-unknown_cPa62,1_10,102,46
chr8-12122037_12122148,cPa308-unknown,0.893617021276596,2,12122112,12122087,cPa308_cPa308-unknown,5_42,111,25
chr8-12243996_12244098,HERV-W_repbase_HERV17_LTR17,1,1,12244048,12244036,HERV-W_repbase_HERV17_LTR17,3,102,12
chr8-12274723_12274829,cPa104-cPa220-hybrid_cPa190-cPa219-hybrid_cPa190-cPa220-hybrid_cPa219_cPa258,0.2,5,12274777,12274773,cPa104-cPa220-hybrid_cPa190-cPa219-hybrid_cPa190-cPa220-hybrid_cPa219_cPa258,1_1_1_1_1,106,4
chr8-1228161_1228263,cPa118,0.6,3,1228234,1228211,cPa118_cPa516-cPa15-hybrid_cPa566,3_1_1,102,23
chr8-12436882_12437046,cPa285,1,1,12436994,12436932,cPa285,2,164,62
chr8-12452879_12452981,cPa419,1,1,12452929,12452929,cPa419,1,102,0
chr8-1250952_1251054,cPa260-cPa62-hybrid_cPa308-cPa62-hybrid,0.5,2,1251047,1251002,cPa260-cPa62-hybrid_cPa308-cPa62-hybrid,1_1,102,45
chr8-12510775_12510877,cPa104_cPa190_cPa220,0.333333333333333,3,12510825,12510825,cPa104_cPa190_cPa220,1_1_1,102,0
chr8-12524851_12524953,cPa62,0.75,2,12524901,12524884,cPa62_cPa62-unknown,3_1,102,17
chr8-12571999_12572101,cPa75,1,1,12572049,12572049,cPa75,1,102,0
chr8-12619733_12619835,cPa75,0.714285714285714,4,12619834,12619759,cPa62_cPa75_cPa75-cPa62-hybrid_cPa75-unknown,1_25_5_4,102,75
chr8-12833163_12833265,cPa260_cPa293,0.5,2,12833213,12833213,cPa260_cPa293,1_1,102,0
chr8-13376080_13376242,ALVJ_Z46390,0.966101694915254,2,13376190,13376122,ALVJ_Z46390_ALVJ_Z46390-unknown,57_2,162,68
chr8-13647824_13647926,cPa540,0.304347826086957,14,13647909,13647838,cPa127_cPa127-cPa356-hybrid_cPa127-unknown_cPa241_cPa241-cPa11-hybrid_cPa241-cPa356-hybrid_cPa241-cPa515-hybrid_cPa241-cPa540-hybrid_cPa241-unknown_cPa515_cPa515-cPa241-hybrid_cPa515-cPa356-hybrid_cPa515-unknown_cPa540,7_1_1_8_1_1_1_1_3_5_1_1_1_14,102,71
chr8-14223295_14223434,cPa62,0.977777777777778,2,14223412,14223333,cPa62_cPa62-cPa419-hybrid,44_1,139,79
chr8-14562148_14562250,cPa62,0.8,2,14562201,14562195,cPa62_cPa62-unknown,4_1,102,6
chr8-14973513_14973615,cPa363_cPa452,0.333333333333333,4,14973563,14973528,cPa363_cPa452_cPa71_cPa71-cPa176-hybrid,3_3_2_1,102,35
chr8-1537824_1537926,cPa260_HERVHcons-cPa111-hybrid,0.5,2,1537874,1537846,cPa260_HERVHcons-cPa111-hybrid,1_1,102,28
chr8-16705122_16705224,cPa452,0.5,4,16705196,16705159,cPa363_cPa452_cPa71_cPa71-cPa16-hybrid,1_7_5_1,102,37
chr8-16758820_16758970,cPa75,0.333333333333333,17,16758932,16758821,cPa113_cPa113-unknown_cPa176-cPa260-hybrid_cPa176-cPa75-hybrid_cPa293_cPa413_cPa62_cPa62-cPa113-hybrid_cPa62-cPa223-hybrid_cPa62-cPa293-hybrid_cPa62-cPa363-hybrid_cPa62-cPa75-hybrid_cPa62-unknown_cPa75_cPa75-cPa260-hybrid_PERV_AJ293656_PERVC_HM159246,1_2_1_1_6_1_2_1_3_2_1_7_5_19_2_1_2,150,111
chr8-1684322_1684424,cPa75,0.923076923076923,2,1684417,1684372,cPa75_cPa75-cPa402-hybrid,12_1,102,45
chr8-1685093_1685195,cPa75,0.785714285714286,2,1685192,1685105,cPa75_cPa75-cPa62-hybrid,11_3,102,87
chr8-17203708_17203839,cPa101,0.5,3,17203790,17203758,cPa101_cPa51_cPa582,2_1_1,131,32
chr8-17445570_17445672,cPa419,1,1,17445620,17445620,cPa419,1,102,0
chr8-1835361_1835495,cPa62,1,1,1835452,1835411,cPa62,6,134,41
chr8-18458700_18458808,cPa118_cPa15,0.5,2,18458756,18458750,cPa118_cPa15,1_1,108,6
chr8-1911682_1911804,cPa75-FeFV_NC001871-hybrid,0.666666666666667,2,1911753,1911732,cPa75-FeFV_NC001871-hybrid_cPa75-unknown,4_2,122,21
chr8-1913492_1913594,cPa62,1,1,1913542,1913542,cPa62,1,102,0
chr8-1924363_1924465,cPa75-cPa113-hybrid_KWERV_GQ222416-unknown,0.5,2,1924413,1924397,cPa75-cPa113-hybrid_KWERV_GQ222416-unknown,1_1,102,16
chr8-19244195_19244306,cPa257_cPa285_cPa555,0.333333333333333,3,19244254,19244245,cPa257_cPa285_cPa555,1_1_1,111,9
chr8-1924545_1924657,cPa62-cPa113-hybrid,0.5,3,1924614,1924577,cPa62-cPa113-hybrid_cPa62-unknown_cPa75-cPa113-hybrid,4_1_3,112,37
chr8-19548220_19548390,cPa62,0.944444444444444,2,19548372,19548262,cPa285-cPa62-hybrid_cPa62,1_17,170,110
chr8-1975850_1975952,cPa419,1,1,1975900,1975900,cPa419,1,102,0
chr8-19835371_19835473,cPa62,1,1,19835421,19835387,cPa62,2,102,34
chr8-20424261_20424363,cPa15,0.928571428571429,2,20424315,20424260,cPa15_cPa268-cPa118-hybrid,13_1,102,55
chr8-20750062_20750164,cPa241_cPa540,0.379310344827586,7,20750121,20750096,cPa127_cPa127-cPa241-hybrid_cPa127-cPa540-hybrid_cPa241_cPa540_cPa540-cPa127-hybrid_cPa540-unknown,3_1_1_11_11_1_1,102,25
chr8-21122371_21122473,cPa62,1,1,21122421,21122391,cPa62,11,102,30
chr8-21217660_21217762,cPa75,1,1,21217710,21217710,cPa75,1,102,0
chr8-21257867_21257969,cPa219_cPa220_cPa258,0.333333333333333,3,21257917,21257917,cPa219_cPa220_cPa258,1_1_1,102,0
chr8-22297583_22297688,cPa452-cPa183-hybrid,0.222222222222222,10,22297656,22297633,cPa183_cPa223_cPa363-cPa183-hybrid_cPa363-cPa223-hybrid_cPa363-cPa424-hybrid_cPa452-cPa183-hybrid_cPa452-cPa223-hybrid_cPa452-cPa379-hybrid_cPa452-cPa424-hybrid_cPa452-cPa446-hybrid,1_3_3_2_1_4_1_1_1_1,105,23
chr8-22317118_22317220,WDSV_NC001867,0.6,2,22317172,22317159,cPa298_WDSV_NC001867,2_3,102,13
chr8-23743076_23743178,cPa456,0.333333333333333,5,23743173,23743126,cPa363_cPa456_cPa587-cPa117-hybrid_cPa587-cPa119-hybrid_cPa587-cPa363-hybrid,1_2_1_1_1,102,47
chr8-24338303_24338627,cPa260-unknown,0.621621621621622,12,24338575,24338327,cPa168_cPa260_cPa260-cPa130-hybrid_cPa260-cPa502-hybrid_cPa260-PERVC_HM159246-hybrid_cPa260-unknown_cPa502_cPa502-unknown_PERVE_NC003059-cPa130-hybrid_PERVE_NC003059-cPa502-hybrid_PERVE_NC003059-PERVC_HM159246-hybrid_PERVE_NC003059-unknown,1_20_1_12_2_92_1_1_1_5_2_10,324,248
chr8-24368860_24368962,cPa260_PERVE_NC003059,0.5,2,24368910,24368910,cPa260_PERVE_NC003059,1_1,102,0
chr8-24488528_24488727,cPa260,0.490909090909091,10,24488699,24488559,cPa260_cPa260-cPa117-hybrid_cPa260-cPa205-hybrid_cPa260-cPa61-hybrid_cPa260-cPa62-hybrid_cPa260-unknown_cPa260-WDSV_NC001867-hybrid_cPa539-cPa61-hybrid_cPa62-cPa205-hybrid_PERVE_NC003059-cPa61-hybrid,27_1_1_16_4_1_2_1_1_1,199,140
chr8-24494343_24494445,cPa62,0.75,3,24494415,24494346,cPa293_cPa62_cPa62-unknown,1_6_1,102,69
chr8-24532358_24532460,cPa16_cPa260,0.5,2,24532448,24532408,cPa16_cPa260,1_1,102,40
chr8-24587950_24588052,cPa62,1,1,24588000,24587966,cPa62,9,102,34
chr8-24663551_24663662,cPa62,0.923076923076923,2,24663622,24663558,cPa419_cPa62,1_12,111,64
chr8-24680292_24680394,cPa62,0.5,3,24680350,24680334,cPa62_cPa62-cPa75-hybrid_cPa62-unknown,3_2_1,102,16
chr8-24754797_24754899,cPa254,0.666666666666667,2,24754880,24754847,cPa254_cPa419,2_1,102,33
chr8-24794098_24794732,cPa502,0.448,16,24794713,24794104,cPa260-cPa502-hybrid_cPa260-cPa543-hybrid_cPa260-SMRV_NC001514-hybrid_cPa260-unknown_cPa402-cPa502-hybrid_cPa402-cPa543-hybrid_cPa402-SMRV_NC001514-hybrid_cPa419_cPa502_cPa502-cPa395-hybrid_cPa502-unknown_cPa75-cPa502-hybrid_PERVE_NC003059-cPa502-hybrid_PERVE_NC003059-cPa543-hybrid_PERVE_NC003059-SMRV_NC001514-hybrid_PERVE_NC003059-unknown,5_11_23_5_1_1_3_2_56_1_2_1_2_8_3_1,634,609
chr8-24813285_24813527,HERV-W_repbase_HERV17_LTR17-cPa62-hybrid,0.611111111111111,5,24813515,24813331,cPa75_cPa75-cPa62-hybrid_HERV-W_repbase_HERV17_LTR17-cPa62-hybrid_HERV-W_repbase_HERV17_LTR17-cPa75-hybrid_HERV-W_repbase_HERV17_LTR17-unknown,6_2_22_2_4,242,184
chr8-2500433_2500535,cPa379,0.6,3,2500483,2500451,cPa16-cPa260-hybrid_cPa379_WDSV_NC001867,1_3_1,102,32
chr8-25034605_25034707,cPa363-cPa452-hybrid_cPa379_cPa452-unknown_cPa71_cPa71-cPa446-hybrid,0.2,5,25034707,25034647,cPa363-cPa452-hybrid_cPa379_cPa452-unknown_cPa71_cPa71-cPa446-hybrid,1_1_1_1_1,102,60
chr8-25129415_25129522,cPa539,0.511111111111111,7,25129519,25129443,cPa486_cPa486-unknown_cPa486-WDSV_NC001867-hybrid_cPa539_cPa539-unknown_cPa539-WDSV_NC001867-hybrid_WDSV_NC001867,1_1_1_23_3_1_15,107,76
chr8-25241873_25241976,cPa260-unknown,1,1,25241925,25241923,cPa260-unknown,3,103,2
chr8-25247764_25247866,cPa75,1,1,25247826,25247806,cPa75,6,102,20
chr8-25247982_25248325,cPa75,0.591666666666667,12,25248324,25248014,cPa285_cPa285-cPa293-hybrid_cPa285-cPa75-hybrid_cPa285-unknown_cPa293_cPa293-unknown_cPa62-cPa293-hybrid_cPa62-cPa75-hybrid_cPa62-unknown_cPa75_cPa75-cPa293-hybrid_cPa75-unknown,2_1_1_2_24_1_12_1_3_71_1_1,343,310
chr8-2546764_2546866,HERVHcons,0.7,4,2546865,2546814,cPa106_cPa260_HERVHcons_HERVHcons-cPa260-hybrid,1_1_7_1,102,51
chr8-25472835_25472937,cPa62,0.9,2,25472909,25472877,cPa62_cPa62-unknown,18_2,102,32
chr8-25636950_25637052,MMTV_NC001503-cPa62-hybrid,0.75,2,25637051,25636955,cPa75_MMTV_NC001503-cPa62-hybrid,1_3,102,96
chr8-25637077_25637179,cPa71-cPa62-hybrid,0.4,4,25637178,25637124,cPa62_cPa71-cPa62-hybrid_cPa75_MMTV_NC001503-cPa62-hybrid,1_2_1_1,102,54
chr8-26012166_26012268,cPa566,0.666666666666667,4,26012246,26012166,cPa260_cPa434_cPa566_cPa566-unknown,1_2_8_1,102,80
chr8-26366462_26366564,cPa62,1,1,26366522,26366499,cPa62,4,102,23
chr8-27291846_27291955,cPa391,0.75,2,27291910,27291896,cPa293_cPa391,1_3,109,14
chr8-27343000_27343102,cPa75,1,1,27343050,27343023,cPa75,5,102,27
chr8-27406439_27406541,cPa118_cPa15_cPa248-unknown_cPa443,0.25,4,27406489,27406489,cPa118_cPa15_cPa248-unknown_cPa443,1_1_1_1,102,0
chr8-27597934_27598058,cPa323,0.6,3,27598006,27597943,cPa323_cPa323-unknown_cPa371,3_1_1,124,63
chr8-27702257_27702372,cPa62,0.947368421052632,2,27702320,27702302,cPa62_cPa62-cPa254-hybrid,18_1,115,18
chr8-27706452_27706573,cPa293,0.9,2,27706560,27706461,cPa293_cPa293-cPa71-hybrid,9_1,121,99
chr8-27781655_27781809,cPa62,0.769230769230769,2,27781782,27781684,cPa62_cPa62-unknown,10_3,154,98
chr8-27850503_27850623,cPa285,0.4,7,27850595,27850537,cPa285_cPa285-cPa62-hybrid_cPa293_cPa293-cPa285-hybrid_cPa293-unknown_cPa62_cPa62-cPa285-hybrid,20_1_10_1_1_16_1,120,58
chr8-27854478_27854580,cPa356-cPa394-hybrid,0.666666666666667,2,27854528,27854528,cPa356-cPa394-hybrid_MLV_Pmv4-unknown,2_1,102,0
chr8-27896914_27897025,cPa75,1,1,27896974,27896964,cPa75,3,111,10
chr8-28088222_28088324,cPa67-cPa62-hybrid_cPa75-cPa67-hybrid,0.5,2,28088323,28088272,cPa67-cPa62-hybrid_cPa75-cPa67-hybrid,1_1,102,51
chr8-28088333_28088678,HERV-W_repbase_HERV17_LTR17,0.34375,12,28088626,28088383,cPa260_cPa260-HERV-W_repbase_HERV17_LTR17-hybrid_cPa293_cPa293-cPa67-hybrid_cPa293-HERV-W_repbase_HERV17_LTR17-hybrid_cPa293-S71_repbase_HERVS71_LTR6A-hybrid_cPa71-cPa62-hybrid_cPa75_cPa75-cPa62-hybrid_cPa75-unknown_HERV-W_repbase_HERV17_LTR17_PERVC_HM159246,1_1_1_1_2_1_1_7_1_2_11_3,345,243
chr8-28088758_28088934,HERV-W_repbase_HERV17_LTR17,0.5,6,28088918,28088793,cPa293-HERV-W_repbase_HERV17_LTR17-hybrid_cPa67-HERV-W_repbase_HERV17_LTR17-hybrid_cPa75_cPa75-cPa62-hybrid_HERV-W_repbase_HERV17_LTR17_PERVC_HM159246-HERV-W_repbase_HERV17_LTR17-hybrid,1_1_3_1_7_1,176,125
chr8-28089046_28089214,cPa75,0.666666666666667,2,28089162,28089065,cPa75_HERV-W_repbase_HERV17_LTR17,2_1,168,97
chr8-28140616_28140718,cPa67,0.695652173913043,6,28140715,28140622,cPa119_cPa119-unknown_cPa194_cPa194-unknown_cPa67_SnRV_NC001724,1_1_2_1_16_2,102,93
chr8-28199040_28199142,cPa62,0.894736842105263,2,28199102,28199084,cPa285_cPa62,2_17,102,18
chr8-28199158_28199260,cPa62,1,1,28199208,28199160,cPa62,4,102,48
chr8-28201060_28201162,cPa62,1,1,28201131,28201080,cPa62,3,102,51
chr8-28334701_28334803,cPa62,1,1,28334751,28334751,cPa62,1,102,0
chr8-28601251_28601607,cPa428,0.75,4,28601558,28601255,cPa356_cPa356-cPa428-hybrid_cPa356-unknown_cPa428,9_1_1_33,356,303
chr8-28601865_28601967,cPa428,0.666666666666667,2,28601915,28601905,cPa356_cPa428,1_2,102,10
chr8-28602265_28602477,cPa428,1,1,28602444,28602315,cPa428,20,212,129
chr8-2874296_2874398,cPa75,1,1,2874346,2874346,cPa75,1,102,0
chr8-2874638_2875085,cPa62,0.826086956521739,3,2875045,2874688,cPa285-cPa62-hybrid_cPa62_cPa75,1_38_7,447,357
chr8-28785390_28785492,cPa71,0.6,5,28785488,28785408,cPa176-cPa327-hybrid_cPa363-cPa71-hybrid_cPa452-unknown_cPa71_cPa71-cPa446-hybrid,1_1_1_6_1,102,80
chr8-28791914_28792016,cPa113,0.666666666666667,2,28791969,28791961,cPa113_KoRV_AF151794-cPa516-hybrid,2_1,102,8
chr8-28816554_28816656,cPa260-unknown,1,1,28816604,28816604,cPa260-unknown,1,102,0
chr8-28898735_28898837,cPa285_cPa62,0.285714285714286,5,28898820,28898773,cPa285_cPa293_cPa62_cPa62-cPa15-hybrid_cPa71,2_1_2_1_1,102,47
chr8-28898896_28898998,cPa118-cPa285-hybrid_cPa15-cPa293-hybrid,0.5,2,28898946,28898917,cPa118-cPa285-hybrid_cPa15-cPa293-hybrid,1_1,102,29
chr8-28899824_28899926,cPa118_cPa443,0.3,6,28899923,28899825,cPa118_cPa125-unknown_cPa140-cPa15-hybrid_cPa248_cPa264_cPa443,3_1_1_1_1_3,102,98
chr8-29286000_29286190,cPa260,0.8,2,29286138,29286050,cPa260_cPa539-cPa260-hybrid,4_1,190,88
chr8-29434220_29434322,cPa456,0.431372549019608,9,29434322,29434221,cPa117-unknown_cPa363_cPa363-cPa587-hybrid_cPa363-unknown_cPa452-unknown_cPa456_cPa456-cPa223-hybrid_cPa456-cPa587-hybrid_cPa456-unknown,2_3_2_2_2_22_1_5_12,102,101
chr8-29434332_29434434,cPa223_cPa456-unknown,0.4,3,29434389,29434333,cPa223_cPa363_cPa456-unknown,2_1_2,102,56
chr8-29959653_29959926,cPa75-unknown,0.5,4,29959874,29959662,cPa216_cPa260_cPa75-cPa131-hybrid_cPa75-unknown,1_4_1_6,273,212
chr8-30111844_30111959,cPa450,0.4,4,30111932,30111894,cPa199-cPa553-hybrid_cPa199-unknown_cPa273_cPa450,1_1_1_2,115,38
chr8-30536133_30536235,cPa47,1,1,30536183,30536183,cPa47,1,102,0
chr8-30537446_30537548,cPa363-cPa47-hybrid_cPa516,0.333333333333333,4,30537547,30537464,cPa247-cPa425-hybrid_cPa363-cPa425-hybrid_cPa363-cPa47-hybrid_cPa516,1_1_2_2,102,83
chr8-30538799_30538901,cPa363-unknown,1,1,30538849,30538849,cPa363-unknown,1,102,0
chr8-310356_310458,cPa452-cPa75-hybrid,1,1,310406,310406,cPa452-cPa75-hybrid,1,102,0
chr8-3110985_3111087,cPa75,1,1,3111035,3111035,cPa75,3,102,0
chr8-3111706_3111808,cPa75,1,1,3111777,3111756,cPa75,2,102,21
chr8-3112109_3112211,cPa75,1,1,3112159,3112159,cPa75,1,102,0
chr8-3138080_3138182,cPa285,1,1,3138130,3138130,cPa285,1,102,0
chr8-3138760_3138862,cPa75,1,1,3138810,3138810,cPa75,1,102,0
chr8-3191319_3191421,cPa62,0.9,2,3191375,3191357,cPa356-cPa62-hybrid_cPa62,1_9,102,18
chr8-3288692_3288794,cPa75,0.6,3,3288770,3288695,cPa260-unknown_cPa75_SMRV_NC001514-cPa75-hybrid,1_3_1,102,75
chr8-3389285_3389418,cPa583,0.496124031007752,7,3389402,3389286,cPa251_cPa251-cPa298-hybrid_cPa251-cPa358-hybrid_cPa251-unknown_cPa358_cPa583_cPa583-cPa251-hybrid,17_2_6_2_37_64_1,133,116
chr8-351144_351246,HML8_repbase_HERVK11I_MER11A,1,1,351194,351194,HML8_repbase_HERVK11I_MER11A,1,102,0
chr8-3513417_3513519,cPa62,1,1,3513467,3513467,cPa62,1,102,0
chr8-362280_362456,cPa260,0.95,2,362404,362304,cPa260_cPa75-cPa260-hybrid,19_1,176,100
chr8-3752935_3753037,cPa61-cPa75-hybrid,1,1,3752985,3752985,cPa61-cPa75-hybrid,1,102,0
chr8-4415417_4415608,cPa62-WDSV_NC001867-hybrid,0.5,3,4415556,4415467,cPa62_cPa62-WDSV_NC001867-hybrid_WDSV_NC001867,1_3_2,191,89
chr8-462820_462922,cPa463-MLV_Pmv4-hybrid,1,1,462870,462870,cPa463-MLV_Pmv4-hybrid,1,102,0
chr8-4648770_4648948,cPa62-unknown,0.4375,7,4648927,4648820,CAEV_NC001463-cPa75-hybrid_cPa285_cPa62_cPa62-cPa254-hybrid_cPa62-cPa285-hybrid_cPa62-unknown_cPa75,1_1_1_4_1_7_1,178,107
chr8-4648972_4649074,cPa62-unknown,0.571428571428571,4,4649050,4648993,cPa62_cPa62-cPa254-hybrid_cPa62-cPa75-hybrid_cPa62-unknown,1_1_1_4,102,57
chr8-4649141_4649301,cPa62-unknown,0.823529411764706,4,4649252,4649153,cPa62-cPa254-hybrid_cPa62-cPa293-hybrid_cPa62-cPa75-hybrid_cPa62-unknown,1_1_1_14,160,99
chr8-4649317_4649419,cPa62-unknown,0.75,2,4649377,4649367,cPa62-unknown_cPa75,3_1,102,10
chr8-4661579_4661681,cPa75,1,1,4661629,4661629,cPa75,1,102,0
chr8-4741087_4741199,cPa62,0.951612903225806,2,4741192,4741093,cPa62_cPa62-unknown,59_3,112,99
chr8-4838650_4838752,cPa75,1,1,4838700,4838700,cPa75,1,102,0
chr8-4865165_4865267,cPa62,1,1,4865215,4865215,cPa62,1,102,0
chr8-506389_506517,cPa227,0.923076923076923,3,506469,506420,cPa168_cPa168-unknown_cPa227,1_1_24,128,49
chr8-538437_538558,cPa194,0.583333333333333,5,538512,538437,cPa194_cPa194-cPa345-hybrid_cPa67_cPa67-cPa345-hybrid_cPa67-unknown,14_1_7_1_1,121,75
chr8-538729_538856,cPa194,0.454545454545455,4,538815,538777,cPa194_cPa360_cPa67_cPa67-unknown,5_1_4_1,127,38
chr8-566851_566953,CAEV_NC001463_cPa260,0.5,2,566901,566901,CAEV_NC001463_cPa260,1_1,102,0
chr8-589402_589504,cPa199_cPa273_cPa553,0.333333333333333,3,589452,589452,cPa199_cPa273_cPa553,1_1_1,102,0
chr8-6356765_6356867,cPa62-unknown,1,1,6356815,6356815,cPa62-unknown,1,102,0
chr8-638816_638961,FeFV_NC001871,0.818181818181818,2,638922,638838,cPa75-unknown_FeFV_NC001871,2_9,145,84
chr8-687716_687818,cPa260,0.523809523809524,6,687808,687716,cPa106_cPa260_cPa523_HERVHcons_HERVHcons-cPa260-hybrid_HERVHcons-unknown,1_11_1_5_1_2,102,92
chr8-6898427_6898529,cPa62,1,1,6898477,6898470,cPa62,30,102,7
chr8-7090819_7091023,cPa62,0.964285714285714,2,7090971,7090832,cPa254_cPa62,1_27,204,139
chr8-7290491_7290687,cPa62,0.956521739130435,2,7290682,7290503,cPa62_cPa62-unknown,22_1,196,179
chr8-7311776_7311878,cPa62,1,1,7311838,7311826,cPa62,2,102,12
chr8-747559_747661,cPa67-cPa75-hybrid,1,1,747609,747609,cPa67-cPa75-hybrid,1,102,0
chr8-753601_753806,cPa75,0.833333333333333,2,753754,753651,cPa546_cPa75,1_5,205,103
chr8-753965_754084,cPa75,1,1,754032,754015,cPa75,2,119,17
chr8-762789_762891,cPa260-cPa193-hybrid,1,1,762839,762839,cPa260-cPa193-hybrid,1,102,0
chr8-7634485_7634633,cPa360,0.714285714285714,3,7634629,7634532,cPa224_cPa224-unknown_cPa360,1_1_5,148,97
chr8-7638637_7638739,PERVE_NC003059-unknown,1,1,7638687,7638686,PERVE_NC003059-unknown,5,102,1
chr8-7638818_7638957,PERVE_NC003059-unknown,0.980392156862745,2,7638906,7638868,cPa419_PERVE_NC003059-unknown,1_50,139,38
chr8-777160_777262,cPa251_cPa251-cPa260-hybrid_cPa251-cPa357-hybrid_cPa260_cPa273-cPa357-hybrid_cPa358-cPa357-hybrid,0.166666666666667,6,777258,777210,cPa251_cPa251-cPa260-hybrid_cPa251-cPa357-hybrid_cPa260_cPa273-cPa357-hybrid_cPa358-cPa357-hybrid,1_1_1_1_1_1,102,48
chr8-8059307_8059409,cPa62,0.981818181818182,2,8059408,8059357,cPa62_cPa62-unknown,54_1,102,51
chr8-8081771_8081873,cPa62-unknown,1,1,8081842,8081821,cPa62-unknown,2,102,21
chr8-8092328_8092430,cPa62,1,1,8092427,8092378,cPa62,30,102,49
chr8-8092482_8092584,cPa62,1,1,8092578,8092488,cPa62,6,102,90
chr8-8094149_8094394,cPa62,1,1,8094347,8094156,cPa62,38,245,191
chr8-8196152_8196308,cPa62,0.833333333333333,2,8196266,8196202,cPa419_cPa62,1_5,156,64
chr8-8196365_8196467,cPa62,1,1,8196415,8196415,cPa62,1,102,0
chr8-8346264_8346442,cPa492,1,1,8346390,8346285,cPa492,11,178,105
chr8-8463458_8463560,cPa62,1,1,8463543,8463457,cPa62,3,102,86
chr8-8499445_8499547,cPa62,1,1,8499495,8499495,cPa62,1,102,0
chr8-8510058_8510160,cPa75,1,1,8510108,8510108,cPa75,1,102,0
chr8-882302_882404,cPa75,1,1,882384,882308,cPa75,4,102,76
chr8-882770_882880,cPa75,0.782608695652174,5,882878,882774,cPa62-cPa260-hybrid_cPa62-cPa285-hybrid_cPa62-cPa413-hybrid_cPa62-cPa75-hybrid_cPa75,1_1_1_2_18,110,104
chr8-883015_883117,cPa75,0.75,2,883074,883023,cPa62-cPa75-hybrid_cPa75,1_3,102,51
chr8-884722_884824,cPa486-cPa62-hybrid,1,1,884772,884770,cPa486-cPa62-hybrid,2,102,2
chr8-948058_948160,cPa260,0.714285714285714,3,948149,948059,cPa260_cPa71_HERVHcons,5_1_1,102,90
chr8-991422_991524,cPa62,1,1,991503,991472,cPa62,6,102,31
chr9-10029331_10029433,cPa118_cPa15,0.5,2,10029381,10029363,cPa118_cPa15,5_5,102,18
chr9-10129999_10130136,cPa62,0.857142857142857,2,10130084,10130049,cPa62_cPa62-cPa293-hybrid,6_1,137,35
chr9-1053022_1053124,cPa260,1,1,1053072,1053072,cPa260,1,102,0
chr9-10611814_10611948,cPa75,0.296296296296296,8,10611940,10611864,cPa113_cPa62_cPa62-cPa113-hybrid_cPa62-HERV-W_repbase_HERV17_LTR17-hybrid_cPa75_cPa75-cPa113-hybrid_cPa75-unknown_HERV-W_repbase_HERV17_LTR17,3_3_7_1_8_2_2_1,134,76
chr9-10711556_10711658,cPa75,1,1,10711620,10711606,cPa75,3,102,14
chr9-10712964_10713253,HERV-W_repbase_HERV17_LTR17,0.426229508196721,13,10713230,10713009,cPa313-cPa62-hybrid_cPa62_cPa75_cPa75-cPa62-hybrid_cPa75-HERV-W_repbase_HERV17_LTR17-hybrid_cPa75-KoRV_AF151794-hybrid_cPa75-unknown_HERV-W_repbase_HERV17_LTR17_HERV-W_repbase_HERV17_LTR17-cPa62-hybrid_HERV-W_repbase_HERV17_LTR17-cPa75-hybrid_HERV-W_repbase_HERV17_LTR17-unknown_KoRV_AF151794_PERV_AJ293656-cPa75-hybrid,5_1_31_6_1_1_2_52_15_1_5_1_1,289,221
chr9-1107976_1108128,cPa228_cPa260,0.5,2,1108076,1108026,cPa228_cPa260,1_1,152,50
chr9-11095536_11095638,cPa363_cPa452_cPa71,0.285714285714286,4,11095633,11095586,cPa363_cPa419_cPa452_cPa71,2_1_2_2,102,47
chr9-12046772_12046883,cPa176_cPa363_cPa452_cPa71,0.25,4,12046831,12046822,cPa176_cPa363_cPa452_cPa71,1_1_1_1,111,9
chr9-12100941_12101054,cPa450,0.412280701754386,18,12101048,12100964,cPa199_cPa199-cPa227-hybrid_cPa199-cPa273-hybrid_cPa199-cPa450-hybrid_cPa199-cPa542-hybrid_cPa199-cPa553-hybrid_cPa199-unknown_cPa227_cPa227-cPa542-hybrid_cPa227-cPa553-hybrid_cPa227-unknown_cPa273_cPa447-cPa273-hybrid_cPa450_cPa450-cPa542-hybrid_cPa542_cPa553_cPa553-cPa542-hybrid,44_2_10_2_12_8_8_2_2_1_1_1_1_94_1_1_37_1,113,84
chr9-12941314_12941416,cPa62,1,1,12941378,12941364,cPa62,6,102,14
chr9-14832622_14832724,cPa62,1,1,14832675,14832621,cPa62,44,102,54
chr9-1502431_1502533,cPa539,1,1,1502520,1502454,cPa539,4,102,66
chr9-15377911_15378017,cPa363_cPa452,0.5,2,15377965,15377961,cPa363_cPa452,1_1,106,4
chr9-15828947_15829049,cPa529,0.5,4,15829010,15828988,cPa247_cPa529_cPa529-cPa545-hybrid_cPa529-cPa95-hybrid,1_3_1_1,102,22
chr9-15849306_15849408,cPa4_cPa541,0.4,3,15849357,15849356,cPa18-cPa14-hybrid_cPa4_cPa541,1_2_2,102,1
chr9-1588134_1588334,cPa260,0.846153846153846,2,1588318,1588184,cPa260_cPa540,11_2,200,134
chr9-16094745_16094847,cPa62,1,1,16094796,16094779,cPa62,24,102,17
chr9-1622973_1623119,cPa75,1,1,1623069,1623023,cPa75,4,146,46
chr9-1623217_1623319,cPa75,1,1,1623267,1623267,cPa75,1,102,0
chr9-1623683_1623823,cPa75,1,1,1623771,1623733,cPa75,3,140,38
chr9-1623902_1624040,cPa75,1,1,1623988,1623952,cPa75,4,138,36
chr9-1624114_1624290,cPa75,1,1,1624238,1624164,cPa75,5,176,74
chr9-1624535_1624738,cPa75,1,1,1624692,1624585,cPa75,12,203,107
chr9-1627101_1627234,EIAV_NC001450,0.545454545454545,4,1627186,1627151,cPa260_EIAV_NC001450_SIV_NC001870_WDSV_NC001867,3_6_1_1,133,35
chr9-17374160_17374273,cPa47-cPa174-hybrid,0.285714285714286,7,17374222,17374168,cPa174_cPa254_cPa404_cPa404-cPa254-hybrid_cPa425_cPa47_cPa47-cPa174-hybrid,2_2_2_1_2_1_4,113,54
chr9-1782386_1782488,cPa75-cPa228-hybrid,0.666666666666667,2,1782438,1782435,cPa75-cPa228-hybrid_cPa75-PtERV1_AC142352-hybrid,2_1,102,3
chr9-18189188_18189290,cPa15,0.739130434782609,5,18189260,18189233,cPa15_cPa268_cPa268-cPa118-hybrid_cPa268-cPa443-hybrid_cPa268-unknown,17_2_2_1_1,102,27
chr9-18279829_18279970,cPa109,0.666666666666667,2,18279918,18279879,cPa109_cPa419,2_1,141,39
chr9-18670785_18670891,cPa391,0.75,2,18670839,18670805,cPa293_cPa391,1_3,106,34
chr9-1876425_1876527,cPa62,1,1,1876505,1876446,cPa62,37,102,59
chr9-1901509_1901611,cPa62,0.952380952380952,2,1901588,1901548,cPa62_cPa62-unknown,20_1,102,40
chr9-19953691_19953793,cPa62,0.956521739130435,2,19953750,19953715,cPa285-cPa62-hybrid_cPa62,1_22,102,35
chr9-20034091_20034379,cPa194,0.625,5,20034369,20034099,cPa194_cPa194-cPa67-hybrid_cPa194-unknown_cPa67_PERVE_NC003059-cPa67-hybrid,20_4_1_6_1,288,270
chr9-20034416_20034518,cPa67,0.666666666666667,2,20034492,20034466,cPa194_cPa67,1_2,102,26
chr9-20135589_20135691,cPa500-cPa260-hybrid,1,1,20135639,20135639,cPa500-cPa260-hybrid,1,102,0
chr9-20256328_20256469,cPa75,0.866666666666667,3,20256417,20256374,cPa75_cPa75-PERVC_HM159246-hybrid_PERVC_HM159246,13_1_1,141,43
chr9-2039636_2039738,cPa75-cPa62-hybrid,0.384615384615385,6,2039730,2039641,cPa113-cPa62-hybrid_cPa293-cPa62-hybrid_cPa62_cPa75_cPa75-cPa62-hybrid_cPa75-unknown,1_1_2_3_5_1,102,89
chr9-2039795_2039903,cPa75,0.444444444444444,6,2039876,2039799,cPa113_cPa413-cPa62-hybrid_cPa413-unknown_cPa62_cPa75_cPa75-cPa62-hybrid,1_1_1_3_8_4,108,77
chr9-20469316_20469457,cPa465,1,1,20469405,20469366,cPa465,5,141,39
chr9-20505379_20505481,cPa62,1,1,20505467,20505380,cPa62,21,102,87
chr9-20518060_20518247,cPa75,1,1,20518229,20518110,cPa75,11,187,119
chr9-20518700_20518816,cPa75,1,1,20518769,20518749,cPa75,9,116,20
chr9-20523050_20523152,WDSV_NC001867-cPa62-hybrid,0.666666666666667,2,20523137,20523100,WDSV_NC001867_WDSV_NC001867-cPa62-hybrid,1_2,102,37
chr9-20574802_20574936,cPa413,0.5,5,20574884,20574826,cPa413_cPa413-unknown_cPa75_cPa75-cPa413-hybrid_cPa75-unknown,9_3_2_1_3,134,58
chr9-20821392_20821494,cPa363,0.428571428571429,5,20821454,20821393,cPa363_cPa363-unknown_cPa379_cPa452-cPa379-hybrid_cPa452-unknown,3_1_1_1_1,102,61
chr9-20879231_20879333,cPa199,0.703703703703704,3,20879333,20879246,cPa199_cPa505_WDSV_NC001867,19_1_7,102,87
chr9-21000143_21000273,cPa194,0.490740740740741,5,21000265,21000143,cPa194_cPa194-unknown_cPa360_cPa67_cPa67-unknown,53_1_3_47_4,130,122
chr9-21110372_21110474,cPa194,1,1,21110466,21110422,cPa194,2,102,44
chr9-21131792_21131894,cPa75,1,1,21131886,21131835,cPa75,6,102,51
chr9-21134893_21134995,cPa75,1,1,21134990,21134943,cPa75,4,102,47
chr9-21160002_21160104,cPa15,1,1,21160053,21160038,cPa15,3,102,15
chr9-2136367_2136489,cPa62,1,1,2136457,2136374,cPa62,24,122,83
chr9-21490477_21490862,HERV-W_repbase_HERV17_LTR17,0.730769230769231,9,21490849,21490527,cPa75_cPa75-cPa62-hybrid_cPa75-HERV-W_repbase_HERV17_LTR17-hybrid_cPa75-unknown_HERV-W_repbase_HERV17_LTR17_HERV-W_repbase_HERV17_LTR17-cPa62-hybrid_HERV-W_repbase_HERV17_LTR17-unknown_KoRV_AF151794_PERV_AJ293656,11_2_2_1_57_1_1_2_1,385,322
chr9-21727759_21727915,cPa199_cPa553,0.24,11,21727900,21727785,cPa199_cPa223_cPa227_cPa273_cPa273-cPa450-hybrid_cPa345_cPa450_cPa450-cPa345-hybrid_cPa450-cPa540-hybrid_cPa542_cPa553,12_2_3_3_1_10_4_1_1_1_12,156,115
chr9-21744829_21744931,cPa117-cPa16-hybrid,0.875,2,21744880,21744867,cPa117-cPa16-hybrid_cPa117-cPa419-hybrid,7_1,102,13
chr9-21853920_21854022,cPa194,0.583333333333333,4,21854020,21853920,cPa194_cPa360_cPa67_cPa67-unknown,56_1_38_1,102,100
chr9-22009278_22009380,cPa174-cPa404-hybrid,1,1,22009328,22009328,cPa174-cPa404-hybrid,1,102,0
chr9-22039011_22039113,cPa450,0.213793103448276,20,22039083,22039013,cPa199_cPa199-cPa345-hybrid_cPa199-cPa450-hybrid_cPa199-cPa542-hybrid_cPa199-cPa553-hybrid_cPa223_cPa223-cPa199-hybrid_cPa223-cPa273-hybrid_cPa223-cPa345-hybrid_cPa223-cPa553-hybrid_cPa273_cPa273-cPa345-hybrid_cPa345_cPa450_cPa450-unknown_cPa542_cPa542-cPa199-hybrid_cPa542-cPa273-hybrid_cPa542-cPa345-hybrid_cPa553,26_1_1_1_1_17_2_1_1_1_11_1_13_31_1_11_1_1_1_22,102,70
chr9-22148365_22148468,cPa285_cPa293_cPa419_cPa492_cPa62,0.2,5,22148416,22148403,cPa285_cPa293_cPa419_cPa492_cPa62,1_1_1_1_1,103,13
chr9-22162501_22162603,cPa118,0.75,2,22162566,22162551,cPa118_cPa15,3_1,102,15
chr9-22212594_22212699,cPa194,0.666666666666667,2,22212698,22212644,cPa194_cPa67-cPa194-hybrid,2_1,105,54
chr9-22233792_22233894,cPa194,0.666666666666667,2,22233842,22233807,cPa194_cPa67,2_1,102,35
chr9-22240542_22240644,cPa434,1,1,22240592,22240592,cPa434,1,102,0
chr9-22323110_22323212,cPa177-unknown,0.916666666666667,2,22323162,22323112,cPa177-unknown_cPa419,11_1,102,50
chr9-22632468_22632578,cPa15,0.537037037037037,7,22632567,22632467,cPa118_cPa118-cPa15-hybrid_cPa118-cPa268-hybrid_cPa118-cPa443-hybrid_cPa118-unknown_cPa15_cPa268,9_1_1_1_11_29_2,110,100
chr9-22733508_22733610,cPa199,0.75,2,22733600,22733558,cPa199_cPa450,3_1,102,42
chr9-22735299_22735401,cPa183,0.4,8,22735399,22735306,cPa183_cPa183-cPa199-hybrid_cPa223_cPa363_cPa379_cPa446_cPa452_cPa71-cPa363-hybrid,8_1_3_2_1_1_3_1,102,93
chr9-22739432_22739534,cPa15,0.529411764705882,5,22739485,22739471,cPa118_cPa118-cPa140-hybrid_cPa15_cPa15-cPa118-hybrid_cPa443-cPa118-hybrid,5_1_9_1_1,102,14
chr9-22858478_22858580,cPa223,1,1,22858578,22858481,cPa223,24,102,97
chr9-22868970_22869095,cPa553,0.3,9,22869082,22868978,cPa199_cPa223_cPa273_cPa273-cPa345-hybrid_cPa345_cPa450_cPa542_cPa553_cPa553-unknown,6_1_1_1_4_3_4_9_1,125,104
chr9-22869224_22869326,cPa345_cPa553,0.25,6,22869274,22869230,cPa199_cPa273_cPa345_cPa542_cPa542-cPa450-hybrid_cPa553,1_1_2_1_1_2,102,44
chr9-22907545_22907647,cPa285_cPa75,0.5,2,22907595,22907568,cPa285_cPa75,1_1,102,27
chr9-22907882_22907990,cPa293,0.5,3,22907963,22907898,cPa293_cPa75_cPa75-cPa285-hybrid,3_2_1,108,65
chr9-22908173_22908275,cPa285,1,1,22908223,22908223,cPa285,1,102,0
chr9-22908283_22908385,cPa75,1,1,22908333,22908333,cPa75,1,102,0
chr9-23039266_23039442,cPa260,0.866666666666667,3,23039390,23039316,cPa260_cPa260-unknown_cPa419,13_1_1,176,74
chr9-23039444_23039581,cPa260,1,1,23039580,23039449,cPa260,12,137,131
chr9-23039657_23039759,cPa260,1,1,23039707,23039679,cPa260,4,102,28
chr9-23074834_23074936,cPa15,0.540540540540541,7,23074895,23074836,cPa118_cPa118-cPa268-hybrid_cPa118-unknown_cPa15_cPa15-unknown_cPa268_cPa419-cPa268-hybrid,11_1_1_20_1_2_1,102,59
chr9-23088708_23088814,cPa323,0.521739130434783,5,23088780,23088721,cPa323_cPa371_cPa371-cPa323-hybrid_cPa371-cPa424-hybrid_cPa371-unknown,12_6_2_2_1,106,59
chr9-23088939_23089376,cPa323,0.607142857142857,6,23089324,23088948,cPa323_cPa371_cPa371-cPa323-hybrid_cPa371-cPa424-hybrid_cPa371-cPa449-hybrid_cPa371-unknown,17_6_1_2_1_1,437,376
chr9-23127500_23127602,cPa205,1,1,23127550,23127550,cPa205,1,102,0
chr9-23201178_23201280,cPa482_cPa543,0.5,2,23201266,23201228,cPa482_cPa543,1_1,102,38
chr9-23201304_23201490,cPa543,0.7,3,23201461,23201331,cPa465-cPa543-hybrid_cPa482_cPa543,1_2_7,186,130
chr9-2339124_2339226,WDSV_NC001867,1,1,2339174,2339174,WDSV_NC001867,1,102,0
chr9-23517428_23517530,cPa345-cPa544-hybrid,1,1,23517478,23517478,cPa345-cPa544-hybrid,1,102,0
chr9-23557115_23557275,cPa75,0.875,2,23557223,23557120,cPa75_cPa75-HERV-W_repbase_HERV17_LTR17-hybrid,14_2,160,103
chr9-23557490_23557592,cPa75,0.9,2,23557580,23557532,cPa75_HERV-W_repbase_HERV17_LTR17,9_1,102,48
chr9-23557759_23557888,cPa75,0.857142857142857,2,23557836,23557764,cPa75_HERV-W_repbase_HERV17_LTR17,6_1,129,72
chr9-23736408_23736510,cPa113,0.6,2,23736492,23736436,cPa113_cPa113-cPa67-hybrid,3_2,102,56
chr9-2375865_2375967,cPa492-cPa419-hybrid,1,1,2375915,2375915,cPa492-cPa419-hybrid,1,102,0
chr9-23808676_23808778,cPa419,1,1,23808726,23808726,cPa419,1,102,0
chr9-24022002_24022104,cPa208,1,1,24022052,24022052,cPa208,2,102,0
chr9-24609564_24609666,cPa260_cPa434-cPa260-hybrid,0.333333333333333,4,24609665,24609582,cPa260_cPa434-cPa260-hybrid_cPa434-cPa268-hybrid_cPa566-cPa260-hybrid,2_2_1_1,102,83
chr9-24675503_24675629,cPa268-unknown,0.620689655172414,6,24675615,24675528,cPa268-cPa223-hybrid_cPa268-cPa505-hybrid_cPa268-cPa527-hybrid_cPa268-unknown_cPa308-unknown_cPa381-unknown,1_1_2_18_2_5,126,87
chr9-24847772_24847874,cPa62,0.6,3,24847822,24847798,cPa285_cPa62_cPa62-unknown,1_3_1,102,24
chr9-24877203_24877317,cPa15_cPa268,0.428571428571429,3,24877296,24877253,cPa118_cPa15_cPa268,1_3_3,114,43
chr9-24949988_24950090,cPa15,0.6,3,24950042,24950021,cPa118_cPa15_cPa248-unknown,1_3_1,102,21
chr9-2573069_2573171,cPa62,1,1,2573131,2573114,cPa62,3,102,17
chr9-2573747_2573849,cPa62,1,1,2573797,2573797,cPa62,1,102,0
chr9-2584593_2584785,cPa67,0.431372549019608,5,2584766,2584603,cPa194_cPa194-cPa345-hybrid_cPa194-cPa67-hybrid_cPa194-unknown_cPa67,21_4_2_2_22,192,163
chr9-2697783_2697885,cPa62,1,1,2697833,2697833,cPa62,1,102,0
chr9-2698120_2698322,cPa62,0.5,4,2698270,2698155,cPa482-cPa62-hybrid_cPa482-cPa75-hybrid_cPa62_HERV-F_repbase_HERVFH19I_LTR19A-cPa62-hybrid,1_1_3_1,202,115
chr9-2773863_2773965,cPa293_cPa419,0.5,2,2773913,2773913,cPa293_cPa419,1_1,102,0
chr9-2801799_2802086,cPa539,0.861111111111111,4,2802085,2801836,cPa260-cPa381-hybrid_cPa539_cPa539-unknown_cPa75-cPa539-hybrid,1_31_1_3,287,249
chr9-2853896_2854147,cPa75,0.583333333333333,4,2854142,2853904,cPa62-cPa75-hybrid_cPa62-unknown_cPa75_cPa75-unknown,6_17_35_2,251,238
chr9-2854162_2854384,cPa75,0.823529411764706,2,2854332,2854182,cPa62-cPa75-hybrid_cPa75,3_14,222,150
chr9-2872880_2872982,HERV-W_repbase_HERV17_LTR17,0.75,3,2872976,2872882,cPa62-unknown_cPa75-unknown_HERV-W_repbase_HERV17_LTR17,1_1_6,102,94
chr9-2924627_2924748,cPa62-unknown,0.533333333333333,3,2924735,2924677,cPa254-unknown_cPa62-cPa176-hybrid_cPa62-unknown,5_2_8,121,58
chr9-3081955_3082057,cPa566,0.692307692307692,5,3082039,3081954,cPa15_cPa260-unknown_cPa434_cPa566_cPa566-cPa434-hybrid,1_1_9_27_1,102,85
chr9-3085869_3086027,cPa260_cPa260-cPa75-hybrid,0.5,2,3085975,3085919,cPa260_cPa260-cPa75-hybrid,3_3,158,56
chr9-3201508_3201610,cPa194,1,1,3201607,3201558,cPa194,2,102,49
chr9-3201900_3202002,cPa194,0.8,2,3202000,3201907,cPa194_cPa67,8_2,102,93
chr9-3202047_3202149,cPa67,0.555555555555556,4,3202130,3202047,cPa194_cPa345_cPa345-unknown_cPa67,4_3_1_10,102,83
chr9-3934403_3934505,cPa75,1,1,3934467,3934453,cPa75,5,102,14
chr9-4277653_4277765,cPa450,0.377622377622378,13,4277760,4277694,cPa199_cPa199-cPa227-hybrid_cPa199-cPa273-hybrid_cPa199-cPa450-hybrid_cPa199-cPa542-hybrid_cPa199-cPa553-hybrid_cPa199-unknown_cPa227_cPa273_cPa450_cPa542_cPa553_cPa553-cPa273-hybrid,20_3_25_4_1_4_2_5_8_54_7_9_1,112,66
chr9-438285_438387,cPa75,1,1,438335,438335,cPa75,1,102,0
chr9-4450185_4450287,cPa62,1,1,4450235,4450235,cPa62,1,102,0
chr9-445400_445503,cPa75,1,1,445451,445450,cPa75,2,103,1
chr9-445647_445754,cPa75,1,1,445702,445697,cPa75,2,107,5
chr9-4784310_4784412,cPa62,0.923076923076923,2,4784363,4784346,cPa62_cPa62-unknown,12_1,102,17
chr9-5157841_5157943,cPa62,0.903225806451613,4,5157901,5157880,cPa285_cPa419_cPa62_cPa62-unknown,1_1_28_1,102,21
chr9-5371974_5372076,cPa62,1,1,5372024,5372024,cPa62,1,102,0
chr9-5439629_5439731,cPa75,0.8,2,5439704,5439661,cPa75_cPa75-cPa62-hybrid,4_1,102,43
chr9-5482981_5483083,cPa62,1,1,5483077,5483031,cPa62,4,102,46
chr9-5483104_5483206,cPa62,0.848484848484849,5,5483197,5483105,cPa285_cPa285-unknown_cPa419_cPa62_cPa62-unknown,2_1_1_28_1,102,92
chr9-5591937_5592039,cPa62,1,1,5591987,5591987,cPa62,1,102,0
chr9-5715740_5715842,cPa118_cPa15,0.5,2,5715802,5715790,cPa118_cPa15,1_1,102,12
chr9-5822895_5822997,WDSV_NC001867,0.75,2,5822945,5822945,cPa260_WDSV_NC001867,1_3,102,0
chr9-5955430_5955538,cPa363,0.30188679245283,10,5955497,5955440,cPa176_cPa176-cPa452-hybrid_cPa223-cPa71-hybrid_cPa223-unknown_cPa363_cPa363-cPa176-hybrid_cPa363-cPa452-hybrid_cPa452_cPa71_cPa71-cPa452-hybrid,2_1_1_1_16_1_2_13_15_1,108,57
chr9-6062956_6063074,cPa62,1,1,6063025,6063002,cPa62,53,118,23
chr9-6124870_6124974,cPa62,1,1,6124941,6124916,cPa62,18,104,25
chr9-7035874_7035976,cPa452,0.47,9,7035937,7035887,cPa16-cPa363-hybrid_cPa16-cPa71-hybrid_cPa363_cPa363-cPa452-hybrid_cPa363-cPa71-hybrid_cPa363-unknown_cPa452_cPa452-cPa363-hybrid_cPa71,1_1_32_1_1_2_47_1_14,102,50
chr9-763614_763716,cPa194,1,1,763664,763664,cPa194,1,102,0
chr9-763720_763822,cPa194,0.533333333333333,2,763819,763721,cPa194_cPa67,8_7,102,98
chr9-767690_767792,cPa75,1,1,767740,767740,cPa75,1,102,0
chr9-7761030_7761132,cPa62,0.923076923076923,2,7761106,7761072,cPa254_cPa62,1_12,102,34
chr9-8993224_8993328,cPa15_cPa174_cPa404_cPa443,0.25,4,8993276,8993274,cPa15_cPa174_cPa404_cPa443,1_1_1_1,104,2
chr9-9149319_9149521,cPa75,1,1,9149469,9149341,cPa75,7,202,128
chr9-9262175_9262312,cPa452,0.446153846153846,6,9262293,9262205,cPa363_cPa363-cPa16-hybrid_cPa363-unknown_cPa452_cPa452-cPa71-hybrid_cPa71,26_1_1_29_2_6,137,88
chr9-9323374_9323476,cPa117,0.714285714285714,2,9323432,9323412,cPa117_cPa117-cPa75-hybrid,5_2,102,20
chr9-9332960_9333062,cPa62,1,1,9333024,9333005,cPa62,4,102,19
chr9-9668218_9668403,cPa62-cPa71-hybrid,0.588235294117647,5,9668376,9668239,cPa62_cPa62-cPa71-hybrid_cPa62-cPa75-hybrid_cPa62-unknown_cPa75,3_20_8_1_2,185,137
chr9-9668435_9668567,cPa62-cPa71-hybrid,0.319148936170213,7,9668565,9668437,cPa419_cPa62-cPa71-hybrid_cPa62-cPa75-hybrid_cPa62-unknown_cPa71_cPa75_HERV-W_repbase_HERV17_LTR17,1_15_13_2_4_11_1,132,128
chr9-9685375_9685477,cPa363,1,1,9685425,9685425,cPa363,1,102,0
chr9-9823024_9823126,cPa75-cPa62-hybrid,1,1,9823074,9823074,cPa75-cPa62-hybrid,1,102,0
chrLGE22-1025505_1025607,cPa62,0.875,3,1025597,1025540,cPa62_cPa62-cPa75-hybrid_cPa62-unknown,14_1_1,102,57
chrLGE22-1026330_1026432,cPa254-cPa75-hybrid,0.5,3,1026411,1026343,cPa254-cPa75-hybrid_cPa62-cPa75-hybrid_cPa75,3_2_1,102,68
chrLGE22-10418_10802,cPa62,0.414285714285714,16,10752,10418,cPa199-cPa62-hybrid_cPa199-cPa75-hybrid_cPa199-unknown_cPa419_cPa62_cPa62-cPa345-hybrid_cPa62-cPa75-hybrid_cPa75_cPa75-cPa345-hybrid_cPa75-cPa539-hybrid_cPa75-cPa62-hybrid_cPa75-unknown_WDSV_NC001867-cPa227-hybrid_WDSV_NC001867-cPa62-hybrid_WDSV_NC001867-cPa75-hybrid_WDSV_NC001867-unknown,2_1_1_1_29_1_1_17_1_1_5_2_1_4_1_2,384,334
chrLGE22-1069898_1070000,cPa75,1,1,1069948,1069931,cPa75,2,102,17
chrLGE22-1089021_1089123,cPa419,1,1,1089071,1089071,cPa419,1,102,0
chrLGE22-112115_112217,cPa75,1,1,112165,112165,cPa75,1,102,0
chrLGE22-112231_112526,cPa75,1,1,112474,112281,cPa75,12,295,193
chrLGE22-112570_112672,cPa75,1,1,112620,112620,cPa75,1,102,0
chrLGE22-1162140_1162253,cPa75,1,1,1162201,1162190,cPa75,3,113,11
chrLGE22-116316_117165,cPa75,1,1,117113,116366,cPa75,45,849,747
chrLGE22-117188_117290,cPa75,1,1,117238,117238,cPa75,1,102,0
chrLGE22-117291_117393,cPa75,1,1,117341,117341,cPa75,1,102,0
chrLGE22-117618_117750,cPa75,1,1,117698,117668,cPa75,3,132,30
chrLGE22-1176404_1176506,cPa75,1,1,1176454,1176454,cPa75,1,102,0
chrLGE22-117763_118005,cPa75,1,1,117953,117813,cPa75,10,242,140
chrLGE22-1178608_1178793,cPa75,1,1,1178741,1178658,cPa75,3,185,83
chrLGE22-1178911_1179178,cPa75,1,1,1179126,1178961,cPa75,12,267,165
chrLGE22-1193471_1193573,cPa75,1,1,1193521,1193521,cPa75,1,102,0
chrLGE22-1193820_1193922,cPa75,1,1,1193870,1193870,cPa75,1,102,0
chrLGE22-1198663_1198765,cPa62,1,1,1198727,1198704,cPa62,4,102,23
chrLGE22-1199053_1199155,cPa62,0.666666666666667,2,1199103,1199062,cPa62_cPa75,2_1,102,41
chrLGE22-120157_120456,cPa75,1,1,120422,120204,cPa75,14,299,218
chrLGE22-120472_120596,cPa75,1,1,120583,120507,cPa75,7,124,76
chrLGE22-120657_121057,cPa75,1,1,121005,120707,cPa75,17,400,298
chrLGE22-121127_121232,cPa75,1,1,121180,121177,cPa75,2,105,3
chrLGE22-121236_121338,cPa75,1,1,121286,121286,cPa75,1,102,0
chrLGE22-121405_121658,cPa75,1,1,121606,121455,cPa75,5,253,151
chrLGE22-122633_122735,cPa75,1,1,122683,122683,cPa75,1,102,0
chrLGE22-123491_123593,cPa75,1,1,123541,123541,cPa75,1,102,0
chrLGE22-123654_123810,cPa75,1,1,123758,123700,cPa75,3,156,58
chrLGE22-123970_124102,cPa75,1,1,124050,124020,cPa75,2,132,30
chrLGE22-1249693_1250076,cPa75,1,1,1250073,1249743,cPa75,31,383,330
chrLGE22-1250126_1250295,cPa75,1,1,1250255,1250134,cPa75,13,169,121
chrLGE22-1250477_1250579,cPa75,1,1,1250527,1250488,cPa75,3,102,39
chrLGE22-1257210_1257312,cPa75,1,1,1257260,1257260,cPa75,1,102,0
chrLGE22-1261109_1261211,cPa75,1,1,1261159,1261159,cPa75,1,102,0
chrLGE22-1261306_1261421,cPa75,1,1,1261369,1261356,cPa75,4,115,13
chrLGE22-1261497_1261599,cPa75,1,1,1261547,1261547,cPa75,1,102,0
chrLGE22-1261713_1261983,cPa75,1,1,1261931,1261763,cPa75,3,270,168
chrLGE22-1262234_1262336,cPa75,1,1,1262284,1262284,cPa75,1,102,0
chrLGE22-127195_127297,cPa75,1,1,127282,127207,cPa75,3,102,75
chrLGE22-127326_127740,cPa75,1,1,127688,127376,cPa75,25,414,312
chrLGE22-127794_128095,cPa75,1,1,128079,127833,cPa75,29,301,246
chrLGE22-128383_128485,cPa75,1,1,128433,128433,cPa75,1,102,0
chrLGE22-128602_128739,cPa75,1,1,128687,128652,cPa75,6,137,35
chrLGE22-1286468_1286570,cPa75,1,1,1286518,1286518,cPa75,1,102,0
chrLGE22-1286873_1287062,cPa75,1,1,1287010,1286923,cPa75,2,189,87
chrLGE22-1292503_1292663,cPa75,1,1,1292611,1292553,cPa75,5,160,58
chrLGE22-1292702_1293019,cPa75,1,1,1292967,1292752,cPa75,36,317,215
chrLGE22-129293_129395,cPa75,1,1,129351,129343,cPa75,2,102,8
chrLGE22-1303786_1303954,cPa356,0.529411764705882,2,1303907,1303787,cPa356_cPa428,9_8,168,120
chrLGE22-1304312_1304448,cPa428,0.625,2,1304423,1304342,cPa356_cPa428,3_5,136,81
chrLGE22-1304519_1304865,cPa428,0.518518518518518,2,1304837,1304569,cPa356_cPa428,13_14,346,268
chrLGE22-1305252_1305354,cPa356,0.571428571428571,2,1305339,1305253,cPa356_cPa428,4_3,102,86
chrLGE22-1305377_1305542,cPa428,0.833333333333333,2,1305507,1305377,cPa356_cPa428,1_5,165,130
chrLGE22-1306163_1306274,cPa356,0.5,3,1306270,1306184,cPa356_cPa428_cPa428-unknown,6_5_1,111,86
chrLGE22-1343153_1343285,cPa434,0.625,3,1343233,1343203,cPa434_cPa434-unknown_cPa61,5_1_2,132,30
chrLGE22-1345133_1345235,cPa75-cPa456-hybrid,1,1,1345183,1345183,cPa75-cPa456-hybrid,1,102,0
chrLGE22-1355446_1355548,cPa199_cPa539,0.5,2,1355518,1355481,cPa199_cPa539,3_3,102,37
chrLGE22-1355628_1355794,cPa199_cPa482,0.384615384615385,4,1355742,1355627,cPa199_cPa199-unknown_cPa482_cPa539,5_1_5_2,166,115
chrLGE22-1369413_1369566,cPa379-cPa75-hybrid_cPa75,0.5,2,1369514,1369463,cPa379-cPa75-hybrid_cPa75,1_1,153,51
chrLGE22-1375363_1375465,cPa75,1,1,1375413,1375392,cPa75,2,102,21
chrLGE22-1376097_1376272,cPa75,1,1,1376220,1376147,cPa75,3,175,73
chrLGE22-1376844_1376946,cPa75,1,1,1376894,1376894,cPa75,1,102,0
chrLGE22-1377330_1377432,cPa75,1,1,1377380,1377380,cPa75,1,102,0
chrLGE22-1377921_1378023,cPa75,1,1,1377971,1377971,cPa75,1,102,0
chrLGE22-1378223_1378403,cPa75,1,1,1378351,1378273,cPa75,2,180,78
chrLGE22-1378441_1378543,cPa75,1,1,1378491,1378469,cPa75,2,102,22
chrLGE22-1378631_1378733,cPa75,1,1,1378681,1378681,cPa75,1,102,0
chrLGE22-1394351_1394453,cPa75,1,1,1394401,1394401,cPa75,1,102,0
chrLGE22-1394455_1394557,cPa75,1,1,1394505,1394478,cPa75,2,102,27
chrLGE22-1410336_1410438,cPa15-unknown,1,1,1410386,1410386,cPa15-unknown,1,102,0
chrLGE22-1412133_1412235,cPa75,1,1,1412183,1412183,cPa75,1,102,0
chrLGE22-1423238_1423340,cPa75,1,1,1423288,1423288,cPa75,1,102,0
chrLGE22-1426756_1426881,cPa75,1,1,1426842,1426774,cPa75,6,125,68
chrLGE22-1427060_1427501,cPa75,1,1,1427449,1427110,cPa75,20,441,339
chrLGE22-1427594_1427736,cPa75,1,1,1427684,1427644,cPa75,10,142,40
chrLGE22-1427834_1427937,cPa75,1,1,1427887,1427866,cPa75,4,103,21
chrLGE22-1427961_1428063,cPa75,1,1,1428011,1428011,cPa75,1,102,0
chrLGE22-1428655_1428757,cPa75,1,1,1428750,1428685,cPa75,9,102,65
chrLGE22-1428998_1429100,cPa75,1,1,1429086,1429048,cPa75,4,102,38
chrLGE22-1429132_1429406,cPa75,1,1,1429359,1429173,cPa75,20,274,186
chrLGE22-1429458_1429594,cPa75,1,1,1429560,1429508,cPa75,5,136,52
chrLGE22-1429620_1429782,cPa75,1,1,1429741,1429658,cPa75,6,162,83
chrLGE22-1429869_1429971,cPa75,1,1,1429958,1429881,cPa75,3,102,77
chrLGE22-1476724_1476913,cPa434,0.48,12,1476901,1476735,cPa118_cPa118-unknown_cPa15_cPa15-cPa118-hybrid_cPa15-cPa566-hybrid_cPa434_cPa434-cPa118-hybrid_cPa434-cPa516-hybrid_cPa434-unknown_cPa516_cPa516-cPa434-hybrid_cPa516-unknown,6_1_3_1_1_24_1_1_2_8_1_1,189,166
chrLGE22-1476981_1477148,cPa118_cPa434,0.375,4,1477105,1476996,cPa118_cPa118-cPa434-hybrid_cPa434_cPa516-cPa15-hybrid,3_1_3_1,167,109
chrLGE22-1509051_1509223,cPa75,1,1,1509171,1509101,cPa75,4,172,70
chrLGE22-1509328_1509593,cPa75,1,1,1509541,1509378,cPa75,6,265,163
chrLGE22-152032_152137,cPa75,0.75,2,152087,152072,cPa75_cPa75-unknown,3_1,105,15
chrLGE22-152272_152374,cPa75-unknown,1,1,152322,152322,cPa75-unknown,1,102,0
chrLGE22-1548694_1548796,cPa75,1,1,1548744,1548744,cPa75,1,102,0
chrLGE22-1600839_1600941,cPa75,1,1,1600889,1600889,cPa75,1,102,0
chrLGE22-1636052_1636154,cPa75,1,1,1636102,1636089,cPa75,8,102,13
chrLGE22-1637336_1637444,cPa75,1,1,1637443,1637386,cPa75,3,108,57
chrLGE22-1650936_1651038,cPa75,1,1,1651021,1650967,cPa75,3,102,54
chrLGE22-1651444_1651631,cPa75,1,1,1651579,1651494,cPa75,3,187,85
chrLGE22-1651675_1651842,cPa75,0.666666666666667,2,1651790,1651725,cPa75_cPa75-cPa308-hybrid,2_1,167,65
chrLGE22-1652057_1652252,cPa75,1,1,1652200,1652107,cPa75,4,195,93
chrLGE22-1652515_1652761,cPa75,1,1,1652709,1652565,cPa75,6,246,144
chrLGE22-1652859_1653145,cPa75,0.714285714285714,2,1653093,1652909,cPa62_cPa75,2_5,286,184
chrLGE22-1655120_1655222,cPa62,1,1,1655170,1655170,cPa62,1,102,0
chrLGE22-1655235_1655459,cPa62,0.964285714285714,2,1655407,1655249,cPa62_cPa75,27_1,224,158
chrLGE22-1655579_1655681,cPa75,0.5,3,1655669,1655629,cPa62_cPa62-cPa75-hybrid_cPa75,1_1_2,102,40
chrLGE22-1655720_1655914,cPa62-cPa75-hybrid_cPa75,0.5,2,1655862,1655770,cPa62-cPa75-hybrid_cPa75,4_4,194,92
chrLGE22-1660034_1660136,cPa75,1,1,1660084,1660084,cPa75,1,102,0
chrLGE22-1662138_1662240,cPa75,1,1,1662188,1662188,cPa75,1,102,0
chrLGE22-1664717_1664843,cPa75,1,1,1664816,1664748,cPa75,6,126,68
chrLGE22-1665014_1665184,cPa75,1,1,1665132,1665064,cPa75,2,170,68
chrLGE22-1665195_1665419,cPa75,1,1,1665367,1665245,cPa75,10,224,122
chrLGE22-1665995_1666097,cPa75,1,1,1666049,1666044,cPa75,4,102,5
chrLGE22-1686152_1686588,cPa75,1,1,1686536,1686189,cPa75,41,436,347
chrLGE22-1691783_1692151,cPa75,0.5,3,1692099,1691797,cPa199_cPa505_cPa75,2_1_3,368,302
chrLGE22-1692478_1692841,cPa505-cPa75-hybrid_cPa75,0.375,4,1692789,1692528,cPa199_cPa482-cPa75-hybrid_cPa505-cPa75-hybrid_cPa75,1_1_3_3,363,261
chrLGE22-1697210_1697312,cPa75,1,1,1697260,1697260,cPa75,1,102,0
chrLGE22-1707840_1708049,cPa75,1,1,1707997,1707890,cPa75,5,209,107
chrLGE22-1708505_1708665,cPa75,1,1,1708613,1708555,cPa75,5,160,58
chrLGE22-1709145_1709398,cPa75,1,1,1709346,1709195,cPa75,4,253,151
chrLGE22-1709489_1709591,cPa75,1,1,1709539,1709539,cPa75,1,102,0
chrLGE22-1745408_1745510,cPa75,1,1,1745458,1745458,cPa75,1,102,0
chrLGE22-1745580_1745682,cPa75,1,1,1745630,1745630,cPa75,1,102,0
chrLGE22-1745728_1745830,cPa75,1,1,1745778,1745778,cPa75,1,102,0
chrLGE22-1748125_1748403,cPa75,1,1,1748351,1748135,cPa75,5,278,216
chrLGE22-1749073_1749293,cPa75,1,1,1749241,1749123,cPa75,5,220,118
chrLGE22-1771193_1771353,cPa492,1,1,1771311,1771236,cPa492,7,160,75
chrLGE22-17792_17964,cPa435,1,1,17962,17832,cPa435,14,172,130
chrLGE22-1783552_1783654,cPa75,1,1,1783602,1783602,cPa75,1,102,0
chrLGE22-1783737_1783842,cPa75,1,1,1783790,1783787,cPa75,2,105,3
chrLGE22-1783851_1784209,cPa75,1,1,1784157,1783901,cPa75,37,358,256
chrLGE22-1789209_1789311,cPa62,0.91304347826087,3,1789311,1789254,cPa62_cPa62-cPa75-hybrid_cPa62-unknown,21_1_1,102,57
chrLGE22-1789341_1789443,cPa62,1,1,1789441,1789361,cPa62,5,102,80
chrLGE22-1789671_1789773,cPa62,0.625,4,1789735,1789678,cPa254-cPa75-hybrid_cPa285-cPa75-hybrid_cPa62_cPa62-cPa75-hybrid,1_1_5_1,102,57
chrLGE22-1789876_1789978,cPa62,0.833333333333333,2,1789934,1789891,cPa62_cPa62-cPa75-hybrid,5_1,102,43
chrLGE22-1790066_1790168,cPa62-cPa75-hybrid_cPa75,0.5,2,1790116,1790105,cPa62-cPa75-hybrid_cPa75,1_1,102,11
chrLGE22-1790217_1790319,cPa62-cPa75-hybrid,1,1,1790267,1790267,cPa62-cPa75-hybrid,1,102,0
chrLGE22-1790424_1790526,cPa62,1,1,1790474,1790474,cPa62,1,102,0
chrLGE22-1791646_1791748,cPa75,1,1,1791696,1791696,cPa75,1,102,0
chrLGE22-1791848_1791950,cPa75,1,1,1791898,1791898,cPa75,1,102,0
chrLGE22-1792287_1792389,cPa75,1,1,1792337,1792337,cPa75,1,102,0
chrLGE22-1792392_1792494,cPa75,1,1,1792442,1792442,cPa75,1,102,0
chrLGE22-1792614_1792809,cPa62-cPa75-hybrid,0.666666666666667,2,1792806,1792664,cPa62-cPa75-hybrid_cPa75,2_1,195,142
chrLGE22-1793459_1793650,cPa75,1,1,1793624,1793509,cPa75,5,191,115
chrLGE22-1798716_1798818,cPa75,1,1,1798766,1798766,cPa75,1,102,0
chrLGE22-1798857_1799045,cPa75,1,1,1798993,1798907,cPa75,2,188,86
chrLGE22-1799142_1799244,cPa75,1,1,1799192,1799192,cPa75,1,102,0
chrLGE22-1799370_1799472,cPa75,1,1,1799420,1799420,cPa75,1,102,0
chrLGE22-17997_18145,cPa435,0.8,2,18093,18003,cPa419_cPa435,1_4,148,90
chrLGE22-1800507_1800609,cPa75,1,1,1800594,1800513,cPa75,3,102,81
chrLGE22-1801111_1801446,cPa75,1,1,1801394,1801161,cPa75,17,335,233
chrLGE22-1801551_1801996,cPa75,1,1,1801944,1801601,cPa75,13,445,343
chrLGE22-1802052_1802154,cPa75,1,1,1802102,1802102,cPa75,1,102,0
chrLGE22-1823630_1823747,cPa75,1,1,1823695,1823680,cPa75,3,117,15
chrLGE22-1823943_1824045,cPa75,1,1,1823993,1823993,cPa75,1,102,0
chrLGE22-1831055_1831157,cPa75_cPa75-unknown,0.5,2,1831105,1831070,cPa75_cPa75-unknown,1_1,102,35
chrLGE22-1832673_1832775,cPa75,1,1,1832723,1832723,cPa75,2,102,0
chrLGE22-1832827_1832939,cPa75,1,1,1832887,1832877,cPa75,2,112,10
chrLGE22-1833323_1833869,cPa75,1,1,1833817,1833373,cPa75,9,546,444
chrLGE22-1834005_1834123,cPa75,1,1,1834071,1834055,cPa75,2,118,16
chrLGE22-1840890_1841242,cPa75,1,1,1841190,1840940,cPa75,8,352,250
chrLGE22-1841381_1841490,cPa75,1,1,1841438,1841431,cPa75,2,109,7
chrLGE22-1843145_1843583,cPa75,1,1,1843531,1843195,cPa75,7,438,336
chrLGE22-1843623_1844426,cPa75,1,1,1844375,1843673,cPa75,27,803,702
chrLGE22-1844428_1844769,cPa75,1,1,1844717,1844478,cPa75,11,341,239
chrLGE22-1845094_1845196,cPa75,1,1,1845154,1845144,cPa75,2,102,10
chrLGE22-1847264_1847366,cPa75,1,1,1847314,1847314,cPa75,1,102,0
chrLGE22-1847451_1847823,cPa75,1,1,1847771,1847501,cPa75,7,372,270
chrLGE22-1847924_1848695,cPa75,1,1,1848643,1847974,cPa75,29,771,669
chrLGE22-1848735_1848838,cPa75,1,1,1848786,1848785,cPa75,2,103,1
chrLGE22-1849011_1849113,cPa75,1,1,1849061,1849061,cPa75,1,102,0
chrLGE22-1853008_1853110,cPa75,1,1,1853058,1853058,cPa75,1,102,0
chrLGE22-1853242_1853344,cPa75,1,1,1853292,1853259,cPa75,2,102,33
chrLGE22-1853684_1853786,cPa75,1,1,1853734,1853734,cPa75,1,102,0
chrLGE22-1854010_1854112,cPa75,1,1,1854060,1854060,cPa75,2,102,0
chrLGE22-1857564_1857666,cPa75,1,1,1857614,1857614,cPa75,1,102,0
chrLGE22-1858269_1858371,cPa75,1,1,1858357,1858319,cPa75,2,102,38
chrLGE22-1858428_1858610,cPa75,1,1,1858558,1858478,cPa75,11,182,80
chrLGE22-1882922_1883026,cPa75,1,1,1882974,1882972,cPa75,2,104,2
chrLGE22-1883310_1883454,cPa75,1,1,1883402,1883360,cPa75,3,144,42
chrLGE22-1883512_1883614,cPa75,1,1,1883562,1883562,cPa75,1,102,0
chrLGE22-1883993_1884095,cPa75,1,1,1884043,1884043,cPa75,1,102,0
chrLGE22-1965754_1965953,cPa75,1,1,1965930,1965804,cPa75,5,199,126
chrLGE22-1965979_1966115,cPa75,1,1,1966112,1966029,cPa75,7,136,83
chrLGE22-1966496_1966598,cPa75,1,1,1966546,1966546,cPa75,1,102,0
chrLGE22-1966968_1967070,cPa75,1,1,1967018,1967018,cPa75,1,102,0
chrLGE22-1978988_1979092,cPa75,1,1,1979040,1979038,cPa75,2,104,2
chrLGE22-1979162_1979264,cPa75,1,1,1979212,1979212,cPa75,1,102,0
chrLGE22-1979413_1979515,cPa75,1,1,1979463,1979463,cPa75,1,102,0
chrLGE22-1979623_1979834,cPa75,1,1,1979782,1979673,cPa75,13,211,109
chrLGE22-1979975_1980189,cPa75,1,1,1980167,1980025,cPa75,15,214,142
chrLGE22-1980214_1980495,cPa75,1,1,1980443,1980264,cPa75,11,281,179
chrLGE22-1983350_1983452,cPa75,1,1,1983400,1983400,cPa75,1,102,0
chrLGE22-1983556_1983658,cPa75,1,1,1983606,1983606,cPa75,1,102,0
chrLGE22-1984079_1984181,cPa75,1,1,1984129,1984128,cPa75,2,102,1
chrLGE22-1984899_1985001,cPa75,1,1,1984971,1984949,cPa75,2,102,22
chrLGE22-2001104_2001206,cPa75,1,1,2001174,2001154,cPa75,2,102,20
chrLGE22-2001230_2001398,cPa75,1,1,2001346,2001240,cPa75,4,168,106
chrLGE22-2001413_2001648,cPa75,1,1,2001602,2001463,cPa75,13,235,139
chrLGE22-2001659_2001861,cPa75,1,1,2001851,2001709,cPa75,26,202,142
chrLGE22-2002085_2002196,cPa75,1,1,2002147,2002135,cPa75,22,111,12
chrLGE22-2006157_2006379,cPa75,1,1,2006327,2006207,cPa75,4,222,120
chrLGE22-2006532_2006634,cPa75,1,1,2006582,2006582,cPa75,1,102,0
chrLGE22-2006730_2006904,cPa75,1,1,2006852,2006780,cPa75,7,174,72
chrLGE22-2006910_2007189,cPa75,1,1,2007137,2006960,cPa75,6,279,177
chrLGE22-2008323_2008425,cPa75,1,1,2008406,2008373,cPa75,3,102,33
chrLGE22-2008430_2008719,cPa75,1,1,2008667,2008480,cPa75,8,289,187
chrLGE22-2008766_2009461,cPa75,1,1,2009409,2008816,cPa75,49,695,593
chrLGE22-2011076_2011178,cPa75,1,1,2011126,2011126,cPa75,1,102,0
chrLGE22-2011924_2012026,cPa75,1,1,2011974,2011974,cPa75,1,102,0
chrLGE22-2015035_2015137,cPa75,1,1,2015085,2015085,cPa75,1,102,0
chrLGE22-2015216_2015318,cPa75,1,1,2015266,2015266,cPa75,1,102,0
chrLGE22-2018207_2018309,cPa75,1,1,2018257,2018257,cPa75,1,102,0
chrLGE22-2021816_2021918,cPa75,1,1,2021866,2021866,cPa75,1,102,0
chrLGE22-2021980_2022082,cPa75,1,1,2022078,2022030,cPa75,3,102,48
chrLGE22-2022139_2022535,cPa75,1,1,2022483,2022189,cPa75,17,396,294
chrLGE22-2022550_2022874,cPa75,1,1,2022822,2022600,cPa75,24,324,222
chrLGE22-2022909_2023186,cPa75,1,1,2023134,2022959,cPa75,7,277,175
chrLGE22-2024478_2024580,cPa75,1,1,2024528,2024528,cPa75,1,102,0
chrLGE22-2025539_2025728,cPa75,1,1,2025676,2025548,cPa75,11,189,128
chrLGE22-2026070_2026172,cPa75,1,1,2026120,2026094,cPa75,2,102,26
chrLGE22-2026210_2026407,cPa75,1,1,2026357,2026260,cPa75,24,197,97
chrLGE22-2034698_2034911,cPa75,1,1,2034859,2034748,cPa75,7,213,111
chrLGE22-2034982_2035084,cPa75,1,1,2035032,2035032,cPa75,1,102,0
chrLGE22-2035304_2035409,cPa75,1,1,2035357,2035354,cPa75,2,105,3
chrLGE22-2035513_2035615,cPa75,1,1,2035563,2035563,cPa75,1,102,0
chrLGE22-2051618_2051813,cPa75,1,1,2051761,2051668,cPa75,3,195,93
chrLGE22-2051845_2052027,cPa75,1,1,2051975,2051895,cPa75,6,182,80
chrLGE22-2055865_2055967,cPa75,1,1,2055915,2055915,cPa75,1,102,0
chrLGE22-2081055_2081157,cPa75,1,1,2081105,2081105,cPa75,1,102,0
chrLGE22-2081306_2081408,cPa75,1,1,2081356,2081356,cPa75,1,102,0
chrLGE22-2081559_2081661,cPa75,1,1,2081609,2081609,cPa75,1,102,0
chrLGE22-2082316_2082418,cPa75,1,1,2082366,2082366,cPa75,1,102,0
chrLGE22-2085551_2085774,cPa75,1,1,2085722,2085601,cPa75,4,223,121
chrLGE22-2090901_2091003,cPa75,1,1,2090951,2090951,cPa75,1,102,0
chrLGE22-2095553_2095918,cPa75,1,1,2095866,2095603,cPa75,7,365,263
chrLGE22-2095924_2096654,cPa75,1,1,2096602,2095974,cPa75,18,730,628
chrLGE22-2096732_2096911,cPa75,1,1,2096859,2096754,cPa75,9,179,105
chrLGE22-2096926_2097028,cPa75,1,1,2096976,2096976,cPa75,1,102,0
chrLGE22-2099396_2099498,cPa75,1,1,2099446,2099446,cPa75,1,102,0
chrLGE22-2100000_2100138,cPa75,1,1,2100086,2100050,cPa75,2,138,36
chrLGE22-2100187_2100339,cPa75,1,1,2100287,2100237,cPa75,3,152,50
chrLGE22-2100360_2100462,cPa75,1,1,2100410,2100410,cPa75,1,102,0
chrLGE22-2100906_2101168,cPa75,1,1,2101116,2100956,cPa75,23,262,160
chrLGE22-2101317_2101419,cPa75,1,1,2101367,2101336,cPa75,2,102,31
chrLGE22-2140163_2140265,cPa356,0.615384615384615,2,2140213,2140193,cPa356_cPa428,8_5,102,20
chrLGE22-2140775_2140877,cPa356_cPa428,0.5,2,2140830,2140818,cPa356_cPa428,3_3,102,12
chrLGE22-2141335_2141437,cPa356,1,1,2141385,2141385,cPa356,1,102,0
chrLGE22-2142784_2142886,cPa428,0.666666666666667,2,2142848,2142834,cPa356_cPa428,2_4,102,14
chrLGE22-2144525_2144627,cPa356_cPa428,0.5,2,2144626,2144573,cPa356_cPa428,3_3,102,53
chrLGE22-2144655_2144757,cPa356,0.714285714285714,2,2144748,2144657,cPa356_cPa428,5_2,102,91
chrLGE22-2145272_2145451,cPa356_cPa428,0.5,2,2145439,2145273,cPa356_cPa428,23_23,179,166
chrLGE22-2145469_2145716,cPa356,0.516666666666667,2,2145670,2145493,cPa356_cPa428,31_29,247,177
chrLGE22-2145859_2145977,cPa356,0.533333333333333,2,2145976,2145864,cPa356_cPa428,16_14,118,112
chrLGE22-2147407_2147532,cPa428,0.571428571428571,2,2147480,2147428,cPa356_cPa428,3_4,125,52
chrLGE22-2147538_2147640,cPa428,0.666666666666667,2,2147639,2147588,cPa356_cPa428,2_4,102,51
chrLGE22-2148045_2148280,cPa428,0.575,2,2148270,2148044,cPa356_cPa428,34_46,235,226
chrLGE22-2148783_2148975,cPa356,0.588235294117647,2,2148964,2148833,cPa356_cPa428,10_7,192,131
chrLGE22-2149611_2149713,cPa356,1,1,2149661,2149655,cPa356,2,102,6
chrLGE22-2150129_2150231,cPa428,0.666666666666667,2,2150217,2150179,cPa356_cPa428,1_2,102,38
chrLGE22-2150753_2150855,cPa356,0.567901234567901,2,2150855,2150760,cPa356_cPa428,46_35,102,95
chrLGE22-2151696_2151798,cPa428,0.5625,2,2151783,2151701,cPa356_cPa428,7_9,102,82
chrLGE22-2152203_2152305,cPa356,0.571428571428571,2,2152285,2152218,cPa356_cPa428,4_3,102,67
chrLGE22-2152312_2152414,cPa356_cPa428,0.5,2,2152411,2152362,cPa356_cPa428,1_1,102,49
chrLGE22-2152445_2152603,cPa428,0.625,2,2152585,2152487,cPa356_cPa428,3_5,158,98
chrLGE22-2152660_2152777,cPa428,0.645161290322581,2,2152766,2152667,cPa356_cPa428,11_20,117,99
chrLGE22-2153092_2153194,cPa428,0.857142857142857,2,2153184,2153102,cPa356_cPa428,1_6,102,82
chrLGE22-2153451_2153707,cPa428,0.666666666666667,2,2153655,2153501,cPa356_cPa428,7_14,256,154
chrLGE22-2180187_2180289,cPa452_cPa71,0.5,2,2180237,2180237,cPa452_cPa71,2_2,102,0
chrLGE22-2508698_2508830,cPa75-unknown,0.928571428571429,2,2508778,2508726,cPa75_cPa75-unknown,1_13,132,52
chrLGE22-2509013_2509145,cPa75-unknown,1,1,2509132,2509052,cPa75-unknown,7,132,80
chrLGE22-25585_25687,cPa434,0.777777777777778,3,25662,25596,cPa434_cPa435-cPa434-hybrid_cPa482-cPa182-hybrid,7_1_1,102,66
chrLGE22-2569102_2569204,cPa75,1,1,2569152,2569118,cPa75,3,102,34
chrLGE22-2570804_2570964,cPa75,1,1,2570912,2570854,cPa75,2,160,58
chrLGE22-2583321_2583423,cPa75,1,1,2583371,2583371,cPa75,1,102,0
chrLGE22-26118_26220,cPa182,0.24,23,26172,26130,cPa118-cPa182-hybrid_cPa163_cPa182_cPa371_cPa419_cPa419-cPa182-hybrid_cPa434_cPa434-cPa182-hybrid_cPa435-cPa118-hybrid_cPa435-cPa163-hybrid_cPa435-cPa182-hybrid_cPa435-cPa241-hybrid_cPa435-cPa434-hybrid_cPa435-cPa566-hybrid_cPa435-unknown_cPa449-cPa163-hybrid_cPa512-cPa182-hybrid_cPa516_cPa516-cPa182-hybrid_cPa516-cPa566-hybrid_cPa566_cPa566-cPa182-hybrid_cPa61,1_3_18_1_1_1_6_3_1_4_5_2_1_1_1_1_1_2_3_1_16_1_1,102,42
chrLGE22-2612551_2612653,cPa75,1,1,2612601,2612601,cPa75,1,102,0
chrLGE22-2612787_2612946,cPa75,1,1,2612900,2612837,cPa75,4,159,63
chrLGE22-2619799_2619901,cPa75,1,1,2619849,2619849,cPa75,1,102,0
chrLGE22-26222_26339,cPa434,0.375,4,26287,26257,cPa163-unknown_cPa315-cPa182-hybrid_cPa434_cPa566,1_2_3_2,117,30
chrLGE22-2625708_2625810,cPa75,1,1,2625758,2625758,cPa75,1,102,0
chrLGE22-2627091_2627193,cPa194,1,1,2627141,2627141,cPa194,1,102,0
chrLGE22-2630924_2631065,cPa75,1,1,2631013,2630974,cPa75,2,141,39
chrLGE22-2631084_2631186,cPa75,1,1,2631134,2631134,cPa75,1,102,0
chrLGE22-2631189_2631291,cPa75,1,1,2631239,2631239,cPa75,1,102,0
chrLGE22-2631368_2631470,cPa75,1,1,2631418,2631418,cPa75,1,102,0
chrLGE22-2634057_2634222,cPa75,1,1,2634170,2634107,cPa75,3,165,63
chrLGE22-2634323_2634425,cPa75,1,1,2634373,2634373,cPa75,1,102,0
chrLGE22-2636546_2636664,cPa75,1,1,2636612,2636596,cPa75,2,118,16
chrLGE22-2636920_2637022,cPa75,1,1,2636970,2636970,cPa75,1,102,0
chrLGE22-2637102_2637345,cPa75,1,1,2637293,2637152,cPa75,10,243,141
chrLGE22-2637409_2637720,cPa75,1,1,2637668,2637459,cPa75,8,311,209
chrLGE22-2637927_2638033,cPa75,1,1,2637982,2637977,cPa75,4,106,5
chrLGE22-2648080_2648183,cPa75,1,1,2648131,2648097,cPa75,3,103,34
chrLGE22-2651885_2651997,cPa75,1,1,2651945,2651935,cPa75,2,112,10
chrLGE22-2652009_2652220,cPa75,1,1,2652168,2652059,cPa75,3,211,109
chrLGE22-2654976_2655078,cPa486,1,1,2655026,2655026,cPa486,1,102,0
chrLGE22-2655404_2655506,cPa62-cPa75-hybrid,1,1,2655454,2655454,cPa62-cPa75-hybrid,1,102,0
chrLGE22-2658816_2658918,cPa75,1,1,2658866,2658866,cPa75,1,102,0
chrLGE22-2658935_2659037,cPa75,1,1,2658985,2658985,cPa75,1,102,0
chrLGE22-2671288_2671390,cPa75,1,1,2671338,2671338,cPa75,1,102,0
chrLGE22-2681671_2681773,cPa75,1,1,2681721,2681721,cPa75,1,102,0
chrLGE22-2687403_2687505,cPa75,1,1,2687453,2687453,cPa75,1,102,0
chrLGE22-2696278_2696380,cPa75,1,1,2696328,2696328,cPa75,1,102,0
chrLGE22-2696621_2696723,cPa75,1,1,2696671,2696650,cPa75,2,102,21
chrLGE22-2696752_2697088,cPa75,1,1,2697036,2696802,cPa75,16,336,234
chrLGE22-2700279_2700381,cPa75,1,1,2700329,2700329,cPa75,1,102,0
chrLGE22-2703695_2703870,cPa75,1,1,2703818,2703745,cPa75,3,175,73
chrLGE22-2703878_2704012,cPa75,1,1,2703960,2703928,cPa75,4,134,32
chrLGE22-2704024_2704126,cPa75,1,1,2704074,2704074,cPa75,1,102,0
chrLGE22-2717459_2717561,cPa75,1,1,2717509,2717509,cPa75,1,102,0
chrLGE22-2717716_2717818,cPa75,1,1,2717805,2717725,cPa75,10,102,80
chrLGE22-2717958_2718152,cPa75,1,1,2718100,2718008,cPa75,3,194,92
chrLGE22-2718527_2718774,cPa75,1,1,2718722,2718577,cPa75,4,247,145
chrLGE22-2725263_2725365,cPa62,1,1,2725313,2725313,cPa62,1,102,0
chrLGE22-2727111_2727213,cPa75,1,1,2727161,2727161,cPa75,1,102,0
chrLGE22-2727881_2727983,cPa75,1,1,2727931,2727931,cPa75,1,102,0
chrLGE22-2728336_2728438,cPa75,1,1,2728386,2728386,cPa75,1,102,0
chrLGE22-2728505_2728607,cPa75,1,1,2728555,2728555,cPa75,1,102,0
chrLGE22-2730971_2731093,cPa177_cPa75,0.5,2,2731041,2731021,cPa177_cPa75,1_1,122,20
chrLGE22-2731142_2731323,cPa75,1,1,2731288,2731192,cPa75,3,181,96
chrLGE22-2764888_2764990,cPa75,1,1,2764938,2764938,cPa75,1,102,0
chrLGE22-2765717_2765819,cPa62,1,1,2765767,2765767,cPa62,1,102,0
chrLGE22-2766216_2766318,cPa62,1,1,2766266,2766266,cPa62,1,102,0
chrLGE22-2766389_2766704,cPa62,1,1,2766685,2766439,cPa62,68,315,246
chrLGE22-2768349_2768451,cPa62,1,1,2768409,2768393,cPa62,13,102,16
chrLGE22-2771875_2772040,cPa62,1,1,2771988,2771925,cPa62,12,165,63
chrLGE22-2776752_2776881,cPa62-unknown,1,1,2776829,2776802,cPa62-unknown,2,129,27
chrLGE22-2782466_2782568,cPa62,1,1,2782516,2782516,cPa62,1,102,0
chrLGE22-2782845_2783070,cPa75,0.5,3,2783018,2782895,cPa62_cPa75_cPa75-cPa62-hybrid,1_3_2,225,123
chrLGE22-2793280_2793382,HERV-W_repbase_HERV17_LTR17,1,1,2793330,2793330,HERV-W_repbase_HERV17_LTR17,1,102,0
chrLGE22-2794905_2795040,cPa62,0.95,2,2794991,2794944,cPa62_cPa62-unknown,19_1,135,47
chrLGE22-2795151_2795253,cPa62,1,1,2795201,2795201,cPa62,1,102,0
chrLGE22-2798228_2798330,cPa75-cPa62-hybrid,1,1,2798278,2798247,cPa75-cPa62-hybrid,2,102,31
chrLGE22-2798439_2798575,cPa75-cPa62-hybrid,1,1,2798523,2798489,cPa75-cPa62-hybrid,3,136,34
chrLGE22-2798595_2798748,cPa75-cPa62-hybrid,1,1,2798696,2798645,cPa75-cPa62-hybrid,2,153,51
chrLGE22-2798767_2798934,cPa285-cPa62-hybrid_cPa75-cPa62-hybrid,0.5,2,2798882,2798817,cPa285-cPa62-hybrid_cPa75-cPa62-hybrid,1_1,167,65
chrLGE22-2798937_2799076,cPa62,0.6,2,2799041,2798987,cPa62_cPa75-cPa62-hybrid,3_2,139,54
chrLGE22-2799113_2799598,cPa62,0.872727272727273,6,2799571,2799113,cPa285_cPa285-cPa62-hybrid_cPa62_cPa62-cPa419-hybrid_cPa62-cPa75-hybrid_cPa62-unknown,1_1_48_1_3_1,485,458
chrLGE22-2802868_2803110,cPa75,1,1,2803058,2802918,cPa75,4,242,140
chrLGE22-2803247_2803515,cPa75,1,1,2803463,2803297,cPa75,4,268,166
chrLGE22-2803579_2803681,cPa75,1,1,2803629,2803629,cPa75,1,102,0
chrLGE22-2806875_2806977,cPa62,1,1,2806925,2806925,cPa62,1,102,0
chrLGE22-2807799_2807901,cPa62,1,1,2807849,2807849,cPa62,1,102,0
chrLGE22-2808248_2808350,cPa62,1,1,2808298,2808286,cPa62,2,102,12
chrLGE22-2808596_2808698,cPa62,1,1,2808646,2808646,cPa62,1,102,0
chrLGE22-2831455_2831557,cPa75,1,1,2831505,2831505,cPa75,1,102,0
chrLGE22-2831559_2831661,cPa75,1,1,2831609,2831609,cPa75,1,102,0
chrLGE22-2833773_2833987,cPa62,1,1,2833935,2833823,cPa62,4,214,112
chrLGE22-2843388_2843490,cPa260,1,1,2843438,2843438,cPa260,1,102,0
chrLGE22-2845123_2845233,cPa62,1,1,2845203,2845169,cPa62,14,110,34
chrLGE22-2845341_2845443,cPa62,1,1,2845412,2845343,cPa62,10,102,69
chrLGE22-2851401_2851503,cPa75,0.695652173913043,5,2851490,2851451,cPa62_cPa62-cPa75-hybrid_cPa62-unknown_cPa75_cPa75-unknown,3_1_2_16_1,102,39
chrLGE22-2851523_2851625,cPa62-cPa285-hybrid_cPa75,0.5,2,2851573,2851573,cPa62-cPa285-hybrid_cPa75,1_1,102,0
chrLGE22-2851655_2851757,cPa75,0.666666666666667,2,2851705,2851695,cPa62_cPa75,1_2,102,10
chrLGE22-2863557_2863740,cPa62_cPa62-cPa75-hybrid_cPa62-WDSV_NC001867-hybrid,0.333333333333333,3,2863688,2863607,cPa62_cPa62-cPa75-hybrid_cPa62-WDSV_NC001867-hybrid,1_1_1,183,81
chrLGE22-2863884_2863986,cPa62-cPa260-hybrid_cPa62-WDSV_NC001867-hybrid,0.5,2,2863950,2863934,cPa62-cPa260-hybrid_cPa62-WDSV_NC001867-hybrid,1_1,102,16
chrLGE22-2864160_2864262,cPa62-cPa260-hybrid,1,1,2864210,2864210,cPa62-cPa260-hybrid,1,102,0
chrLGE22-2864332_2864474,cPa260-unknown_WDSV_NC001867,0.428571428571429,3,2864422,2864336,cPa260-unknown_cPa260-WDSV_NC001867-hybrid_WDSV_NC001867,3_1_3,142,86
chrLGE22-2874825_2875577,cPa75,1,1,2875525,2874875,cPa75,38,752,650
chrLGE22-2884186_2884316,cPa75,0.666666666666667,2,2884264,2884221,cPa285_cPa75,1_2,130,43
chrLGE22-2884683_2884785,cPa75,1,1,2884733,2884733,cPa75,1,102,0
chrLGE22-2884830_2884932,cPa75,1,1,2884897,2884880,cPa75,2,102,17
chrLGE22-2889618_2889720,cPa75_cPa75-unknown,0.5,2,2889668,2889642,cPa75_cPa75-unknown,1_1,102,26
chrLGE22-2889742_2889865,cPa75-cPa293-hybrid_cPa75-unknown,0.5,2,2889813,2889792,cPa75-cPa293-hybrid_cPa75-unknown,1_1,123,21
chrLGE22-2889889_2890141,cPa75_cPa75-unknown,0.307692307692308,4,2890113,2889939,cPa62-cPa293-hybrid_cPa75_cPa75-cPa293-hybrid_cPa75-unknown,3_4_2_4,252,174
chrLGE22-2900515_2900764,cPa62,0.5,3,2900712,2900516,cPa62_cPa62-cPa486-hybrid_cPa62-cPa75-hybrid,3_1_2,249,196
chrLGE22-2901207_2901496,cPa75,0.533333333333333,3,2901444,2901257,cPa285-cPa75-hybrid_cPa62-cPa75-hybrid_cPa75,1_6_8,289,187
chrLGE22-2901533_2901713,cPa224_cPa62-cPa75-hybrid_cPa75,0.333333333333333,3,2901661,2901583,cPa224_cPa62-cPa75-hybrid_cPa75,1_1_1,180,78
chrLGE22-2906624_2906726,cPa47,1,1,2906674,2906674,cPa47,1,102,0
chrLGE22-2907090_2907338,cPa75,1,1,2907286,2907140,cPa75,5,248,146
chrLGE22-2907342_2907501,cPa398-cPa75-hybrid_cPa75,0.5,2,2907449,2907392,cPa398-cPa75-hybrid_cPa75,1_1,159,57
chrLGE22-2907502_2907604,cPa75,1,1,2907552,2907552,cPa75,1,102,0
chrLGE22-2907694_2907796,cPa75,1,1,2907744,2907744,cPa75,1,102,0
chrLGE22-2907856_2907958,cPa75,1,1,2907949,2907906,cPa75,2,102,43
chrLGE22-2913406_2913508,cPa75-unknown,1,1,2913456,2913456,cPa75-unknown,1,102,0
chrLGE22-2918044_2918176,cPa75,0.666666666666667,2,2918124,2918094,cPa177-cPa75-hybrid_cPa75,1_2,132,30
chrLGE22-2918428_2918530,cPa75,0.6,3,2918489,2918476,cPa177_cPa177-cPa75-hybrid_cPa75,1_1_3,102,13
chrLGE22-2935676_2935779,cPa75,1,1,2935727,2935726,cPa75,2,103,1
chrLGE22-2936050_2936152,cPa75,1,1,2936100,2936052,cPa75,3,102,48
chrLGE22-2936165_2936267,cPa75,1,1,2936215,2936215,cPa75,1,102,0
chrLGE22-2936563_2936962,cPa75,1,1,2936910,2936613,cPa75,10,399,297
chrLGE22-2940974_2941076,cPa75,1,1,2941035,2941019,cPa75,3,102,16
chrLGE22-29457_29559,cPa542-unknown_cPa553,0.5,2,29507,29484,cPa542-unknown_cPa553,1_1,102,23
chrLGE22-2959293_2959395,cPa75-unknown,1,1,2959343,2959343,cPa75-unknown,1,102,0
chrLGE22-2989225_2989442,cPa75,1,1,2989438,2989275,cPa75,5,217,163
chrLGE22-2989452_2989703,cPa75,1,1,2989651,2989502,cPa75,7,251,149
chrLGE22-2990126_2990302,cPa75,1,1,2990250,2990176,cPa75,10,176,74
chrLGE22-2990340_2990442,cPa75,1,1,2990390,2990390,cPa75,1,102,0
chrLGE22-2990696_2990812,cPa75,1,1,2990760,2990746,cPa75,2,116,14
chrLGE22-29926_30078,cPa542-cPa62-hybrid,0.4,4,30026,29976,cPa315-cPa62-hybrid_cPa542-cPa62-hybrid_cPa587-cPa62-hybrid_cPa62,1_2_1_1,152,50
chrLGE22-2996307_2996409,cPa75,1,1,2996396,2996327,cPa75,8,102,69
chrLGE22-2998112_2998555,cPa75,1,1,2998503,2998162,cPa75,27,443,341
chrLGE22-2998905_2999007,cPa75,1,1,2998955,2998955,cPa75,1,102,0
chrLGE22-2999016_2999413,cPa75,1,1,2999361,2999066,cPa75,15,397,295
chrLGE22-2999539_2999641,cPa75,1,1,2999589,2999589,cPa75,1,102,0
chrLGE22-3032047_3032199,cPa62-cPa75-hybrid_cPa75,0.5,2,3032147,3032097,cPa62-cPa75-hybrid_cPa75,1_1,152,50
chrLGE22-3049590_3049692,cPa75,1,1,3049640,3049640,cPa75,1,102,0
chrLGE22-3052832_3053090,cPa75,1,1,3053038,3052882,cPa75,5,258,156
chrLGE22-3105016_3105118,cPa75,1,1,3105066,3105066,cPa75,1,102,0
chrLGE22-3105275_3105439,cPa75,1,1,3105387,3105325,cPa75,2,164,62
chrLGE22-3105500_3105609,cPa75,1,1,3105557,3105550,cPa75,2,109,7
chrLGE22-3106065_3106167,cPa75,1,1,3106115,3106115,cPa75,1,102,0
chrLGE22-3106213_3106349,cPa75,1,1,3106338,3106263,cPa75,4,136,75
chrLGE22-377043_377145,cPa75,1,1,377120,377043,cPa75,3,102,77
chrLGE22-429016_429217,cPa199,0.526315789473684,3,429165,429062,cPa199_cPa505_cPa505-cPa75-hybrid,10_6_3,201,103
chrLGE22-430447_430550,cPa75,0.4,4,430514,430462,cPa199-cPa75-hybrid_cPa505-cPa75-hybrid_cPa75_WDSV_NC001867-cPa75-hybrid,3_1_4_2,103,52
chrLGE22-458839_458941,cPa75-unknown,1,1,458889,458889,cPa75-unknown,1,102,0
chrLGE22-458972_459074,cPa75,1,1,459022,459022,cPa75,1,102,0
chrLGE22-4654_4799,cPa194,1,1,4747,4698,cPa194,8,145,49
chrLGE22-522886_523001,cPa75,1,1,522949,522936,cPa75,3,115,13
chrLGE22-550458_550560,cPa285,1,1,550508,550508,cPa285,1,102,0
chrLGE22-550704_550881,cPa75,0.55,3,550866,550754,cPa254_cPa285_cPa75,2_7_11,177,112
chrLGE22-552988_553160,cPa75,1,1,553108,553031,cPa75,6,172,77
chrLGE22-553219_553965,cPa75,1,1,553930,553269,cPa75,40,746,661
chrLGE22-553976_554390,cPa75,1,1,554338,554026,cPa75,36,414,312
chrLGE22-601360_601462,cPa323,0.613636363636364,6,601459,601365,cPa323_cPa323-unknown_cPa371_cPa371-unknown_cPa449_cPa512-cPa158-hybrid,27_1_13_1_1_1,102,94
chrLGE22-601489_601611,cPa323,0.515151515151515,8,601609,601510,cPa323_cPa371_cPa371-cPa323-hybrid_cPa371-cPa50-hybrid_cPa371-cPa512-hybrid_cPa371-unknown_cPa512_cPa512-unknown,17_5_2_1_1_5_1_1,122,99
chrLGE22-601971_602086,cPa323,0.944444444444444,2,602060,601987,cPa323_cPa371,17_1,115,73
chrLGE22-6339_6441,cPa583,1,1,6429,6389,cPa583,2,102,40
chrLGE22-6491_6813,cPa450,0.414634146341463,15,6784,6541,cPa138-cPa553-hybrid_cPa199_cPa199-cPa273-hybrid_cPa199-cPa566-hybrid_cPa199-cPa583-hybrid_cPa345-cPa273-hybrid_cPa345-cPa583-hybrid_cPa395-cPa273-hybrid_cPa419_cPa450_cPa450-cPa273-hybrid_cPa450-cPa358-hybrid_cPa450-cPa542-hybrid_cPa553_cPa583,1_1_1_1_1_1_1_2_3_17_2_2_1_1_6,322,243
chrLGE22-666912_667014,cPa75,1,1,666962,666962,cPa75,1,102,0
chrLGE22-667247_667349,cPa75,1,1,667297,667297,cPa75,1,102,0
chrLGE22-667424_667526,cPa75,1,1,667474,667474,cPa75,1,102,0
chrLGE22-688173_688275,cPa75,1,1,688223,688223,cPa75,1,102,0
chrLGE22-688885_688987,cPa75,1,1,688935,688935,cPa75,1,102,0
chrLGE22-689186_689288,cPa75,1,1,689236,689236,cPa75,1,102,0
chrLGE22-699729_699831,cPa75,1,1,699779,699779,cPa75,1,102,0
chrLGE22-699957_700288,cPa75,1,1,700236,700007,cPa75,21,331,229
chrLGE22-700301_700659,cPa75,1,1,700609,700351,cPa75,13,358,258
chrLGE22-700675_700807,cPa75,1,1,700786,700720,cPa75,10,132,66
chrLGE22-700953_701055,cPa75,1,1,701054,700977,cPa75,5,102,77
chrLGE22-701268_701370,cPa75,1,1,701353,701300,cPa75,10,102,53
chrLGE22-705046_705148,cPa75,1,1,705096,705096,cPa75,1,102,0
chrLGE22-705413_705515,cPa75,1,1,705463,705463,cPa75,1,102,0
chrLGE22-705680_705884,cPa75,1,1,705832,705730,cPa75,5,204,102
chrLGE22-705892_706383,cPa75,1,1,706331,705942,cPa75,21,491,389
chrLGE22-706401_706715,cPa75,1,1,706703,706451,cPa75,9,314,252
chrLGE22-716674_717048,cPa75,1,1,716996,716724,cPa75,9,374,272
chrLGE22-717052_717154,cPa75,1,1,717102,717102,cPa75,1,102,0
chrLGE22-717219_717321,cPa75,1,1,717269,717269,cPa75,1,102,0
chrLGE22-717690_717792,cPa75,1,1,717740,717740,cPa75,1,102,0
chrLGE22-718107_718209,cPa75,1,1,718157,718157,cPa75,1,102,0
chrLGE22-720491_720593,cPa75,1,1,720541,720541,cPa75,1,102,0
chrLGE22-738085_738187,cPa75,1,1,738135,738135,cPa75,3,102,0
chrLGE22-738205_738307,cPa75,1,1,738255,738255,cPa75,1,102,0
chrLGE22-738645_738747,cPa75,1,1,738695,738672,cPa75,2,102,23
chrLGE22-7445_7547,cPa419,0.666666666666667,2,7523,7495,cPa199_cPa419,1_2,102,28
chrLGE22-747777_747879,cPa75,1,1,747827,747827,cPa75,1,102,0
chrLGE22-766979_767081,cPa539,1,1,767069,767008,cPa539,5,102,61
chrLGE22-780654_780836,cPa75,0.578947368421053,6,780819,780669,cPa62_cPa71-cPa62-hybrid_cPa75_cPa75-cPa62-hybrid_cPa75-unknown_HERV-W_repbase_HERV17_LTR17-cPa62-hybrid,3_1_33_10_9_1,182,150
chrLGE22-780871_781099,cPa75,0.7,3,781047,780893,cPa75_cPa75-cPa62-hybrid_cPa75-unknown,14_1_5,228,154
chrLGE22-795941_796043,cPa75,1,1,795991,795991,cPa75,1,102,0
chrLGE22-796235_796482,cPa75,1,1,796430,796269,cPa75,6,247,161
chrLGE22-796568_796721,cPa75,1,1,796669,796618,cPa75,4,153,51
chrLGE22-796741_796919,cPa75,1,1,796867,796791,cPa75,2,178,76
chrLGE22-800386_800488,cPa75,1,1,800436,800436,cPa75,1,102,0
chrLGE22-813919_814021,cPa539,1,1,813969,813930,cPa539,3,102,39
chrLGE22-814054_814156,cPa539,0.875,2,814136,814084,cPa438_cPa539,1_7,102,52
chrLGE22-823536_823638,cPa75,1,1,823586,823586,cPa75,1,102,0
chrLGE22-827067_827169,cPa75,1,1,827132,827117,cPa75,2,102,15
chrLGE22-827678_827780,cPa75,1,1,827766,827728,cPa75,2,102,38
chrLGE22-828085_828187,cPa75,1,1,828135,828135,cPa75,1,102,0
chrLGE22-82905_83128,cPa75-unknown,0.764705882352941,4,83076,82932,cPa419_cPa75_cPa75-cPa201-hybrid_cPa75-unknown,2_1_1_13,223,144
chrLGE22-83137_83466,cPa75-unknown,0.769230769230769,3,83414,83187,cPa177-unknown_cPa75_cPa75-unknown,5_1_20,329,227
chrLGE22-842006_842108,cPa75,1,1,842056,842056,cPa75,1,102,0
chrLGE22-842155_842257,cPa75,1,1,842205,842205,cPa75,1,102,0
chrLGE22-842270_842461,cPa75,1,1,842409,842320,cPa75,4,191,89
chrLGE22-845286_845503,cPa75,1,1,845451,845336,cPa75,4,217,115
chrLGE22-845555_847022,cPa75,1,1,846970,845605,cPa75,51,1467,1365
chrLGE22-847080_847191,cPa75,1,1,847139,847130,cPa75,2,111,9
chrLGE22-858948_859050,cPa75,1,1,858998,858998,cPa75,1,102,0
chrLGE22-860293_860395,cPa75,1,1,860343,860343,cPa75,1,102,0
chrLGE22-860797_860899,cPa75,1,1,860847,860847,cPa75,1,102,0
chrLGE22-863201_863378,cPa75,1,1,863326,863251,cPa75,2,177,75
chrLGE22-863448_863550,cPa75,1,1,863534,863498,cPa75,2,102,36
chrLGE22-864091_864193,cPa75,1,1,864141,864141,cPa75,1,102,0
chrLGE22-86417_86573,cPa75,1,1,86521,86467,cPa75,3,156,54
chrLGE22-866281_866383,cPa75,1,1,866364,866314,cPa75,7,102,50
chrLGE22-866438_867008,cPa75,1,1,866956,866488,cPa75,35,570,468
chrLGE22-867009_867500,cPa75,1,1,867448,867059,cPa75,34,491,389
chrLGE22-873190_873354,cPa75,1,1,873302,873240,cPa75,6,164,62
chrLGE22-873546_873730,cPa75,1,1,873678,873596,cPa75,7,184,82
chrLGE22-873934_874169,cPa75,1,1,874122,873984,cPa75,4,235,138
chrLGE22-877032_877134,cPa75,1,1,877082,877082,cPa75,1,102,0
chrLGE22-877310_877412,cPa75,1,1,877360,877360,cPa75,1,102,0
chrLGE22-877443_877545,cPa75,1,1,877493,877493,cPa75,1,102,0
chrLGE22-890516_890696,cPa75,1,1,890644,890566,cPa75,10,180,78
chrLGE22-890712_891079,cPa75,1,1,891027,890762,cPa75,39,367,265
chrLGE22-891117_891231,cPa75,1,1,891179,891167,cPa75,2,114,12
chrLGE22-891553_891655,cPa75,1,1,891603,891603,cPa75,1,102,0
chrLGE22-895504_895606,cPa75,1,1,895554,895554,cPa75,1,102,0
chrLGE22-947246_947348,cPa62-cPa581-hybrid,1,1,947296,947296,cPa62-cPa581-hybrid,1,102,0
chrLGE22-969323_969488,cPa539,0.846153846153846,3,969460,969373,cPa539_cPa539-cPa486-hybrid_cPa539-unknown,11_1_1,165,87
chrLGE22-970025_970185,cPa492,0.956521739130435,2,970171,970042,cPa492_cPa492-unknown,22_1,160,129
chrLGE22-970215_970317,cPa492,1,1,970311,970218,cPa492,5,102,93
chrLGE22-975917_976019,cPa482,1,1,975967,975967,cPa482,1,102,0
chrLGE22-976150_976351,cPa482_cPa482-cPa273-hybrid,0.5,2,976299,976200,cPa482_cPa482-cPa273-hybrid,1_1,201,99
chrLGE22-984305_984407,cPa62-WDSV_NC001867-hybrid_MLV_Xmv43-WDSV_NC001867-hybrid,0.384615384615385,5,984400,984328,cPa62_cPa62-unknown_cPa62-WDSV_NC001867-hybrid_MLV_Xmv43-WDSV_NC001867-hybrid_WDSV_NC001867,1_1_5_5_1,102,72
chrLGE22-991673_991839,cPa67,0.384615384615385,12,991828,991678,cPa194_cPa194-cPa308-hybrid_cPa194-cPa345-hybrid_cPa194-cPa67-hybrid_cPa194-unknown_cPa345_cPa345-cPa194-hybrid_cPa345-FeFV_NC001871-hybrid_cPa345-unknown_cPa67_cPa67-unknown_cPa75-cPa67-hybrid,36_1_1_2_7_34_1_1_2_55_2_1,166,150
chrLGE22-991930_992041,cPa345_cPa67,0.375,4,991989,991942,cPa194-unknown_cPa345_cPa345-unknown_cPa67,1_3_1_3,111,47
chrZ-10020387_10020489,cPa363,0.5,3,10020448,10020437,cPa117-cPa587-hybrid_cPa363_cPa456,1_2_1,102,11
chrZ-10026882_10026984,cPa75,0.666666666666667,2,10026932,10026932,cPa71-cPa62-hybrid_cPa75,1_2,102,0
chrZ-10027102_10027204,cPa75,0.4,4,10027162,10027152,cPa62-HERV-W_repbase_HERV17_LTR17-hybrid_cPa71-cPa62-hybrid_cPa75_HERV-W_repbase_HERV17_LTR17,1_1_2_1,102,10
chrZ-10048440_10048542,cPa75,1,1,10048490,10048490,cPa75,1,102,0
chrZ-10048658_10048760,cPa75,1,1,10048708,10048708,cPa75,1,102,0
chrZ-10132696_10132798,cPa75,1,1,10132746,10132746,cPa75,1,102,0
chrZ-10148798_10148900,cPa62,1,1,10148848,10148826,cPa62,8,102,22
chrZ-10217013_10217115,cPa62,1,1,10217088,10217063,cPa62,4,102,25
chrZ-10245361_10245463,cPa62,1,1,10245445,10245380,cPa62,4,102,65
chrZ-10267090_10267192,cPa62,0.977272727272727,2,10267154,10267137,cPa450-cPa62-hybrid_cPa62,1_43,102,17
chrZ-10269873_10269975,cPa62,0.8,2,10269923,10269898,cPa62_cPa62-unknown,4_1,102,25
chrZ-10270002_10270104,cPa62,0.8,2,10270080,10270031,cPa62_cPa62-unknown,4_1,102,49
chrZ-10304710_10304812,cPa62,1,1,10304807,10304710,cPa62,18,102,97
chrZ-10336470_10336592,cPa75,1,1,10336542,10336520,cPa75,12,122,22
chrZ-10412145_10412365,cPa75-unknown,1,1,10412313,10412195,cPa75-unknown,10,220,118
chrZ-10412502_10412639,cPa75-unknown,1,1,10412587,10412534,cPa75-unknown,5,137,53
chrZ-10476763_10476865,WDSV_NC001867-cPa62-hybrid_WDSV_NC001867-unknown,0.5,2,10476830,10476813,WDSV_NC001867-cPa62-hybrid_WDSV_NC001867-unknown,1_1,102,17
chrZ-10477212_10477317,cPa62,0.928571428571429,2,10477273,10477246,cPa62_cPa71,13_1,105,27
chrZ-10488102_10488224,cPa62,1,1,10488178,10488151,cPa62,31,122,27
chrZ-10488522_10488624,cPa62,1,1,10488601,10488570,cPa62,7,102,31
chrZ-10576281_10576383,cPa75,0.666666666666667,2,10576331,10576314,cPa174-cPa75-hybrid_cPa75,1_2,102,17
chrZ-10597107_10597209,cPa293-cPa113-hybrid_cPa75,0.5,2,10597157,10597106,cPa293-cPa113-hybrid_cPa75,1_1,102,51
chrZ-10597731_10597833,cPa62,1,1,10597781,10597781,cPa62,1,102,0
chrZ-10597901_10598061,cPa75,0.5,3,10598009,10597951,cPa201-cPa113-hybrid_cPa62_cPa75,1_1_2,160,58
chrZ-10598474_10598840,cPa75,0.727272727272727,3,10598788,10598488,cPa293-cPa75-hybrid_cPa62_cPa75,1_2_8,366,300
chrZ-10602240_10602342,cPa260-cPa62-hybrid_cPa293-cPa62-hybrid_cPa62,0.333333333333333,3,10602320,10602290,cPa260-cPa62-hybrid_cPa293-cPa62-hybrid_cPa62,1_1_1,102,30
chrZ-10602343_10602475,cPa71-cPa62-hybrid_cPa75-cPa62-hybrid,0.333333333333333,4,10602423,10602393,cPa16_cPa71_cPa71-cPa62-hybrid_cPa75-cPa62-hybrid,1_1_2_2,132,30
chrZ-10602481_10602701,cPa71_cPa75,0.25,7,10602650,10602527,cPa260-cPa62-hybrid_cPa293-cPa62-hybrid_cPa71_cPa71-cPa62-hybrid_cPa75_cPa75-cPa62-hybrid_cPa75-cPa71-hybrid,1_1_3_1_3_2_1,220,123
chrZ-10753332_10753434,cPa62-unknown,1,1,10753382,10753375,cPa62-unknown,2,102,7
chrZ-10778155_10778393,cPa71,0.260869565217391,8,10778385,10778168,cPa15-cPa390-hybrid_cPa16_cPa16-cPa363-hybrid_cPa16-unknown_cPa363_cPa446-cPa363-hybrid_cPa452_cPa71,1_4_1_1_4_1_5_6,238,217
chrZ-10778455_10778571,cPa16-unknown_cPa452_cPa71,0.333333333333333,3,10778520,10778505,cPa16-unknown_cPa452_cPa71,1_1_1,116,15
chrZ-10779144_10779246,cPa363_cPa452,0.363636363636364,4,10779226,10779144,cPa16-cPa379-hybrid_cPa363_cPa452_cPa71,1_4_4_2,102,82
chrZ-10780175_10780277,cPa16_cPa363_cPa452,0.272727272727273,4,10780261,10780188,cPa16_cPa363_cPa452_cPa71,3_3_3_2,102,73
chrZ-10780323_10780514,cPa452,0.3,7,10780462,10780328,cPa111-cPa71-hybrid_cPa111-unknown_cPa363_cPa363-cPa176-hybrid_cPa363-cPa452-hybrid_cPa452_cPa71,1_1_2_1_1_3_1,191,134
chrZ-10780560_10780726,cPa452,0.368421052631579,5,10780691,10780581,cPa16_cPa363_cPa363-unknown_cPa452_cPa71,5_5_1_7_1,166,110
chrZ-1083322_1083424,cPa254_cPa425_cPa47,0.333333333333333,3,1083372,1083372,cPa254_cPa425_cPa47,1_1_1,102,0
chrZ-10913891_10913993,cPa456,0.473684210526316,6,10913954,10913909,cPa363_cPa363-cPa587-hybrid_cPa363-unknown_cPa452-cPa587-hybrid_cPa452-unknown_cPa456,5_1_1_1_2_9,102,45
chrZ-10989055_10989157,cPa247,0.625,4,10989139,10989063,cPa247_cPa247-cPa61-hybrid_cPa51-cPa61-hybrid_cPa51-unknown,10_2_2_2,102,76
chrZ-10989180_10989282,cPa247_cPa51-cPa61-hybrid_HML4_repbase_HERVK13I_LTR13,0.333333333333333,3,10989230,10989225,cPa247_cPa51-cPa61-hybrid_HML4_repbase_HERVK13I_LTR13,1_1_1,102,5
chrZ-10989291_10989435,cPa247,1,1,10989383,10989341,cPa247,3,144,42
chrZ-10989811_10989942,cPa51-cPa61-hybrid,0.625,2,10989942,10989860,cPa247-cPa61-hybrid_cPa51-cPa61-hybrid,3_5,131,82
chrZ-11004032_11004134,cPa109-cPa223-hybrid,1,1,11004082,11004082,cPa109-cPa223-hybrid,1,102,0
chrZ-11026783_11026971,cPa363,0.5,5,11026926,11026798,cPa363_cPa452-cPa363-hybrid_cPa587_cPa587-cPa363-hybrid_cPa587-cPa456-hybrid,7_1_2_2_2,188,128
chrZ-1125183_1125285,cPa15,1,1,1125233,1125233,cPa15,1,102,0
chrZ-1126905_1127007,cPa62,1,1,1126985,1126955,cPa62,3,102,30
chrZ-1127028_1127271,cPa62,0.8125,3,1127219,1127078,cPa285-cPa15-hybrid_cPa293_cPa62,1_2_13,243,141
chrZ-1127860_1127962,cPa62,1,1,1127916,1127910,cPa62,2,102,6
chrZ-11618851_11618953,cPa363_cPa452-unknown,0.5,2,11618901,11618901,cPa363_cPa452-unknown,1_1,102,0
chrZ-1164774_1164919,cPa62-cPa75-hybrid,1,1,1164867,1164817,cPa62-cPa75-hybrid,19,145,50
chrZ-1164953_1165298,cPa62-cPa75-hybrid,1,1,1165285,1165003,cPa62-cPa75-hybrid,22,345,282
chrZ-11925059_11925161,cPa363_cPa456_cPa456-cPa452-hybrid,0.333333333333333,3,11925109,11925099,cPa363_cPa456_cPa456-cPa452-hybrid,1_1_1,102,10
chrZ-12129987_12130089,cPa62,0.944444444444444,3,12130054,12130015,cPa62_cPa62-unknown_cPa62-WDSV_NC001867-hybrid,34_1_1,102,39
chrZ-12169778_12169880,cPa62,0.875,2,12169840,12169824,cPa285_cPa62,2_14,102,16
chrZ-12253464_12253566,cPa339_cPa357,0.5,2,12253514,12253514,cPa339_cPa357,1_1,102,0
chrZ-1231315_1231619,cPa308,0.925925925925926,3,1231617,1231315,cPa308_cPa308-unknown_cPa62,50_2_2,304,302
chrZ-12325871_12325973,cPa62,0.5,3,12325973,12325921,cPa293_cPa62_cPa75-cPa62-hybrid,1_2_1,102,52
chrZ-1239422_1239524,cPa391-cPa71-hybrid,1,1,1239472,1239472,cPa391-cPa71-hybrid,1,102,0
chrZ-12396094_12396196,cPa345,1,1,12396144,12396144,cPa345,1,102,0
chrZ-1239712_1239822,cPa363_cPa363-cPa71-hybrid_cPa391-cPa363-hybrid,0.333333333333333,3,1239777,1239762,cPa363_cPa363-cPa71-hybrid_cPa391-cPa363-hybrid,1_1_1,110,15
chrZ-1239900_1240075,cPa363,0.266666666666667,8,1240061,1239904,cPa16_cPa16-cPa452-hybrid_cPa363_cPa391-cPa16-hybrid_cPa391-cPa452-hybrid_cPa452_cPa71_cPa71-cPa363-hybrid,2_1_4_1_1_2_3_1,175,157
chrZ-1240870_1241027,cPa223-cPa446-hybrid,0.25,9,1241024,1240920,cPa183-cPa327-hybrid_cPa223_cPa223-cPa363-hybrid_cPa223-cPa446-hybrid_cPa327-cPa446-hybrid_cPa379_cPa379-cPa446-hybrid_cPa446_cPa71-cPa327-hybrid,1_3_1_5_4_1_1_3_1,157,104
chrZ-1241039_1241171,cPa223,0.5,11,1241130,1241040,cPa183-cPa446-hybrid_cPa223_cPa223-cPa424-hybrid_cPa223-cPa446-hybrid_cPa223-unknown_cPa327_cPa327-cPa446-hybrid_cPa363_cPa446_cPa452_cPa452-cPa446-hybrid,1_21_1_3_3_1_1_2_7_1_1,132,90
chrZ-1241254_1241356,cPa223,0.428571428571429,5,1241304,1241263,cPa223_cPa223-unknown_cPa327_cPa363-cPa446-hybrid_cPa446,6_1_1_1_5,102,41
chrZ-12427862_12427964,cPa479,0.428571428571429,9,12427912,12427883,cPa131_cPa131-cPa246-hybrid_cPa131-cPa255-hybrid_cPa150_cPa150-cPa131-hybrid_cPa150-cPa246-hybrid_cPa150-cPa255-hybrid_cPa255_cPa479,2_1_1_5_1_3_6_1_15,102,29
chrZ-12543536_12543638,cPa75,0.75,2,12543607,12543586,cPa75_cPa75-unknown,3_1,102,21
chrZ-12543759_12543861,cPa75,0.75,3,12543821,12543787,cPa71_cPa75_KoRV_AF151794-unknown,1_6_1,102,34
chrZ-1257210_1257312,cPa199-cPa381-hybrid_cPa273,0.5,2,1257299,1257260,cPa199-cPa381-hybrid_cPa273,1_1,102,39
chrZ-1257370_1257472,cPa199_cPa223_cPa345_cPa450_cPa542_cPa553,0.166666666666667,6,1257420,1257420,cPa199_cPa223_cPa345_cPa450_cPa542_cPa553,1_1_1_1_1_1,102,0
chrZ-12613641_12613754,cPa540,0.391304347826087,8,12613706,12613689,cPa127_cPa241_cPa290_cPa515_cPa515-cPa530-hybrid_cPa540_cPa540-cPa530-hybrid_cPa540-unknown,5_1_2_2_1_9_2_1,113,17
chrZ-12736390_12736502,cPa540,0.333333333333333,8,12736468,12736438,cPa241_cPa241-cPa531-hybrid_cPa241-cPa540-hybrid_cPa290_cPa290-cPa531-hybrid_cPa515_cPa515-cPa531-hybrid_cPa540,5_2_1_10_1_4_1_12,112,30
chrZ-12739117_12739219,cPa75,0.428571428571429,5,12739167,12739131,cPa113-cPa62-hybrid_cPa293-cPa62-hybrid_cPa62_cPa75_cPa75-cPa62-hybrid,1_1_1_3_1,102,36
chrZ-1278862_1278976,cPa118_cPa15_cPa248-unknown,0.333333333333333,3,1278924,1278912,cPa118_cPa15_cPa248-unknown,1_1_1,114,12
chrZ-1293810_1293912,cPa62,1,1,1293890,1293836,cPa62,7,102,54
chrZ-13085148_13085298,cPa357,1,1,13085275,13085198,cPa357,15,150,77
chrZ-1314709_1314811,cPa260-cPa75-hybrid,1,1,1314759,1314759,cPa260-cPa75-hybrid,1,102,0
chrZ-1314824_1314929,cPa157-cPa75-hybrid_SMRV_NC001514-cPa75-hybrid,0.5,2,1314877,1314874,cPa157-cPa75-hybrid_SMRV_NC001514-cPa75-hybrid,1_1,105,3
chrZ-1315221_1315323,cPa332-cPa285-hybrid_cPa75,0.5,2,1315271,1315271,cPa332-cPa285-hybrid_cPa75,1_1,102,0
chrZ-13214318_13214424,cPa107-unknown,0.538461538461538,2,13214402,13214335,cPa107-cPa447-hybrid_cPa107-unknown,12_14,106,67
chrZ-1322393_1322610,cPa62,1,1,1322558,1322443,cPa62,16,217,115
chrZ-1322663_1322765,cPa62,1,1,1322713,1322713,cPa62,1,102,0
chrZ-1322773_1322875,cPa62,1,1,1322825,1322823,cPa62,2,102,2
chrZ-13230086_13230298,cPa71,0.583333333333333,5,13230286,13230094,cPa16_cPa16-cPa379-hybrid_cPa379_cPa71_cPa71-cPa16-hybrid,15_1_3_28_1,212,192
chrZ-1339431_1339533,cPa345-cPa434-hybrid,1,1,1339481,1339481,cPa345-cPa434-hybrid,1,102,0
chrZ-13425731_13425833,cPa419,1,1,13425781,13425781,cPa419,1,102,0
chrZ-13501409_13501511,cPa479-cPa438-hybrid,0.285714285714286,6,13501497,13501459,cPa131-cPa438-hybrid_cPa131-cPa463-hybrid_cPa131-cPa526-hybrid_cPa255-cPa438-hybrid_cPa479-cPa438-hybrid_cPa563,1_1_1_1_2_1,102,38
chrZ-13584086_13584188,cPa546_cPa75-unknown,0.5,2,13584187,13584136,cPa546_cPa75-unknown,1_1,102,51
chrZ-13584233_13584335,cPa75-unknown,1,1,13584283,13584283,cPa75-unknown,1,102,0
chrZ-1370253_1370355,cPa75,1,1,1370303,1370303,cPa75,1,102,0
chrZ-1370588_1370771,HERV-W_repbase_HERV17_LTR17,0.666666666666667,2,1370762,1370638,cPa75_HERV-W_repbase_HERV17_LTR17,1_2,183,124
chrZ-1370916_1371018,HERV-W_repbase_HERV17_LTR17,0.857142857142857,2,1370984,1370962,cPa75_HERV-W_repbase_HERV17_LTR17,1_6,102,22
chrZ-1371035_1371177,HERV-W_repbase_HERV17_LTR17,1,1,1371130,1371069,HERV-W_repbase_HERV17_LTR17,4,142,61
chrZ-1371256_1371358,HERV-W_repbase_HERV17_LTR17,1,1,1371355,1371273,HERV-W_repbase_HERV17_LTR17,7,102,82
chrZ-13869626_13869728,cPa62,1,1,13869679,13869661,cPa62,22,102,18
chrZ-14134326_14134428,cPa34-cPa75-hybrid,1,1,14134376,14134376,cPa34-cPa75-hybrid,1,102,0
chrZ-14141765_14141867,cPa358_cPa583,0.4,3,14141852,14141815,cPa251_cPa358_cPa583,1_2_2,102,37
chrZ-1417909_1418011,WDSV_NC001867,0.666666666666667,2,1417998,1417959,WDSV_NC001867_WDSV_NC001867-unknown,2_1,102,39
chrZ-14199691_14199793,cPa75-unknown,1,1,14199741,14199741,cPa75-unknown,1,102,0
chrZ-1425031_1425133,cPa62,1,1,1425081,1425081,cPa62,1,102,0
chrZ-1425196_1425460,HERV-W_repbase_HERV17_LTR17,0.444444444444444,5,1425437,1425239,cPa62_cPa75_cPa75-cPa62-hybrid_HERV-W_repbase_HERV17_LTR17_HERV-W_repbase_HERV17_LTR17-cPa62-hybrid,1_4_1_8_4,264,198
chrZ-1425557_1425825,HERV-W_repbase_HERV17_LTR17,0.65,6,1425787,1425591,cPa62_cPa75_cPa75-cPa62-hybrid_HERV-W_repbase_HERV17_LTR17_HERV-W_repbase_HERV17_LTR17-cPa62-hybrid_KoRV_AF151794,2_6_2_26_3_1,268,196
chrZ-1425880_1425991,cPa75_HERV-W_repbase_HERV17_LTR17,0.384615384615385,4,1425984,1425930,cPa75_cPa75-cPa62-hybrid_HERV-W_repbase_HERV17_LTR17_HERV-W_repbase_HERV17_LTR17-cPa62-hybrid,5_1_5_2,111,54
chrZ-1426028_1426130,HERV-W_repbase_HERV17_LTR17,0.875,2,1426078,1426043,cPa75_HERV-W_repbase_HERV17_LTR17,1_7,102,35
chrZ-1430002_1430104,cPa302_cPa75-unknown,0.5,2,1430086,1430052,cPa302_cPa75-unknown,1_1,102,34
chrZ-14399625_14399727,cPa101,0.666666666666667,2,14399676,14399665,cPa101_cPa582,2_1,102,11
chrZ-1445763_1445952,cPa62,0.818181818181818,2,1445913,1445813,cPa62_cPa62-cPa75-hybrid,9_2,189,100
chrZ-1447114_1447252,cPa62_cPa62-cPa75-hybrid_HERV-W_repbase_HERV17_LTR17-unknown,0.3,4,1447200,1447164,cPa62_cPa62-cPa75-hybrid_HERV-W_repbase_HERV17_LTR17_HERV-W_repbase_HERV17_LTR17-unknown,3_3_1_3,138,36
chrZ-1447360_1447794,HERV-W_repbase_HERV17_LTR17-unknown,0.4,9,1447742,1447409,cPa62_cPa62-cPa75-hybrid_cPa71_cPa71-cPa75-hybrid_cPa71-unknown_cPa75_HERV-W_repbase_HERV17_LTR17_HERV-W_repbase_HERV17_LTR17-cPa75-hybrid_HERV-W_repbase_HERV17_LTR17-unknown,2_1_1_3_2_6_4_5_16,434,333
chrZ-1451126_1451228,cPa539-cPa62-hybrid,1,1,1451176,1451176,cPa539-cPa62-hybrid,1,102,0
chrZ-1454530_1454632,cPa472,0.833333333333333,2,1454583,1454529,cPa472_cPa472-unknown,5_1,102,54
chrZ-14573757_14573859,cPa555,0.333333333333333,6,14573845,14573799,cPa257_cPa546-cPa257-hybrid_cPa546-cPa60-hybrid_cPa555_cPa555-cPa257-hybrid_cPa555-cPa60-hybrid,1_7_2_8_4_2,102,46
chrZ-14689183_14689285,cPa260_cPa75,0.5,2,14689233,14689229,cPa260_cPa75,1_1,102,4
chrZ-14689318_14689420,cPa260,0.5,3,14689391,14689348,cPa260_cPa260-cPa75-hybrid_cPa75,3_1_2,102,43
chrZ-14709021_14709192,cPa75,0.357142857142857,11,14709178,14709020,CAEV_NC001463-cPa75-hybrid_cPa285_cPa293_cPa402_cPa62_cPa62-cPa285-hybrid_cPa62-cPa293-hybrid_cPa62-cPa75-hybrid_cPa62-unknown_cPa75_cPa75-cPa109-hybrid,1_1_2_1_9_1_1_2_8_15_1,171,158
chrZ-14731179_14731281,cPa62,0.272727272727273,6,14731241,14731199,cPa254-cPa62-hybrid_cPa293-cPa62-hybrid_cPa62_cPa75_cPa75-cPa62-hybrid_cPa75-unknown,2_1_3_2_2_1,102,42
chrZ-14731457_14731559,cPa62,0.35,7,14731554,14731474,cPa201-cPa419-hybrid_cPa254-cPa62-hybrid_cPa285_cPa62_cPa75_cPa75-cPa62-hybrid_cPa75-unknown,1_2_1_7_1_3_5,102,80
chrZ-1477412_1477694,cPa62,0.711111111111111,3,1477664,1477462,cPa62_cPa62-cPa75-hybrid_cPa75,32_1_12,282,202
chrZ-1477841_1477995,cPa62,0.666666666666667,2,1477960,1477884,cPa62_cPa75,16_8,154,76
chrZ-1478169_1478271,cPa62,1,1,1478219,1478219,cPa62,1,102,0
chrZ-15003565_15003684,cPa62,0.96,2,15003646,15003599,cPa62_cPa62-unknown,24_1,119,47
chrZ-15089294_15089420,cPa450,0.426086956521739,12,15089391,15089297,cPa199_cPa199-cPa227-hybrid_cPa199-cPa273-hybrid_cPa199-cPa450-hybrid_cPa199-cPa542-hybrid_cPa199-cPa553-hybrid_cPa199-unknown_cPa227_cPa273_cPa450_cPa542_cPa553,7_4_14_3_5_9_6_4_9_49_4_1,126,94
chrZ-15147720_15147822,cPa62,1,1,15147789,15147770,cPa62,3,102,19
chrZ-15155802_15155911,cPa339,0.254385964912281,10,15155894,15155806,cPa339_cPa339-cPa447-hybrid_cPa339-cPa62-hybrid_cPa339-unknown_cPa444-cPa339-hybrid_cPa444-cPa390-hybrid_cPa444-cPa447-hybrid_cPa444-cPa62-hybrid_cPa444-unknown_cPa447,29_7_1_2_5_8_23_5_13_21,109,88
chrZ-15287438_15287553,cPa456,0.4,8,15287541,15287465,cPa363_cPa363-cPa117-hybrid_cPa363-cPa452-hybrid_cPa419-cPa117-hybrid_cPa456_cPa456-cPa117-hybrid_cPa543-cPa117-hybrid_cPa587-cPa117-hybrid,8_1_1_1_14_6_1_3,115,76
chrZ-15440367_15440469,cPa452,1,1,15440417,15440417,cPa452,1,102,0
chrZ-15452216_15452372,cPa75,0.5,3,15452320,15452266,cPa75_cPa75-HERV-W_repbase_HERV17_LTR17-hybrid_HERV-W_repbase_HERV17_LTR17,2_1_1,156,54
chrZ-15452809_15453059,cPa75_cPa75-HERV-W_repbase_HERV17_LTR17-hybrid,0.5,2,15453007,15452859,cPa75_cPa75-HERV-W_repbase_HERV17_LTR17-hybrid,4_4,250,148
chrZ-15453122_15453224,cPa75-HERV-W_repbase_HERV17_LTR17-hybrid_HERV-W_repbase_HERV17_LTR17,0.5,2,15453221,15453172,cPa75-HERV-W_repbase_HERV17_LTR17-hybrid_HERV-W_repbase_HERV17_LTR17,1_1,102,49
chrZ-1546998_1547100,cPa142,1,1,1547048,1547048,cPa142,1,102,0
chrZ-15531044_15531211,cPa540,0.577777777777778,8,15531205,15531086,cPa127_cPa127-cPa11-hybrid_cPa241-cPa11-hybrid_cPa515_cPa515-cPa11-hybrid_cPa515-unknown_cPa540_cPa540-cPa11-hybrid,6_1_5_1_4_1_26_1,167,119
chrZ-15639434_15639536,cPa188-EqFV_NC002201-hybrid,0.5,4,15639498,15639443,cPa188-EqFV_NC002201-hybrid_cPa188-HML7_repbase_HERVK11DI_MER11D-hybrid_cPa188-unknown_cPa545-EqFV_NC002201-hybrid,6_1_2_3,102,55
chrZ-15640318_15640430,HML7_repbase_HERVK11DI_MER11D,0.84,2,15640380,15640330,HML7_repbase_HERVK11DI_MER11D_HML7_repbase_HERVK11DI_MER11D-unknown,21_4,112,50
chrZ-1570495_1570597,cPa75_HERV-W_repbase_HERV17_LTR17-cPa75-hybrid,0.5,2,1570595,1570545,cPa75_HERV-W_repbase_HERV17_LTR17-cPa75-hybrid,1_1,102,50
chrZ-1585274_1585461,cPa62,1,1,1585409,1585324,cPa62,7,187,85
chrZ-16058054_16058167,cPa174-cPa404-hybrid_cPa254_cPa425_cPa47,0.25,4,16058115,16058104,cPa174-cPa404-hybrid_cPa254_cPa425_cPa47,1_1_1_1,113,11
chrZ-16069261_16069363,cPa75,1,1,16069320,16069311,cPa75,29,102,9
chrZ-16237370_16237472,cPa555-HERV-W_repbase_HERV17_LTR17-hybrid_cPa95-HERV-W_repbase_HERV17_LTR17-hybrid,0.285714285714286,5,16237421,16237392,cPa272-cPa75-hybrid_cPa272-S71_repbase_HERVS71_LTR6A-hybrid_cPa555-HERV-W_repbase_HERV17_LTR17-hybrid_cPa95-HERV-W_repbase_HERV17_LTR17-hybrid_cPa95-S71_repbase_HERVS71_LTR6A-hybrid,1_1_2_2_1,102,29
chrZ-16237618_16237720,cPa95-HERV-W_repbase_HERV17_LTR17-hybrid,0.255813953488372,9,16237670,16237668,cPa272-cPa75-hybrid_cPa272-GaLV_M26927-hybrid_cPa272-HERV-W_repbase_HERV17_LTR17-hybrid_cPa272-S71_repbase_HERVS71_LTR6A-hybrid_cPa555-GaLV_M26927-hybrid_cPa555-HERV-W_repbase_HERV17_LTR17-hybrid_cPa555-S71_repbase_HERVS71_LTR6A-hybrid_cPa95-GaLV_M26927-hybrid_cPa95-HERV-W_repbase_HERV17_LTR17-hybrid,4_2_10_1_3_10_1_1_11,102,2
chrZ-16270681_16270783,cPa339_cPa390_cPa447,0.285714285714286,4,16270741,16270731,cPa339_cPa390_cPa444-unknown_cPa447,2_2_1_2,102,10
chrZ-16334472_16334574,cPa363_cPa456,0.333333333333333,4,16334525,16334520,cPa363_cPa456_cPa587-cPa117-hybrid_cPa75-cPa117-hybrid,2_2_1_1,102,5
chrZ-16538751_16538853,cPa47,0.714285714285714,2,16538843,16538788,cPa425_cPa47,2_5,102,55
chrZ-16539910_16540083,cPa47,0.375,5,16540061,16539940,cPa174_cPa404_cPa404-unknown_cPa425_cPa47,5_2_1_7_9,173,121
chrZ-16641316_16641418,cPa15,0.666666666666667,2,16641370,16641366,cPa118_cPa15,1_2,102,4
chrZ-16962605_16962707,HERV-R_repbase_HERV3_LTR4-cPa530-hybrid,1,1,16962655,16962655,HERV-R_repbase_HERV3_LTR4-cPa530-hybrid,1,102,0
chrZ-16962985_16963094,HERV-R_repbase_HERV3_LTR4-unknown,0.6,2,16963044,16963035,HERV-R_repbase_HERV3_LTR4-cPa138-hybrid_HERV-R_repbase_HERV3_LTR4-unknown,2_3,109,9
chrZ-16966569_16966876,cPa127,0.226130653266332,61,16966874,16966570,cPa11_cPa11-cPa127-hybrid_cPa11-cPa290-hybrid_cPa11-cPa356-hybrid_cPa11-cPa515-hybrid_cPa11-cPa530-hybrid_cPa11-cPa531-hybrid_cPa11-cPa540-hybrid_cPa11-cPa552-hybrid_cPa11-cPa555-hybrid_cPa11-unknown_cPa127_cPa127-cPa356-hybrid_cPa127-cPa515-hybrid_cPa127-cPa530-hybrid_cPa127-cPa540-hybrid_cPa127-unknown_cPa241_cPa241-cPa127-hybrid_cPa241-cPa356-hybrid_cPa241-cPa515-hybrid_cPa241-cPa530-hybrid_cPa241-cPa540-hybrid_cPa241-cPa552-hybrid_cPa241-cPa555-hybrid_cPa241-unknown_cPa356_cPa356-cPa515-hybrid_cPa356-cPa530-hybrid_cPa356-cPa540-hybrid_cPa356-cPa552-hybrid_cPa356-unknown_cPa419_cPa511-cPa241-hybrid_cPa511-cPa515-hybrid_cPa515_cPa515-cPa356-hybrid_cPa515-cPa530-hybrid_cPa530_cPa530-cPa515-hybrid_cPa531_cPa531-cPa127-hybrid_cPa531-cPa241-hybrid_cPa531-cPa515-hybrid_cPa531-cPa530-hybrid_cPa531-cPa540-hybrid_cPa531-cPa555-hybrid_cPa531-unknown_cPa540_cPa540-cPa127-hybrid_cPa540-cPa515-hybrid_cPa540-cPa530-hybrid_cPa540-cPa531-hybrid_cPa540-unknown_cPa552_cPa552-cPa127-hybrid_cPa552-cPa515-hybrid_cPa552-cPa530-hybrid_cPa552-unknown_cPa555_cPa555-cPa530-hybrid,16_8_2_11_5_9_1_2_1_3_15_135_1_2_1_1_1_10_1_1_7_12_1_2_1_1_75_2_8_2_1_3_3_1_1_58_1_2_11_1_39_1_1_2_3_2_1_3_76_1_2_4_1_6_20_2_1_3_2_7_1,307,304
chrZ-16966936_16967038,cPa127,0.25,7,16966986,16966935,cPa11_cPa11-cPa515-hybrid_cPa127_cPa356_cPa419_cPa530_cPa552,1_1_2_1_1_1_1,102,51
chrZ-17090900_17091002,cPa62,0.8,2,17090973,17090919,cPa62_cPa62-unknown,4_1,102,54
chrZ-1713176_1713278,cPa62,0.9375,2,1713226,1713188,cPa62_cPa62-unknown,15_1,102,38
chrZ-17165173_17165275,CAEV_NC001463,0.666666666666667,2,17165254,17165192,CAEV_NC001463_CAEV_NC001463-HML7_repbase_HERVK11DI_MER11D-hybrid,2_1,102,62
chrZ-17222418_17222535,cPa75-cPa62-hybrid,0.625,4,17222520,17222468,cPa201_cPa62_cPa75_cPa75-cPa62-hybrid,1_1_1_5,117,52
chrZ-1735697_1735867,cPa75,0.525,7,1735839,1735742,cPa62-HERV-W_repbase_HERV17_LTR17-hybrid_cPa71-cPa62-hybrid_cPa75_cPa75-HERV-W_repbase_HERV17_LTR17-hybrid_HERV-W_repbase_HERV17_LTR17_HERV-W_repbase_HERV17_LTR17-cPa62-hybrid_HERV-W_repbase_HERV17_LTR17-cPa75-hybrid,2_1_21_2_11_2_1,170,97
chrZ-17612059_17612216,cPa104,0.412280701754386,13,17612198,17612109,cPa104_cPa190_cPa219_cPa220_cPa220-cPa104-hybrid_cPa220-cPa190-hybrid_cPa220-cPa219-hybrid_cPa258_cPa258-cPa104-hybrid_cPa258-cPa190-hybrid_cPa258-cPa219-hybrid_cPa258-cPa220-hybrid_cPa258-unknown,47_12_22_9_1_2_2_1_3_4_7_1_3,157,89
chrZ-17703394_17703496,cPa62,1,1,17703444,17703444,cPa62,1,102,0
chrZ-18066505_18066701,HERV-W_repbase_HERV17_LTR17-cPa75-hybrid,0.555555555555556,3,18066652,18066555,cPa482-cPa75-hybrid_cPa75_HERV-W_repbase_HERV17_LTR17-cPa75-hybrid,1_3_5,196,97
chrZ-18066961_18067097,cPa75,0.5,3,18067075,18067011,cPa75_HERV-W_repbase_HERV17_LTR17_HERV-W_repbase_HERV17_LTR17-cPa75-hybrid,6_1_5,136,64
chrZ-1818128_1818234,cPa62,1,1,1818182,1818166,cPa62,13,106,16
chrZ-18228907_18229009,cPa529,0.333333333333333,5,18228960,18228931,cPa14-unknown_cPa247_cPa452_cPa456_cPa529,1_1_1_1_2,102,29
chrZ-18301_18403,cPa529-cPa254-hybrid,1,1,18351,18351,cPa529-cPa254-hybrid,1,102,0
chrZ-18696942_18697044,cPa220,0.333333333333333,5,18697004,18696985,cPa104-cPa18-hybrid_cPa104-cPa190-hybrid_cPa104-cPa220-hybrid_cPa190_cPa220,6_2_2_4_7,102,19
chrZ-18734805_18734909,cPa62,1,1,18734859,18734812,cPa62,12,104,47
chrZ-18734912_18735014,cPa62,1,1,18734962,18734946,cPa62,3,102,16
chrZ-1897427_1897529,cPa447,1,1,1897478,1897477,cPa447,2,102,1
chrZ-19196271_19196373,cPa75,1,1,19196324,19196281,cPa75,5,102,43
chrZ-19242965_19243077,cPa241-unknown,0.970588235294118,2,19243026,19243010,cPa241-unknown_cPa419,33_1,112,16
chrZ-19314915_19315017,cPa62,0.972222222222222,2,19314988,19314938,cPa285-cPa62-hybrid_cPa62,1_35,102,50
chrZ-19505737_19505839,cPa452,0.583333333333333,3,19505823,19505761,cPa363_cPa452_cPa452-unknown,4_7_1,102,62
chrZ-19506103_19506257,cPa363,0.5,5,19506247,19506112,cPa363_cPa452_cPa452-cPa363-hybrid_cPa452-cPa587-hybrid_cPa587,10_6_1_1_2,154,135
chrZ-1959535_1959637,cPa62,1,1,1959585,1959538,cPa62,2,102,47
chrZ-1970901_1971003,cPa75,1,1,1970951,1970951,cPa75,1,102,0
chrZ-1976250_1976352,cPa75-unknown,1,1,1976300,1976300,cPa75-unknown,1,102,0
chrZ-1977799_1977901,cPa308,0.5,3,1977859,1977849,cPa308_cPa353_cPa353-unknown,3_2_1,102,10
chrZ-19844722_19844873,cPa62-unknown,0.533333333333333,4,19844853,19844732,cPa62-cPa75-hybrid_cPa62-HERV-W_repbase_HERV17_LTR17-hybrid_cPa62-unknown_cPa75,4_2_8_1,151,121
chrZ-19844882_19844985,cPa62-unknown_cPa75,0.363636363636364,4,19844963,19844891,cPa62-cPa75-hybrid_cPa62-HERV-W_repbase_HERV17_LTR17-hybrid_cPa62-unknown_cPa75,2_1_4_4,103,72
chrZ-19890860_19890962,cPa75,1,1,19890910,19890910,cPa75,1,102,0
chrZ-19891031_19891308,cPa75,0.521739130434783,7,19891256,19891033,cPa62_cPa62-cPa71-hybrid_cPa62-cPa75-hybrid_cPa62-unknown_cPa71-cPa75-hybrid_cPa75_cPa75-unknown,14_1_3_2_1_24_1,277,223
chrZ-19891373_19891533,cPa62,0.454545454545455,7,19891495,19891410,cPa62_cPa62-cPa75-hybrid_cPa62-unknown_cPa71_cPa71-cPa75-hybrid_cPa75_cPa75-unknown,30_4_4_1_1_25_1,160,85
chrZ-20013133_20013235,cPa62,1,1,20013186,20013164,cPa62,7,102,22
chrZ-20264419_20264533,cPa150_cPa150-cPa246-hybrid_cPa216-cPa302-hybrid_cPa246_cPa255-cPa246-hybrid,0.2,5,20264481,20264469,cPa150_cPa150-cPa246-hybrid_cPa216-cPa302-hybrid_cPa246_cPa255-cPa246-hybrid,1_1_1_1_1,114,12
chrZ-20329029_20329131,HERV-W_repbase_HERV17_LTR17,1,1,20329079,20329079,HERV-W_repbase_HERV17_LTR17,1,102,0
chrZ-20329500_20329602,HERV-W_repbase_HERV17_LTR17,0.736842105263158,3,20329555,20329520,cPa62_cPa62-HERV-W_repbase_HERV17_LTR17-hybrid_HERV-W_repbase_HERV17_LTR17,2_3_14,102,35
chrZ-20329736_20329838,HERV-W_repbase_HERV17_LTR17,1,1,20329786,20329776,HERV-W_repbase_HERV17_LTR17,3,102,10
chrZ-20330660_20330762,HERV-W_repbase_HERV17_LTR17,0.888888888888889,2,20330750,20330682,cPa75_HERV-W_repbase_HERV17_LTR17,1_8,102,68
chrZ-20330869_20331090,HERV-W_repbase_HERV17_LTR17,0.321428571428571,15,20331038,20330877,cPa62_cPa62-cPa71-hybrid_cPa62-HERV-W_repbase_HERV17_LTR17-hybrid_cPa62-KoRV_AF151794-hybrid_cPa62-unknown_cPa71_cPa71-KoRV_AF151794-hybrid_cPa71-unknown_cPa75_cPa75-HERV-W_repbase_HERV17_LTR17-hybrid_cPa75-KoRV_AF151794-hybrid_cPa75-unknown_HERV-W_repbase_HERV17_LTR17_HERV-W_repbase_HERV17_LTR17-KoRV_AF151794-hybrid_KoRV_AF151794,3_1_5_1_9_6_1_2_2_1_1_2_18_1_3,221,161
chrZ-20373105_20373271,cPa472,0.68,8,20373220,20373145,cPa395_cPa395-unknown_cPa419_cPa472_cPa472-unknown_cPa511-unknown_cPa527-unknown_cPa555,1_1_1_34_8_1_3_1,166,75
chrZ-20373550_20373652,cPa472-cPa315-hybrid,1,1,20373600,20373600,cPa472-cPa315-hybrid,1,102,0
chrZ-20416203_20416305,cPa529,0.8,2,20416259,20416249,cPa529_cPa529-cPa14-hybrid,4_1,102,10
chrZ-20467026_20467128,cPa529,0.5,4,20467082,20467067,cPa247_cPa247-cPa14-hybrid_cPa247-cPa95-hybrid_cPa529,1_1_2_4,102,15
chrZ-2053257_2053551,HERV-W_repbase_HERV17_LTR17-cPa62-hybrid,0.5,5,2053531,2053272,cPa75_cPa75-cPa62-hybrid_HERV-W_repbase_HERV17_LTR17_HERV-W_repbase_HERV17_LTR17-cPa62-hybrid_HERV-W_repbase_HERV17_LTR17-cPa75-hybrid,7_1_3_13_2,294,259
chrZ-2053730_2054136,cPa75,0.433333333333333,6,2054117,2053780,cPa62_cPa75_cPa75-cPa62-hybrid_HERV-W_repbase_HERV17_LTR17_HERV-W_repbase_HERV17_LTR17-cPa62-hybrid_HERV-W_repbase_HERV17_LTR17-cPa75-hybrid,1_13_1_4_8_3,406,337
chrZ-2054156_2054258,cPa75,0.5,3,2054257,2054168,cPa75_HERV-W_repbase_HERV17_LTR17-cPa62-hybrid_HERV-W_repbase_HERV17_LTR17-cPa75-hybrid,2_1_1,102,89
chrZ-2054279_2054409,HERV-W_repbase_HERV17_LTR17-cPa62-hybrid,0.44,4,2054406,2054280,cPa62_cPa75_HERV-W_repbase_HERV17_LTR17_HERV-W_repbase_HERV17_LTR17-cPa62-hybrid,1_7_6_11,130,126
chrZ-2057409_2057716,cPa75,0.571428571428571,4,2057686,2057459,cPa413-cPa62-hybrid_cPa413-unknown_cPa75_cPa75-cPa62-hybrid,1_1_8_4,307,227
chrZ-2057788_2058008,cPa75,0.571428571428571,4,2057997,2057838,cPa260-cPa62-hybrid_cPa62_cPa75_cPa75-cPa62-hybrid,1_1_4_1,220,159
chrZ-2058122_2058224,cPa75_cPa75-cPa62-hybrid,0.5,2,2058193,2058172,cPa75_cPa75-cPa62-hybrid,1_1,102,21
chrZ-20728525_20728627,cPa456_cPa456-cPa452-hybrid,0.5,2,20728575,20728529,cPa456_cPa456-cPa452-hybrid,1_1,102,46
chrZ-20728745_20728952,cPa465,0.433526011560694,21,20728952,20728795,cPa205_cPa247-cPa465-hybrid_cPa254-cPa465-hybrid_cPa298-cPa581-hybrid_cPa357-HERV-W_repbase_HERV17_LTR17-hybrid_cPa363_cPa363-cPa465-hybrid_cPa363-HERV-W_repbase_HERV17_LTR17-hybrid_cPa390-HERV-W_repbase_HERV17_LTR17-hybrid_cPa419_cPa452-cPa465-hybrid_cPa452-HERV-W_repbase_HERV17_LTR17-hybrid_cPa456-cPa131-hybrid_cPa456-cPa465-hybrid_cPa456-HERV-W_repbase_HERV17_LTR17-hybrid_cPa465_cPa465-HERV-W_repbase_HERV17_LTR17-hybrid_cPa61_cPa61-cPa465-hybrid_cPa61-HERV-W_repbase_HERV17_LTR17-hybrid_cPa71-HERV-W_repbase_HERV17_LTR17-hybrid,19_1_1_1_3_2_1_2_3_5_4_11_1_1_4_75_3_30_2_3_1,207,157
chrZ-20731527_20732128,cPa199,0.290804597701149,35,20732125,20731529,cPa138-cPa465-hybrid_cPa176-unknown_cPa183-cPa56-hybrid_cPa183-unknown_cPa199_cPa205_cPa223-unknown_cPa273-cPa119-hybrid_cPa273-cPa357-hybrid_cPa357-cPa199-hybrid_cPa363-unknown_cPa371-cPa56-hybrid_cPa390-cPa119-hybrid_cPa390-cPa199-hybrid_cPa390-cPa201-hybrid_cPa390-cPa332-hybrid_cPa390-cPa357-hybrid_cPa390-cPa419-hybrid_cPa390-cPa465-hybrid_cPa390-cPa518-hybrid_cPa390-cPa56-hybrid_cPa390-unknown_cPa394_cPa394-cPa332-hybrid_cPa394-cPa357-hybrid_cPa394-cPa56-hybrid_cPa394-unknown_cPa419_cPa428_cPa450-cPa56-hybrid_cPa452_cPa452-unknown_cPa542_cPa61_cPa61-unknown,1_1_1_2_253_251_1_1_1_1_9_1_2_2_2_9_2_2_1_1_1_55_2_5_1_1_1_5_1_1_1_10_2_239_1,601,596
chrZ-20733447_20733625,cPa205,0.50561797752809,2,20733575,20733464,cPa205_cPa61,45_44,178,111
chrZ-20744610_20744712,cPa62,1,1,20744710,20744660,cPa62,14,102,50
chrZ-21088301_21088403,cPa62,1,1,21088358,21088344,cPa62,3,102,14
chrZ-21131247_21131349,cPa285,1,1,21131297,21131297,cPa285,1,102,0
chrZ-21131404_21131506,cPa62,1,1,21131463,21131454,cPa62,2,102,9
chrZ-2119646_2119748,cPa62,1,1,2119746,2119686,cPa62,22,102,60
chrZ-21221115_21221217,cPa546-cPa113-hybrid,1,1,21221165,21221165,cPa546-cPa113-hybrid,1,102,0
chrZ-21221376_21221478,cPa546-cPa113-hybrid,1,1,21221426,21221426,cPa546-cPa113-hybrid,1,102,0
chrZ-21221650_21221752,cPa113,1,1,21221700,21221700,cPa113,1,102,0
chrZ-2127119_2127221,cPa62,0.75,2,2127175,2127160,cPa62_cPa62-unknown,3_1,102,15
chrZ-2127314_2127416,cPa62,1,1,2127364,2127364,cPa62,1,102,0
chrZ-21285084_21285188,cPa425,0.35,8,21285145,21285129,cPa174_cPa174-cPa404-hybrid_cPa174-cPa425-hybrid_cPa174-cPa47-hybrid_cPa254_cPa254-unknown_cPa425_cPa47,3_1_1_1_1_1_7_5,104,16
chrZ-2128546_2128649,cPa62,1,1,2128608,2128595,cPa62,10,103,13
chrZ-21314_21416,cPa18-cPa254-hybrid,1,1,21364,21364,cPa18-cPa254-hybrid,1,102,0
chrZ-21584755_21585400,HERV-W_repbase_HERV17_LTR17,0.541176470588235,9,21585348,21584776,cPa419_cPa62_cPa75_cPa75-HERV-W_repbase_HERV17_LTR17-hybrid_cPa75-unknown_HERV-W_repbase_HERV17_LTR17_HERV-W_repbase_HERV17_LTR17-cPa62-hybrid_HERV-W_repbase_HERV17_LTR17-cPa75-hybrid_HERV-W_repbase_HERV17_LTR17-unknown,1_1_5_1_1_46_12_1_17,645,572
chrZ-2164525_2164697,cPa62-unknown,0.5,3,2164667,2164537,cPa62-cPa71-hybrid_cPa62-unknown_cPa75,2_4_2,172,130
chrZ-2164703_2164805,cPa75,1,1,2164753,2164753,cPa75,1,102,0
chrZ-2201106_2201292,HERV-W_repbase_HERV17_LTR17,0.842105263157895,4,2201267,2201132,cPa75-PERV_AJ293656-hybrid_HERV-W_repbase_HERV17_LTR17_HERV-W_repbase_HERV17_LTR17-cPa75-hybrid_PERV_AJ293656,1_16_1_1,186,135
chrZ-2201513_2201921,HERV-W_repbase_HERV17_LTR17,0.675,9,2201869,2201513,cPa62-cPa75-hybrid_cPa67-KoRV_AF151794-hybrid_cPa75_cPa75-cPa71-hybrid_HERV-W_repbase_HERV17_LTR17_HERV-W_repbase_HERV17_LTR17-unknown_KoRV_AF151794_PERV_AJ293656_PERV_AJ293656-KoRV_AF151794-hybrid,3_1_3_1_27_1_2_1_1,408,356
chrZ-2220067_2220173,cPa62,0.980769230769231,2,2220121,2220089,cPa62_cPa62-unknown,51_1,106,32
chrZ-22300892_22300994,cPa419-cPa456-hybrid,1,1,22300942,22300942,cPa419-cPa456-hybrid,1,102,0
chrZ-22468946_22469048,cPa62-HERV-W_repbase_HERV17_LTR17-hybrid_HERV-W_repbase_HERV17_LTR17,0.416666666666667,4,22469013,22468975,cPa62-cPa75-hybrid_cPa62-HERV-W_repbase_HERV17_LTR17-hybrid_cPa75_HERV-W_repbase_HERV17_LTR17,1_5_1_5,102,38
chrZ-22527323_22527437,cPa391,0.5,3,22527385,22527373,cPa293_cPa293-unknown_cPa391,1_1_2,114,12
chrZ-2270015_2270117,cPa285_cPa62,0.333333333333333,5,2270065,2270021,cPa285_cPa285-cPa71-hybrid_cPa62_cPa71_cPa71-cPa62-hybrid,3_1_3_1_1,102,44
chrZ-22711081_22711183,cPa456-cPa315-hybrid,0.317647058823529,9,22711170,22711118,cPa363_cPa363-cPa315-hybrid_cPa456_cPa456-cPa315-hybrid_cPa456-cPa587-hybrid_cPa456-unknown_cPa587_cPa587-cPa315-hybrid_cPa75-cPa315-hybrid,24_2_24_27_1_1_4_1_1,102,52
chrZ-22757178_22757300,cPa391-cPa62-hybrid,0.75,2,22757248,22757228,cPa363-cPa62-hybrid_cPa391-cPa62-hybrid,1_3,122,20
chrZ-22961034_22961136,cPa285-cPa293-hybrid,1,1,22961084,22961084,cPa285-cPa293-hybrid,1,102,0
chrZ-230977_231079,cPa62,1,1,231027,231027,cPa62,1,102,0
chrZ-231387_231492,cPa62,0.352941176470588,5,231484,231391,cPa492-cPa75-hybrid_cPa62_cPa62-cPa75-hybrid_cPa71_cPa75,1_6_3_3_4,105,93
chrZ-23194240_23194342,cPa62-unknown_cPa75-unknown,0.428571428571429,3,23194303,23194245,cPa62-unknown_cPa75_cPa75-unknown,3_1_3,102,58
chrZ-231968_232070,cPa62,1,1,232018,232012,cPa62,2,102,6
chrZ-232298_232435,cPa75_HERV-W_repbase_HERV17_LTR17,0.285714285714286,5,232428,232326,cPa62_cPa75_HERV-W_repbase_HERV17_LTR17_HERV-W_repbase_HERV17_LTR17-cPa62-hybrid_HERV-W_repbase_HERV17_LTR17-unknown,1_2_2_1_1,137,102
chrZ-232454_232556,cPa75,0.8,2,232511,232493,cPa62_cPa75,1_4,102,18
chrZ-23301806_23301911,cPa254,0.405405405405405,7,23301911,23301805,cPa174_cPa254_cPa404_cPa404-cPa174-hybrid_cPa404-cPa254-hybrid_cPa425-unknown_cPa47-cPa174-hybrid,7_15_2_9_1_1_2,105,106
chrZ-23381099_23381201,cPa62-cPa75-hybrid,0.428571428571429,4,23381182,23381116,cPa62_cPa62-cPa402-hybrid_cPa62-cPa75-hybrid_cPa62-unknown,2_1_3_1,102,66
chrZ-23381204_23381306,cPa62_cPa62-cPa75-hybrid,0.5,2,23381258,23381254,cPa62_cPa62-cPa75-hybrid,1_1,102,4
chrZ-23550662_23550767,cPa223,0.4,6,23550755,23550681,cPa174_cPa223_cPa223-cPa174-hybrid_cPa223-unknown_cPa392_cPa425,1_6_5_1_1_1,105,74
chrZ-24002415_24002517,cPa219,1,1,24002465,24002465,cPa219,1,102,0
chrZ-24002669_24002771,cPa219,1,1,24002719,24002719,cPa219,1,102,0
chrZ-24117377_24117483,cPa450,0.347826086956522,9,24117431,24117412,cPa199_cPa227_cPa227-unknown_cPa273-cPa199-hybrid_cPa273-unknown_cPa450_cPa542_cPa542-cPa199-hybrid_cPa553,1_1_1_3_1_8_1_2_5,106,19
chrZ-24502742_24502845,cPa500,0.369369369369369,13,24502826,24502760,cPa121_cPa157_cPa157-cPa121-hybrid_cPa157-cPa183-hybrid_cPa157-cPa500-hybrid_cPa183_cPa193_cPa193-cPa183-hybrid_cPa193-unknown_cPa229_cPa500_cPa500-cPa183-hybrid_cPa500-unknown,1_2_2_2_3_4_40_2_1_11_41_1_1,103,66
chrZ-24580445_24580547,cPa434,0.666666666666667,2,24580500,24580489,cPa434_cPa443,2_1,102,11
chrZ-24580693_24580835,cPa443,0.560975609756098,4,24580809,24580743,cPa434_cPa443_cPa566_cPa566-cPa443-hybrid,16_23_1_1,142,66
chrZ-2487541_2487964,HERV-W_repbase_HERV17_LTR17,0.587628865979381,9,2487912,2487591,cPa62-cPa75-hybrid_cPa62-HERV-W_repbase_HERV17_LTR17-hybrid_cPa62-KoRV_AF151794-hybrid_cPa62-unknown_cPa75_cPa75-unknown_HERV-W_repbase_HERV17_LTR17_HERV-W_repbase_HERV17_LTR17-unknown_KoRV_AF151794,5_7_1_13_9_1_57_3_1,423,321
chrZ-25286164_25286266,cPa75,1,1,25286214,25286214,cPa75,1,102,0
chrZ-25292931_25293033,cPa75,1,1,25292981,25292981,cPa75,1,102,0
chrZ-25311623_25311732,cPa62,0.857142857142857,2,25311680,25311673,cPa62_cPa75,6_1,109,7
chrZ-2531200_2531302,cPa62,1,1,2531250,2531232,cPa62,12,102,18
chrZ-25315169_25315297,cPa75,0.96,2,25315252,25315192,cPa75_cPa75-cPa62-hybrid,24_1,128,60
chrZ-25316827_25316994,cPa62,0.583333333333333,3,25316942,25316877,cPa62_cPa75_cPa75-cPa62-hybrid,7_3_2,167,65
chrZ-25317074_25317280,cPa62_cPa75,0.5,2,25317228,25317116,cPa62_cPa75,3_3,206,112
chrZ-25480558_25480681,cPa104,0.588235294117647,6,25480643,25480608,cPa104_cPa18-cPa220-hybrid_cPa219-cPa190-hybrid_cPa219-cPa220-hybrid_cPa219-unknown_cPa220,10_1_1_1_3_1,123,35
chrZ-25695613_25695736,cPa15,0.591836734693878,7,25695690,25695658,cPa118_cPa118-cPa15-hybrid_cPa118-cPa268-hybrid_cPa118-unknown_cPa15_cPa268_cPa539-cPa268-hybrid,11_1_11_10_58_6_1,123,32
chrZ-25728088_25728202,cPa95,0.5,3,25728150,25728137,cPa14-cPa529-hybrid_cPa545_cPa95,1_1_2,114,13
chrZ-26099800_26099902,cPa15,0.666666666666667,2,26099850,26099849,cPa15_cPa61,2_1,102,1
chrZ-26194364_26194468,cPa75,0.8,3,26194441,26194412,cPa546_cPa75_cPa75-unknown,1_8_1,104,29
chrZ-26254111_26254213,cPa450-unknown_cPa475-unknown,0.5,2,26254161,26254154,cPa450-unknown_cPa475-unknown,1_1,102,7
chrZ-2634700_2634802,cPa117-unknown,1,1,2634750,2634750,cPa117-unknown,1,102,0
chrZ-26456408_26456514,cPa456,0.75,3,26456477,26456458,cPa363_cPa363-cPa117-hybrid_cPa456,1_3_12,106,19
chrZ-26550803_26550982,cPa260,0.857142857142857,2,26550932,26550842,cPa260_cPa75,6_1,179,90
chrZ-2662754_2662856,HERV-W_repbase_HERV17_LTR17-unknown,0.5,3,2662848,2662804,cPa62_cPa75_HERV-W_repbase_HERV17_LTR17-unknown,1_1_2,102,44
chrZ-26872041_26872143,cPa285,1,1,26872091,26872091,cPa285,1,102,0
chrZ-26955073_26955175,cPa450,0.666666666666667,5,26955168,26955084,cPa227_cPa345-cPa450-hybrid_cPa450_cPa553_cPa553-cPa450-hybrid,1_1_8_1_1,102,84
chrZ-27091575_27091681,cPa541,0.666666666666667,2,27091657,27091625,cPa4_cPa541,1_2,106,32
chrZ-27127707_27127809,cPa425,0.6,3,27127805,27127709,cPa174_cPa174-cPa425-hybrid_cPa425,3_1_6,102,96
chrZ-27335184_27335286,cPa492,1,1,27335234,27335185,cPa492,3,102,49
chrZ-27448751_27448853,cPa61-cPa339-hybrid,1,1,27448801,27448801,cPa61-cPa339-hybrid,1,102,0
chrZ-27450756_27450858,HML1a_repbase_HERV-K14CI_LTR14C-cPa125-hybrid,1,1,27450806,27450806,HML1a_repbase_HERV-K14CI_LTR14C-cPa125-hybrid,1,102,0
chrZ-27476982_27477084,cPa248-cPa413-hybrid,1,1,27477032,27477032,cPa248-cPa413-hybrid,1,102,0
chrZ-27478880_27479110,cPa62,0.791666666666667,5,27479079,27478881,cPa254_cPa345_cPa62_cPa62-cPa345-hybrid_cPa62-unknown,1_6_38_2_1,230,198
chrZ-27927040_27927142,cPa75,1,1,27927090,27927090,cPa75,1,102,0
chrZ-2810735_2810837,cPa71-cPa62-hybrid,1,1,2810785,2810785,cPa71-cPa62-hybrid,1,102,0
chrZ-28309179_28309281,cPa62-SMRV_NC001514-hybrid_cPa62-unknown,0.5,2,28309231,28309229,cPa62-SMRV_NC001514-hybrid_cPa62-unknown,1_1,102,2
chrZ-2833074_2833176,cPa75,0.75,2,2833135,2833121,cPa260_cPa75,1_3,102,14
chrZ-2833361_2833463,cPa75,0.727272727272727,4,2833448,2833392,cPa293-cPa75-hybrid_cPa75_cPa75-unknown_PERVC_HM159246-cPa75-hybrid,1_8_1_1,102,56
chrZ-2844243_2844345,cPa75,1,1,2844332,2844258,cPa75,4,102,74
chrZ-2844348_2844576,cPa75,0.607142857142857,3,2844524,2844387,cPa62_cPa75_cPa75-cPa62-hybrid,1_17_10,228,137
chrZ-2845189_2845291,cPa75,1,1,2845262,2845239,cPa75,3,102,23
chrZ-28527350_28527452,cPa419,1,1,28527400,28527400,cPa419,1,102,0
chrZ-28552637_28552747,cPa15,0.6,2,28552695,28552687,cPa118_cPa15,2_3,110,8
chrZ-28812533_28812635,cPa62,1,1,28812604,28812571,cPa62,14,102,33
chrZ-28838591_28838693,cPa101_cPa256_cPa582,0.333333333333333,3,28838641,28838641,cPa101_cPa256_cPa582,1_1_1,102,0
chrZ-29077164_29077291,cPa75-GaLV_M26927-hybrid,1,1,29077239,29077176,cPa75-GaLV_M26927-hybrid,11,127,63
chrZ-29088789_29088891,cPa75-cPa113-hybrid,0.666666666666667,2,29088839,29088793,cPa75-cPa113-hybrid_PERV_AJ293656-unknown,2_1,102,46
chrZ-29265782_29265884,cPa345,1,1,29265832,29265832,cPa345,1,102,0
chrZ-29316236_29316347,cPa339,0.5,3,29316298,29316286,cPa339_cPa444-cPa390-hybrid_cPa444-cPa447-hybrid,2_1_1,111,12
chrZ-29465537_29465639,cPa62,1,1,29465599,29465582,cPa62,7,102,17
chrZ-29478723_29478933,cPa410-unknown,0.697916666666667,12,29478881,29478724,cPa109_cPa109-cPa15-hybrid_cPa109-unknown_cPa118_cPa118-cPa273-hybrid_cPa118-cPa443-hybrid_cPa118-unknown_cPa273_cPa410_cPa410-cPa273-hybrid_cPa410-unknown_cPa419,1_1_1_1_2_1_14_3_1_2_67_2,210,157
chrZ-29514442_29514544,cPa205,1,1,29514492,29514492,cPa205,1,102,0
chrZ-29514847_29515023,cPa205,0.484536082474227,6,29514982,29514849,cPa205_cPa205-cPa465-hybrid_cPa205-cPa61-hybrid_cPa527-cPa465-hybrid_cPa61_cPa61-cPa465-hybrid,47_1_6_1_41_1,176,133
chrZ-29515617_29515719,cPa61,0.529411764705882,4,29515715,29515660,cPa205_cPa449_cPa527-cPa61-hybrid_cPa61,5_1_2_9,102,55
chrZ-29515720_29516062,cPa61,0.520661157024793,11,29516061,29515741,cPa205_cPa419_cPa449_cPa449-cPa61-hybrid_cPa449-unknown_cPa527_cPa527-cPa449-hybrid_cPa527-cPa61-hybrid_cPa527-unknown_cPa61_cPa75-cPa117-hybrid,46_1_1_3_1_1_1_2_1_63_1,342,320
chrZ-29536118_29536235,cPa363_cPa452,0.333333333333333,4,29536183,29536168,cPa176-cPa446-hybrid_cPa363_cPa452_cPa71,1_2_2_1,117,15
chrZ-29818955_29819060,cPa456-cPa104-hybrid,0.6,3,29819013,29819005,cPa117-cPa104-hybrid_cPa456-cPa104-hybrid_cPa456-cPa18-hybrid,1_3_1,105,8
chrZ-29819223_29819325,cPa456-cPa18-hybrid,1,1,29819273,29819273,cPa456-cPa18-hybrid,1,102,0
chrZ-29928715_29928817,cPa62,1,1,29928778,29928744,cPa62,27,102,34
chrZ-3070770_3070872,HERV-W_repbase_HERV17_LTR17,1,1,3070820,3070820,HERV-W_repbase_HERV17_LTR17,1,102,0
chrZ-30838769_30838871,cPa15,0.523809523809524,4,30838868,30838788,cPa118_cPa118-cPa268-hybrid_cPa118-unknown_cPa15,64_3_3_77,102,80
chrZ-3101347_3101461,cPa62,0.954545454545455,2,3101426,3101347,cPa254-cPa62-hybrid_cPa62,1_21,114,79
chrZ-31201649_31201757,cPa118_cPa15_cPa248-unknown_cPa443,0.25,4,31201705,31201699,cPa118_cPa15_cPa248-unknown_cPa443,1_1_1_1,108,6
chrZ-31203472_31203579,cPa15,0.569343065693431,6,31203534,31203505,cPa118_cPa15_cPa248-cPa118-hybrid_cPa248-unknown_cPa443_cPa443-cPa118-hybrid,49_78_5_3_1_1,107,29
chrZ-31293311_31293481,cPa62,1,1,31293435,31293351,cPa62,32,170,84
chrZ-31538740_31538857,cPa255,0.4,4,31538805,31538790,cPa131_cPa255_cPa478-cPa526-hybrid_cPa478-unknown,1_2_1_1,117,15
chrZ-31687793_31687895,cPa62-cPa75-hybrid,0.615384615384615,4,31687895,31687813,cPa62_cPa62-cPa75-hybrid_cPa62-unknown_cPa75,1_8_2_2,102,82
chrZ-31910801_31910903,cPa75,1,1,31910851,31910851,cPa75,1,102,0
chrZ-31982576_31982695,cPa75,0.264705882352941,13,31982691,31982591,cPa62-cPa75-hybrid_cPa62-HERV-W_repbase_HERV17_LTR17-hybrid_cPa62-unknown_cPa67-cPa75-hybrid_cPa75_cPa75-HERV-W_repbase_HERV17_LTR17-hybrid_cPa75-KoRV_AF151794-hybrid_cPa75-KWERV_GQ222416-hybrid_HERV-W_repbase_HERV17_LTR17_HERV-W_repbase_HERV17_LTR17-cPa75-hybrid_KoRV_AF151794_KoRV_AF151794-KWERV_GQ222416-hybrid_KWERV_GQ222416,2_1_1_1_9_1_1_1_2_2_6_4_3,119,100
chrZ-32029829_32029931,cPa4_cPa541,0.5,2,32029879,32029878,cPa4_cPa541,2_2,102,1
chrZ-32048466_32048568,HERV-W_repbase_HERV17_LTR17,1,1,32048516,32048516,HERV-W_repbase_HERV17_LTR17,1,102,0
chrZ-3211795_3211897,WDSV_NC001867-cPa62-hybrid,1,1,3211845,3211845,WDSV_NC001867-cPa62-hybrid,1,102,0
chrZ-32137500_32137602,cPa450,0.411764705882353,8,32137581,32137505,cPa199_cPa227_cPa273_cPa273-cPa199-hybrid_cPa273-cPa553-hybrid_cPa450_cPa542_cPa553,1_1_1_4_1_7_1_1,102,76
chrZ-3242854_3242956,cPa142,0.666666666666667,2,3242941,3242904,cPa142_cPa51-cPa101-hybrid,2_1,102,37
chrZ-32463091_32463193,cPa75,1,1,32463141,32463106,cPa75,3,102,35
chrZ-32463299_32463451,cPa75,0.714285714285714,3,32463399,32463349,cPa62_cPa75_GaLV_M26927-cPa62-hybrid,1_5_1,152,50
chrZ-3336270_3336372,cPa456,0.578947368421053,6,3336326,3336291,cPa363_cPa363-cPa452-hybrid_cPa456_cPa587-cPa117-hybrid_cPa587-cPa452-hybrid_cPa587-unknown,4_1_11_1_1_1,102,35
chrZ-33432_33534,cPa444,1,1,33482,33482,cPa444,1,102,0
chrZ-33720825_33720927,HERV-W_repbase_HERV17_LTR17,1,1,33720875,33720875,HERV-W_repbase_HERV17_LTR17,1,102,0
chrZ-33904197_33904309,cPa101_cPa256_cPa582,0.333333333333333,3,33904257,33904247,cPa101_cPa256_cPa582,1_1_1,112,10
chrZ-34189711_34190071,cPa75,0.428571428571429,8,34190019,34189719,cPa260_cPa62_cPa75_cPa75-cPa62-hybrid_cPa75-unknown_HERV-W_repbase_HERV17_LTR17_HERV-W_repbase_HERV17_LTR17-cPa62-hybrid_HERV-W_repbase_HERV17_LTR17-unknown,1_1_27_8_5_2_13_6,360,300
chrZ-34269433_34269535,cPa75-cPa117-hybrid,1,1,34269483,34269483,cPa75-cPa117-hybrid,1,102,0
chrZ-34269861_34269963,cPa363-cPa117-hybrid_cPa587-cPa117-hybrid,0.5,2,34269911,34269899,cPa363-cPa117-hybrid_cPa587-cPa117-hybrid,1_1,102,12
chrZ-34385618_34385798,cPa62,1,1,34385748,34385623,cPa62,50,180,125
chrZ-34494364_34494466,cPa75,1,1,34494414,34494414,cPa75,1,102,0
chrZ-3450627_3450730,cPa268_cPa381,0.26530612244898,13,3450714,3450633,cPa268_cPa268-cPa381-hybrid_cPa268-unknown_cPa308_cPa308-cPa486-hybrid_cPa339_cPa339-cPa486-hybrid_cPa353_cPa353-cPa381-hybrid_cPa353-cPa486-hybrid_cPa353-unknown_cPa381_cPa486,13_1_1_3_1_1_1_2_1_2_1_13_9,103,81
chrZ-34534054_34534156,cPa391-unknown,1,1,34534120,34534104,cPa391-unknown,2,102,16
chrZ-34640748_34640850,cPa150_cPa219-cPa255-hybrid_cPa478,0.333333333333333,3,34640798,34640798,cPa150_cPa219-cPa255-hybrid_cPa478,1_1_1,102,0
chrZ-34650981_34651095,cPa363_cPa452_cPa71-cPa183-hybrid,0.333333333333333,3,34651043,34651031,cPa363_cPa452_cPa71-cPa183-hybrid,1_1_1,114,12
chrZ-34705448_34705550,cPa75,1,1,34705498,34705498,cPa75,1,102,0
chrZ-34845003_34845112,Xen1_AJ506107-unknown,1,1,34845061,34845053,Xen1_AJ506107-unknown,26,109,8
chrZ-34899786_34899901,cPa190,0.5,9,34899896,34899831,cPa18-cPa104-hybrid_cPa18-cPa190-hybrid_cPa190_cPa219_cPa219-cPa104-hybrid_cPa220_cPa220-cPa104-hybrid_cPa220-cPa190-hybrid_cPa220-unknown,16_2_37_1_2_2_11_1_2,115,65
chrZ-34966735_34966912,cPa75,0.567567567567568,5,34966872,34966785,cPa62_cPa62-cPa75-hybrid_cPa62-HERV-W_repbase_HERV17_LTR17-hybrid_cPa62-unknown_cPa75,8_4_2_2_21,177,87
chrZ-34966993_34967148,cPa75,0.450980392156863,7,34967105,34966997,cPa62_cPa62-cPa75-hybrid_cPa62-HERV-W_repbase_HERV17_LTR17-hybrid_cPa62-unknown_cPa75_HERV-W_repbase_HERV17_LTR17_HERV-W_repbase_HERV17_LTR17-MER52A_repbase_MER52AI_MER52A-hybrid,8_5_2_5_23_7_1,155,108
chrZ-35099875_35100077,cPa62_cPa62-cPa75-hybrid,0.318181818181818,5,35100025,35099923,cPa62_cPa62-cPa201-hybrid_cPa62-cPa75-hybrid_cPa62-unknown_cPa75,14_4_14_8_4,202,102
chrZ-35100117_35100311,cPa62_cPa62-cPa75-hybrid_cPa75,0.212121212121212,11,35100301,35100119,cPa109_cPa201_cPa201-cPa75-hybrid_cPa293_cPa62_cPa62-cPa109-hybrid_cPa62-cPa201-hybrid_cPa62-cPa75-hybrid_cPa62-unknown_cPa75_cPa75-cPa109-hybrid,1_1_1_1_7_1_2_7_4_7_1,194,182
chrZ-35103857_35103959,cPa425,0.357142857142857,7,35103914,35103878,cPa174_cPa254_cPa404_cPa404-cPa174-hybrid_cPa425_cPa47_cPa47-cPa254-hybrid,2_1_1_1_5_3_1,102,36
chrZ-35109537_35109639,cPa223-cPa273-hybrid_cPa227-cPa273-hybrid_cPa450_cPa553_cPa553-unknown,0.2,5,35109589,35109577,cPa223-cPa273-hybrid_cPa227-cPa273-hybrid_cPa450_cPa553_cPa553-unknown,1_1_1_1_1,102,12
chrZ-35118543_35118645,cPa529,0.875,2,35118601,35118588,cPa247_cPa529,1_7,102,13
chrZ-35177971_35178073,cPa75-cPa62-hybrid,1,1,35178021,35178021,cPa75-cPa62-hybrid,1,102,0
chrZ-35178986_35179105,cPa75-cPa62-hybrid,0.666666666666667,2,35179053,35179020,cPa62_cPa75-cPa62-hybrid,1_2,119,33
chrZ-36113100_36113203,cPa95,0.333333333333333,5,36113159,36113147,cPa14-cPa545-hybrid_cPa247_cPa4_cPa541-cPa545-hybrid_cPa95,1_1_1_1_2,103,12
chrZ-36417918_36418020,cPa62,1,1,36417998,36417918,cPa62,19,102,80
chrZ-37840348_37840450,cPa357-unknown,0.6,2,37840414,37840372,cPa357_cPa357-unknown,2_3,102,42
chrZ-37897497_37897599,cPa62,1,1,37897584,37897547,cPa62,8,102,37
chrZ-38143249_38143351,cPa62,0.8,3,38143316,38143299,cPa308-cPa62-hybrid_cPa308-unknown_cPa62,1_1_8,102,17
chrZ-3852466_3852589,cPa75,0.545454545454545,2,3852543,3852516,cPa308_cPa75,5_6,123,27
chrZ-38692320_38692437,cPa255,0.333333333333333,5,38692385,38692342,cPa131_cPa131-cPa14-hybrid_cPa131-cPa551-hybrid_cPa255_cPa478,6_1_1_7_6,117,43
chrZ-3913929_3914031,cPa62,1,1,3914000,3913974,cPa62,17,102,26
chrZ-39498851_39498962,cPa75,0.6,4,39498913,39498860,cPa75_cPa75-cPa62-hybrid_HERV-W_repbase_HERV17_LTR17-cPa62-hybrid_HERV-W_repbase_HERV17_LTR17-unknown,6_1_1_2,111,53
chrZ-39672077_39672179,cPa257,0.375,5,39672132,39672104,cPa257_cPa257-cPa546-hybrid_cPa257-cPa555-hybrid_cPa285-cPa546-hybrid_cPa555,6_2_1_3_4,102,28
chrZ-40278743_40278845,cPa75,1,1,40278793,40278793,cPa75,1,102,0
chrZ-4028586_4028688,cPa308,0.8,2,4028636,4028594,cPa308_cPa381,4_1,102,42
chrZ-40336814_40336916,cPa363,0.5,3,40336882,40336841,cPa363_cPa452_cPa456,6_1_5,102,41
chrZ-4039810_4040278,cPa75,0.352941176470588,11,4040248,4039812,cPa260-cPa75-hybrid_cPa260-HERV-W_repbase_HERV17_LTR17-hybrid_cPa62_cPa62-cPa75-hybrid_cPa62-HERV-W_repbase_HERV17_LTR17-hybrid_cPa62-unknown_cPa71-HERV-W_repbase_HERV17_LTR17-hybrid_cPa75_cPa75-KoRV_AF151794-hybrid_HERV-W_repbase_HERV17_LTR17_HERV-W_repbase_HERV17_LTR17-cPa75-hybrid,3_1_11_9_2_3_1_18_1_1_1,468,436
chrZ-40454024_40454126,cPa62,1,1,40454074,40454074,cPa62,1,102,0
chrZ-40609292_40609406,cPa117-cPa587-hybrid_cPa363_cPa452_cPa456,0.25,4,40609354,40609342,cPa117-cPa587-hybrid_cPa363_cPa452_cPa456,1_1_1_1,114,12
chrZ-40695439_40695541,cPa246,0.333333333333333,6,40695534,40695489,cPa150_cPa246_cPa246-cPa131-hybrid_cPa302_cPa479_cPa479-cPa131-hybrid,4_5_1_3_1_1,102,45
chrZ-40843907_40844012,cPa62,1,1,40843960,40843957,cPa62,2,105,3
chrZ-40860777_40860927,HERV-W_repbase_HERV17_LTR17,1,1,40860875,40860778,HERV-W_repbase_HERV17_LTR17,3,150,97
chrZ-40860953_40861055,HERV-W_repbase_HERV17_LTR17,1,1,40861003,40860963,HERV-W_repbase_HERV17_LTR17,3,102,40
chrZ-40861448_40861789,HERV-W_repbase_HERV17_LTR17,0.954545454545455,4,40861780,40861450,cPa75_HERV-W_repbase_HERV17_LTR17_KoRV_AF151794-cPa75-hybrid_PERV_AJ293656,3_105_1_1,341,330
chrZ-41014537_41014647,cPa452,0.421052631578947,9,41014605,41014554,cPa176_cPa363_cPa363-cPa16-hybrid_cPa363-unknown_cPa452_cPa71_cPa71-cPa16-hybrid_cPa71-cPa363-hybrid_cPa71-cPa452-hybrid,1_56_1_1_64_23_2_2_2,110,51
chrZ-41081618_41081794,cPa363,0.8,2,41081761,41081668,cPa363_cPa587,4_1,176,93
chrZ-41258449_41258551,cPa456_cPa456-cPa117-hybrid_cPa587-cPa363-hybrid,0.333333333333333,3,41258500,41258499,cPa456_cPa456-cPa117-hybrid_cPa587-cPa363-hybrid,1_1_1,102,1
chrZ-41417927_41418029,cPa75-unknown,1,1,41417977,41417977,cPa75-unknown,1,102,0
chrZ-41495356_41495458,cPa363,1,1,41495406,41495406,cPa363,1,102,0
chrZ-41554227_41554329,cPa419,1,1,41554277,41554277,cPa419,1,102,0
chrZ-41556767_41556869,cPa14-cPa545-hybrid_cPa95,0.5,2,41556817,41556817,cPa14-cPa545-hybrid_cPa95,1_1,102,0
chrZ-42459250_42459352,cPa75,0.5,5,42459351,42459287,cPa260-cPa227-hybrid_cPa62_cPa62-cPa75-hybrid_cPa62-HERV-W_repbase_HERV17_LTR17-hybrid_cPa75,1_3_2_4_10,102,64
chrZ-42459742_42459844,cPa75,0.333333333333333,6,42459829,42459768,cPa62_cPa62-cPa75-hybrid_cPa62-HERV-W_repbase_HERV17_LTR17-hybrid_cPa62-KoRV_AF151794-hybrid_cPa75_cPa75-HERV-W_repbase_HERV17_LTR17-hybrid,5_2_5_1_7_1,102,61
chrZ-42515848_42515950,cPa62,1,1,42515898,42515898,cPa62,1,102,0
chrZ-42526328_42526430,cPa75-unknown,1,1,42526378,42526378,cPa75-unknown,1,102,0
chrZ-42924112_42924219,cPa452,0.55045871559633,9,42924203,42924149,cPa16_cPa223-cPa16-hybrid_cPa223-unknown_cPa327-cPa16-hybrid_cPa363_cPa452_cPa452-cPa16-hybrid_cPa71_cPa71-cPa16-hybrid,2_11_2_2_1_60_3_8_20,107,54
chrZ-42938802_42938904,cPa529,0.846153846153846,4,42938856,42938838,cPa247-cPa529-hybrid_cPa247-cPa95-hybrid_cPa529_cPa529-cPa95-hybrid,1_2_22_1,102,18
chrZ-43085317_43085419,cPa363,0.5,3,43085367,43085332,cPa363_cPa456_cPa75-cPa452-hybrid,2_1_1,102,35
chrZ-4341131_4341248,cPa75,0.571428571428571,9,4341230,4341153,cPa293_cPa308-cPa62-hybrid_cPa413_cPa413-cPa293-hybrid_cPa413-cPa62-hybrid_cPa75_cPa75-cPa308-hybrid_cPa75-cPa62-hybrid_cPa75-unknown,4_1_1_1_2_24_2_6_1,117,77
chrZ-43477958_43478060,cPa62-cPa75-hybrid,0.5,4,43478035,43477992,cPa62_cPa62-cPa75-hybrid_cPa62-unknown_cPa75,3_5_1_1,102,43
chrZ-43486500_43486608,cPa62,0.945945945945946,3,43486587,43486510,cPa62_cPa62-cPa285-hybrid_cPa62-unknown,35_1_1,108,77
chrZ-43804004_43804106,cPa293-cPa62-hybrid_cPa75-cPa62-hybrid,0.5,2,43804054,43804054,cPa293-cPa62-hybrid_cPa75-cPa62-hybrid,1_1,102,0
chrZ-43935272_43935379,cPa131_cPa255_cPa478,0.333333333333333,3,43935334,43935322,cPa131_cPa255_cPa478,1_1_1,107,12
chrZ-44023468_44023683,cPa62-unknown,0.909090909090909,2,44023631,44023484,cPa62-cPa293-hybrid_cPa62-unknown,1_10,215,147
chrZ-44057803_44057905,cPa62,1,1,44057856,44057809,cPa62,3,102,47
chrZ-440945_441047,cPa106,1,1,440995,440995,cPa106,1,102,0
chrZ-441220_441410,cPa568_cPa568-cPa106-hybrid,0.5,2,441358,441270,cPa568_cPa568-cPa106-hybrid,1_1,190,88
chrZ-44137731_44137833,cPa119_cPa119-unknown,0.5,2,44137781,44137745,cPa119_cPa119-unknown,1_1,102,36
chrZ-44191283_44191385,cPa62,0.5,6,44191348,44191287,cPa285_cPa285-cPa62-hybrid_cPa293_cPa293-unknown_cPa62_cPa62-unknown,5_3_1_1_11_1,102,61
chrZ-44504020_44504122,cPa254_cPa47,0.5,2,44504070,44504070,cPa254_cPa47,1_1,102,0
chrZ-44591968_44592070,cPa62,0.75,2,44592018,44592001,cPa254-cPa62-hybrid_cPa62,1_3,102,17
chrZ-44859555_44859657,cPa62,1,1,44859615,44859580,cPa62,13,102,35
chrZ-44955963_44956065,cPa345,0.666666666666667,2,44956013,44955965,cPa345_cPa345-unknown,2_1,102,48
chrZ-44956083_44956240,cPa345,0.823529411764706,4,44956193,44956133,cPa345_cPa345-unknown_cPa527_cPa75-cPa543-hybrid,14_1_1_1,157,60
chrZ-4509654_4509756,cPa174_cPa254_cPa404_cPa425_cPa47-cPa392-hybrid,0.2,5,4509704,4509704,cPa174_cPa254_cPa404_cPa425_cPa47-cPa392-hybrid,1_1_1_1_1,102,0
chrZ-45382628_45382736,HIV1_NC001802,0.222222222222222,8,45382685,45382675,cPa298-cPa391-hybrid_cPa545-cPa391-hybrid_cPa545-cPa583-hybrid_cPa74-cPa251-hybrid_cPa74-cPa583-hybrid_cPa75-cPa391-hybrid_HIV1_NC001802_HIV1_NC001802-cPa251-hybrid,1_1_1_1_1_1_2_1,108,10
chrZ-45450302_45450413,cPa459,0.3,6,45450361,45450307,cPa308_cPa327_cPa424_cPa433_cPa459_cPa459-cPa196-hybrid,2_1_2_1_3_1,111,54
chrZ-46172875_46172977,cPa363_cPa452,0.333333333333333,4,46172925,46172925,cPa176-unknown_cPa363_cPa452_cPa71,1_2_2_1,102,0
chrZ-4627286_4627401,cPa247_cPa529,0.5,2,4627349,4627336,cPa247_cPa529,1_1,115,13
chrZ-46367372_46367474,cPa363_cPa452-cPa587-hybrid_cPa456,0.333333333333333,3,46367422,46367422,cPa363_cPa452-cPa587-hybrid_cPa456,1_1_1,102,0
chrZ-4660467_4660643,cPa16,0.5,3,4660591,4660517,cPa16_cPa16-cPa62-hybrid_cPa568-cPa379-hybrid,3_2_1,176,74
chrZ-46810185_46810294,cPa118_cPa15,0.5,2,46810243,46810230,cPa118_cPa15,3_3,109,13
chrZ-4686089_4686191,HML8_repbase_HERVK11I_MER11A-cPa563-hybrid,0.666666666666667,2,4686139,4686131,cPa15_HML8_repbase_HERVK11I_MER11A-cPa563-hybrid,1_2,102,8
chrZ-4707331_4707433,cPa308,0.428571428571429,7,4707430,4707381,cPa308_cPa339_cPa339-cPa486-hybrid_cPa353_cPa381_cPa381-cPa486-hybrid_cPa486,21_7_1_1_13_2_4,102,49
chrZ-4707581_4707683,cPa486,0.594594594594595,5,4707654,4707623,cPa308_cPa339-cPa381-hybrid_cPa381_cPa419_cPa486,3_3_8_1_22,102,31
chrZ-4728905_4729080,cPa131-cPa216-hybrid_cPa131-cPa523-hybrid,0.222222222222222,10,4729044,4728955,cPa131-cPa216-hybrid_cPa131-cPa305-hybrid_cPa131-cPa518-hybrid_cPa131-cPa523-hybrid_cPa131-cPa549-hybrid_cPa131-unknown_cPa216_cPa216-cPa549-hybrid_cPa255-cPa216-hybrid_cPa255-cPa523-hybrid,6_1_2_6_4_2_1_1_3_1,175,89
chrZ-47386704_47386818,cPa363_cPa452_cPa71,0.25,5,47386766,47386754,cPa176_cPa363_cPa452_cPa61-cPa410-hybrid_cPa71,1_2_2_1_2,114,12
chrZ-47534277_47534379,cPa15,0.5,4,47534366,47534294,cPa118_cPa118-cPa443-hybrid_cPa15_cPa268-cPa419-hybrid,9_1_11_1,102,72
chrZ-48064592_48064694,cPa62,1,1,48064667,48064617,cPa62,19,102,50
chrZ-48286022_48286124,cPa62,0.95,2,48286072,48286041,cPa62_cPa62-unknown,19_1,102,31
chrZ-48722477_48722579,cPa118_cPa15,0.466666666666667,3,48722529,48722512,cPa118_cPa118-cPa15-hybrid_cPa15,7_1_7,102,17
chrZ-48749552_48749654,cPa345_cPa62,0.5,2,48749602,48749593,cPa345_cPa62,1_1,102,9
chrZ-48946711_48946813,cPa419,1,1,48946761,48946761,cPa419,1,102,0
chrZ-49004236_49004338,cPa62-cPa75-hybrid,0.666666666666667,2,49004286,49004243,cPa62-cPa75-hybrid_cPa75,2_1,102,43
chrZ-49005697_49005799,cPa62,0.545454545454545,3,49005772,49005738,cPa62_cPa62-cPa75-hybrid_cPa62-unknown,6_2_3,102,34
chrZ-49051074_49051176,cPa404,0.666666666666667,2,49051139,49051124,cPa404_cPa425-cPa404-hybrid,2_1,102,15
chrZ-4991539_4991645,cPa62,1,1,4991611,4991589,cPa62,8,106,22
chrZ-4991822_4991924,cPa62,1,1,4991902,4991872,cPa62,4,102,30
chrZ-49924807_49924954,cPa363,0.5,3,49924902,49924853,cPa363_cPa456_cPa456-cPa452-hybrid,2_1_1,147,49
chrZ-50051090_50051192,cPa75,1,1,50051140,50051140,cPa75,1,102,0
chrZ-50717358_50717460,cPa75-cPa62-hybrid,0.444444444444444,6,50717458,50717408,cPa285_cPa293_cPa293-cPa62-hybrid_cPa62_cPa75_cPa75-cPa62-hybrid,1_1_1_1_1_4,102,50
chrZ-51102290_51102417,cPa450,0.380952380952381,7,51102366,51102313,cPa199-cPa273-hybrid_cPa199-cPa450-hybrid_cPa223-cPa450-hybrid_cPa223-cPa542-hybrid_cPa450_cPa482-cPa273-hybrid_cPa553,1_1_1_3_8_1_6,127,53
chrZ-5110563_5110665,cPa62,0.785714285714286,3,5110636,5110564,cPa254-cPa62-hybrid_cPa62_cPa62-cPa117-hybrid,2_11_1,102,72
chrZ-51251721_51251974,cPa224,0.53968253968254,8,51251952,51251771,cPa163_cPa224_cPa254-cPa360-hybrid_cPa360_cPa419_cPa452-cPa163-hybrid_cPa516-cPa163-hybrid_cPa516-cPa360-hybrid,16_34_1_3_5_1_2_1,253,181
chrZ-51261300_51261682,cPa553,0.16875,33,51261679,51261313,cPa199_cPa223_cPa227_cPa227-cPa199-hybrid_cPa254-cPa118-hybrid_cPa254-cPa223-hybrid_cPa254-cPa345-hybrid_cPa273-cPa15-hybrid_cPa273-cPa223-hybrid_cPa273-cPa227-hybrid_cPa273-cPa428-hybrid_cPa273-cPa47-hybrid_cPa273-cPa482-hybrid_cPa273-cPa531-hybrid_cPa285_cPa285-cPa223-hybrid_cPa345_cPa419_cPa450_cPa482_cPa531_cPa542_cPa542-cPa118-hybrid_cPa542-cPa199-hybrid_cPa542-cPa223-hybrid_cPa542-cPa428-hybrid_cPa542-cPa47-hybrid_cPa542-cPa482-hybrid_cPa542-cPa531-hybrid_cPa553_cPa75_PERVE_NC003059_PERVE_NC003059-cPa223-hybrid,22_4_21_1_1_3_1_1_11_1_1_1_3_1_1_2_8_5_20_4_3_1_1_4_2_1_1_1_1_27_1_4_1,382,366
chrZ-51263916_51264034,cPa285_cPa62,0.285714285714286,5,51264027,51263916,cPa254-cPa223-hybrid_cPa285_cPa285-cPa61-hybrid_cPa419_cPa62,1_2_1_1_2,118,111
chrZ-51264171_51264285,cPa62,0.488372093023256,10,51264233,51264186,cPa254-cPa285-hybrid_cPa254-cPa75-hybrid_cPa254-unknown_cPa285_cPa285-cPa75-hybrid_cPa293_cPa391_cPa419_cPa62_cPa75,1_3_1_5_1_1_3_6_21_1,114,47
chrZ-51266640_51266742,cPa419,0.666666666666667,2,51266690,51266654,cPa419_cPa75,2_1,102,36
chrZ-51267537_51268234,cPa163-cPa47-hybrid,0.390243902439024,13,51268182,51267587,cPa163-cPa254-hybrid_cPa163-cPa404-hybrid_cPa163-cPa425-hybrid_cPa163-cPa47-hybrid_cPa163-unknown_cPa224-cPa404-hybrid_cPa224-cPa425-hybrid_cPa224-cPa47-hybrid_cPa224-unknown_cPa254_cPa360-cPa404-hybrid_cPa360-cPa47-hybrid_cPa419,4_2_3_16_3_3_2_1_1_1_1_2_2,697,595
chrZ-51268269_51268493,cPa163-cPa47-hybrid,0.75,2,51268441,51268319,cPa163-cPa47-hybrid_cPa360-cPa47-hybrid,3_1,224,122
chrZ-51304885_51304987,cPa62,0.903225806451613,5,51304947,51304912,cPa254_cPa254-cPa118-hybrid_cPa254-unknown_cPa62_cPa62-cPa118-hybrid,1_2_1_56_2,102,35
chrZ-51620432_51620534,cPa260-cPa75-hybrid,1,1,51620505,51620476,cPa260-cPa75-hybrid,5,102,29
chrZ-51620636_51620738,cPa260-cPa75-hybrid,1,1,51620736,51620686,cPa260-cPa75-hybrid,3,102,50
chrZ-51790390_51790492,cPa75-unknown,0.75,2,51790477,51790415,cPa75-unknown_HERV-W_repbase_HERV17_LTR17,3_1,102,62
chrZ-52044055_52044157,cPa4_cPa541,0.5,2,52044105,52044105,cPa4_cPa541,1_1,102,0
chrZ-52079818_52079920,cPa257-cPa555-hybrid_cPa285-cPa546-hybrid,0.272727272727273,5,52079891,52079864,cPa257_cPa257-cPa546-hybrid_cPa257-cPa555-hybrid_cPa285-cPa546-hybrid_cPa555,2_2_3_3_1,102,27
chrZ-52242162_52242269,cPa220,0.658536585365854,8,52242233,52242168,cPa104_cPa104-cPa190-hybrid_cPa104-unknown_cPa190_cPa219-cPa190-hybrid_cPa219-cPa258-hybrid_cPa220_cPa258,3_2_1_2_2_1_27_3,107,65
chrZ-52380449_52380551,EqFV_NC002201-cPa543-hybrid,1,1,52380499,52380499,EqFV_NC002201-cPa543-hybrid,1,102,0
chrZ-524037_524139,cPa176-cPa75-hybrid_cPa308-cPa75-hybrid,0.5,2,524107,524087,cPa176-cPa75-hybrid_cPa308-cPa75-hybrid,1_1,102,20
chrZ-5265584_5265686,cPa62,0.666666666666667,2,5265658,5265620,cPa62_cPa62-cPa75-hybrid,2_1,102,38
chrZ-52720623_52720765,cPa75,0.833333333333333,2,52720713,52720673,cPa482-cPa75-hybrid_cPa75,1_5,142,40
chrZ-52721389_52721501,cPa482-cPa75-hybrid_cPa75,0.5,2,52721449,52721439,cPa482-cPa75-hybrid_cPa75,1_1,112,10
chrZ-53029678_53029795,cPa363_cPa456,0.318181818181818,7,53029743,53029693,cPa117-cPa452-hybrid_cPa117-cPa456-hybrid_cPa117-cPa587-hybrid_cPa363_cPa452_cPa452-cPa587-hybrid_cPa456,1_1_2_7_3_1_7,117,50
chrZ-5318626_5318728,cPa62,1,1,5318676,5318676,cPa62,1,102,0
chrZ-53213682_53213790,cPa452-cPa183-hybrid,0.428571428571429,18,53213786,53213710,cPa16-cPa223-hybrid_cPa183_cPa223_cPa223-cPa446-hybrid_cPa327_cPa363-cPa183-hybrid_cPa363-cPa223-hybrid_cPa363-cPa327-hybrid_cPa363-cPa424-hybrid_cPa363-cPa446-hybrid_cPa363-unknown_cPa419_cPa452-cPa183-hybrid_cPa452-cPa223-hybrid_cPa452-unknown_cPa71-cPa183-hybrid_cPa71-cPa223-hybrid_cPa71-cPa424-hybrid,1_8_9_1_1_9_3_1_2_1_3_1_45_14_1_2_2_1,108,76
chrZ-53312200_53312302,cPa142,1,1,53312250,53312235,cPa142,2,102,15
chrZ-53332120_53332222,cPa529_cPa545,0.5,2,53332181,53332170,cPa529_cPa545,1_1,102,11
chrZ-53332494_53332596,cPa142,1,1,53332544,53332544,cPa142,1,102,0
chrZ-53336182_53336284,cPa216_cPa419-cPa438-hybrid,0.5,2,53336280,53336232,cPa216_cPa419-cPa438-hybrid,1_1,102,48
chrZ-53413810_53413912,cPa62,1,1,53413863,53413846,cPa62,27,102,17
chrZ-53801334_53801446,cPa127-cPa241-hybrid,0.3125,7,53801395,53801384,cPa127_cPa127-cPa241-hybrid_cPa241_cPa290_cPa290-cPa241-hybrid_cPa290-cPa530-hybrid_cPa540,1_5_1_1_3_1_4,112,11
chrZ-53846673_53846775,cPa456,1,1,53846723,53846723,cPa456,1,102,0
chrZ-53846858_53846960,cPa456,1,1,53846908,53846908,cPa456,1,102,0
chrZ-53847396_53847498,cPa363-cPa117-hybrid_cPa456_cPa587-cPa117-hybrid,0.333333333333333,3,53847460,53847446,cPa363-cPa117-hybrid_cPa456_cPa587-cPa117-hybrid,1_1_1,102,14
chrZ-53945215_53945346,cPa540,0.571428571428571,4,53945294,53945223,cPa241-cPa127-hybrid_cPa515-cPa142-hybrid_cPa515-cPa540-hybrid_cPa540,1_1_1_4,131,71
chrZ-54125302_54125404,cPa62,0.9375,2,54125368,54125336,cPa510-cPa62-hybrid_cPa62,1_15,102,32
chrZ-54183357_54183476,cPa254,0.319727891156463,17,54183465,54183386,cPa174_cPa174-cPa254-hybrid_cPa174-cPa404-hybrid_cPa174-cPa425-hybrid_cPa174-cPa47-hybrid_cPa174-unknown_cPa254_cPa254-cPa404-hybrid_cPa254-cPa425-hybrid_cPa254-cPa47-hybrid_cPa404_cPa404-cPa47-hybrid_cPa425_cPa425-cPa404-hybrid_cPa425-cPa47-hybrid_cPa47_cPa62-cPa47-hybrid,21_1_4_4_14_1_47_2_2_6_18_1_17_1_5_2_1,119,79
chrZ-54240171_54240273,cPa323,1,1,54240221,54240189,cPa323,2,102,32
chrZ-54240560_54240662,cPa323_cPa50_cPa568,0.333333333333333,3,54240642,54240587,cPa323_cPa50_cPa568,1_1_1,102,55
chrZ-54359305_54359407,cPa452,0.375,5,54359355,54359333,cPa363_cPa452_cPa71_cPa71-cPa363-hybrid_cPa71-unknown,5_6_3_1_1,102,22
chrZ-54907962_54908076,cPa15_cPa248-cPa118-hybrid_cPa443-cPa118-hybrid,0.333333333333333,3,54908024,54908012,cPa15_cPa248-cPa118-hybrid_cPa443-cPa118-hybrid,1_1_1,114,12
chrZ-5511395_5511577,HERV-W_repbase_HERV17_LTR17,0.826086956521739,3,5511525,5511445,cPa75_HERV-W_repbase_HERV17_LTR17_HERV-W_repbase_HERV17_LTR17-cPa315-hybrid,3_19_1,182,80
chrZ-5511585_5511848,HERV-W_repbase_HERV17_LTR17,0.866666666666667,4,5511828,5511589,cPa75_cPa75-HERV-W_repbase_HERV17_LTR17-hybrid_HERV-W_repbase_HERV17_LTR17_KoRV_AF151794,2_1_26_1,263,239
chrZ-5512008_5512141,HERV-W_repbase_HERV17_LTR17,0.9,2,5512091,5512018,HERV-W_repbase_HERV17_LTR17_KoRV_AF151794,9_1,133,73
chrZ-5512251_5512353,HERV-W_repbase_HERV17_LTR17,1,1,5512301,5512301,HERV-W_repbase_HERV17_LTR17,1,102,0
chrZ-55265280_55265382,cPa47,0.216216216216216,11,55265374,55265330,cPa174_cPa174-cPa404-hybrid_cPa174-cPa47-hybrid_cPa174-unknown_cPa254_cPa254-cPa404-hybrid_cPa254-cPa47-hybrid_cPa404_cPa425_cPa425-cPa404-hybrid_cPa47,1_15_1_4_14_5_1_1_13_3_16,102,44
chrZ-55298518_55298620,cPa62,0.961538461538462,2,55298570,55298554,cPa254_cPa62,1_25,102,16
chrZ-55340550_55340652,cPa15,0.611111111111111,4,55340651,55340592,cPa118_cPa118-cPa268-hybrid_cPa118-unknown_cPa15,1_3_3_11,102,59
chrZ-5546500_5546602,cPa15,0.5,3,5546563,5546550,cPa118_cPa15_cPa443,1_2_1,102,13
chrZ-5556178_5556542,HERV-W_repbase_HERV17_LTR17,0.75,5,5556530,5556180,cPa75_HERV-W_repbase_HERV17_LTR17_HERV-W_repbase_HERV17_LTR17-cPa62-hybrid_HERV-W_repbase_HERV17_LTR17-unknown_KoRV_AF151794,1_12_1_1_1,364,350
chrZ-55947208_55947319,cPa62,0.956521739130435,2,55947280,55947252,cPa356-unknown_cPa62,1_22,111,28
chrZ-56003890_56003992,cPa492,1,1,56003982,56003890,cPa492,20,102,92
chrZ-56150539_56151161,HERV-W_repbase_HERV17_LTR17,0.689655172413793,8,56151109,56150541,cPa62_cPa62-cPa75-hybrid_cPa75_cPa75-cPa62-hybrid_HERV-W_repbase_HERV17_LTR17_HERV-W_repbase_HERV17_LTR17-cPa75-hybrid_HERV-W_repbase_HERV17_LTR17-unknown_KoRV_AF151794,3_2_13_1_60_1_6_1,622,568
chrZ-56433582_56433687,cPa404,0.672727272727273,6,56433639,56433630,cPa174_cPa254_cPa392_cPa404_cPa404-cPa174-hybrid_cPa404-unknown,2_12_1_37_1_2,105,9
chrZ-57002112_57002235,cPa75,0.511111111111111,4,57002193,57002112,cPa62_cPa62-cPa75-hybrid_cPa62-unknown_cPa75,1_8_13_23,123,81
chrZ-57400351_57400520,cPa62,1,1,57400493,57400375,cPa62,41,169,118
chrZ-57444351_57444453,cPa219,0.421052631578947,7,57444407,57444374,cPa104_cPa104-cPa190-hybrid_cPa104-unknown_cPa190_cPa219_cPa220_cPa220-cPa18-hybrid,6_1_1_1_8_1_1,102,33
chrZ-57502632_57502783,cPa62,0.677966101694915,8,57502766,57502677,cPa285_cPa285-cPa293-hybrid_cPa285-cPa62-hybrid_cPa285-unknown_cPa293_cPa62_cPa62-cPa293-hybrid_cPa62-unknown,9_1_3_1_3_40_1_1,151,89
chrZ-5790657_5790763,cPa75,0.7,4,5790711,5790679,cPa260_cPa260-cPa62-hybrid_cPa75_cPa75-cPa62-hybrid,1_1_7_1,106,32
chrZ-5790920_5791022,cPa75,0.636363636363636,11,5791022,5790922,cPa113-cPa75-hybrid_cPa260_cPa260-cPa62-hybrid_cPa285-cPa62-hybrid_cPa308_cPa71-cPa62-hybrid_cPa75_cPa75-cPa293-hybrid_cPa75-unknown_HERV-W_repbase_HERV17_LTR17-cPa62-hybrid_HERV-W_repbase_HERV17_LTR17-unknown,1_1_1_1_1_1_21_1_2_2_1,102,100
chrZ-58056473_58056575,cPa75_HERV-W_repbase_HERV17_LTR17,0.4,3,58056570,58056523,cPa62-unknown_cPa75_HERV-W_repbase_HERV17_LTR17,1_2_2,102,47
chrZ-58056904_58057017,HERV-W_repbase_HERV17_LTR17,0.454545454545455,8,58057004,58056935,cPa62_cPa62-cPa75-hybrid_cPa62-HERV-W_repbase_HERV17_LTR17-hybrid_cPa62-unknown_cPa75_cPa75-HERV-W_repbase_HERV17_LTR17-hybrid_HERV-W_repbase_HERV17_LTR17_HERV-W_repbase_HERV17_LTR17-cPa71-hybrid,1_1_3_4_1_1_10_1,113,69
chrZ-58230356_58230516,cPa62,0.75,5,58230509,58230384,cPa285_cPa293_cPa62_cPa62-cPa75-hybrid_cPa75,3_1_30_2_4,160,125
chrZ-58753487_58753589,cPa62,1,1,58753558,58753521,cPa62,15,102,37
chrZ-58783441_58783543,cPa62,1,1,58783491,58783491,cPa62,1,102,0
chrZ-5925259_5925361,cPa62,1,1,5925319,5925304,cPa62,14,102,15
chrZ-59253971_59254073,cPa273,0.571428571428571,7,59254053,59253970,cPa223-cPa199-hybrid_cPa227_cPa273_cPa273-cPa227-hybrid_cPa273-cPa553-hybrid_cPa345_cPa553,1_1_8_1_1_1_1,102,83
chrZ-59254098_59254200,cPa273,0.255813953488372,16,59254154,59254109,cPa199-cPa553-hybrid_cPa223_cPa223-cPa227-hybrid_cPa223-cPa273-hybrid_cPa223-cPa450-hybrid_cPa223-cPa553-hybrid_cPa227_cPa227-cPa553-hybrid_cPa273_cPa273-cPa553-hybrid_cPa345_cPa345-cPa450-hybrid_cPa345-cPa553-hybrid_cPa542_cPa553_HIV1_NC001802-cPa553-hybrid,1_5_2_1_4_6_16_3_22_5_2_2_4_1_11_1,102,45
chrZ-59258970_59259072,cPa152-cPa194-hybrid_cPa505-cPa194-hybrid,0.5,2,59259020,59259001,cPa152-cPa194-hybrid_cPa505-cPa194-hybrid,1_1,102,19
chrZ-59609379_59609591,cPa75,0.5,5,59609539,59609379,cPa62_cPa62-MMTV_NC001503-hybrid_cPa75_cPa75-MMTV_NC001503-hybrid_cPa75-unknown,1_1_6_1_3,212,160
chrZ-59609691_59609822,cPa75,0.6,3,59609788,59609709,cPa62_cPa75_cPa75-unknown,3_6_1,131,79
chrZ-59609961_59610079,cPa75,0.416666666666667,5,59610034,59610005,cPa293_cPa62_cPa62-cPa293-hybrid_cPa75_cPa75-MMTV_NC001503-hybrid,1_4_1_5_1,118,29
chrZ-59699444_59699579,cPa174_cPa392_cPa404_cPa425_cPa47-cPa254-hybrid,0.2,5,59699527,59699494,cPa174_cPa392_cPa404_cPa425_cPa47-cPa254-hybrid,1_1_1_1_1,135,33
chrZ-60118894_60118996,cPa62,1,1,60118990,60118932,cPa62,17,102,58
chrZ-60201682_60201784,cPa62,1,1,60201732,60201724,cPa62,2,102,8
chrZ-60225007_60225125,HERV-W_repbase_HERV17_LTR17,0.6,2,60225088,60225057,cPa75_HERV-W_repbase_HERV17_LTR17,2_3,118,31
chrZ-60225192_60225294,cPa75,0.625,4,60225242,60225195,cPa75_cPa75-cPa62-hybrid_HERV-W_repbase_HERV17_LTR17_S71_repbase_HERVS71_LTR6A-cPa71-hybrid,10_1_4_1,102,47
chrZ-6033602_6033704,cPa113,1,1,6033652,6033652,cPa113,1,102,0
chrZ-60565004_60565106,HERV-W_repbase_HERV17_LTR17,0.5,3,60565095,60565054,cPa75_HERV-W_repbase_HERV17_LTR17_PERVA_AY099323,1_2_1,102,41
chrZ-60658096_60658216,cPa163_cPa224-cPa360-hybrid,0.5,2,60658164,60658146,cPa163_cPa224-cPa360-hybrid,1_1,120,18
chrZ-61045208_61045316,cPa62,0.949152542372881,4,61045271,61045233,cPa62_HERV30_repbase_HERV30I_LTR30-cPa293-hybrid_HERV30_repbase_HERV30I_LTR30-cPa62-hybrid_HERV30_repbase_HERV30I_LTR30-unknown,56_1_1_1,108,38
chrZ-61745337_61745546,cPa62-HERV-W_repbase_HERV17_LTR17-hybrid,0.5,6,61745494,61745378,cPa62_cPa62-cPa75-hybrid_cPa62-HERV-W_repbase_HERV17_LTR17-hybrid_cPa75-S71_repbase_HERVS71_LTR6A-hybrid_HERV-W_repbase_HERV17_LTR17_HERV-W_repbase_HERV17_LTR17-cPa75-hybrid,1_1_8_1_4_1,209,116
chrZ-61746077_61746487,HERV-W_repbase_HERV17_LTR17,0.333333333333333,6,61746435,61746127,cPa293-cPa75-hybrid_cPa62-cPa75-hybrid_cPa62-HERV-W_repbase_HERV17_LTR17-hybrid_cPa75_HERV-W_repbase_HERV17_LTR17_HERV-W_repbase_HERV17_LTR17-cPa75-hybrid,1_3_4_3_6_1,410,308
chrZ-61746591_61746723,cPa75,0.6,3,61746671,61746641,cPa75_HERV-W_repbase_HERV17_LTR17_HERV-W_repbase_HERV17_LTR17-KoRV_AF151794-hybrid,3_1_1,132,30
chrZ-61746799_61747160,HERV-W_repbase_HERV17_LTR17,0.333333333333333,6,61747108,61746849,cPa62_cPa62-cPa75-hybrid_cPa62-HERV-W_repbase_HERV17_LTR17-hybrid_cPa75_HERV-W_repbase_HERV17_LTR17_HERV-W_repbase_HERV17_LTR17-unknown,1_5_3_2_6_1,361,259
chrZ-61792414_61792553,cPa62,1,1,61792509,61792464,cPa62,14,139,45
chrZ-62019823_62019931,cPa247-cPa14-hybrid_cPa545_cPa95,0.333333333333333,3,62019879,62019873,cPa247-cPa14-hybrid_cPa545_cPa95,1_1_1,108,6
chrZ-62277769_62277871,cPa118_cPa15,0.5,2,62277819,62277796,cPa118_cPa15,2_2,102,23
chrZ-62345449_62345561,cPa404_cPa47,0.25,6,62345509,62345499,cPa174_cPa254_cPa254-unknown_cPa404_cPa425_cPa47,1_1_1_2_1_2,112,10
chrZ-62529957_62530059,BLV_NC001414-cPa419-hybrid,1,1,62530007,62530007,BLV_NC001414-cPa419-hybrid,1,102,0
chrZ-62673173_62673275,cPa568-cPa323-hybrid,0.375,4,62673227,62673211,cPa323_cPa333_cPa568-cPa323-hybrid_cPa568-cPa371-hybrid,1_2_3_2,102,16
chrZ-62752055_62752159,cPa363_cPa452_cPa71,0.333333333333333,3,62752107,62752105,cPa363_cPa452_cPa71,2_2_2,104,2
chrZ-63674285_63674387,cPa539,1,1,63674338,63674335,cPa539,2,102,3
chrZ-64876522_64876636,cPa118_cPa15_cPa248-unknown,0.333333333333333,3,64876584,64876572,cPa118_cPa15_cPa248-unknown,1_1_1,114,12
chrZ-65234448_65234555,cPa15_cPa443,0.4,3,65234509,65234498,cPa118_cPa15_cPa443,1_2_2,107,11
chrZ-65312891_65312996,cPa183-cPa16-hybrid_cPa424-cPa16-hybrid_cPa424-cPa223-hybrid_cPa446-cPa223-hybrid,0.25,4,65312944,65312929,cPa183-cPa16-hybrid_cPa424-cPa16-hybrid_cPa424-cPa223-hybrid_cPa446-cPa223-hybrid,1_1_1_1,105,15
chrZ-6548058_6548168,cPa363_cPa456,0.5,2,6548116,6548108,cPa363_cPa456,1_1,110,8
chrZ-65556319_65556421,cPa62,1,1,65556389,65556357,cPa62,11,102,32
chrZ-656875_656977,cPa62,1,1,656956,656925,cPa62,5,102,31
chrZ-656987_657089,cPa62,1,1,657084,656999,cPa62,9,102,85
chrZ-65725006_65725108,cPa452,0.6,3,65725067,65725055,cPa363-cPa71-hybrid_cPa452_cPa452-unknown,1_3_1,102,12
chrZ-65749777_65749879,cPa62,1,1,65749841,65749822,cPa62,26,102,19
chrZ-65750250_65750352,cPa62,0.666666666666667,2,65750312,65750272,cPa62_cPa62-unknown,2_1,102,40
chrZ-65782452_65782554,cPa118,1,1,65782502,65782502,cPa118,1,102,0
chrZ-66389349_66389494,cPa75,0.666666666666667,2,66389483,66389399,cPa75_cPa75-cPa260-hybrid,2_1,145,84
chrZ-66389497_66389599,cPa75,0.666666666666667,2,66389547,66389542,cPa75_cPa75-HERV-W_repbase_HERV17_LTR17-hybrid,2_1,102,5
chrZ-66389602_66390052,cPa75,0.454545454545455,4,66390000,66389626,cPa62-cPa293-hybrid_cPa75_cPa75-cPa260-hybrid_cPa75-HERV-W_repbase_HERV17_LTR17-hybrid,1_10_9_2,450,374
chrZ-66474152_66474254,cPa117,0.75,2,66474202,66474176,cPa117_cPa539,3_1,102,26
chrZ-66624753_66624866,cPa62,1,1,66624816,66624790,cPa62,22,113,26
chrZ-66636706_66636808,cPa75-unknown,1,1,66636756,66636756,cPa75-unknown,1,102,0
chrZ-66945636_66945738,cPa62-HERV-W_repbase_HERV17_LTR17-hybrid,0.666666666666667,3,66945737,66945652,cPa62-HERV-W_repbase_HERV17_LTR17-hybrid_cPa62-unknown_cPa75,4_1_1,102,85
chrZ-67123288_67123792,HERV-W_repbase_HERV17_LTR17,0.415584415584416,7,67123772,67123305,cPa62_cPa62-cPa75-hybrid_cPa62-HERV-W_repbase_HERV17_LTR17-hybrid_cPa62-unknown_cPa75_HERV-W_repbase_HERV17_LTR17_PERV_AJ293656,6_7_26_3_2_32_1,504,467
chrZ-67174224_67174326,cPa75,1,1,67174274,67174274,cPa75,1,102,0
chrZ-67174398_67174500,cPa75_cPa75-unknown,0.5,2,67174448,67174418,cPa75_cPa75-unknown,1_1,102,30
chrZ-67185689_67185794,cPa62,0.952380952380952,2,67185742,67185720,cPa62_cPa75-unknown,20_1,105,22
chrZ-67193341_67193452,cPa62,0.951612903225806,3,67193440,67193376,cPa285_cPa293_cPa62,1_2_59,111,64
chrZ-67200685_67200794,cPa62,1,1,67200754,67200735,cPa62,14,109,19
chrZ-67332530_67332649,cPa62-cPa75-hybrid,0.6,3,67332597,67332580,cPa62_cPa62-cPa75-hybrid_cPa75,1_3_1,119,17
chrZ-67345448_67345725,cPa75,0.333333333333333,12,67345701,67345476,cPa113_cPa113-cPa260-hybrid_cPa260_cPa293_cPa308_cPa419_cPa62_cPa62-cPa75-hybrid_cPa75_cPa75-unknown_HERV-W_repbase_HERV17_LTR17_PERVC_HM159246-cPa113-hybrid,3_1_10_3_4_2_3_1_15_1_1_1,277,225
chrZ-67394598_67394700,cPa62,0.9,2,67394659,67394637,cPa254-unknown_cPa62,1_9,102,22
chrZ-67401138_67401278,cPa62,0.962962962962963,2,67401244,67401188,cPa62_cPa62-unknown,26_1,140,56
chrZ-67401354_67401456,cPa62,1,1,67401404,67401404,cPa62,1,102,0
chrZ-67438124_67438226,cPa62,1,1,67438175,67438140,cPa62,7,102,35
chrZ-67440010_67440182,cPa75-unknown,1,1,67440130,67440060,cPa75-unknown,2,172,70
chrZ-67485099_67485213,cPa363_cPa452_cPa71,0.3,4,67485161,67485141,cPa176-cPa16-hybrid_cPa363_cPa452_cPa71,1_3_3_3,114,20
chrZ-67555533_67555681,HERV-W_repbase_HERV17_LTR17,0.235294117647059,8,67555632,67555583,cPa75_cPa75-cPa285-hybrid_HERV-W_repbase_HERV17_LTR17_HERV-W_repbase_HERV17_LTR17-cPa293-hybrid_HERV-W_repbase_HERV17_LTR17-cPa402-hybrid_HERV-W_repbase_HERV17_LTR17-cPa62-hybrid_HERV-W_repbase_HERV17_LTR17-cPa75-hybrid_KoRV_AF151794-cPa293-hybrid,3_1_4_2_1_2_3_1,148,49
chrZ-67555716_67555887,HERV-W_repbase_HERV17_LTR17,0.3125,4,67555835,67555761,cPa75_HERV-W_repbase_HERV17_LTR17_HERV-W_repbase_HERV17_LTR17-cPa293-hybrid_HERV-W_repbase_HERV17_LTR17-cPa62-hybrid,4_5_3_4,171,74
chrZ-67556005_67556115,cPa75,1,1,67556093,67556055,cPa75,4,110,38
chrZ-67556226_67556364,HERV-W_repbase_HERV17_LTR17,0.272727272727273,7,67556360,67556240,cPa75_HERV-W_repbase_HERV17_LTR17_HERV-W_repbase_HERV17_LTR17-cPa293-hybrid_HERV-W_repbase_HERV17_LTR17-cPa75-hybrid_KoRV_AF151794-cPa293-hybrid_KoRV_AF151794-cPa62-hybrid_S71_repbase_HERVS71_LTR6A,2_3_1_2_1_1_1,138,120
chrZ-67561968_67562080,cPa62,0.916666666666667,2,67562044,67561971,cPa285-cPa62-hybrid_cPa62,1_11,112,73
chrZ-67587194_67587296,cPa62,0.956521739130435,2,67587286,67587220,cPa293-cPa62-hybrid_cPa62,1_22,102,66
chrZ-67587400_67587522,cPa62,1,1,67587492,67587436,cPa62,10,122,56
chrZ-67587583_67587689,cPa62,1,1,67587670,67587590,cPa62,15,106,80
chrZ-67593649_67593751,cPa62,0.75,3,67593699,67593670,cPa285-unknown_cPa62_cPa75-cPa62-hybrid,2_9_1,102,29
chrZ-67623941_67624043,cPa62,1,1,67623991,67623972,cPa62,14,102,19
chrZ-6766185_6766305,cPa62,0.954545454545455,2,6766296,6766233,cPa572_cPa62,1_21,120,63
chrZ-67669596_67669698,cPa62,1,1,67669671,67669635,cPa62,25,102,36
chrZ-67669759_67669871,cPa62,0.714285714285714,3,67669854,67669769,cPa62_cPa75_cPa75-cPa62-hybrid,10_3_1,112,85
chrZ-67670118_67670409,cPa62,0.5,10,67670357,67670147,cPa293_cPa293-cPa62-hybrid_cPa293-cPa71-hybrid_cPa62_cPa71_cPa71-cPa62-hybrid_cPa71-cPa75-hybrid_cPa75_cPa75-cPa293-hybrid_cPa75-cPa62-hybrid,4_1_1_32_3_6_1_13_1_2,291,210
chrZ-67737744_67737846,cPa62,0.941176470588235,2,67737845,67737790,cPa285_cPa62,1_16,102,55
chrZ-67759338_67759440,cPa285,0.5,4,67759388,67759386,cPa285_cPa293_cPa62_cPa75-cPa264-hybrid,3_1_1_1,102,2
chrZ-67773862_67773964,cPa75,1,1,67773912,67773912,cPa75,1,102,0
chrZ-67774110_67774388,cPa75,0.666666666666667,2,67774336,67774160,cPa62_cPa75,2_4,278,176
chrZ-67841982_67842084,cPa75,0.4,4,67842042,67842030,cPa75_cPa75-cPa62-hybrid_cPa75-unknown_HERV-W_repbase_HERV17_LTR17,2_1_1_1,102,12
chrZ-67842121_67842559,HERV-W_repbase_HERV17_LTR17,0.441860465116279,7,67842507,67842142,cPa75_cPa75-cPa62-hybrid_cPa75-HERV-W_repbase_HERV17_LTR17-hybrid_cPa75-unknown_HERV-W_repbase_HERV17_LTR17_HERV-W_repbase_HERV17_LTR17-cPa62-hybrid_HERV-W_repbase_HERV17_LTR17-unknown,13_3_2_1_19_4_1,438,365
chrZ-67848275_67848377,cPa62_cPa75-cPa62-hybrid,0.5,2,67848374,67848325,cPa62_cPa75-cPa62-hybrid,1_1,102,49
chrZ-67858158_67858260,cPa260,0.578947368421053,4,67858245,67858187,cPa260_cPa260-cPa75-hybrid_cPa260-SMRV_NC001514-hybrid_cPa260-unknown,11_1_3_4,102,58
chrZ-6786123_6786225,cPa15,0.444444444444444,8,6786207,6786163,cPa118_cPa118-cPa125-hybrid_cPa118-cPa248-hybrid_cPa118-unknown_cPa15_cPa248_cPa443-cPa248-hybrid_cPa443-unknown,6_1_1_2_12_1_2_2,102,44
chrZ-67874376_67874478,cPa75_HERV-W_repbase_HERV17_LTR17,0.5,2,67874441,67874426,cPa75_HERV-W_repbase_HERV17_LTR17,1_1,102,15
chrZ-68081583_68081685,cPa62,0.777777777777778,3,68081674,68081586,cPa285_cPa62_cPa62-unknown,1_7_1,102,88
chrZ-68113004_68113136,cPa75,0.375,5,68113133,68113016,cPa62_cPa62-cPa293-hybrid_cPa62-cPa75-hybrid_cPa62-unknown_cPa75,1_2_5_2_6,132,117
chrZ-68122386_68122504,cPa62,1,1,68122452,68122399,cPa62,9,118,53
chrZ-68271211_68271410,cPa75,0.666666666666667,3,68271358,68271261,cPa75_cPa75-cPa293-hybrid_cPa75-cPa62-hybrid,4_1_1,199,97
chrZ-68289913_68290015,cPa62-unknown_cPa75,0.285714285714286,5,68290010,68289918,cPa62_cPa62-cPa75-hybrid_cPa62-unknown_cPa75_cPa75-unknown,3_5_6_6_1,102,92
chrZ-68503594_68503700,cPa62,1,1,68503699,68503601,cPa62,14,106,98
chrZ-68548583_68548685,cPa62,1,1,68548649,68548626,cPa62,9,102,23
chrZ-68602407_68602509,cPa62,1,1,68602481,68602457,cPa62,4,102,24
chrZ-68606537_68606639,cPa62,1,1,68606587,68606587,cPa62,1,102,0
chrZ-68653410_68653512,cPa62,1,1,68653466,68653427,cPa62,5,102,39
chrZ-68657204_68657306,cPa75,0.555555555555556,3,68657304,68657238,cPa62_cPa75_cPa75-unknown,1_5_3,102,66
chrZ-68658987_68659089,cPa62,1,1,68659037,68658991,cPa62,16,102,46
chrZ-68989534_68989636,cPa345,1,1,68989584,68989584,cPa345,1,102,0
chrZ-6901864_6901977,cPa358_cPa583,0.5,2,6901925,6901914,cPa358_cPa583,2_2,113,11
chrZ-69189078_69189186,cPa380,0.575,7,69189185,69189083,cPa380_cPa380-cPa572-hybrid_cPa518_cPa518-cPa150-hybrid_cPa518-cPa380-hybrid_cPa527-cPa104-hybrid_cPa572,23_3_2_1_2_1_8,108,102
chrZ-69209055_69209161,cPa247_cPa529_cPa95,0.333333333333333,3,69209109,69209105,cPa247_cPa529_cPa95,1_1_1,106,4
chrZ-69253070_69253186,cPa62,0.952380952380952,2,69253149,69253120,cPa285_cPa62,1_20,116,29
chrZ-693011_693113,cPa15-cPa516-hybrid,0.272727272727273,7,693113,693025,cPa15_cPa15-cPa516-hybrid_cPa15-unknown_cPa248_cPa443_cPa61-cPa118-hybrid_cPa61-cPa443-hybrid,2_3_1_2_1_1_1,102,88
chrZ-693248_693385,cPa248,0.3,13,693369,693265,cPa118_cPa15_cPa15-cPa118-hybrid_cPa15-cPa248-hybrid_cPa15-cPa264-hybrid_cPa15-unknown_cPa248_cPa248-unknown_cPa443_cPa443-cPa118-hybrid_cPa516_cPa61-cPa264-hybrid_cPa61-cPa516-hybrid,4_3_1_1_1_1_12_1_10_1_3_1_1,137,104
chrZ-69356058_69356160,cPa62,1,1,69356117,69356108,cPa62,2,102,9
chrZ-69367271_69367416,cPa260_cPa62-unknown_cPa75-unknown,0.333333333333333,3,69367364,69367321,cPa260_cPa62-unknown_cPa75-unknown,1_1_1,145,43
chrZ-69367597_69367699,cPa75-cPa260-hybrid,0.666666666666667,2,69367647,69367603,cPa260_cPa75-cPa260-hybrid,1_2,102,44
chrZ-69417240_69417342,cPa62,0.461538461538462,5,69417327,69417240,cPa254-unknown_cPa62_cPa75_cPa75-cPa62-hybrid_cPa75-unknown,1_6_3_1_2,102,87
chrZ-69417344_69417591,cPa62,0.346153846153846,8,69417580,69417385,cPa260-KoRV_AF151794-hybrid_cPa62_cPa62-unknown_cPa75_cPa75-cPa62-hybrid_cPa75-HERV-W_repbase_HERV17_LTR17-hybrid_cPa75-unknown_HERV-W_repbase_HERV17_LTR17,1_9_1_3_1_2_2_7,247,195
chrZ-69417592_69418025,HERV-W_repbase_HERV17_LTR17,0.344978165938865,19,69418021,69417594,cPa254-cPa285-hybrid_cPa254-HERV-W_repbase_HERV17_LTR17-hybrid_cPa293-unknown_cPa62_cPa62-cPa67-hybrid_cPa62-cPa75-hybrid_cPa62-HERV-W_repbase_HERV17_LTR17-hybrid_cPa62-KoRV_AF151794-hybrid_cPa62-unknown_cPa71_cPa75_cPa75-cPa62-hybrid_cPa75-HERV-W_repbase_HERV17_LTR17-hybrid_cPa75-KoRV_AF151794-hybrid_cPa75-PERV_AJ293656-hybrid_cPa75-unknown_HERV-W_repbase_HERV17_LTR17_HERV-W_repbase_HERV17_LTR17-unknown_KoRV_AF151794,1_1_1_52_1_1_7_3_2_1_49_4_12_1_1_8_79_3_2,433,427
chrZ-69494329_69494504,cPa174-cPa62-hybrid_cPa254_cPa425_cPa47,0.25,4,69494452,69494379,cPa174-cPa62-hybrid_cPa254_cPa425_cPa47,1_1_1_1,175,73
chrZ-69540124_69540226,cPa62_cPa75,0.5,2,69540221,69540174,cPa62_cPa75,1_1,102,47
chrZ-69540426_69540756,cPa62,0.441176470588235,8,69540704,69540432,cPa260_cPa293_cPa62_cPa62-cPa260-hybrid_cPa62-cPa75-hybrid_cPa62-unknown_cPa75_cPa75-cPa260-hybrid,1_2_15_1_2_3_9_1,330,272
chrZ-69567358_69567460,cPa113_MLV_Xmv43-cPa75-hybrid,0.333333333333333,4,69567460,69567406,cPa113_cPa113-unknown_cPa260-cPa75-hybrid_MLV_Xmv43-cPa75-hybrid,2_1_1_2,102,54
chrZ-69567472_69567580,cPa113_MLV_Xmv43-cPa62-hybrid,0.5,2,69567528,69567522,cPa113_MLV_Xmv43-cPa62-hybrid,1_1,108,6
chrZ-69567666_69567768,cPa113,0.5,3,69567716,69567677,cPa113_cPa113-unknown_cPa260-cPa75-hybrid,3_1_2,102,39
chrZ-69567854_69568025,cPa113,0.526315789473684,5,69567980,69567862,cPa113_cPa260-cPa75-hybrid_HERV-W_repbase_HERV17_LTR17-cPa62-hybrid_MLV_Xmv43-cPa62-hybrid_MLV_Xmv43-cPa75-hybrid,10_3_1_2_3,171,118
chrZ-69568121_69568223,cPa113,1,1,69568191,69568171,cPa113,2,102,20
chrZ-69568250_69568352,cPa113_HERV-W_repbase_HERV17_LTR17-cPa75-hybrid,0.5,2,69568304,69568300,cPa113_HERV-W_repbase_HERV17_LTR17-cPa75-hybrid,1_1,102,4
chrZ-69591708_69591810,cPa62-HERV-W_repbase_HERV17_LTR17-hybrid,0.310344827586207,7,69591793,69591727,cPa62-cPa75-hybrid_cPa62-HERV-W_repbase_HERV17_LTR17-hybrid_cPa62-unknown_cPa75_cPa75-HERV-W_repbase_HERV17_LTR17-hybrid_cPa75-unknown_HERV-W_repbase_HERV17_LTR17,2_9_7_7_2_1_1,102,66
chrZ-69591926_69592028,cPa62-HERV-W_repbase_HERV17_LTR17-hybrid_cPa62-unknown,0.285714285714286,5,69592006,69591930,cPa62_cPa62-cPa75-hybrid_cPa62-HERV-W_repbase_HERV17_LTR17-hybrid_cPa62-unknown_cPa75,1_2_4_4_3,102,76
chrZ-69729774_69729947,cPa241_cPa515,0.294117647058824,8,69729946,69729824,cPa127-WDSV_NC001867-hybrid_cPa241_cPa241-cPa540-hybrid_cPa254-cPa540-hybrid_cPa515_cPa530-cPa515-hybrid_cPa530-WDSV_NC001867-hybrid_cPa540,1_5_1_1_5_1_1_2,173,122
chrZ-69746498_69746600,cPa390,0.8,2,69746600,69746543,cPa390_cPa511-cPa260-hybrid,4_1,102,57
chrZ-69749131_69749233,cPa176_cPa363_cPa452_cPa71,0.25,4,69749181,69749181,cPa176_cPa363_cPa452_cPa71,1_1_1_1,102,0
chrZ-69819326_69819657,cPa75,0.372093023255814,10,69819628,69819325,cPa113_cPa293-cPa113-hybrid_cPa293-cPa75-hybrid_cPa293-unknown_cPa62_cPa75_cPa75-cPa113-hybrid_cPa75-cPa62-hybrid_cPa75-unknown_PERVC_HM159246-cPa75-hybrid,4_2_1_4_3_16_2_4_6_1,331,303
chrZ-69927862_69927964,cPa62,1,1,69927934,69927863,cPa62,8,102,71
chrZ-69945020_69945122,cPa62,1,1,69945085,69945060,cPa62,20,102,25
chrZ-70193743_70193845,cPa285-cPa62-hybrid,1,1,70193793,70193793,cPa285-cPa62-hybrid,1,102,0
chrZ-70194222_70194347,cPa62,1,1,70194295,70194250,cPa62,5,125,45
chrZ-70194895_70194997,cPa62,1,1,70194945,70194941,cPa62,2,102,4
chrZ-70312819_70312921,cPa62,1,1,70312920,70312841,cPa62,14,102,79
chrZ-70356215_70356317,cPa75,0.454545454545455,4,70356317,70356230,cPa62_cPa75_cPa75-cPa62-hybrid_cPa75-unknown,2_5_1_3,102,87
chrZ-70418710_70419256,cPa75,0.878048780487805,4,70419204,70418744,cPa62-HERV-W_repbase_HERV17_LTR17-hybrid_cPa75_cPa75-HERV-W_repbase_HERV17_LTR17-hybrid_HERV-W_repbase_HERV17_LTR17,1_36_3_1,546,460
chrZ-70419344_70419657,cPa75,0.888888888888889,3,70419657,70419394,cPa62-HERV-W_repbase_HERV17_LTR17-hybrid_cPa75_HERV-W_repbase_HERV17_LTR17,1_16_1,313,263
chrZ-7049292_7049461,cPa75_cPa75-unknown,0.5,2,7049409,7049342,cPa75_cPa75-unknown,1_1,169,67
chrZ-70549315_70549461,cPa62,0.82051282051282,3,70549446,70549328,cPa62_cPa75_cPa75-cPa62-hybrid,32_6_1,146,118
chrZ-70549479_70549680,cPa62,0.761904761904762,4,70549666,70549487,cPa293_cPa293-cPa75-hybrid_cPa62_cPa75,1_1_16_3,201,179
chrZ-70603215_70603317,cPa419_cPa75_HERV-W_repbase_HERV17_LTR17,0.333333333333333,3,70603308,70603265,cPa419_cPa75_HERV-W_repbase_HERV17_LTR17,1_1_1,102,43
chrZ-70603750_70603852,cPa62-HERV-W_repbase_HERV17_LTR17-hybrid,0.5,3,70603843,70603790,cPa62-HERV-W_repbase_HERV17_LTR17-hybrid_cPa62-unknown_HERV-W_repbase_HERV17_LTR17,2_1_1,102,53
chrZ-70712483_70712593,cPa345,1,1,70712552,70712503,cPa345,25,110,49
chrZ-70845869_70846061,cPa62,0.352941176470588,5,70846009,70845891,cPa62_cPa62-cPa260-hybrid_cPa62-cPa75-hybrid_cPa62-unknown_cPa75,6_3_5_2_1,192,118
chrZ-71246672_71246774,cPa62,1,1,71246731,71246689,cPa62,17,102,42
chrZ-71332514_71332616,cPa118_cPa15_cPa268-unknown,0.333333333333333,3,71332564,71332564,cPa118_cPa15_cPa268-unknown,1_1_1,102,0
chrZ-71374596_71374698,cPa539,1,1,71374646,71374646,cPa539,1,102,0
chrZ-71454820_71454999,HERV-W_repbase_HERV17_LTR17,1,1,71454947,71454870,HERV-W_repbase_HERV17_LTR17,4,179,77
chrZ-71455076_71455235,cPa75_HERV-W_repbase_HERV17_LTR17,0.333333333333333,6,71455230,71455126,cPa285-cPa62-hybrid_cPa293-cPa75-hybrid_cPa75_cPa75-HERV-W_repbase_HERV17_LTR17-hybrid_HERV-W_repbase_HERV17_LTR17_HERV-W_repbase_HERV17_LTR17-cPa75-hybrid,1_1_4_1_4_1,159,104
chrZ-71455259_71455425,HERV-W_repbase_HERV17_LTR17,0.666666666666667,3,71455373,71455289,cPa62-cPa75-hybrid_cPa75_HERV-W_repbase_HERV17_LTR17,1_2_6,166,84
chrZ-71455438_71455540,HERV-W_repbase_HERV17_LTR17,1,1,71455491,71455488,HERV-W_repbase_HERV17_LTR17,2,102,3
chrZ-71455758_71455977,HERV-W_repbase_HERV17_LTR17,0.4,5,71455966,71455781,cPa71-cPa75-hybrid_cPa75_cPa75-HERV-W_repbase_HERV17_LTR17-hybrid_HERV-W_repbase_HERV17_LTR17_HERV-W_repbase_HERV17_LTR17-cPa75-hybrid,1_3_1_4_1,219,185
chrZ-71612683_71612811,cPa127_cPa290_cPa540_cPa555,0.25,4,71612759,71612733,cPa127_cPa290_cPa540_cPa555,1_1_1_1,128,26
chrZ-71713038_71713140,cPa444,1,1,71713088,71713088,cPa444,1,102,0
chrZ-71804575_71804677,cPa552_cPa552-cPa75-hybrid,0.5,2,71804641,71804625,cPa552_cPa552-cPa75-hybrid,1_1,102,16
chrZ-71841428_71841577,cPa113,0.555555555555556,5,71841525,71841466,cPa113_cPa62-HERV-W_repbase_HERV17_LTR17-hybrid_cPa75_HERV-W_repbase_HERV17_LTR17_KoRV_AF151794-cPa75-hybrid,5_1_1_1_1,149,59
chrZ-7208923_7209025,HERV-W_repbase_HERV17_LTR17,0.75,2,7209001,7208965,cPa75_HERV-W_repbase_HERV17_LTR17,1_3,102,36
chrZ-7209392_7209597,HERV-W_repbase_HERV17_LTR17,0.892857142857143,3,7209574,7209428,cPa75_HERV-W_repbase_HERV17_LTR17_HERV-W_repbase_HERV17_LTR17-unknown,2_25_1,205,146
chrZ-7210057_7210159,cPa62,1,1,7210129,7210107,cPa62,3,102,22
chrZ-72109102_72109204,cPa62-HERV-W_repbase_HERV17_LTR17-hybrid,1,1,72109152,72109152,cPa62-HERV-W_repbase_HERV17_LTR17-hybrid,1,102,0
chrZ-72109569_72109671,HERV-W_repbase_HERV17_LTR17,0.7,6,72109666,72109574,cPa391-cPa62-hybrid_cPa62-cPa75-hybrid_cPa75_cPa75-cPa62-hybrid_HERV-W_repbase_HERV17_LTR17_HERV-W_repbase_HERV17_LTR17-unknown,1_1_1_2_14_1,102,92
chrZ-72109787_72109889,HERV-W_repbase_HERV17_LTR17,0.733333333333333,5,72109880,72109810,cPa62_cPa62-cPa75-hybrid_cPa75_HERV-W_repbase_HERV17_LTR17_HERV-W_repbase_HERV17_LTR17-unknown,1_1_5_22_1,102,70
chrZ-72109946_72110051,HERV-W_repbase_HERV17_LTR17,0.928571428571429,2,72110032,72109946,cPa75_HERV-W_repbase_HERV17_LTR17,1_13,105,86
chrZ-72114380_72114542,cPa62,1,1,72114490,72114430,cPa62,51,162,60
chrZ-72114610_72114712,cPa62,1,1,72114660,72114660,cPa62,1,102,0
chrZ-72125463_72125565,cPa254_cPa254-cPa75-hybrid_cPa62,0.333333333333333,3,72125522,72125513,cPa254_cPa254-cPa75-hybrid_cPa62,1_1_1,102,9
chrZ-72164373_72164475,cPa75,1,1,72164423,72164423,cPa75,1,102,0
chrZ-72164641_72164743,cPa75-cPa482-hybrid,1,1,72164691,72164691,cPa75-cPa482-hybrid,1,102,0
chrZ-72277854_72277956,cPa438,1,1,72277904,72277904,cPa438,1,102,0
chrZ-72277983_72278085,cPa216,0.727272727272727,2,72278050,72278024,cPa216_cPa260,8_3,102,26
chrZ-726633_726804,cPa227,0.538461538461538,4,726766,726669,cPa227_cPa323-cPa227-hybrid_cPa323-cPa62-hybrid_cPa62,7_3_2_1,171,97
chrZ-72771311_72771413,cPa194,0.625,4,72771361,72771319,cPa194_cPa194-cPa67-hybrid_cPa360_cPa67,5_1_1_1,102,42
chrZ-72771636_72771785,cPa194,0.571428571428571,2,72771733,72771686,cPa194_cPa67,4_3,149,47
chrZ-72771844_72772023,cPa194,0.5,3,72772015,72771894,cPa194_cPa194-cPa345-hybrid_cPa360,2_1_1,179,121
chrZ-72772091_72772193,cPa360-cPa67-hybrid,1,1,72772141,72772141,cPa360-cPa67-hybrid,1,102,0
chrZ-72772297_72772405,cPa67,0.833333333333333,3,72772402,72772299,cPa194_cPa345_cPa67,1_1_10,108,103
chrZ-72772418_72772549,cPa67,0.533333333333333,2,72772546,72772462,cPa194_cPa67,7_8,131,84
chrZ-72777380_72777637,cPa323,0.75,3,72777604,72777403,cPa323_cPa371_cPa371-cPa323-hybrid,27_3_6,257,201
chrZ-72777639_72777741,cPa323,0.6,2,72777736,72777666,cPa323_cPa371,6_4,102,70
chrZ-72782750_72782861,cPa75-cPa62-hybrid,1,1,72782809,72782800,cPa75-cPa62-hybrid,2,111,9
chrZ-72783989_72784091,cPa75-cPa62-hybrid,1,1,72784039,72784039,cPa75-cPa62-hybrid,1,102,0
chrZ-72793617_72793719,cPa75,1,1,72793667,72793667,cPa75,1,102,0
chrZ-72794277_72794484,cPa75,1,1,72794432,72794327,cPa75,9,207,105
chrZ-72802133_72802235,HML5_repbase_HERVK22I_LTR22,1,1,72802183,72802183,HML5_repbase_HERVK22I_LTR22,1,102,0
chrZ-72802241_72802343,HML5_repbase_HERVK22I_LTR22-cPa118-hybrid,1,1,72802291,72802291,HML5_repbase_HERVK22I_LTR22-cPa118-hybrid,1,102,0
chrZ-72802379_72802554,HML5_repbase_HERVK22I_LTR22,0.5,4,72802513,72802429,cPa450-cPa15-hybrid_cPa450-HML5_repbase_HERVK22I_LTR22-hybrid_HML5_repbase_HERVK22I_LTR22_HML5_repbase_HERVK22I_LTR22-unknown,1_1_3_1,175,84
chrZ-72802617_72802719,HML5_repbase_HERVK22I_LTR22,1,1,72802667,72802667,HML5_repbase_HERVK22I_LTR22,1,102,0
chrZ-72802722_72802834,cPa268-cPa15-hybrid_cPa450-cPa15-hybrid,0.5,2,72802782,72802772,cPa268-cPa15-hybrid_cPa450-cPa15-hybrid,1_1,112,10
chrZ-72813366_72813495,cPa194,1,1,72813476,72813416,cPa194,3,129,60
chrZ-72813566_72813673,cPa194,0.5,3,72813646,72813584,cPa194_cPa194-unknown_cPa67,3_1_2,107,62
chrZ-72813684_72813983,cPa67,0.625,2,72813951,72813734,cPa194_cPa67,6_10,299,217
chrZ-72915115_72915316,cPa117,1,1,72915264,72915130,cPa117,5,201,134
chrZ-72940502_72940604,cPa75,0.666666666666667,2,72940552,72940543,cPa260-cPa75-hybrid_cPa75,1_2,102,9
chrZ-72958393_72958498,cPa75_cPa75-cPa410-hybrid,0.5,2,72958446,72958443,cPa75_cPa75-cPa410-hybrid,1_1,105,3
chrZ-72958563_72958674,cPa75_cPa75-unknown,0.5,2,72958622,72958613,cPa75_cPa75-unknown,1_1,111,9
chrZ-72958676_72958791,cPa75-unknown,0.375,6,72958746,72958698,cPa183-cPa381-hybrid_cPa381_cPa75_cPa75-cPa381-hybrid_cPa75-cPa410-hybrid_cPa75-unknown,1_1_1_1_1_3,115,48
chrZ-72963559_72963661,cPa75,1,1,72963617,72963568,cPa75,3,102,49
chrZ-72963720_72963822,cPa75,1,1,72963770,72963770,cPa75,1,102,0
chrZ-72965650_72965752,cPa456,1,1,72965700,72965700,cPa456,1,102,0
chrZ-72984094_72984196,cPa270-unknown_cPa285,0.5,2,72984152,72984144,cPa270-unknown_cPa285,1_1,102,8
chrZ-72993541_72993693,cPa285-cPa62-hybrid_cPa62,0.5,2,72993641,72993591,cPa285-cPa62-hybrid_cPa62,1_1,152,50
chrZ-72993883_72994188,cPa285-cPa62-hybrid_cPa62,0.25,6,72994184,72993933,cPa119_cPa285-cPa254-hybrid_cPa285-cPa62-hybrid_cPa285-WDSV_NC001867-hybrid_cPa62_WDSV_NC001867,1_1_2_1_2_1,305,251
chrZ-72994330_72994657,WDSV_NC001867,0.538461538461538,6,72994609,72994358,cPa285-cPa62-hybrid_cPa285-WDSV_NC001867-hybrid_cPa62_WDSV_NC001867_WDSV_NC001867-cPa254-hybrid_WDSV_NC001867-cPa62-hybrid,3_1_5_21_1_8,327,251
chrZ-73011928_73012030,cPa62-unknown,1,1,73011978,73011978,cPa62-unknown,1,102,0
chrZ-73021665_73021799,cPa492-cPa62-hybrid_cPa492-unknown_cPa539,0.333333333333333,3,73021747,73021715,cPa492-cPa62-hybrid_cPa492-unknown_cPa539,1_1_1,134,32
chrZ-73120066_73120260,cPa75,1,1,73120250,73120114,cPa75,5,194,136
chrZ-73120282_73120384,cPa75,1,1,73120332,73120332,cPa75,1,102,0
chrZ-73124934_73125036,cPa106-unknown,1,1,73124984,73124984,cPa106-unknown,1,102,0
chrZ-73132592_73132694,cPa75,1,1,73132642,73132642,cPa75,1,102,0
chrZ-73141979_73142112,cPa75,1,1,73142060,73142029,cPa75,2,133,31
chrZ-73142249_73142351,cPa75,1,1,73142299,73142299,cPa75,1,102,0
chrZ-73414943_73415045,cPa75,1,1,73415040,73414993,cPa75,4,102,47
chrZ-7402126_7402241,cPa293_cPa391,0.5,2,7402189,7402176,cPa293_cPa391,1_1,115,13
chrZ-7450825_7450927,cPa583,0.916666666666667,2,7450914,7450875,cPa583_cPa583-unknown,11_1,102,39
chrZ-7521736_7521931,cPa75,0.909090909090909,2,7521879,7521786,cPa75_HERV-W_repbase_HERV17_LTR17,10_1,195,93
chrZ-7522229_7522424,cPa75,0.875,2,7522419,7522228,cPa75_cPa75-cPa62-hybrid,7_1,195,191
chrZ-7522700_7522802,cPa75,1,1,7522750,7522750,cPa75,1,102,0
chrZ-7624488_7624590,cPa285_cPa62,0.5,2,7624563,7624538,cPa285_cPa62,1_1,102,25
chrZ-7822753_7822984,KWERV_GQ222416,0.392857142857143,19,7822932,7822776,cPa131-KWERV_GQ222416-hybrid_cPa131-unknown_cPa150-KWERV_GQ222416-hybrid_cPa163_cPa173-unknown_cPa254-cPa47-hybrid_cPa255-cPa419-hybrid_cPa255-unknown_cPa391_cPa419_cPa478-cPa419-hybrid_cPa478-cPa75-hybrid_cPa478-KWERV_GQ222416-hybrid_cPa478-unknown_cPa563-unknown_HERV-R_repbase_HERV3_LTR4-cPa425-hybrid_HERV-R_repbase_HERV3_LTR4-unknown_KWERV_GQ222416_KWERV_GQ222416-unknown,2_2_1_2_1_1_1_1_1_5_1_1_1_10_1_1_1_22_1,231,156
chrZ-7826501_7826603,cPa419,0.666666666666667,2,7826565,7826547,cPa419_cPa515-cPa150-hybrid,2_1,102,18
chrZ-7829085_7829187,cPa61,0.39,13,7829186,7829084,cPa111-cPa247-hybrid_cPa121-cPa258-hybrid_cPa2-cPa21-hybrid_cPa2-cPa219-hybrid_cPa2-cPa258-hybrid_cPa2-cPa551-hybrid_cPa205_cPa205-cPa258-hybrid_cPa256-cPa258-hybrid_cPa258_cPa308_cPa419_cPa61,1_1_1_1_2_1_24_1_2_1_25_1_39,102,102
chrZ-7829210_7829312,cPa308,0.394736842105263,11,7829310,7829210,cPa111-cPa258-hybrid_cPa121-cPa258-hybrid_cPa2-cPa247-hybrid_cPa205_cPa205-cPa258-hybrid_cPa205-cPa463-hybrid_cPa258_cPa308_cPa308-unknown_cPa419_cPa61,2_1_1_5_1_1_2_15_1_2_7,102,100
chrZ-7829331_7829437,cPa308,0.48,20,7829437,7829341,cPa121-cPa205-hybrid_cPa121-cPa219-hybrid_cPa121-cPa61-hybrid_cPa2-cPa174-hybrid_cPa2-cPa205-hybrid_cPa2-cPa465-hybrid_cPa2-cPa61-hybrid_cPa2-unknown_cPa205_cPa205-cPa174-hybrid_cPa205-cPa258-hybrid_cPa256-cPa205-hybrid_cPa256-unknown_cPa258_cPa308_cPa308-cPa61-hybrid_cPa308-unknown_cPa419_cPa541-cPa258-hybrid_cPa61,1_1_1_1_6_1_7_10_9_1_1_1_1_1_72_1_4_1_1_29,106,96
chrZ-8279117_8279219,cPa15,1,1,8279194,8279153,cPa15,3,102,41
chrZ-8284386_8284501,cPa315,0.375,8,8284496,8284388,cPa315_cPa419_cPa581-cPa516-hybrid_cPa62-cPa285-hybrid_cPa62-cPa581-hybrid_cPa62-unknown_cPa75-unknown_HERV-XA34_repbase_HERVFH21I_LTR21A-cPa285-hybrid,6_1_1_1_1_3_1_2,115,108
chrZ-8306342_8306444,cPa113-HML4_repbase_HERVK13I_LTR13-hybrid,0.666666666666667,2,8306401,8306377,cPa113-cPa332-hybrid_cPa113-HML4_repbase_HERVK13I_LTR13-hybrid,1_2,102,24
chrZ-8322300_8322402,cPa555-cPa358-hybrid_cPa62-cPa358-hybrid,0.5,2,8322350,8322346,cPa555-cPa358-hybrid_cPa62-cPa358-hybrid,1_1,102,4
chrZ-8322829_8322942,cPa62-cPa492-hybrid,1,1,8322890,8322879,cPa62-cPa492-hybrid,2,113,11
chrZ-8322965_8323089,cPa419,0.666666666666667,2,8323057,8323015,cPa419_cPa62-cPa492-hybrid,2_1,124,42
chrZ-8335062_8335232,cPa387-cPa356-hybrid,0.28,7,8335181,8335099,cPa308-cPa356-hybrid_cPa356_cPa360-cPa356-hybrid_cPa387-cPa356-hybrid_cPa387-cPa74-hybrid_HERVHcons-cPa356-hybrid_HML3_repbase_HERVK9I_MER9-cPa356-hybrid,3_6_4_7_1_1_3,170,82
chrZ-8335304_8335410,cPa356,1,1,8335363,8335354,cPa356,3,106,9
chrZ-8335608_8335712,cPa356,1,1,8335697,8335655,cPa356,8,104,42
chrZ-8343208_8343310,cPa575,1,1,8343258,8343258,cPa575,1,102,0
chrZ-8502336_8502534,cPa42-HERV-W_repbase_HERV17_LTR17-hybrid,0.36734693877551,13,8502488,8502364,cPa138-cPa95-hybrid_cPa138-HERV-W_repbase_HERV17_LTR17-hybrid_cPa138-S71_repbase_HERVS71_LTR6A-hybrid_cPa199-HERV-W_repbase_HERV17_LTR17-hybrid_cPa270-HERV-W_repbase_HERV17_LTR17-hybrid_cPa270-S71_repbase_HERVS71_LTR6A-hybrid_cPa42-cPa95-hybrid_cPa42-HERV-W_repbase_HERV17_LTR17-hybrid_cPa42-S71_repbase_HERVS71_LTR6A-hybrid_cPa500-PERV_AJ293656-hybrid_cPa62-cPa95-hybrid_cPa62-HERV-W_repbase_HERV17_LTR17-hybrid_cPa62-S71_repbase_HERVS71_LTR6A-hybrid,1_2_2_1_2_1_1_18_1_1_1_17_1,198,124
chrZ-8556296_8556398,MPMVs_NC001550-unknown,1,1,8556346,8556346,MPMVs_NC001550-unknown,1,102,0
chrZ-8559385_8559487,cPa456-unknown,1,1,8559435,8559435,cPa456-unknown,1,102,0
chrZ-8626078_8626182,cPa450_cPa553,0.333333333333333,4,8626130,8626128,cPa199_cPa199-unknown_cPa450_cPa553,1_1_2_2,104,2
chrZ-8631158_8631263,cPa356-unknown,0.461538461538462,5,8631224,8631196,cPa177-cPa419-hybrid_cPa356-unknown_cPa419_cPa523-FeFV_NC001871-hybrid_cPa542-FeFV_NC001871-hybrid,1_6_4_1_1,105,28
chrZ-8631827_8632282,cPa177,0.378238341968912,59,8632281,8631869,cPa11-cPa511-hybrid_cPa127-cPa177-hybrid_cPa127-cPa356-hybrid_cPa127-cPa419-hybrid_cPa127-cPa511-hybrid_cPa127-HERV-W_repbase_HERV17_LTR17-hybrid_cPa127-unknown_cPa176-cPa356-hybrid_cPa176-cPa419-hybrid_cPa176-cPa511-hybrid_cPa176-FeFV_NC001871-hybrid_cPa177_cPa177-cPa356-hybrid_cPa177-cPa511-hybrid_cPa177-unknown_cPa216-cPa356-hybrid_cPa216-cPa511-hybrid_cPa216-FeFV_NC001871-hybrid_cPa290-cPa511-hybrid_cPa356_cPa356-cPa177-hybrid_cPa356-cPa511-hybrid_cPa356-cPa62-hybrid_cPa395-cPa177-hybrid_cPa395-cPa511-hybrid_cPa419_cPa438-cPa177-hybrid_cPa438-cPa2-hybrid_cPa438-cPa254-hybrid_cPa438-cPa356-hybrid_cPa438-cPa419-hybrid_cPa438-cPa511-hybrid_cPa438-cPa523-hybrid_cPa438-cPa542-hybrid_cPa438-FeFV_NC001871-hybrid_cPa438-HERV-W_repbase_HERV17_LTR17-hybrid_cPa438-unknown_cPa515-cPa511-hybrid_cPa518-cPa177-hybrid_cPa518-cPa254-hybrid_cPa518-cPa511-hybrid_cPa523-cPa511-hybrid_cPa527-cPa2-hybrid_cPa527-cPa511-hybrid_cPa529-cPa511-hybrid_cPa540-cPa356-hybrid_cPa540-cPa511-hybrid_cPa540-unknown_cPa541-cPa511-hybrid_cPa542-cPa511-hybrid_cPa544-cPa511-hybrid_cPa56-cPa177-hybrid_cPa56-cPa511-hybrid_cPa56-FeFV_NC001871-hybrid_cPa56-unknown_HERV-F_repbase_HERVFH19I_LTR19A-cPa511-hybrid_HERV-W_repbase_HERV17_LTR17_HERV-W_repbase_HERV17_LTR17-cPa177-hybrid_HERV-W_repbase_HERV17_LTR17-cPa511-hybrid,1_5_1_1_36_1_10_1_1_4_1_219_1_5_2_1_17_1_5_47_3_23_1_2_8_2_20_1_1_5_2_42_1_1_3_1_63_4_1_1_3_1_1_1_1_1_6_1_1_2_1_2_3_2_2_1_2_1_2,455,412
chrZ-8632936_8633100,cPa356,0.973684210526316,2,8633063,8632976,cPa356_cPa4-cPa356-hybrid,37_1,164,87
chrZ-8648568_8648670,cPa419,1,1,8648618,8648618,cPa419,1,102,0
chrZ-8673862_8673964,cPa75,0.863636363636364,2,8673915,8673902,cPa75_cPa75-unknown,19_3,102,13
chrZ-8674010_8674117,cPa75,0.8,2,8674079,8674024,cPa75_cPa75-unknown,4_1,107,55
chrZ-8713024_8713126,cPa527,0.246575342465753,28,8713126,8713064,cPa395_cPa395-cPa174-hybrid_cPa395-cPa223-hybrid_cPa395-cPa254-hybrid_cPa395-cPa472-hybrid_cPa395-cPa511-hybrid_cPa472_cPa518-cPa174-hybrid_cPa518-cPa223-hybrid_cPa518-cPa254-hybrid_cPa518-cPa472-hybrid_cPa518-cPa555-hybrid_cPa527_cPa527-cPa174-hybrid_cPa527-cPa223-hybrid_cPa540-cPa555-hybrid_cPa572_cPa572-cPa254-hybrid_cPa575_cPa575-cPa174-hybrid_cPa575-cPa223-hybrid_cPa575-cPa254-hybrid_cPa575-cPa404-hybrid_cPa575-cPa425-hybrid_cPa575-cPa472-hybrid_cPa575-cPa511-hybrid_cPa575-cPa527-hybrid_cPa575-MSFV_NC010819-hybrid,13_4_4_2_1_1_26_1_1_1_1_1_36_1_2_1_1_2_7_18_6_5_1_1_2_3_1_3,102,62
chrZ-8713191_8713293,cPa472,0.379310344827586,10,8713292,8713190,cPa395_cPa395-cPa223-hybrid_cPa395-cPa511-hybrid_cPa472_cPa527_cPa527-cPa472-hybrid_cPa575_cPa575-cPa527-hybrid_cPa575-cPa555-hybrid_cPa575-MSFV_NC010819-hybrid,3_1_1_11_6_1_1_1_2_2,102,102
chrZ-8857626_8857728,cPa353,0.163265306122449,31,8857728,8857643,BIV_NC001413-cPa268-hybrid_BIV_NC001413-cPa308-hybrid_BIV_NC001413-cPa339-hybrid_BIV_NC001413-cPa381-hybrid_BIV_NC001413-cPa486-hybrid_BIV_NC001413-unknown_cPa205-cPa268-hybrid_cPa205-cPa486-hybrid_cPa205-VISNA_S55323-hybrid_cPa268_cPa308_cPa339_cPa339-cPa268-hybrid_cPa339-cPa308-hybrid_cPa339-cPa486-hybrid_cPa339-unknown_cPa353_cPa353-cPa268-hybrid_cPa353-VISNA_S55323-hybrid_cPa381_cPa381-cPa268-hybrid_cPa390-cPa268-hybrid_cPa390-unknown_cPa390-VISNA_S55323-hybrid_cPa419_cPa444-cPa268-hybrid_cPa444-cPa339-hybrid_cPa444-cPa486-hybrid_cPa444-unknown_cPa444-VISNA_S55323-hybrid_cPa486,22_6_2_1_11_14_4_1_1_46_13_53_8_1_3_2_56_1_1_29_1_3_1_4_1_4_1_1_2_4_46,102,85
chrZ-906971_907073,cPa15_cPa15-cPa323-hybrid,0.4,3,907021,907001,cPa15_cPa15-cPa323-hybrid_cPa516-cPa323-hybrid,2_2_1,102,20
chrZ-9075723_9076393,cPa452,0.440251572327044,14,9076341,9075739,cPa117_cPa117-cPa452-hybrid_cPa363_cPa363-cPa117-hybrid_cPa363-cPa452-hybrid_cPa363-PtERV1_AC142352-hybrid_cPa363-unknown_cPa452_cPa452-unknown_cPa544-cPa452-hybrid_cPa71-cPa117-hybrid_PERVC_HM159246_PERVC_HM159246-cPa117-hybrid_PtERV1_AC142352,57_3_19_1_1_1_1_70_1_1_1_1_1_1,670,602
chrZ-9079995_9080097,cPa15,0.692307692307692,4,9080083,9080000,cPa118_cPa118-cPa248-hybrid_cPa15_cPa443,2_1_18_5,102,83
chrZ-9111718_9111979,cPa356-cPa585-hybrid,0.615384615384615,9,9111927,9111732,cPa107-cPa585-hybrid_cPa353-cPa585-hybrid_cPa353-unknown_cPa356_cPa356-cPa111-hybrid_cPa356-cPa410-hybrid_cPa356-cPa585-hybrid_cPa356-unknown_cPa419,1_2_1_1_1_1_16_1_2,261,195
chrZ-9112739_9112904,cPa356-cPa585-hybrid,0.75,2,9112852,9112789,cPa356-cPa585-hybrid_cPa419,3_1,165,63
chrZ-9133058_9133193,cPa107-cPa360-hybrid_cPa107-unknown_cPa356-cPa381-hybrid,0.333333333333333,3,9133141,9133108,cPa107-cPa360-hybrid_cPa107-unknown_cPa356-cPa381-hybrid,1_1_1,135,33
chrZ-9133205_9133310,cPa107-unknown,0.666666666666667,2,9133258,9133246,cPa107-cPa381-hybrid_cPa107-unknown,1_2,105,12
chrZ-9141886_9142014,cPa339,1,1,9142001,9141892,cPa339,8,128,109
chrZ-9142104_9142217,cPa339,0.777777777777778,3,9142169,9142149,cPa339_cPa353-cPa379-hybrid_cPa419,7_1_1,113,20
chrZ-9142484_9142598,cPa339,1,1,9142546,9142534,cPa339,6,114,12
chrZ-9142888_9142990,cPa492,1,1,9142949,9142936,cPa492,3,102,13
chrZ-9149617_9149796,cPa75,0.465116279069767,16,9149775,9149631,cPa199_cPa223_cPa223-cPa452-hybrid_cPa273-cPa199-hybrid_cPa273-cPa74-hybrid_cPa345-cPa452-hybrid_cPa392-cPa62-hybrid_cPa402_cPa62-cPa199-hybrid_cPa62-cPa223-hybrid_cPa62-cPa392-hybrid_cPa62-cPa402-hybrid_cPa62-cPa404-hybrid_cPa75_cPa75-cPa392-hybrid_cPa75-cPa62-hybrid,2_1_1_1_1_1_1_3_3_1_3_1_1_20_1_2,179,144
chrZ-9150646_9150749,cPa62,0.863636363636364,4,9150742,9150665,cPa285_cPa62_cPa62-cPa482-hybrid_cPa75-cPa205-hybrid,1_19_1_1,103,77
chrZ-9156957_9157204,cPa356-cPa371-hybrid,0.41025641025641,11,9157202,9157007,cPa174-cPa371-hybrid_cPa356-cPa371-hybrid_cPa356-cPa572-hybrid_cPa379-cPa371-hybrid_cPa404-cPa371-hybrid_cPa413-cPa371-hybrid_cPa413-cPa572-hybrid_cPa413-unknown_cPa450-cPa371-hybrid_cPa450-unknown_PERVC_HM159246-cPa371-hybrid,2_48_2_2_1_43_2_7_4_3_3,247,195
chrZ-9157735_9157841,cPa356-unknown,0.5,4,9157797,9157773,cPa356_cPa356-cPa404-hybrid_cPa356-cPa575-hybrid_cPa356-unknown,1_1_1_3,106,24
chrZ-9159834_9159989,cPa50,0.668831168831169,15,9159984,9159841,cPa15-cPa371-hybrid_cPa323_cPa371_cPa419_cPa425_cPa425-cPa323-hybrid_cPa425-cPa333-hybrid_cPa50_cPa50-cPa323-hybrid_cPa50-cPa333-hybrid_cPa50-cPa371-hybrid_cPa50-unknown_cPa568_cPa568-cPa323-hybrid_cPa568-cPa371-hybrid,1_19_4_1_1_1_1_103_7_2_1_1_10_1_1,155,143
chrZ-9165527_9165846,HERV-W_repbase_HERV17_LTR17,0.543859649122807,14,9165794,9165530,cPa273-cPa581-hybrid_cPa273-SFV_U04327-hybrid_cPa450-cPa581-hybrid_cPa553-cPa581-hybrid_HERV-W_repbase_HERV17_LTR17_HERV-W_repbase_HERV17_LTR17-cPa273-hybrid_HERV-W_repbase_HERV17_LTR17-cPa581-hybrid_HERV-W_repbase_HERV17_LTR17-cPa75-hybrid_HERV-W_repbase_HERV17_LTR17-MMTV_NC001503-hybrid_HERV-W_repbase_HERV17_LTR17-unknown_KoRV_AF151794_MMTV_NC001503_MoMLV_J02255_S71_repbase_HERVS71_LTR6A,3_1_3_2_31_1_3_1_1_4_2_2_1_2,319,264
chrZ-9165898_9166053,HERV-W_repbase_HERV17_LTR17,0.666666666666667,3,9166042,9165948,cPa16-cPa75-hybrid_HERV-W_repbase_HERV17_LTR17_MMTV_NC001503,1_4_1,155,94
chrZ-9166734_9167177,cPa273,0.124161073825503,76,9167140,9166733,cPa16-cPa585-hybrid_cPa199_cPa199-cPa227-hybrid_cPa199-cPa450-hybrid_cPa199-cPa553-hybrid_cPa199-cPa585-hybrid_cPa199-cPa62-hybrid_cPa199-cPa75-hybrid_cPa199-HERV-W_repbase_HERV17_LTR17-hybrid_cPa199-KoRV_AF151794-hybrid_cPa199-MMTV_NC001503-hybrid_cPa199-unknown_cPa227_cPa227-cPa199-hybrid_cPa227-cPa345-hybrid_cPa227-cPa585-hybrid_cPa227-MMTV_NC001503-hybrid_cPa227-PERV_AJ293656-hybrid_cPa228-cPa199-hybrid_cPa228-cPa62-hybrid_cPa228-cPa75-hybrid_cPa228-KoRV_AF151794-hybrid_cPa273_cPa273-cPa199-hybrid_cPa273-cPa450-hybrid_cPa273-cPa581-hybrid_cPa273-cPa585-hybrid_cPa273-cPa75-hybrid_cPa273-MMTV_NC001503-hybrid_cPa273-MoMLV_J02255-hybrid_cPa273-unknown_cPa345_cPa394-cPa199-hybrid_cPa394-unknown_cPa413-cPa227-hybrid_cPa446-cPa199-hybrid_cPa446-cPa223-hybrid_cPa446-cPa273-hybrid_cPa446-cPa345-hybrid_cPa446-cPa585-hybrid_cPa446-cPa62-hybrid_cPa446-cPa75-hybrid_cPa446-HERV-W_repbase_HERV17_LTR17-hybrid_cPa446-MMTV_NC001503-hybrid_cPa450_cPa450-cPa199-hybrid_cPa450-cPa223-hybrid_cPa450-cPa227-hybrid_cPa450-cPa581-hybrid_cPa450-cPa585-hybrid_cPa450-cPa62-hybrid_cPa450-cPa75-hybrid_cPa450-KoRV_AF151794-hybrid_cPa450-MMTV_NC001503-hybrid_cPa450-unknown_cPa482_cPa482-cPa553-hybrid_cPa482-cPa581-hybrid_cPa482-cPa585-hybrid_cPa482-KoRV_AF151794-hybrid_cPa482-unknown_cPa553_cPa553-cPa199-hybrid_cPa553-cPa227-hybrid_cPa553-cPa273-hybrid_cPa553-cPa410-hybrid_cPa553-cPa581-hybrid_cPa553-cPa585-hybrid_cPa553-cPa62-hybrid_cPa553-cPa75-hybrid_cPa553-HERV-W_repbase_HERV17_LTR17-hybrid_cPa553-MMTV_NC001503-hybrid_cPa553-unknown_HERV-W_repbase_HERV17_LTR17-cPa227-hybrid_HERV-W_repbase_HERV17_LTR17-cPa585-hybrid_MLV_Xmv43-cPa585-hybrid,1_30_1_1_1_6_1_2_3_1_2_3_14_1_1_3_1_1_3_1_1_1_37_2_1_2_9_2_1_1_1_1_1_1_1_1_1_3_2_4_1_3_1_3_13_2_1_1_7_17_1_2_1_4_3_7_1_1_3_1_1_20_6_1_1_1_3_10_1_2_2_3_17_1_5_1,443,407
chrZ-9171219_9171325,cPa391,0.590909090909091,6,9171273,9171218,cPa391_cPa391-cPa390-hybrid_cPa391-unknown_cPa419-cPa391-hybrid_cPa543-unknown_HIV2_NC001722-cPa339-hybrid,13_1_5_1_1_1,106,55
chrZ-9174217_9174319,cPa15_cPa270-cPa15-hybrid,0.5,2,9174291,9174267,cPa15_cPa270-cPa15-hybrid,1_1,102,24
chrZ-9188959_9189391,cPa164-cPa199-hybrid,0.416666666666667,23,9189339,9189009,cPa138-cPa199-hybrid_cPa138-cPa223-hybrid_cPa138-cPa553-hybrid_cPa164-cPa199-hybrid_cPa164-cPa223-hybrid_cPa164-cPa227-hybrid_cPa164-cPa273-hybrid_cPa164-cPa345-hybrid_cPa164-cPa450-hybrid_cPa164-cPa482-hybrid_cPa164-cPa553-hybrid_cPa273_cPa327-cPa553-hybrid_cPa402-cPa199-hybrid_cPa402-cPa345-hybrid_cPa402-cPa450-hybrid_cPa402-cPa553-hybrid_cPa419-cPa199-hybrid_cPa542-cPa390-hybrid_cPa74-cPa199-hybrid_cPa74-cPa227-hybrid_cPa74-cPa450-hybrid_cPa74-cPa553-hybrid,3_2_1_65_2_1_7_6_9_1_6_4_1_22_1_3_5_1_1_12_1_1_1,432,330
chrZ-9191587_9191788,cPa15,0.875,2,9191736,9191637,cPa15_cPa419-cPa387-hybrid,7_1,201,99
chrZ-9315977_9316186,cPa75,1,1,9316134,9316027,cPa75,5,209,107
chrZ-9416682_9416784,cPa254,0.434782608695652,8,9416744,9416704,cPa174-cPa47-hybrid_cPa254_cPa254-cPa404-hybrid_cPa254-cPa47-hybrid_cPa425_cPa425-cPa404-hybrid_cPa425-cPa47-hybrid_cPa47,1_10_1_1_2_1_1_6,102,40
chrZ-9505023_9505125,cPa62-unknown_cPa75,0.5,2,9505083,9505073,cPa62-unknown_cPa75,1_1,102,10
chrZ-9505221_9505344,cPa75,0.6,3,9505301,9505248,cPa113_cPa62-cPa75-hybrid_cPa75,1_1_3,123,53
chrZ-9816283_9816385,cPa118-cPa75-hybrid,1,1,9816333,9816330,cPa118-cPa75-hybrid,2,102,3
Scaffold100-1106_1208,cPa428,0.666666666666667,2,1163,1137,cPa356_cPa428,2_4,102,26
Scaffold100-40800_40902,cPa428,0.8,2,40900,40841,cPa356_cPa428,1_4,102,59
Scaffold100-41113_41215,cPa428,0.5,3,41163,41117,cPa356_cPa419-cPa428-hybrid_cPa428,2_1_3,102,46
Scaffold100-41284_41386,cPa356,0.5,5,41347,41298,cPa356_cPa356-cPa428-hybrid_cPa356-unknown_cPa419-cPa356-hybrid_cPa428,6_1_1_1_3,102,49
Scaffold100-5529_5631,cPa428,1,1,5579,5579,cPa428,1,102,0
Scaffold1000-1749_1851,cPa428,1,1,1799,1799,cPa428,1,102,0
Scaffold1000-2703_2805,cPa356_cPa428,0.5,2,2780,2720,cPa356_cPa428,7_7,102,60
Scaffold1000-3315_3584,cPa356,0.592105263157895,2,3553,3354,cPa356_cPa428,45_31,269,199
Scaffold1000-4550_4652,cPa356,0.722222222222222,2,4643,4590,cPa356_cPa428,13_5,102,53
Scaffold1003-4078_4193,cPa254_cPa425-cPa174-hybrid,0.428571428571429,3,4141,4128,cPa254_cPa392_cPa425-cPa174-hybrid,3_1_3,115,13
Scaffold1003-5534_5636,cPa223,0.857142857142857,2,5610,5571,cPa223_cPa449-cPa174-hybrid,6_1,102,39
Scaffold1005-9700_9802,cPa339,0.555555555555556,6,9769,9703,cPa174-cPa353-hybrid_cPa254-cPa353-hybrid_cPa254-unknown_cPa339_cPa353_cPa419,1_1_1_20_12_1,102,66
Scaffold1006-5556_5670,cPa428,1,1,5618,5606,cPa428,2,114,12
Scaffold1009-5224_5348,FrMuLV_NC001362,0.777777777777778,3,5296,5273,FrMuLV_NC001362_FrMuLV_NC001362-unknown_SIV_NC001870-unknown,7_1_1,124,23
Scaffold1009-5354_5505,FrMuLV_NC001362,0.875,3,5453,5404,FrMuLV_NC001362_FrMuLV_NC001362-cPa356-hybrid_FrMuLV_NC001362-unknown,14_1_1,151,49
Scaffold1009-7759_7907,cPa413-unknown,0.75,2,7866,7809,cPa158-unknown_cPa413-unknown,1_3,148,57
Scaffold1010-3162_3264,cPa419,1,1,3212,3212,cPa419,1,102,0
Scaffold1010-7745_7847,cPa419,1,1,7795,7795,cPa419,1,102,0
Scaffold1010-8783_8927,cPa419,1,1,8875,8825,cPa419,5,144,50
Scaffold1010-9042_9144,cPa419,1,1,9144,9092,cPa419,8,102,52
Scaffold1010-9858_9960,cPa419,1,1,9908,9908,cPa419,1,102,0
Scaffold1012-3376_3478,cPa428,0.666666666666667,2,3426,3379,cPa356_cPa428,2_4,102,47
Scaffold1012-3808_3910,cPa428,0.75,2,3879,3814,cPa356_cPa428,1_3,102,65
Scaffold1012-3955_4135,cPa428,0.5625,3,4133,4005,cPa356_cPa356-unknown_cPa428,6_1_9,180,128
Scaffold1012-5833_5935,cPa428,1,1,5883,5883,cPa428,1,102,0
Scaffold1012-7904_8006,cPa356,0.625,2,7995,7930,cPa356_cPa428,5_3,102,65
Scaffold1019-5364_5514,cPa428,0.538461538461538,2,5474,5367,cPa356_cPa428,6_7,150,107
Scaffold1019-6173_6356,cPa428,0.559322033898305,2,6352,6223,cPa356_cPa428,26_33,183,129
Scaffold1019-8008_8110,cPa428,0.857142857142857,2,8077,8048,cPa356_cPa428,1_6,102,29
Scaffold1020-1425_1527,cPa356,1,1,1475,1437,cPa356,4,102,38
Scaffold1021-1166_1268,cPa425,0.869565217391304,2,1242,1198,cPa425_cPa425-unknown,20_3,102,44
Scaffold1021-798_904,cPa425,0.888888888888889,2,867,836,cPa425_cPa425-unknown,8_1,106,31
Scaffold1021-956_1058,cPa425,1,1,1032,993,cPa425,5,102,39
Scaffold1024-9048_9150,cPa130,1,1,9098,9098,cPa130,1,102,0
Scaffold1028-2814_2958,cPa419,1,1,2906,2861,cPa419,3,144,45
Scaffold1028-3143_3245,cPa419,1,1,3200,3193,cPa419,3,102,7
Scaffold1028-3568_3698,cPa419,1,1,3698,3586,cPa419,42,130,112
Scaffold1028-3707_3809,cPa419,1,1,3775,3720,cPa419,23,102,55
Scaffold1028-3820_3922,cPa419,1,1,3912,3828,cPa419,34,102,84
Scaffold1028-4868_4970,cPa419,1,1,4920,4911,cPa419,7,102,9
Scaffold1028-4993_5095,cPa419,1,1,5053,5043,cPa419,2,102,10
Scaffold103-1476_1578,cPa356,1,1,1526,1526,cPa356,1,102,0
Scaffold103-1745_1847,cPa356,0.571428571428571,2,1813,1794,cPa356_cPa428,4_3,102,19
Scaffold103-18836_18938,cPa428,1,1,18886,18886,cPa428,1,102,0
Scaffold103-21971_22073,cPa428,1,1,22021,22021,cPa428,1,102,0
Scaffold103-2757_2859,cPa428,1,1,2807,2807,cPa428,1,102,0
Scaffold103-44196_44298,cPa428,0.75,2,44266,44244,cPa356_cPa428,1_3,102,22
Scaffold103-46143_46245,cPa428,0.588235294117647,2,46207,46148,cPa356_cPa428,7_10,102,59
Scaffold103-46290_46392,cPa428,1,1,46340,46340,cPa428,1,102,0
Scaffold103-49138_49240,cPa428,0.666666666666667,2,49192,49187,cPa356_cPa428,1_2,102,5
Scaffold103-49739_49858,cPa428,0.666666666666667,2,49857,49779,cPa356_cPa428,5_10,119,78
Scaffold103-51445_51547,cPa428,0.6,2,51522,51480,cPa356_cPa428,4_6,102,42
Scaffold103-7672_7774,cPa356,1,1,7722,7722,cPa356,1,102,0
Scaffold103-8010_8182,cPa356,0.666666666666667,2,8130,8027,cPa356_cPa428,2_1,172,103
Scaffold1030-2153_2255,cPa419,1,1,2224,2160,cPa419,20,102,64
Scaffold1032-1692_1882,cPa339,0.358695652173913,24,1881,1694,cPa183-cPa444-hybrid_cPa339_cPa339-cPa163-hybrid_cPa339-cPa298-hybrid_cPa339-cPa444-hybrid_cPa339-cPa583-hybrid_cPa379-cPa390-hybrid_cPa379-cPa444-hybrid_cPa390_cPa419_cPa424-cPa444-hybrid_cPa446-cPa390-hybrid_cPa446-cPa444-hybrid_cPa447_cPa447-cPa298-hybrid_cPa447-cPa390-hybrid_cPa447-cPa444-hybrid_cPa447-cPa583-hybrid_cPa486-cPa339-hybrid_cPa486-cPa390-hybrid_cPa486-cPa444-hybrid_cPa62-cPa163-hybrid_cPa62-cPa251-hybrid_cPa62-cPa583-hybrid,1_33_4_1_1_5_2_7_1_2_1_2_4_11_1_1_2_4_1_1_3_1_1_2,190,187
Scaffold1032-2416_2609,cPa199,0.480225988700565,46,2599,2419,cPa15-cPa390-hybrid_cPa199_cPa199-cPa268-hybrid_cPa199-cPa353-hybrid_cPa199-cPa363-hybrid_cPa199-cPa390-hybrid_cPa199-cPa398-hybrid_cPa199-cPa413-hybrid_cPa199-cPa587-hybrid_cPa227-cPa542-hybrid_cPa339_cPa339-cPa268-hybrid_cPa339-cPa353-hybrid_cPa339-cPa363-hybrid_cPa339-cPa413-hybrid_cPa339-cPa502-hybrid_cPa339-cPa587-hybrid_cPa353_cPa358-cPa223-hybrid_cPa379-cPa390-hybrid_cPa379-cPa583-hybrid_cPa381-cPa390-hybrid_cPa419_cPa424-cPa390-hybrid_cPa424-cPa444-hybrid_cPa446-cPa163-hybrid_cPa446-cPa390-hybrid_cPa446-cPa444-hybrid_cPa446-cPa566-hybrid_cPa446-cPa583-hybrid_cPa447-cPa268-hybrid_cPa447-cPa308-hybrid_cPa447-cPa363-hybrid_cPa447-cPa381-hybrid_cPa447-cPa413-hybrid_cPa447-cPa587-hybrid_cPa452-cPa444-hybrid_cPa486-cPa390-hybrid_cPa486-cPa444-hybrid_cPa486-cPa583-hybrid_cPa62-cPa353-hybrid_cPa62-cPa363-hybrid_cPa62-cPa413-hybrid_MLV_Mpmv5-cPa390-hybrid_MLV_Mpmv5-cPa566-hybrid_MLV_Mpmv5-cPa583-hybrid,1_85_2_1_1_1_2_7_1_1_9_2_1_1_7_1_1_1_1_1_1_2_3_1_1_1_1_7_2_1_2_1_1_1_4_1_1_5_3_1_2_1_1_3_1_2,193,180
Scaffold1032-2797_2958,cPa199,0.477272727272727,18,2955,2808,cPa199_cPa199-cPa268-hybrid_cPa199-cPa413-hybrid_cPa223_cPa339-cPa413-hybrid_cPa339-cPa587-hybrid_cPa379-cPa163-hybrid_cPa379-cPa390-hybrid_cPa419_cPa446-cPa163-hybrid_cPa446-cPa390-hybrid_cPa446-cPa583-hybrid_cPa447-cPa308-hybrid_cPa447-cPa413-hybrid_cPa486-cPa223-hybrid_cPa486-cPa339-hybrid_cPa486-cPa390-hybrid_cPa62-cPa413-hybrid,21_1_3_2_3_1_1_1_1_1_1_1_2_1_1_1_1_1,161,147
Scaffold1032-2965_3067,cPa199,0.5,4,3063,2975,cPa199_cPa339-cPa413-hybrid_cPa419_cPa446-cPa390-hybrid,3_1_1_1,102,88
Scaffold1032-3625_3727,cPa199,0.334841628959276,58,3719,3625,cPa183-cPa390-hybrid_cPa183-cPa413-hybrid_cPa199_cPa199-cPa542-hybrid_cPa199-cPa587-hybrid_cPa327-cPa268-hybrid_cPa327-cPa452-hybrid_cPa339_cPa339-cPa268-hybrid_cPa339-cPa308-hybrid_cPa339-cPa363-hybrid_cPa339-cPa419-hybrid_cPa353_cPa379-cPa308-hybrid_cPa379-cPa363-hybrid_cPa379-cPa381-hybrid_cPa381_cPa381-cPa398-hybrid_cPa419_cPa424-cPa308-hybrid_cPa424-cPa398-hybrid_cPa424-cPa452-hybrid_cPa446_cPa446-cPa308-hybrid_cPa446-cPa363-hybrid_cPa447-cPa308-hybrid_cPa447-cPa363-hybrid_cPa447-cPa452-hybrid_cPa452_cPa486_cPa486-cPa163-hybrid_cPa486-cPa268-hybrid_cPa486-cPa270-hybrid_cPa486-cPa308-hybrid_cPa486-cPa353-hybrid_cPa486-cPa363-hybrid_cPa486-cPa381-hybrid_cPa486-cPa390-hybrid_cPa486-cPa398-hybrid_cPa486-cPa413-hybrid_cPa486-cPa444-hybrid_cPa486-cPa502-hybrid_cPa486-cPa542-hybrid_cPa486-cPa587-hybrid_cPa62-cPa363-hybrid_FrMuLV_NC001362-cPa398-hybrid_FrMuLV_NC001362-cPa413-hybrid_FrMuLV_NC001362-cPa587-hybrid_MLV_Mpmv5-cPa268-hybrid_MLV_Mpmv5-cPa308-hybrid_MLV_Mpmv5-cPa353-hybrid_MLV_Mpmv5-cPa363-hybrid_MLV_Mpmv5-cPa381-hybrid_MLV_Mpmv5-cPa390-hybrid_MLV_Mpmv5-cPa398-hybrid_MLV_Mpmv5-cPa413-hybrid_MLV_Mpmv5-cPa419-hybrid_MLV_Mpmv5-cPa587-hybrid,1_1_74_1_1_1_1_2_1_2_2_1_1_1_1_1_6_1_4_1_1_1_5_2_2_1_1_2_3_17_1_7_1_5_4_5_3_4_3_10_1_2_1_4_3_1_1_1_3_4_2_3_2_2_1_5_1_2,102,94
Scaffold1032-7183_7308,cPa323,0.615384615384615,6,7258,7230,cPa323_cPa323-PERV_AJ293656-hybrid_cPa339-PERV_AJ293656-hybrid_cPa339-PERVA_AY099323-hybrid_cPa419_cPa568-PERV_AJ293656-hybrid,16_1_2_2_4_1,125,28
Scaffold1034-2290_2547,cPa107,0.830188679245283,2,2495,2340,cPa107_cPa107-unknown,44_9,257,155
Scaffold1035-7012_7114,cPa356_cPa428,0.5,2,7062,7062,cPa356_cPa428,1_1,102,0
Scaffold1036-2013_2115,cPa61,0.571428571428571,2,2109,2047,cPa205_cPa61,3_4,102,62
Scaffold1036-3125_3227,cPa371_cPa371-unknown_cPa419_cPa75,0.25,4,3177,3149,cPa371_cPa371-unknown_cPa419_cPa75,1_1_1_1,102,28
Scaffold1036-4200_4334,cPa419,1,1,4282,4244,cPa419,2,134,38
Scaffold1036-712_814,cPa205,0.416149068322981,12,783,714,cPa205_cPa223_cPa223-cPa285-hybrid_cPa223-cPa419-hybrid_cPa223-cPa61-hybrid_cPa223-cPa75-hybrid_cPa223-unknown_cPa419_cPa446-cPa223-hybrid_cPa450-cPa223-hybrid_cPa61_HERV-I_repbase_HERVI_LTR10B,67_24_1_1_1_1_4_1_1_1_58_1,102,69
Scaffold1037-1205_1307,cPa392,1,1,1258,1255,cPa392,7,102,3
Scaffold1038-6833_6935,cPa356,1,1,6913,6873,cPa356,26,102,40
Scaffold104-1170_1272,cPa428,0.75,2,1236,1209,cPa356_cPa428,1_3,102,27
Scaffold104-1306_1408,cPa356,1,1,1356,1356,cPa356,1,102,0
Scaffold104-14636_14745,cPa428,0.538461538461538,2,14693,14667,cPa356_cPa428,18_21,109,26
Scaffold104-14816_14965,cPa428,0.583333333333333,2,14913,14832,cPa356_cPa428,10_14,149,81
Scaffold104-15136_15336,cPa356,0.538461538461538,2,15286,15186,cPa356_cPa428,7_6,200,100
Scaffold104-15426_15603,cPa428,0.524390243902439,2,15603,15426,cPa356_cPa428,39_43,177,177
Scaffold104-15926_16095,cPa428,0.833333333333333,2,16043,15952,cPa356_cPa428,1_5,169,91
Scaffold104-16385_16487,cPa428,0.75,2,16473,16435,cPa356_cPa428,1_3,102,38
Scaffold104-16628_16736,cPa356,0.692307692307692,3,16709,16641,cPa356_cPa419_cPa428,9_1_3,108,68
Scaffold104-17039_17141,cPa428,0.666666666666667,2,17090,17039,cPa356_cPa428,13_26,102,51
Scaffold104-1754_1925,cPa428,0.75,2,1873,1777,cPa356_cPa428,1_3,171,96
Scaffold104-17733_17835,cPa428,0.777777777777778,2,17831,17782,cPa356_cPa428,2_7,102,49
Scaffold104-17844_18014,cPa356_cPa428,0.5,2,17974,17894,cPa356_cPa428,5_5,170,80
Scaffold104-18050_18152,cPa428,0.666666666666667,2,18100,18054,cPa356_cPa428,1_2,102,46
Scaffold104-18224_18326,cPa428,0.555555555555556,2,18295,18262,cPa356_cPa428,4_5,102,33
Scaffold104-19328_19430,cPa428,1,1,19378,19378,cPa428,1,102,0
Scaffold104-1965_2067,cPa356_cPa428,0.5,2,2015,2015,cPa356_cPa428,1_1,102,0
Scaffold104-21585_21687,cPa356,1,1,21635,21635,cPa356,1,102,0
Scaffold104-2230_2348,cPa428,0.666666666666667,2,2336,2273,cPa356_cPa428,2_4,118,63
Scaffold104-23647_23749,cPa428,1,1,23697,23697,cPa428,1,102,0
Scaffold104-24955_25057,cPa356_cPa428,0.5,2,25005,25005,cPa356_cPa428,1_1,102,0
Scaffold104-25120_25222,cPa428,1,1,25214,25155,cPa428,4,102,59
Scaffold104-25329_25431,cPa428,0.833333333333333,2,25390,25369,cPa356_cPa428,1_5,102,21
Scaffold104-2545_2647,cPa356_cPa428,0.5,2,2646,2595,cPa356_cPa428,1_1,102,51
Scaffold104-25975_26077,cPa428,0.586206896551724,2,26065,25992,cPa356_cPa428,12_17,102,73
Scaffold104-26113_26406,cPa428,0.615384615384615,2,26371,26117,cPa356_cPa428,15_24,293,254
Scaffold104-26509_26764,cPa428,0.577142857142857,2,26754,26509,cPa356_cPa428,74_101,255,245
Scaffold104-26824_26940,cPa356,0.6,2,26931,26829,cPa356_cPa428,6_4,116,102
Scaffold104-26978_27080,cPa428,0.592592592592593,2,27075,26986,cPa356_cPa428,11_16,102,89
Scaffold104-27134_27236,cPa356,0.571428571428571,3,27235,27134,cPa356_cPa356-unknown_cPa428,4_1_2,102,101
Scaffold104-27246_27348,cPa428,0.545454545454545,2,27347,27250,cPa356_cPa428,5_6,102,97
Scaffold104-27938_28271,cPa428,0.547169811320755,2,28253,27944,cPa356_cPa428,72_87,333,309
Scaffold104-28418_28531,cPa356,0.529411764705882,3,28504,28468,cPa356_cPa428_cPa428-unknown,18_15_1,113,36
Scaffold1040-4790_4892,cPa47-HERVHcons-hybrid,1,1,4840,4840,cPa47-HERVHcons-hybrid,1,102,0
Scaffold1045-5992_6114,HERV-XA34_repbase_HERVFH21I_LTR21A,1,1,6062,6042,HERV-XA34_repbase_HERVFH21I_LTR21A,2,122,20
Scaffold1045-6115_6268,HERV-XA34_repbase_HERVFH21I_LTR21A,0.944444444444444,2,6216,6148,cPa394-HERV-XA34_repbase_HERVFH21I_LTR21A-hybrid_HERV-XA34_repbase_HERVFH21I_LTR21A,1_17,153,68
Scaffold1045-6278_6380,cPa419_HERV-XA34_repbase_HERVFH21I_LTR21A,0.5,2,6356,6328,cPa419_HERV-XA34_repbase_HERVFH21I_LTR21A,1_1,102,28
Scaffold1045-7334_7440,cPa339,0.67741935483871,4,7410,7334,cPa339_cPa353_cPa419_HERV-XA34_repbase_HERVFH21I_LTR21A-cPa353-hybrid,21_5_2_3,106,76
Scaffold1045-7523_7625,cPa356-cPa353-hybrid,0.8,2,7623,7541,cPa339_cPa356-cPa353-hybrid,1_4,102,82
Scaffold1046-4370_4506,cPa356,0.625,2,4470,4420,cPa356_cPa428,5_3,136,50
Scaffold1046-5994_6103,cPa356_cPa428,0.5,2,6057,6024,cPa356_cPa428,4_4,109,33
Scaffold105-15277_15379,cPa428,1,1,15327,15327,cPa428,1,102,0
Scaffold105-15528_15630,cPa428,1,1,15578,15578,cPa428,1,102,0
Scaffold105-20142_20244,cPa428,1,1,20192,20152,cPa428,2,102,40
Scaffold1051-4480_4625,cPa428,0.519230769230769,2,4625,4506,cPa356_cPa428,25_27,145,119
Scaffold1051-4894_5025,cPa428,0.518518518518518,2,4979,4898,cPa356_cPa428,13_14,131,81
Scaffold1053-1536_1638,cPa428,1,1,1586,1586,cPa428,1,102,0
Scaffold1053-1731_1833,cPa356_cPa428,0.5,2,1785,1764,cPa356_cPa428,2_2,102,21
Scaffold1053-2411_2513,cPa356_cPa428,0.5,2,2503,2430,cPa356_cPa428,3_3,102,73
Scaffold1053-3570_3672,cPa356,0.571428571428571,2,3620,3593,cPa356_cPa428,12_9,102,27
Scaffold1053-4061_4253,cPa428,0.551724137931034,2,4215,4102,cPa356_cPa428,26_32,192,113
Scaffold1053-4270_4426,cPa428,0.535714285714286,2,4407,4292,cPa356_cPa428,13_15,156,115
Scaffold1053-4494_4596,cPa356,0.538461538461538,3,4544,4496,cPa356_cPa356-unknown_cPa428,7_1_5,102,48
Scaffold1053-5034_5136,cPa428,0.666666666666667,2,5098,5053,cPa356_cPa428,3_6,102,45
Scaffold1054-2017_2119,cPa356,0.666666666666667,2,2067,2030,cPa356_cPa434-unknown,2_1,102,37
Scaffold1054-2256_2361,cPa356,1,1,2309,2306,cPa356,2,105,3
Scaffold1054-2799_2901,cPa14-cPa353-hybrid,1,1,2849,2849,cPa14-cPa353-hybrid,1,102,0
Scaffold1054-6086_6188,cPa67,1,1,6187,6136,cPa67,3,102,51
Scaffold1054-6719_6821,cPa67,1,1,6800,6769,cPa67,4,102,31
Scaffold1055-4064_4257,cPa308,0.585365853658537,7,4205,4114,cPa308_cPa308-cPa118-hybrid_cPa308-cPa125-hybrid_cPa308-cPa15-hybrid_cPa308-cPa174-hybrid_cPa308-cPa176-hybrid_cPa308-cPa264-hybrid,24_5_1_7_1_1_2,193,91
Scaffold1055-6107_6209,cPa118_cPa140-cPa223-hybrid,0.194444444444444,17,6201,6106,cPa118_cPa125-cPa15-hybrid_cPa125-cPa223-hybrid_cPa125-cPa264-hybrid_cPa125-cPa47-hybrid_cPa125-unknown_cPa140-cPa223-hybrid_cPa140-cPa264-hybrid_cPa140-cPa47-hybrid_cPa15_cPa174_cPa248-cPa223-hybrid_cPa264_cPa268_cPa443-cPa223-hybrid_cPa47_cPa553-cPa264-hybrid,7_1_1_1_1_1_7_1_1_2_2_2_4_2_1_1_1,102,95
Scaffold1055-6647_6749,cPa118_cPa140-cPa223-hybrid_cPa174-cPa223-hybrid,0.333333333333333,3,6697,6671,cPa118_cPa140-cPa223-hybrid_cPa174-cPa223-hybrid,1_1_1,102,26
Scaffold1055-7100_7202,cPa125-cPa223-hybrid,0.428571428571429,5,7191,7120,cPa125-cPa223-hybrid_cPa140-cPa223-hybrid_cPa140-cPa450-hybrid_cPa174_cPa425,3_1_1_1_1,102,71
Scaffold1055-7346_7555,cPa118_cPa118-cPa47-hybrid_cPa125-cPa223-hybrid_cPa125-cPa47-hybrid_cPa140-cPa223-hybrid_cPa140-cPa47-hybrid_cPa223-cPa118-hybrid,0.142857142857143,7,7503,7373,cPa118_cPa118-cPa47-hybrid_cPa125-cPa223-hybrid_cPa125-cPa47-hybrid_cPa140-cPa223-hybrid_cPa140-cPa47-hybrid_cPa223-cPa118-hybrid,1_1_1_1_1_1_1,209,130
Scaffold1055-7803_7980,cPa47,0.148148148148148,17,7951,7803,cPa118_cPa125-cPa199-hybrid_cPa125-cPa223-hybrid_cPa125-cPa450-hybrid_cPa140-cPa223-hybrid_cPa140-cPa47-hybrid_cPa174_cPa174-cPa223-hybrid_cPa254_cPa268_cPa392-cPa443-hybrid_cPa425_cPa450_cPa47_cPa47-cPa450-hybrid_cPa47-unknown_cPa553,2_3_2_1_1_1_2_1_1_1_1_1_2_4_1_2_1,177,148
Scaffold1055-8031_8278,cPa450,0.423728813559322,21,8273,8056,cPa106-cPa223-hybrid_cPa106-cPa482-hybrid_cPa118-cPa223-hybrid_cPa125-cPa223-hybrid_cPa140-cPa223-hybrid_cPa174-cPa223-hybrid_cPa174-cPa450-hybrid_cPa223_cPa273-cPa223-hybrid_cPa273-cPa47-hybrid_cPa345_cPa425_cPa443-cPa223-hybrid_cPa450_cPa47_cPa542-cPa125-hybrid_cPa542-cPa223-hybrid_cPa542-unknown_cPa553_cPa553-cPa223-hybrid_cPa553-cPa450-hybrid,1_1_2_2_4_1_1_3_3_1_1_1_1_25_1_1_1_1_3_4_1,247,217
Scaffold1058-3572_3674,cPa428,0.833333333333333,2,3625,3617,cPa356_cPa428,1_5,102,8
Scaffold1058-4309_4525,cPa428,0.666666666666667,3,4520,4359,cPa356_cPa356-unknown_cPa428,5_2_14,216,161
Scaffold1058-4541_4648,cPa356,0.583333333333333,2,4628,4563,cPa356_cPa428,7_5,107,65
Scaffold1059-5337_5439,cPa15,0.6,3,5387,5342,cPa140-cPa118-hybrid_cPa15_cPa248-cPa516-hybrid,1_3_1,102,45
Scaffold1061-3807_3909,cPa428,1,1,3857,3857,cPa428,1,102,0
Scaffold1061-4589_4691,cPa428,1,1,4639,4639,cPa428,1,102,0
Scaffold1061-5109_5211,cPa428,1,1,5159,5135,cPa428,2,102,24
Scaffold1064-2288_2390,cPa419,1,1,2344,2338,cPa419,3,102,6
Scaffold1066-2057_2159,cPa419,1,1,2107,2100,cPa419,5,102,7
Scaffold1066-3954_4056,cPa419,1,1,4004,3972,cPa419,7,102,32
Scaffold1066-4401_4503,cPa419,1,1,4503,4437,cPa419,14,102,66
Scaffold1067-2294_2396,cPa419,0.444444444444444,4,2344,2313,cPa251-cPa174-hybrid_cPa251-cPa254-hybrid_cPa251-unknown_cPa419,3_1_1_4,102,31
Scaffold1070-6675_6777,cPa363-PRIMA41_repbase_PRIMA41_MER41A-hybrid,0.416666666666667,6,6747,6704,cPa363-GaLV_M26927-hybrid_cPa363-PRIMA41_repbase_PRIMA41_MER41A-hybrid_cPa387-GaLV_M26927-hybrid_cPa387-PRIMA41_repbase_PRIMA41_MER41A-hybrid_cPa452-GaLV_M26927-hybrid_cPa74-PRIMA41_repbase_PRIMA41_MER41A-hybrid,1_5_2_2_1_1,102,43
Scaffold1074-5652_5754,cPa356_cPa356-unknown_cPa434,0.333333333333333,3,5734,5702,cPa356_cPa356-unknown_cPa434,1_1_1,102,32
Scaffold1074-5778_5913,cPa434,0.75,2,5911,5828,cPa356-cPa270-hybrid_cPa434,1_3,135,83
Scaffold1074-6122_6265,cPa434,1,1,6234,6172,cPa434,4,143,62
Scaffold1074-6602_6704,cPa356-cPa434-hybrid_cPa434,0.5,2,6652,6645,cPa356-cPa434-hybrid_cPa434,1_1,102,7
Scaffold1074-6747_6849,cPa434,1,1,6819,6760,cPa434,3,102,59
Scaffold1074-6926_7028,cPa434,1,1,6976,6976,cPa434,1,102,0
Scaffold1074-7173_7290,cPa434,1,1,7242,7223,cPa434,5,117,19
Scaffold1076-4489_4591,cPa356_cPa428,0.5,2,4539,4531,cPa356_cPa428,2_2,102,8
Scaffold1076-4672_4774,cPa428,0.625,2,4767,4686,cPa356_cPa428,3_5,102,81
Scaffold1077-2283_2432,cPa75,1,1,2380,2333,cPa75,2,149,47
Scaffold1079-2122_2236,cPa419,1,1,2189,2136,cPa419,7,114,53
Scaffold1079-2282_2401,cPa419,1,1,2400,2290,cPa419,5,119,110
Scaffold108-8035_8137,cPa428,1,1,8089,8085,cPa428,2,102,4
Scaffold108-9546_9648,cPa428,1,1,9596,9596,cPa428,1,102,0
Scaffold1081-1245_1347,cPa15,1,1,1295,1295,cPa15,1,102,0
Scaffold1081-2245_2354,cPa15,0.529411764705882,6,2307,2270,cPa118-cPa119-hybrid_cPa119_cPa125_cPa140_cPa15_cPa443-cPa140-hybrid,1_2_2_2_9_1,109,37
Scaffold1081-2570_2810,cPa15,0.423076923076923,6,2768,2620,cPa119_cPa125_cPa140_cPa15_cPa268_cPa443-cPa140-hybrid,4_2_6_11_2_1,240,148
Scaffold1081-3994_4096,cPa15,0.285714285714286,6,4078,3998,cPa118_cPa118-cPa404-hybrid_cPa118-cPa47-hybrid_cPa15_cPa47_cPa47-cPa118-hybrid,1_1_1_2_1_1,102,80
Scaffold1081-4823_4925,cPa118,0.6,4,4924,4840,cPa118_cPa356-cPa443-hybrid_cPa443_MDEV_AF053745-cPa268-hybrid,6_1_2_1,102,84
Scaffold1081-6829_6931,cPa523,1,1,6879,6837,cPa523,4,102,42
Scaffold1081-6940_7114,cPa523,0.339622641509434,11,7064,6978,cPa356_cPa356-cPa15-hybrid_cPa356-unknown_cPa425-cPa356-hybrid_cPa434_cPa434-cPa356-hybrid_cPa523_cPa523-cPa125-hybrid_cPa523-cPa15-hybrid_cPa523-cPa356-hybrid_cPa523-cPa434-hybrid,12_2_1_1_14_1_18_1_1_1_1,174,86
Scaffold1082-1025_1254,cPa356,0.588235294117647,2,1227,1032,cPa356_cPa428,20_14,229,195
Scaffold1082-1357_1469,cPa428,0.509803921568627,2,1453,1371,cPa356_cPa428,25_26,112,82
Scaffold1082-1504_1606,cPa356,1,1,1554,1554,cPa356,1,102,0
Scaffold1082-1636_1916,cPa428,0.540540540540541,2,1915,1655,cPa356_cPa428,17_20,280,260
Scaffold1082-1959_2061,cPa428,0.532258064516129,2,2054,1965,cPa356_cPa428,29_33,102,89
Scaffold1082-2521_2623,cPa428,0.857142857142857,2,2608,2553,cPa356_cPa428,1_6,102,55
Scaffold1082-3399_3502,cPa428,0.666666666666667,2,3451,3449,cPa356_cPa428,1_2,103,2
Scaffold1082-3917_4019,cPa428,0.555555555555556,2,4019,3916,cPa356_cPa428,4_5,102,103
Scaffold1082-4460_4705,cPa428,0.617647058823529,2,4693,4506,cPa356_cPa428,13_21,245,187
Scaffold1082-5005_5107,cPa356,0.6,3,5099,5055,cPa356_cPa428_cPa428-unknown,3_1_1,102,44
Scaffold1082-5195_5405,cPa428,0.52,2,5382,5215,cPa356_cPa428,12_13,210,167
Scaffold1082-5512_5642,cPa356_cPa428,0.5,2,5638,5518,cPa356_cPa428,42_42,130,120
Scaffold1084-1174_1376,cPa308,0.944444444444444,2,1371,1224,cPa21-cPa199-hybrid_cPa308,1_17,202,147
Scaffold1084-4700_4832,cPa425,0.5,3,4780,4738,cPa254_cPa425_cPa47-unknown,1_2_1,132,42
Scaffold1086-3984_4086,cPa419,1,1,4071,4030,cPa419,3,102,41
Scaffold1086-7347_7449,cPa168-unknown,1,1,7397,7397,cPa168-unknown,1,102,0
Scaffold1087-3919_4021,cPa356_cPa428,0.464285714285714,4,4002,3921,cPa356_cPa356-cPa428-hybrid_cPa428_cPa428-unknown,13_1_13_1,102,81
Scaffold1088-1238_1341,cPa425,1,1,1289,1287,cPa425,17,103,2
Scaffold1088-1357_1619,cPa425,1,1,1567,1407,cPa425,33,262,160
Scaffold1088-3512_3614,cPa425,1,1,3562,3562,cPa425,1,102,0
Scaffold1088-4548_4750,cPa478,0.444444444444444,4,4715,4598,cPa478_cPa478-MDEV_AF053745-hybrid_cPa478-unknown_MSEV_CT990572,4_1_3_1,202,117
Scaffold1088-4772_4874,cPa478,0.6,2,4848,4804,cPa478_MDEV_AF053745,3_2,102,44
Scaffold1089-5332_5434,cPa356,0.666666666666667,2,5406,5339,cPa356_cPa428,4_2,102,67
Scaffold109-12452_12554,cPa428,0.666666666666667,2,12547,12502,cPa356_cPa428,1_2,102,45
Scaffold109-13320_13482,cPa428,0.666666666666667,2,13436,13370,cPa356_cPa428,3_6,162,66
Scaffold109-13735_13877,cPa356_cPa428,0.5,2,13825,13785,cPa356_cPa428,3_3,142,40
Scaffold109-20484_20598,cPa428,0.75,2,20546,20529,cPa356_cPa428,1_3,114,17
Scaffold109-4568_4670,cPa356,1,1,4618,4618,cPa356,1,102,0
Scaffold1093-1046_1148,cPa339-cPa434-hybrid,1,1,1105,1095,cPa339-cPa434-hybrid,4,102,10
Scaffold1093-4762_4864,cPa410-cPa391-hybrid,1,1,4812,4812,cPa410-cPa391-hybrid,1,102,0
Scaffold1093-4937_5164,cPa410-cPa391-hybrid,1,1,5114,4987,cPa410-cPa391-hybrid,6,227,127
Scaffold1093-6492_6663,PRIMA41_repbase_PRIMA41_MER41A,0.966666666666667,3,6612,6542,cPa410-PRIMA41_repbase_PRIMA41_MER41A-hybrid_cPa42-cPa391-hybrid_PRIMA41_repbase_PRIMA41_MER41A,1_1_58,171,70
Scaffold1093-846_948,cPa339-cPa434-hybrid,1,1,896,896,cPa339-cPa434-hybrid,1,102,0
Scaffold1094-6722_6824,cPa428,1,1,6772,6772,cPa428,1,102,0
Scaffold110-13506_13629,cPa428,0.526315789473684,2,13629,13514,cPa356_cPa428,9_10,123,115
Scaffold110-13761_13863,cPa428,0.714285714285714,2,13826,13761,cPa356_cPa428,2_5,102,65
Scaffold110-15459_15561,cPa428,1,1,15509,15463,cPa428,3,102,46
Scaffold1101-4549_4664,cPa391,0.571428571428571,4,4633,4583,cPa298_cPa298-unknown_cPa391_cPa475-unknown,3_2_8_1,115,50
Scaffold1101-4714_4832,cPa391,0.75,3,4831,4722,cPa391_cPa391-cPa298-hybrid_cPa391-unknown,12_3_1,118,109
Scaffold1102-3594_3696,cPa428,1,1,3644,3644,cPa428,1,102,0
Scaffold1105-2608_2710,cPa193-cPa75-hybrid_cPa257-cPa75-hybrid_HML3_repbase_HERVK9I_MER9-cPa75-hybrid,0.333333333333333,3,2701,2658,cPa193-cPa75-hybrid_cPa257-cPa75-hybrid_HML3_repbase_HERVK9I_MER9-cPa75-hybrid,1_1_1,102,43
Scaffold1105-2825_2927,HML3_repbase_HERVK9I_MER9,1,1,2875,2875,HML3_repbase_HERVK9I_MER9,1,102,0
Scaffold1105-3087_3189,HML3_repbase_HERVK9I_MER9,0.7,3,3188,3137,HML3_repbase_HERVK9I_MER9_HML3_repbase_HERVK9I_MER9-cPa193-hybrid_HML3_repbase_HERVK9I_MER9-unknown,7_1_2,102,51
Scaffold1106-1072_1174,cPa223,1,1,1122,1122,cPa223,1,102,0
Scaffold1106-4927_5029,cPa223_cPa391-cPa323-hybrid,0.5,2,4977,4941,cPa223_cPa391-cPa323-hybrid,1_1,102,36
Scaffold1106-7670_7772,cPa163,1,1,7720,7720,cPa163,1,102,0
Scaffold1107-1252_1472,cPa360,0.3125,9,1472,1302,cPa163_cPa224_cPa360_cPa402-cPa450-hybrid_cPa419_cPa428-cPa450-hybrid_cPa582-cPa163-hybrid_cPa582-cPa224-hybrid_cPa582-cPa308-hybrid,7_16_20_1_1_1_12_5_1,220,170
Scaffold1107-3726_4230,cPa381,0.16403785488959,154,4207,3725,cPa174-cPa199-hybrid_cPa174-cPa223-hybrid_cPa174-cPa268-hybrid_cPa174-cPa308-hybrid_cPa174-cPa345-hybrid_cPa174-cPa450-hybrid_cPa174-cPa47-hybrid_cPa199-cPa268-hybrid_cPa199-cPa308-hybrid_cPa223-cPa308-hybrid_cPa223-cPa404-hybrid_cPa223-cPa47-hybrid_cPa223-cPa486-hybrid_cPa223-cPa553-hybrid_cPa224_cPa224-cPa450-hybrid_cPa227-cPa308-hybrid_cPa227-cPa404-hybrid_cPa254_cPa254-cPa199-hybrid_cPa254-cPa223-hybrid_cPa254-cPa227-hybrid_cPa254-cPa308-hybrid_cPa254-cPa345-hybrid_cPa254-cPa47-hybrid_cPa268_cPa268-cPa113-hybrid_cPa268-cPa163-hybrid_cPa268-cPa224-hybrid_cPa268-cPa450-hybrid_cPa270_cPa270-cPa163-hybrid_cPa270-cPa199-hybrid_cPa270-cPa223-hybrid_cPa270-cPa227-hybrid_cPa270-cPa273-hybrid_cPa270-cPa308-hybrid_cPa270-cPa345-hybrid_cPa270-cPa360-hybrid_cPa270-cPa450-hybrid_cPa270-cPa47-hybrid_cPa270-cPa542-hybrid_cPa273-cPa308-hybrid_cPa273-cPa404-hybrid_cPa308_cPa308-cPa360-hybrid_cPa345-cPa308-hybrid_cPa345-cPa356-hybrid_cPa345-cPa404-hybrid_cPa345-cPa47-hybrid_cPa345-cPa75-hybrid_cPa356_cPa356-cPa542-hybrid_cPa363-cPa113-hybrid_cPa363-cPa163-hybrid_cPa363-cPa199-hybrid_cPa363-cPa223-hybrid_cPa363-cPa224-hybrid_cPa363-cPa227-hybrid_cPa363-cPa268-hybrid_cPa363-cPa273-hybrid_cPa363-cPa308-hybrid_cPa363-cPa345-hybrid_cPa363-cPa360-hybrid_cPa363-cPa391-hybrid_cPa363-cPa394-hybrid_cPa363-cPa450-hybrid_cPa363-cPa47-hybrid_cPa363-cPa542-hybrid_cPa381_cPa381-cPa163-hybrid_cPa381-cPa199-hybrid_cPa381-cPa224-hybrid_cPa381-cPa268-hybrid_cPa381-cPa287-hybrid_cPa381-cPa450-hybrid_cPa390_cPa390-cPa163-hybrid_cPa390-cPa199-hybrid_cPa390-cPa223-hybrid_cPa390-cPa224-hybrid_cPa390-cPa227-hybrid_cPa390-cPa273-hybrid_cPa390-cPa308-hybrid_cPa390-cPa345-hybrid_cPa390-cPa360-hybrid_cPa390-cPa450-hybrid_cPa390-cPa47-hybrid_cPa402-cPa339-hybrid_cPa419_cPa419-cPa308-hybrid_cPa428_cPa447_cPa450-cPa308-hybrid_cPa452-cPa163-hybrid_cPa452-cPa199-hybrid_cPa452-cPa223-hybrid_cPa452-cPa224-hybrid_cPa452-cPa227-hybrid_cPa452-cPa273-hybrid_cPa452-cPa308-hybrid_cPa452-cPa345-hybrid_cPa452-cPa360-hybrid_cPa452-cPa391-hybrid_cPa452-cPa450-hybrid_cPa452-cPa47-hybrid_cPa452-cPa486-hybrid_cPa452-cPa542-hybrid_cPa452-cPa553-hybrid_cPa456-cPa163-hybrid_cPa456-cPa199-hybrid_cPa456-cPa223-hybrid_cPa456-cPa224-hybrid_cPa456-cPa308-hybrid_cPa456-cPa360-hybrid_cPa456-cPa394-hybrid_cPa456-cPa450-hybrid_cPa456-cPa542-hybrid_cPa456-cPa553-hybrid_cPa47_cPa486_cPa486-cPa163-hybrid_cPa486-cPa224-hybrid_cPa486-cPa268-hybrid_cPa486-cPa308-hybrid_cPa486-cPa360-hybrid_cPa486-cPa450-hybrid_cPa542-cPa308-hybrid_cPa553_cPa553-cPa308-hybrid_cPa62_cPa62-cPa163-hybrid_cPa62-cPa224-hybrid_cPa62-cPa227-hybrid_cPa62-cPa308-hybrid_cPa62-cPa360-hybrid_cPa62-cPa404-hybrid_cPa62-cPa450-hybrid_cPa62-cPa47-hybrid_cPa62-cPa542-hybrid_cPa71-cPa163-hybrid_cPa71-cPa199-hybrid_cPa71-cPa223-hybrid_cPa71-cPa224-hybrid_cPa71-cPa227-hybrid_cPa71-cPa273-hybrid_cPa71-cPa308-hybrid_cPa71-cPa345-hybrid_cPa71-cPa360-hybrid_cPa71-cPa391-hybrid_cPa71-cPa450-hybrid_cPa71-cPa542-hybrid_REV_NC006934-cPa113-hybrid_Xen1_AJ506107-cPa199-hybrid,2_2_1_1_1_3_1_1_5_3_1_1_1_1_1_1_4_1_5_1_1_1_1_2_2_189_1_1_1_1_2_7_2_3_2_2_5_1_1_2_2_1_8_1_24_1_1_1_1_2_1_3_1_1_47_12_4_18_5_1_8_40_3_5_1_1_24_2_3_208_2_1_2_1_2_3_14_2_5_1_5_1_3_14_1_1_3_1_1_22_1_2_1_4_14_7_3_20_2_4_11_5_10_1_12_1_1_1_1_17_4_5_24_8_5_1_9_1_2_1_159_2_1_1_2_2_1_4_1_2_59_6_5_2_6_3_1_1_1_1_4_2_3_8_1_1_10_2_3_1_13_1_1_1,504,482
Scaffold1107-4621_4723,cPa345,0.375,5,4698,4642,cPa199_cPa273-cPa227-hybrid_cPa345_cPa450_cPa553,1_1_3_2_1,102,56
Scaffold1107-4808_5199,cPa345,0.223097112860892,40,5147,4827,cPa199_cPa199-cPa223-hybrid_cPa199-cPa273-hybrid_cPa199-cPa308-hybrid_cPa199-cPa345-hybrid_cPa199-cPa542-hybrid_cPa223_cPa223-cPa227-hybrid_cPa223-cPa345-hybrid_cPa223-cPa450-hybrid_cPa227_cPa227-cPa223-hybrid_cPa227-cPa542-hybrid_cPa273_cPa273-cPa199-hybrid_cPa273-cPa542-hybrid_cPa273-cPa553-hybrid_cPa345_cPa345-cPa199-hybrid_cPa345-cPa223-hybrid_cPa345-cPa268-hybrid_cPa345-cPa450-hybrid_cPa345-cPa542-hybrid_cPa419_cPa419-cPa223-hybrid_cPa419-cPa227-hybrid_cPa450_cPa450-cPa223-hybrid_cPa450-cPa227-hybrid_cPa450-cPa273-hybrid_cPa450-cPa308-hybrid_cPa542_cPa542-cPa268-hybrid_cPa542-cPa273-hybrid_cPa542-cPa308-hybrid_cPa542-cPa353-hybrid_cPa553_cPa553-cPa450-hybrid_cPa553-cPa542-hybrid_cPa75-cPa345-hybrid,81_1_1_2_1_1_20_2_1_2_16_1_1_16_2_1_1_85_1_2_1_2_1_5_1_1_73_2_1_1_1_16_1_1_1_1_31_1_1_1,391,320
Scaffold1108-1264_1383,cPa356,0.526881720430108,2,1342,1270,cPa356_cPa428,49_44,119,72
Scaffold1108-1400_1828,cPa356,0.526785714285714,2,1789,1427,cPa356_cPa428,59_53,428,362
Scaffold1108-2574_2731,cPa356_cPa428,0.5,2,2701,2601,cPa356_cPa428,7_7,157,100
Scaffold1109-1823_1927,cPa356_cPa428,0.5,2,1926,1839,cPa356_cPa428,29_29,104,87
Scaffold1109-2659_2761,cPa356,0.6,2,2747,2659,cPa356_cPa428,21_14,102,88
Scaffold1109-4126_4300,cPa428,0.521739130434783,2,4291,4132,cPa356_cPa428,44_48,174,159
Scaffold1109-4883_5146,cPa356,0.54,2,5111,4889,cPa356_cPa428,27_23,263,222
Scaffold1109-5781_5883,cPa356_cPa428,0.5,2,5831,5831,cPa356_cPa428,1_1,102,0
Scaffold111-10066_10168,cPa428,0.56,2,10165,10080,cPa356_cPa428,22_28,102,85
Scaffold111-1294_1556,cPa356,0.56,2,1510,1343,cPa356_cPa428,28_22,262,167
Scaffold111-1614_1784,cPa356,0.575268817204301,3,1783,1664,cPa356_cPa356-unknown_cPa428,107_1_78,170,119
Scaffold111-1790_1969,cPa356,0.555555555555556,2,1917,1793,cPa356_cPa428,5_4,179,124
Scaffold111-2739_2841,cPa356_cPa428,0.5,2,2789,2789,cPa356_cPa428,1_1,102,0
Scaffold111-553_655,cPa428,1,1,603,601,cPa428,2,102,2
Scaffold111-6965_7067,cPa428,1,1,7015,7015,cPa428,1,102,0
Scaffold111-7069_7227,cPa428,0.80952380952381,2,7175,7119,cPa356_cPa428,4_17,158,56
Scaffold111-8311_8413,cPa356_cPa428,0.5,2,8366,8361,cPa356_cPa428,1_1,102,5
Scaffold111-9163_9335,cPa428,0.510416666666667,3,9298,9168,cPa356_cPa419_cPa428,93_1_98,172,130
Scaffold111-9378_9480,cPa356,0.5,3,9479,9399,cPa356_cPa419_cPa428,43_1_42,102,80
Scaffold1111-1103_1390,cPa61,0.184931506849315,50,1385,1145,cPa157-cPa194-hybrid_cPa157-cPa205-hybrid_cPa157-cPa357-hybrid_cPa157-cPa413-hybrid_cPa157-cPa475-hybrid_cPa157-cPa62-hybrid_cPa157-SFV_U04327-hybrid_cPa164-cPa475-hybrid_cPa199-cPa357-hybrid_cPa205_cPa205-cPa308-hybrid_cPa205-cPa345-hybrid_cPa205-cPa357-hybrid_cPa205-HERVHcons-hybrid_cPa223-cPa308-hybrid_cPa223-cPa357-hybrid_cPa308_cPa308-cPa194-hybrid_cPa308-cPa357-hybrid_cPa339-cPa308-hybrid_cPa395-cPa357-hybrid_cPa395-cPa413-hybrid_cPa395-cPa62-hybrid_cPa465-cPa205-hybrid_cPa465-cPa308-hybrid_cPa465-cPa357-hybrid_cPa465-cPa411-hybrid_cPa465-cPa62-hybrid_cPa465-HERVHcons-hybrid_cPa482_cPa482-cPa174-hybrid_cPa482-cPa308-hybrid_cPa482-cPa332-hybrid_cPa482-cPa357-hybrid_cPa482-cPa413-hybrid_cPa482-cPa475-hybrid_cPa482-cPa62-hybrid_cPa482-HERVHcons-hybrid_cPa482-SFV_U04327-hybrid_cPa61_cPa75-cPa117-hybrid_cPa75-cPa205-hybrid_cPa75-cPa308-hybrid_cPa75-cPa357-hybrid_cPa75-cPa475-hybrid_cPa75-cPa62-hybrid_cPa75-HERVHcons-hybrid_cPa75-SFV_U04327-hybrid_cPa75-unknown_PtERV1_AC142352-cPa357-hybrid,1_1_2_2_2_2_1_1_1_3_4_1_3_1_2_1_6_1_1_1_6_2_2_1_15_2_1_1_1_3_1_2_1_4_3_2_1_2_1_27_1_1_3_13_2_6_2_1_1_1,287,240
Scaffold1111-5441_5543,cPa56,1,1,5491,5491,cPa56,1,102,0
Scaffold1111-892_1009,cPa482-cPa308-hybrid,0.24,10,962,927,cPa15-cPa308-hybrid_cPa157-cPa308-hybrid_cPa157-cPa357-hybrid_cPa308_cPa395-cPa308-hybrid_cPa395-cPa339-hybrid_cPa465-cPa308-hybrid_cPa482-cPa308-hybrid_cPa482-cPa357-hybrid_cPa75-cPa357-hybrid,1_2_1_1_5_1_1_6_3_4,117,35
Scaffold1112-2340_2442,cPa419,1,1,2404,2390,cPa419,2,102,14
Scaffold1112-2964_3066,cPa419,1,1,3066,2963,cPa419,24,102,103
Scaffold1112-4267_4571,cPa419,0.990740740740741,2,4542,4268,cPa419_HML4_repbase_HERVK13I_LTR13-cPa581-hybrid,107_1,304,274
Scaffold1112-4613_4715,cPa419,1,1,4708,4626,cPa419,34,102,82
Scaffold1113-1348_1501,cPa199,0.765957446808511,4,1488,1373,cPa125-cPa47-hybrid_cPa199_cPa419_cPa428,1_36_9_1,153,115
Scaffold1113-1597_1754,cPa199,0.911764705882353,2,1738,1647,cPa199_cPa419,31_3,157,91
Scaffold1113-3293_3473,cPa199,0.867469879518072,10,3468,3303,cPa106-cPa428-hybrid_cPa113-cPa106-hybrid_cPa113-cPa228-hybrid_cPa113-unknown_cPa173-cPa106-hybrid_cPa173-unknown_cPa199_cPa257-cPa106-hybrid_cPa257-cPa549-hybrid_cPa419,1_1_2_3_2_1_144_1_1_10,180,165
Scaffold1113-3483_3840,cPa199,0.867647058823529,7,3839,3511,cPa113-unknown_cPa163-unknown_cPa173_cPa173-cPa449-hybrid_cPa199_cPa257-unknown_cPa419,4_1_3_1_118_1_8,357,328
Scaffold1113-4738_4976,cPa199,0.980769230769231,2,4971,4741,cPa199_cPa419,102_2,238,230
Scaffold1113-4979_5081,cPa199,0.454545454545455,10,5066,4978,cPa106_cPa106-cPa362-hybrid_cPa106-cPa50-hybrid_cPa15-cPa50-hybrid_cPa199_cPa273-cPa50-hybrid_cPa323-cPa106-hybrid_cPa333-cPa106-hybrid_cPa419_cPa50-cPa106-hybrid,1_1_1_1_10_1_1_2_3_1,102,88
Scaffold1113-5093_5297,cPa199,0.829268292682927,3,5245,5094,cPa199_cPa356_cPa419,34_1_6,204,151
Scaffold1114-2710_2812,cPa391,1,1,2760,2760,cPa391,1,102,0
Scaffold1114-4510_4654,cPa200-unknown,0.333333333333333,8,4603,4560,cPa200-cPa121-hybrid_cPa200-cPa391-hybrid_cPa200-cPa500-hybrid_cPa200-SFV_U04327-hybrid_cPa200-unknown_cPa257_cPa500_cPa500-cPa298-hybrid,1_2_9_2_11_2_5_1,144,43
Scaffold1114-4771_4873,cPa200-cPa500-hybrid_cPa500,0.375,4,4825,4815,cPa200-cPa391-hybrid_cPa200-cPa500-hybrid_cPa257_cPa500,1_3_1_3,102,10
Scaffold1114-5186_5480,cPa391,0.89041095890411,7,5478,5188,cPa107-unknown_cPa200-cPa500-hybrid_cPa200-SFV_U04327-hybrid_cPa257-cPa500-hybrid_cPa298_cPa298-unknown_cPa391,2_2_1_1_1_1_65,294,290
Scaffold1115-1166_1268,cPa356,0.517241379310345,2,1246,1176,cPa356_cPa428,15_14,102,70
Scaffold1117-1696_1798,cPa419,1,1,1746,1746,cPa419,1,102,0
Scaffold1117-7089_7191,cPa419,1,1,7140,7139,cPa419,2,102,1
Scaffold1119-4904_5006,cPa109,1,1,4954,4954,cPa109,1,102,0
Scaffold112-3459_3561,cPa356,0.8,2,3523,3509,cPa356_cPa428,4_1,102,14
Scaffold112-3736_3838,cPa428,0.571428571428571,2,3817,3737,cPa356_cPa428,15_20,102,80
Scaffold112-3951_4053,cPa356,0.576923076923077,2,4053,3998,cPa356_cPa428,15_11,102,55
Scaffold112-4409_4524,cPa356,0.5625,2,4476,4426,cPa356_cPa428,27_21,115,50
Scaffold112-4589_4691,cPa356,0.545454545454545,2,4688,4628,cPa356_cPa428,12_10,102,60
Scaffold112-5662_5764,cPa356,0.509803921568627,2,5759,5664,cPa356_cPa428,26_25,102,95
Scaffold112-6028_6130,cPa356_cPa428,0.5,2,6084,6078,cPa356_cPa428,2_2,102,6
Scaffold112-6693_6795,cPa428,1,1,6743,6743,cPa428,1,102,0
Scaffold1120-4021_4123,cPa163-cPa391-hybrid,1,1,4071,4071,cPa163-cPa391-hybrid,1,102,0
Scaffold1121-1276_1378,cPa117-cPa357-hybrid_cPa118-cPa357-hybrid_cPa121-cPa339-hybrid_cPa552-cPa15-hybrid_cPa552-cPa443-hybrid,0.2,5,1360,1280,cPa117-cPa357-hybrid_cPa118-cPa357-hybrid_cPa121-cPa339-hybrid_cPa552-cPa15-hybrid_cPa552-cPa443-hybrid,1_1_1_1_1,102,80
Scaffold1121-2751_2873,cPa118,0.475409836065574,7,2823,2769,cPa118_cPa118-unknown_cPa140_cPa248_cPa248-unknown_cPa264_cPa443,29_1_1_1_1_5_23,122,54
Scaffold1121-2952_3054,cPa264,0.666666666666667,2,3021,3002,cPa118_cPa264,1_2,102,19
Scaffold1121-461_563,cPa357,0.7,2,556,501,cPa339_cPa357,3_7,102,55
Scaffold1123-1908_2010,cPa419,1,1,1958,1958,cPa419,1,102,0
Scaffold1123-2767_2869,cPa419,1,1,2866,2767,cPa419,5,102,99
Scaffold1123-3627_3729,cPa419,1,1,3724,3677,cPa419,3,102,47
Scaffold1123-4309_4411,cPa419,1,1,4407,4309,cPa419,15,102,98
Scaffold1123-4419_4546,cPa419,1,1,4540,4421,cPa419,28,127,119
Scaffold1123-4571_4673,cPa419,1,1,4662,4572,cPa419,44,102,90
Scaffold1123-4839_4941,cPa419,1,1,4936,4842,cPa419,39,102,94
Scaffold1123-4993_5095,cPa419,1,1,5090,4996,cPa419,7,102,94
Scaffold1123-5106_5208,cPa419,1,1,5206,5114,cPa419,50,102,92
Scaffold1123-6795_6897,cPa419,1,1,6879,6827,cPa419,5,102,52
Scaffold1123-931_1033,cPa419,1,1,998,981,cPa419,3,102,17
Scaffold1125-6175_6294,cPa428,0.6,2,6242,6190,cPa356_cPa428,2_3,119,52
Scaffold1128-1425_1624,cPa434,0.674418604651163,4,1616,1427,cPa356_cPa434_cPa434-cPa50-hybrid_cPa434-unknown,12_29_1_1,199,189
Scaffold1128-2983_3085,cPa434-cPa247-hybrid,1,1,3033,3033,cPa434-cPa247-hybrid,1,102,0
Scaffold1128-3322_3492,cPa356-cPa254-hybrid,0.176470588235294,12,3460,3372,cPa223-cPa434-hybrid_cPa356-cPa174-hybrid_cPa356-cPa254-hybrid_cPa356-cPa392-hybrid_cPa356-cPa404-hybrid_cPa356-cPa47-hybrid_cPa425_cPa434-cPa174-hybrid_cPa434-cPa254-hybrid_cPa434-cPa392-hybrid_cPa502-cPa174-hybrid_REV_NC006934-cPa50-hybrid,1_2_3_1_2_1_1_1_2_1_1_1,170,88
Scaffold1128-4890_5057,cPa434,0.6,2,5005,4940,cPa434_REV_NC006934-cPa434-hybrid,3_2,167,65
Scaffold113-2956_3058,cPa428,0.714285714285714,2,3011,2993,cPa356_cPa428,4_10,102,18
Scaffold1130-2778_2932,cPa419,1,1,2910,2788,cPa419,34,154,122
Scaffold1130-2934_3036,cPa419,1,1,3026,2934,cPa419,4,102,92
Scaffold1130-3473_3727,cPa419,1,1,3676,3474,cPa419,37,254,202
Scaffold1130-4147_4367,cPa419,1,1,4315,4165,cPa419,11,220,150
Scaffold1130-5379_5481,cPa419,1,1,5429,5415,cPa419,13,102,14
Scaffold1130-5888_6086,cPa419,1,1,6062,5893,cPa419,19,198,169
Scaffold1130-6357_6459,cPa419,1,1,6407,6359,cPa419,3,102,48
Scaffold1131-3270_3372,cPa75-cPa360-hybrid,1,1,3320,3320,cPa75-cPa360-hybrid,1,102,0
Scaffold1131-4274_4376,cPa75,1,1,4324,4324,cPa75,1,102,0
Scaffold1134-3998_4100,cPa176-cPa363-hybrid_cPa71_cPa75,0.333333333333333,3,4048,3998,cPa176-cPa363-hybrid_cPa71_cPa75,1_1_1,102,50
Scaffold1135-3253_3362,cPa428,0.6,2,3324,3287,cPa356_cPa428,2_3,109,37
Scaffold1135-3413_3524,cPa356,0.538461538461538,2,3495,3415,cPa356_cPa428,7_6,111,80
Scaffold1135-3891_3993,cPa356,1,1,3941,3941,cPa356,1,102,0
Scaffold1135-5279_5381,cPa356,0.526315789473684,2,5378,5279,cPa356_cPa428,10_9,102,99
Scaffold114-15003_15262,cPa428,0.505747126436782,2,15225,15053,cPa356_cPa428,43_44,259,172
Scaffold114-16385_16487,cPa356_cPa428,0.5,2,16484,16395,cPa356_cPa428,6_6,102,89
Scaffold114-16640_16753,cPa356_cPa428,0.5,2,16745,16690,cPa356_cPa428,2_2,113,55
Scaffold114-20349_20451,cPa356_cPa428,0.5,2,20399,20399,cPa356_cPa428,1_1,102,0
Scaffold114-20790_20892,cPa356,0.75,2,20854,20840,cPa356_cPa428,3_1,102,14
Scaffold114-21054_21259,cPa428,0.56,2,21243,21104,cPa356_cPa428,11_14,205,139
Scaffold114-21922_22024,cPa428,0.75,2,21972,21926,cPa356_cPa428,1_3,102,46
Scaffold114-22126_22331,cPa428,0.541666666666667,2,22327,22160,cPa356_cPa428,11_13,205,167
Scaffold1141-4502_4604,cPa119,0.466666666666667,6,4604,4520,cPa119_cPa119-cPa15-hybrid_cPa119-cPa394-hybrid_cPa119-unknown_cPa163-cPa463-hybrid_cPa419,7_1_2_3_1_1,102,84
Scaffold1141-4625_4727,cPa119-unknown,0.666666666666667,3,4679,4629,cPa119_cPa119-unknown_cPa585-cPa15-hybrid,2_6_1,102,50
Scaffold1141-6832_6934,cPa308,1,1,6891,6841,cPa308,26,102,50
Scaffold1141-7110_7212,cPa308,1,1,7160,7127,cPa308,6,102,33
Scaffold1143-1195_1297,cPa419,1,1,1245,1228,cPa419,2,102,17
Scaffold1146-6290_6392,cPa75,0.6,3,6360,6306,cPa381_cPa75_cPa75-cPa224-hybrid,1_3_1,102,54
Scaffold1147-3885_3987,cPa419,1,1,3984,3929,cPa419,135,102,55
Scaffold115-3751_3930,cPa428,0.529411764705882,3,3913,3756,cPa356_cPa356-unknown_cPa428,7_1_9,179,157
Scaffold115-4055_4193,cPa356,0.529411764705882,2,4187,4101,cPa356_cPa428,9_8,138,86
Scaffold1150-2624_2726,cPa356,1,1,2674,2674,cPa356,1,102,0
Scaffold1150-523_625,cPa428,1,1,573,568,cPa428,3,102,5
Scaffold1156-1439_1541,cPa356,0.719101123595506,2,1541,1452,cPa356_cPa428,64_25,102,89
Scaffold1156-1724_1852,cPa428,0.615384615384615,2,1852,1725,cPa356_cPa428,70_112,128,127
Scaffold1156-1991_2093,cPa428,0.857142857142857,2,2063,2000,cPa356_cPa428,1_6,102,63
Scaffold1156-2238_2340,cPa356,1,1,2288,2288,cPa356,1,102,0
Scaffold1156-2453_2631,cPa428,0.586206896551724,3,2630,2461,cPa356_cPa428_cPa428-cPa356-hybrid,23_34_1,178,169
Scaffold1156-3227_3329,cPa356_cPa428,0.5,2,3329,3251,cPa356_cPa428,118_118,102,78
Scaffold1156-3397_3560,cPa356,0.64,2,3544,3397,cPa356_cPa428,16_9,163,147
Scaffold1156-3974_4076,cPa428,1,1,4053,4024,cPa428,2,102,29
Scaffold1156-4722_4824,cPa428,0.625,2,4824,4723,cPa356_cPa428,3_5,102,101
Scaffold116-881_983,cPa356,0.52,2,954,901,cPa356_cPa428,13_12,102,53
Scaffold1160-3226_3328,cPa446-cPa75-hybrid,1,1,3276,3276,cPa446-cPa75-hybrid,1,102,0
Scaffold1160-4984_5086,HERV-I_repbase_HERVI_LTR10B-CAEV_NC001463-hybrid,1,1,5034,5034,HERV-I_repbase_HERVI_LTR10B-CAEV_NC001463-hybrid,1,102,0
Scaffold1162-2762_2864,cPa313-cPa353-hybrid,1,1,2812,2812,cPa313-cPa353-hybrid,1,102,0
Scaffold1162-3622_3749,cPa434,0.75,2,3697,3670,cPa434_cPa434-cPa339-hybrid,3_1,127,27
Scaffold1162-4286_4388,cPa229-cPa391-hybrid,1,1,4336,4336,cPa229-cPa391-hybrid,1,102,0
Scaffold1162-4616_4718,cPa229-cPa391-hybrid_cPa391,0.5,2,4666,4630,cPa229-cPa391-hybrid_cPa391,1_1,102,36
Scaffold1166-3423_3577,cPa428,0.666666666666667,2,3528,3473,cPa356_cPa428,1_2,154,55
Scaffold1166-4086_4188,cPa428,1,1,4184,4109,cPa428,4,102,75
Scaffold1166-5117_5231,cPa428,0.7,2,5210,5154,cPa356_cPa428,6_14,114,56
Scaffold1168-1073_1196,cPa356,0.583333333333333,2,1168,1111,cPa356_cPa428,7_5,123,57
Scaffold1169-4839_4941,cPa333,1,1,4889,4889,cPa333,1,102,0
Scaffold1169-6379_6512,cPa75-STLV2_NC001815-hybrid,1,1,6460,6429,cPa75-STLV2_NC001815-hybrid,2,133,31
Scaffold117-1072_1237,cPa356,0.517241379310345,2,1237,1074,cPa356_cPa428,45_42,165,163
Scaffold117-13950_14130,cPa428,0.5,3,14100,13964,cPa356_cPa419_cPa428,12_1_13,180,136
Scaffold117-14640_14814,cPa356,0.520833333333333,2,14787,14639,cPa356_cPa428,25_23,174,148
Scaffold117-15307_15409,cPa356,0.541666666666667,2,15409,15307,cPa356_cPa428,13_11,102,102
Scaffold117-15493_15665,cPa356,0.645161290322581,2,15665,15498,cPa356_cPa428,20_11,172,167
Scaffold117-15842_15944,cPa356,0.586206896551724,2,15944,15851,cPa356_cPa428,17_12,102,93
Scaffold117-16050_16211,cPa428,0.522388059701492,2,16200,16052,cPa356_cPa428,32_35,161,148
Scaffold117-16265_16378,cPa356,0.636363636363636,2,16326,16294,cPa356_cPa428,7_4,113,32
Scaffold117-16698_16800,cPa428,0.536585365853659,2,16800,16721,cPa356_cPa428,19_22,102,79
Scaffold117-1702_1804,cPa428,0.615384615384615,2,1804,1706,cPa356_cPa428,5_8,102,98
Scaffold117-17077_17179,cPa428,0.6,2,17148,17092,cPa356_cPa428,6_9,102,56
Scaffold117-21153_21747,cPa428,0.518691588785047,2,21707,21194,cPa356_cPa428,103_111,594,513
Scaffold117-21771_21873,cPa428,0.56,2,21868,21778,cPa356_cPa428,33_42,102,90
Scaffold117-22068_22264,cPa356,0.5,3,22255,22071,cPa356_cPa428_cPa428-unknown,45_44_1,196,184
Scaffold117-22335_22437,cPa428,0.539473684210526,2,22437,22340,cPa356_cPa428,35_41,102,97
Scaffold117-22884_22986,cPa428,0.53125,2,22984,22886,cPa356_cPa428,15_17,102,98
Scaffold117-23000_23176,cPa428,0.524193548387097,3,23171,23025,cPa356_cPa419_cPa428,57_2_65,176,146
Scaffold117-23196_23298,cPa428,0.51219512195122,2,23262,23195,cPa356_cPa428,40_42,102,67
Scaffold117-23552_23659,cPa428,0.5625,2,23620,23557,cPa356_cPa428,7_9,107,63
Scaffold117-2415_2617,cPa428,0.549019607843137,3,2582,2438,cPa356_cPa419_cPa428,22_1_28,202,144
Scaffold117-2655_2791,cPa356,0.657142857142857,2,2745,2702,cPa356_cPa428,23_12,136,43
Scaffold117-3011_3113,cPa356_cPa419_cPa428,0.333333333333333,3,3061,3061,cPa356_cPa419_cPa428,1_1_1,102,0
Scaffold117-3191_3294,cPa356_cPa428,0.5,2,3242,3241,cPa356_cPa428,1_1,103,1
Scaffold117-3415_3517,cPa428,0.75,2,3511,3423,cPa356_cPa428,1_3,102,88
Scaffold117-3728_3878,cPa428,0.52,2,3877,3748,cPa356_cPa428,12_13,150,129
Scaffold117-3951_4053,cPa428,0.6,2,4050,3976,cPa356_cPa428,2_3,102,74
Scaffold117-4093_4315,cPa356_cPa428,0.486486486486487,3,4269,4092,cPa356_cPa356-cPa428-hybrid_cPa428,18_1_18,222,177
Scaffold117-5192_5294,cPa428,1,1,5242,5242,cPa428,1,102,0
Scaffold117-898_1000,cPa428,0.538461538461538,2,998,903,cPa356_cPa428,12_14,102,95
Scaffold1170-1081_1434,cPa356,0.475609756097561,21,1382,1082,cPa138_cPa138-cPa395-hybrid_cPa138-cPa447-hybrid_cPa138-unknown_cPa188-cPa254-hybrid_cPa188-cPa447-hybrid_cPa356_cPa356-cPa138-hybrid_cPa356-cPa447-hybrid_cPa356-unknown_cPa391-unknown_cPa419_cPa419-cPa356-hybrid_cPa419-cPa447-hybrid_cPa428_cPa434-cPa447-hybrid_cPa447_cPa447-cPa434-hybrid_cPa447-cPa542-hybrid_cPa447-unknown_cPa502-cPa447-hybrid,201_1_2_11_1_1_234_1_1_1_1_3_1_4_1_1_22_1_1_1_2,353,300
Scaffold1170-3477_3581,cPa419-unknown,0.444444444444444,4,3530,3488,cPa410_cPa419_cPa419-unknown_cPa502-cPa447-hybrid,1_3_4_1,104,42
Scaffold1170-464_567,cPa356,0.411764705882353,7,558,506,cPa138-cPa404-hybrid_cPa356_cPa404-cPa199-hybrid_cPa419_cPa447-cPa199-hybrid_cPa447-cPa254-hybrid_cPa447-cPa47-hybrid,1_7_2_2_3_1_1,103,52
Scaffold1170-6314_6416,cPa456,0.666666666666667,4,6406,6314,cPa106_cPa456_cPa456-unknown_cPa530-CAEV_NC001463-hybrid,5_16_1_2,102,92
Scaffold1170-6543_6670,cPa456,0.830188679245283,4,6618,6579,cPa106_cPa456_cPa456-unknown_cPa530-CAEV_NC001463-hybrid,6_44_1_2,127,39
Scaffold1171-654_756,cPa363_cPa456-cPa363-hybrid_cPa587-cPa363-hybrid_cPa587-cPa452-hybrid,0.25,4,756,691,cPa363_cPa456-cPa363-hybrid_cPa587-cPa363-hybrid_cPa587-cPa452-hybrid,1_1_1_1,102,65
Scaffold1172-4055_4191,cPa356,0.45,6,4191,4054,cPa150-cPa447-hybrid_cPa356_cPa356-cPa434-hybrid_cPa356-cPa447-hybrid_cPa434_cPa434-cPa447-hybrid,1_9_1_1_4_4,136,137
Scaffold1172-6074_6209,cPa434,0.583333333333333,5,6160,6124,cPa150-cPa447-hybrid_cPa260-cPa392-hybrid_cPa434_cPa434-cPa392-hybrid_cPa434-unknown,1_1_7_1_2,135,36
Scaffold1173-4751_4853,cPa356,1,1,4801,4801,cPa356,1,102,0
Scaffold1175-2073_2191,cPa419,1,1,2139,2123,cPa419,2,118,16
Scaffold118-12100_12287,cPa356,0.507246376811594,2,12287,12113,cPa356_cPa428,35_34,187,174
Scaffold118-12305_12407,cPa428,0.5,3,12396,12318,cPa356_cPa428_cPa428-unknown,26_27_1,102,78
Scaffold118-12454_12700,cPa356,0.58974358974359,2,12678,12458,cPa356_cPa428,23_16,246,220
Scaffold118-1342_1444,cPa356_cPa428,0.5,2,1419,1378,cPa356_cPa428,8_8,102,41
Scaffold118-13439_13541,cPa15,1,1,13489,13489,cPa15,1,102,0
Scaffold118-13674_13792,cPa15,0.692307692307692,2,13742,13676,cPa15_cPa268-cPa118-hybrid,9_4,118,66
Scaffold118-14059_14161,cPa15,0.4,4,14135,14089,cPa15_cPa15-cPa118-hybrid_cPa268-cPa118-hybrid_cPa356-cPa15-hybrid,2_1_1_1,102,46
Scaffold1180-2466_2619,cPa15_cPa339_cPa419,0.133333333333333,12,2602,2476,cPa125_cPa15_cPa163_cPa248_cPa264_cPa339_cPa339-cPa15-hybrid_cPa410-cPa443-hybrid_cPa419_cPa447-cPa15-hybrid_cPa447-cPa444-hybrid_cPa61,1_2_1_1_1_2_1_1_2_1_1_1,153,126
Scaffold1180-6172_6274,cPa339_cPa419_cPa546-cPa419-hybrid,0.333333333333333,3,6222,6196,cPa339_cPa419_cPa546-cPa419-hybrid,1_1_1,102,26
Scaffold1180-819_1210,cPa15,0.460227272727273,23,1210,826,cPa118_cPa118-cPa125-hybrid_cPa118-cPa140-hybrid_cPa118-cPa268-hybrid_cPa125_cPa125-cPa539-hybrid_cPa140_cPa140-cPa268-hybrid_cPa140-cPa539-hybrid_cPa15_cPa15-cPa125-hybrid_cPa15-cPa140-hybrid_cPa15-cPa264-hybrid_cPa15-cPa268-hybrid_cPa15-cPa394-hybrid_cPa15-cPa539-hybrid_cPa248_cPa248-cPa125-hybrid_cPa248-cPa268-hybrid_cPa248-cPa443-hybrid_cPa264_cPa419_cPa62-cPa394-hybrid,12_1_2_1_1_1_45_1_2_81_1_3_1_1_1_1_12_1_2_1_1_3_1,391,384
Scaffold1182-1576_1738,cPa539-cPa475-hybrid,0.636363636363636,4,1686,1626,cPa447-cPa168-hybrid_cPa472-cPa190-hybrid_cPa539-cPa469-hybrid_cPa539-cPa475-hybrid,1_1_2_7,162,60
Scaffold1182-1979_2104,cPa447-cPa475-hybrid,0.444444444444444,5,2058,2029,cPa447-cPa475-hybrid_cPa539-cPa168-hybrid_cPa539-cPa394-hybrid_cPa539-cPa472-hybrid_cPa539-cPa475-hybrid,4_1_1_1_2,125,29
Scaffold1182-4613_4869,cPa145,0.923076923076923,2,4817,4663,cPa145_cPa145-S71_repbase_HERVS71_LTR6A-hybrid,12_1,256,154
Scaffold1182-4875_4977,cPa145,1,1,4931,4925,cPa145,2,102,6
Scaffold1182-4987_5089,cPa145,0.875,2,5037,5020,cPa145_cPa145-unknown,7_1,102,17
Scaffold1184-5037_5139,cPa356,0.692307692307692,2,5102,5082,cPa356_cPa428,9_4,102,20
Scaffold1185-3636_3747,cPa391,0.575757575757576,11,3745,3664,cPa183_cPa335-cPa500-hybrid_cPa391_cPa391-cPa298-hybrid_cPa391-unknown_cPa500_cPa521-cPa199-hybrid_FeFV_NC001871-cPa298-hybrid_HERV30_repbase_HERV30I_LTR30_HERV30_repbase_HERV30I_LTR30-cPa298-hybrid_HERV30_repbase_HERV30I_LTR30-cPa500-hybrid,1_1_19_1_2_3_1_1_2_1_1,111,81
Scaffold1187-1690_1826,cPa356,0.51063829787234,2,1774,1728,cPa356_cPa428,24_23,136,46
Scaffold1187-1855_1957,cPa356_cPa428,0.5,2,1941,1903,cPa356_cPa428,8_8,102,38
Scaffold1187-2072_2174,cPa356,0.525,2,2146,2087,cPa356_cPa428,21_19,102,59
Scaffold1187-3384_3528,cPa356,0.622222222222222,3,3493,3383,cPa356_cPa419_cPa428,28_1_16,144,110
Scaffold119-16004_16106,cPa428,0.5,3,16089,16048,cPa356_cPa356-cPa428-hybrid_cPa428,2_1_3,102,41
Scaffold119-3943_4066,cPa356,0.64,2,4035,3958,cPa356_cPa428,32_18,123,77
Scaffold119-4068_4289,cPa356,0.514563106796116,2,4281,4104,cPa356_cPa428,53_50,221,177
Scaffold1195-2804_2914,cPa339,0.952380952380952,2,2862,2849,cPa339_cPa419,20_1,110,13
Scaffold1195-3917_4019,cPa339,1,1,4015,3938,cPa339,13,102,77
Scaffold1195-4458_4597,cPa339,0.962962962962963,2,4574,4505,cPa339_cPa419,26_1,139,69
Scaffold1195-452_554,cPa339,1,1,535,453,cPa339,10,102,82
Scaffold1195-6172_6274,cPa339,1,1,6222,6222,cPa339,1,102,0
Scaffold1195-6336_6438,cPa339,0.769230769230769,3,6386,6343,cPa339_cPa402-cPa339-hybrid_cPa402-SnRV_NC001724-hybrid,10_2_1,102,43
Scaffold1195-716_1081,cPa339,0.972222222222222,2,1063,766,cPa339_cPa419,35_1,365,297
Scaffold1198-3981_4083,cPa356_cPa428,0.4,4,4067,3985,cPa356_cPa419-unknown_cPa428_cPa581-unknown,4_1_4_1,102,82
Scaffold120-24401_24503,cPa428,0.666666666666667,2,24457,24451,cPa356_cPa428,1_2,102,6
Scaffold120-24598_24700,cPa356_cPa428,0.5,2,24683,24648,cPa356_cPa428,1_1,102,35
Scaffold120-3078_3180,cPa428,0.535714285714286,2,3154,3108,cPa356_cPa428,13_15,102,46
Scaffold120-30887_31005,cPa356,0.571428571428571,2,30963,30931,cPa356_cPa428,4_3,118,32
Scaffold120-32334_32436,cPa356,1,1,32384,32384,cPa356,1,102,0
Scaffold120-32442_32568,cPa356,0.833333333333333,2,32516,32492,cPa356_cPa428,5_1,126,24
Scaffold1202-2678_2780,cPa419,1,1,2728,2728,cPa419,1,102,0
Scaffold1204-1857_1959,cPa529-PERV_AJ293656-hybrid_PERV_AJ293656,0.5,2,1916,1907,cPa529-PERV_AJ293656-hybrid_PERV_AJ293656,1_1,102,9
Scaffold1204-1988_2212,cPa177-cPa272-hybrid,0.444444444444444,10,2185,1988,cPa150-cPa272-hybrid_cPa177_cPa177-cPa272-hybrid_cPa447-cPa272-hybrid_cPa529-cPa125-hybrid_cPa529-cPa61-hybrid_cPa75_cPa75-cPa177-hybrid_cPa75-cPa413-hybrid_PERV_AJ293656-cPa125-hybrid,1_3_12_2_2_1_3_1_1_1,224,197
Scaffold1204-2426_2528,cPa177_cPa177-cPa125-hybrid_cPa447-cPa272-hybrid,0.333333333333333,3,2476,2444,cPa177_cPa177-cPa125-hybrid_cPa447-cPa272-hybrid,1_1_1,102,32
Scaffold1207-6410_6512,cPa419,1,1,6460,6460,cPa419,1,102,0
Scaffold1217-1269_1371,cPa419,1,1,1319,1319,cPa419,1,102,0
Scaffold1217-1570_1672,cPa419,1,1,1649,1614,cPa419,5,102,35
Scaffold1218-4414_4516,cPa356,0.727272727272727,2,4490,4429,cPa356_cPa428,8_3,102,61
Scaffold1219-5778_5880,cPa419,1,1,5828,5806,cPa419,3,102,22
Scaffold122-10131_10233,cPa356,0.588235294117647,2,10219,10153,cPa356_cPa428,20_14,102,66
Scaffold122-10247_10514,cPa356,0.637931034482759,2,10462,10248,cPa356_cPa428,37_21,267,214
Scaffold122-10591_11028,cPa356,0.525345622119816,2,11026,10591,cPa356_cPa428,114_103,437,435
Scaffold122-11242_11344,cPa356,0.588235294117647,2,11340,11289,cPa356_cPa428,10_7,102,51
Scaffold122-13849_13951,cPa356,0.6,2,13940,13897,cPa356_cPa428,9_6,102,43
Scaffold122-2043_2145,cPa428,0.8125,2,2143,2080,cPa356_cPa428,3_13,102,63
Scaffold122-2179_2281,cPa356,0.525,2,2281,2210,cPa356_cPa428,21_19,102,71
Scaffold122-7166_7268,cPa428,0.625,2,7216,7183,cPa356_cPa428,3_5,102,33
Scaffold122-7945_8047,cPa356,0.5,3,8008,7944,cPa356_cPa428_cPa428-unknown,10_9_1,102,64
Scaffold122-9574_9798,cPa356,0.506329113924051,2,9747,9580,cPa356_cPa428,80_78,224,167
Scaffold122-9912_10043,cPa356,0.676470588235294,2,10040,9914,cPa356_cPa428,23_11,131,126
Scaffold1221-879_981,cPa413-unknown,1,1,929,929,cPa413-unknown,1,102,0
Scaffold1223-1362_1464,cPa117-cPa308-hybrid_cPa357-cPa106-hybrid,0.222222222222222,7,1419,1409,cPa117-cPa308-hybrid_cPa174-cPa109-hybrid_cPa205_cPa357-cPa106-hybrid_cPa392-cPa452-hybrid_cPa456-cPa109-hybrid_cPa523-cPa106-hybrid,2_1_1_2_1_1_1,102,10
Scaffold1223-2073_2175,cPa67,0.285714285714286,6,2135,2072,cPa117-cPa67-hybrid_cPa163_cPa357-cPa67-hybrid_cPa419_cPa67_cPa67-cPa15-hybrid,1_1_1_1_2_1,102,63
Scaffold1224-5425_5615,cPa434,1,1,5563,5462,cPa434,17,190,101
Scaffold1224-5690_5792,cPa434,1,1,5769,5732,cPa434,6,102,37
Scaffold1225-2178_2280,cPa419,1,1,2228,2220,cPa419,2,102,8
Scaffold1225-2662_2764,cPa419,1,1,2718,2669,cPa419,7,102,49
Scaffold1225-2894_3067,cPa419,1,1,3015,2944,cPa419,3,173,71
Scaffold1225-3577_3679,cPa419,1,1,3665,3623,cPa419,3,102,42
Scaffold1225-4597_4721,cPa419,1,1,4721,4639,cPa419,9,124,82
Scaffold1225-6407_6562,cPa419,1,1,6513,6446,cPa419,30,155,67
Scaffold1228-3371_3473,cPa391,0.521739130434783,3,3470,3389,cPa298_cPa391_cPa391-unknown,1_12_10,102,81
Scaffold1228-3495_3614,cPa391,0.617647058823529,3,3614,3494,cPa298_cPa391_cPa391-unknown,8_21_5,119,120
Scaffold1228-3630_3957,cPa391,0.605263157894737,6,3939,3641,cPa298_cPa298-unknown_cPa381-cPa118-hybrid_cPa391_cPa391-cPa298-hybrid_cPa391-unknown,19_6_1_46_1_3,327,298
Scaffold1228-5276_5378,cPa381,1,1,5326,5326,cPa381,1,102,0
Scaffold123-16335_16487,cPa428,0.518518518518518,2,16475,16385,cPa356_cPa428,13_14,152,90
Scaffold123-16821_16923,cPa356_cPa428,0.5,2,16919,16844,cPa356_cPa428,7_7,102,75
Scaffold123-17799_17901,cPa428,0.6,2,17852,17815,cPa356_cPa428,2_3,102,37
Scaffold123-18576_18678,cPa356,0.571428571428571,2,18632,18626,cPa356_cPa428,8_6,102,6
Scaffold123-19483_19613,cPa356,0.555555555555556,2,19601,19527,cPa356_cPa428,15_12,130,74
Scaffold123-19765_19884,cPa356,0.576923076923077,2,19850,19787,cPa356_cPa428,15_11,119,63
Scaffold123-22152_22254,cPa428_cPa428-cPa356-hybrid,0.5,2,22214,22202,cPa428_cPa428-cPa356-hybrid,1_1,102,12
Scaffold123-27698_27800,cPa356,1,1,27748,27748,cPa356,1,102,0
Scaffold123-2814_2916,cPa356,0.6,2,2914,2864,cPa356_cPa428,6_4,102,50
Scaffold123-3167_3269,cPa356,0.545454545454545,2,3240,3217,cPa356_cPa428,6_5,102,23
Scaffold123-3801_3903,cPa356_cPa428,0.5,2,3852,3804,cPa356_cPa428,10_10,102,48
Scaffold1230-1205_1370,cPa428,0.833333333333333,2,1367,1219,cPa356_cPa428,1_5,165,148
Scaffold1230-2323_2568,cPa356_cPa428,0.5,2,2519,2373,cPa356_cPa428,5_5,245,146
Scaffold1230-438_621,cPa356,0.6,2,569,488,cPa356_cPa428,3_2,183,81
Scaffold1232-4129_4231,cPa419,1,1,4179,4179,cPa419,1,102,0
Scaffold1232-4802_4904,cPa419,1,1,4876,4852,cPa419,2,102,24
Scaffold1232-4919_5104,cPa419,1,1,5052,4969,cPa419,4,185,83
Scaffold1232-5300_5402,cPa419,1,1,5387,5323,cPa419,6,102,64
Scaffold1232-5795_6007,cPa419,1,1,5958,5841,cPa419,28,212,117
Scaffold1233-4287_4407,cPa356_cPa428,0.5,2,4384,4333,cPa356_cPa428,5_5,120,51
Scaffold124-10756_11045,cPa428,0.571428571428571,2,11018,10796,cPa356_cPa428,6_8,289,222
Scaffold124-12752_12854,cPa428,0.555555555555556,2,12841,12777,cPa356_cPa428,4_5,102,64
Scaffold124-13976_14078,cPa428,0.666666666666667,2,14026,14025,cPa356_cPa428,1_2,102,1
Scaffold124-15621_15781,cPa356,0.551020408163265,2,15729,15640,cPa356_cPa428,27_22,160,89
Scaffold124-15820_15922,cPa356,0.545454545454545,2,15899,15841,cPa356_cPa428,24_20,102,58
Scaffold124-17206_17308,cPa356,1,1,17256,17224,cPa356,2,102,32
Scaffold124-17747_17849,cPa356,0.75,2,17805,17771,cPa356_cPa428,6_2,102,34
Scaffold124-18229_18349,cPa428,0.538461538461538,2,18326,18279,cPa356_cPa428,6_7,120,47
Scaffold124-19982_20084,cPa356_cPa428,0.5,2,20081,20032,cPa356_cPa428,3_3,102,49
Scaffold124-2907_3009,cPa356,1,1,2957,2957,cPa356,1,102,0
Scaffold124-3087_3200,cPa428,0.8,2,3192,3137,cPa356_cPa428,1_4,113,55
Scaffold1242-997_1106,cPa224,0.5,3,1078,1047,cPa163_cPa224_cPa224-cPa163-hybrid,5_7_2,109,31
Scaffold1245-1445_1547,cPa434,1,1,1499,1495,cPa434,2,102,4
Scaffold1245-4140_4242,cPa425,0.5,5,4214,4165,cPa360-cPa425-hybrid_cPa360-cPa75-hybrid_cPa425_cPa446-cPa425-hybrid_cPa75,1_1_4_1_1,102,49
Scaffold1245-4605_4911,cPa360-cPa75-hybrid_cPa75,0.333333333333333,5,4879,4619,cPa360_cPa360-cPa75-hybrid_cPa360-unknown_cPa419_cPa75,1_4_2_1_4,306,260
Scaffold1245-658_760,cPa356,0.5,5,717,660,cPa356_cPa356-cPa425-hybrid_cPa356-cPa434-hybrid_cPa356-unknown_cPa434-cPa426-hybrid,5_1_1_2_1,102,57
Scaffold1245-777_879,cPa356,1,1,827,827,cPa356,1,102,0
Scaffold1245-881_983,cPa356,1,1,931,931,cPa356,1,102,0
Scaffold1248-1393_1495,cPa246-cPa392-hybrid_cPa410,0.5,2,1443,1440,cPa246-cPa392-hybrid_cPa410,1_1,102,3
Scaffold1248-1542_1644,cPa285-cPa62-hybrid_cPa360,0.5,2,1592,1573,cPa285-cPa62-hybrid_cPa360,1_1,102,19
Scaffold1248-1698_1800,cPa285,1,1,1748,1748,cPa285,1,102,0
Scaffold1248-1990_2092,cPa62,0.428571428571429,3,2090,1995,cPa62_cPa75_cPa75-cPa62-hybrid,3_2_2,102,95
Scaffold1249-4784_4900,cPa356_cPa428,0.5,2,4859,4783,cPa356_cPa428,18_18,116,76
Scaffold1249-4972_5074,cPa428,0.525,2,5033,4978,cPa356_cPa428,38_42,102,55
Scaffold125-11831_11933,cPa356,0.666666666666667,2,11881,11848,cPa356_cPa428,2_1,102,33
Scaffold125-1974_2076,cPa356,1,1,2024,2024,cPa356,1,102,0
Scaffold1251-3961_4364,cPa419,1,1,4312,3963,cPa419,141,403,349
Scaffold1251-4879_4981,cPa419,1,1,4962,4910,cPa419,4,102,52
Scaffold1252-2384_2645,cPa419,1,1,2595,2417,cPa419,54,261,178
Scaffold1252-2690_2848,cPa419,1,1,2832,2731,cPa419,41,158,101
Scaffold1252-3799_4181,cPa419,1,1,4154,3849,cPa419,53,382,305
Scaffold1255-3766_3868,SIV_NC001870,0.857142857142857,2,3854,3800,cPa419_SIV_NC001870,1_6,102,54
Scaffold1257-2736_2893,cPa15,0.764705882352941,4,2849,2786,cPa107_cPa15_cPa268_cPa268-cPa118-hybrid,1_13_1_2,157,63
Scaffold1257-4026_4217,cPa332-HML8_repbase_HERVK11I_MER11A-hybrid,0.5,8,4214,4071,cPa15-HML8_repbase_HERVK11I_MER11A-hybrid_cPa194-HML8_repbase_HERVK11I_MER11A-hybrid_cPa268-HML8_repbase_HERVK11I_MER11A-hybrid_cPa332-cPa95-hybrid_cPa332-HML8_repbase_HERVK11I_MER11A-hybrid_cPa419_cPa478-cPa118-hybrid_cPa75,1_1_3_1_11_2_1_2,191,143
Scaffold1257-4245_4348,cPa478-HML8_repbase_HERVK11I_MER11A-hybrid,0.352941176470588,7,4329,4276,cPa194-HML8_repbase_HERVK11I_MER11A-hybrid_cPa332-HML8_repbase_HERVK11I_MER11A-hybrid_cPa452_cPa478-HML8_repbase_HERVK11I_MER11A-hybrid_cPa478-unknown_cPa75_HTLV2_M10060-HML8_repbase_HERVK11I_MER11A-hybrid,1_1_1_6_2_1_5,103,53
Scaffold126-11242_11467,cPa428,0.525,2,11464,11292,cPa356_cPa428,38_42,225,172
Scaffold126-1235_1337,cPa428,0.833333333333333,2,1286,1256,cPa356_cPa428,1_5,102,30
Scaffold126-12495_12642,cPa356,0.875,2,12639,12525,cPa356_cPa428,7_1,147,114
Scaffold126-12679_12839,cPa356,0.517647058823529,2,12836,12680,cPa356_cPa428,44_41,160,156
Scaffold126-12945_13047,cPa356,0.527777777777778,3,13012,12947,cPa356_cPa428_cPa428-unknown,19_16_1,102,65
Scaffold126-1359_1461,cPa356,0.514285714285714,2,1460,1378,cPa356_cPa428,18_17,102,82
Scaffold126-14997_15117,cPa356,0.583333333333333,2,15092,15035,cPa356_cPa428,7_5,120,57
Scaffold126-15178_15280,cPa356,0.523809523809524,2,15257,15228,cPa356_cPa428,11_10,102,29
Scaffold126-15436_15580,cPa356_cPa428,0.482758620689655,3,15574,15440,cPa356_cPa428_cPa428-cPa356-hybrid,14_14_1,144,134
Scaffold126-15646_15748,cPa356_cPa428,0.5,2,15731,15647,cPa356_cPa428,6_6,102,84
Scaffold126-2659_2761,cPa428,0.7,2,2742,2659,cPa356_cPa428,3_7,102,83
Scaffold126-3130_3232,cPa428,0.522388059701492,2,3231,3132,cPa356_cPa428,32_35,102,99
Scaffold126-3615_3779,cPa428,0.55,2,3754,3621,cPa356_cPa428,54_66,164,133
Scaffold126-4006_4108,cPa428,0.565789473684211,2,4088,4005,cPa356_cPa428,33_43,102,83
Scaffold126-5125_5227,cPa356,0.509433962264151,2,5227,5131,cPa356_cPa428,54_52,102,96
Scaffold126-5447_5549,cPa356,0.525773195876289,2,5541,5448,cPa356_cPa428,51_46,102,93
Scaffold126-5723_5832,cPa356,0.586206896551724,2,5832,5729,cPa356_cPa428,17_12,109,103
Scaffold126-9176_9310,cPa356,0.615384615384615,2,9268,9226,cPa356_cPa428,8_5,134,42
Scaffold1262-4279_4381,cPa356,0.541666666666667,2,4374,4283,cPa356_cPa428,13_11,102,91
Scaffold1264-4742_4844,cPa419,1,1,4792,4792,cPa419,1,102,0
Scaffold1266-1031_1520,cPa356,0.939759036144578,3,1513,1049,cPa356_cPa356-cPa313-hybrid_cPa419,78_4_1,489,464
Scaffold1266-1594_1696,cPa356,1,1,1685,1644,cPa356,4,102,41
Scaffold1266-4228_4404,cPa486,0.261904761904762,20,4397,4232,cPa157-cPa199-hybrid_cPa157-cPa268-hybrid_cPa157-cPa270-hybrid_cPa157-cPa353-hybrid_cPa157-cPa379-hybrid_cPa157-cPa62-hybrid_cPa268_cPa268-cPa308-hybrid_cPa270-cPa381-hybrid_cPa308_cPa381_cPa381-cPa270-hybrid_cPa390-cPa381-hybrid_cPa419_cPa486_cPa486-cPa201-hybrid_cPa486-cPa353-hybrid_cPa486-cPa62-hybrid_cPa62_cPa62-cPa381-hybrid,1_1_1_1_1_2_1_1_1_2_9_1_1_2_11_1_1_2_1_1,176,165
Scaffold1266-4543_4718,cPa486,0.333333333333333,7,4686,4547,cPa157-cPa199-hybrid_cPa270-cPa381-hybrid_cPa381_cPa390_cPa419_cPa486_cPa62,1_1_3_7_1_10_7,175,139
Scaffold1266-4795_4937,cPa62,0.384615384615385,5,4934,4795,cPa157-unknown_cPa381_cPa390_cPa486_cPa62,1_2_3_2_5,142,139
Scaffold1266-802_904,cPa356,0.8125,3,901,829,cPa356_cPa356-cPa193-hybrid_cPa356-unknown,13_1_2,102,72
Scaffold1269-1189_1291,cPa419,1,1,1285,1205,cPa419,5,102,80
Scaffold1269-1889_1991,cPa419,1,1,1988,1890,cPa419,7,102,98
Scaffold1269-2167_2269,cPa419,1,1,2259,2217,cPa419,3,102,42
Scaffold1269-3026_3242,cPa419,1,1,3201,3025,cPa419,41,216,176
Scaffold1269-3588_3692,cPa419,1,1,3690,3638,cPa419,5,104,52
Scaffold1269-3960_4062,cPa419,1,1,4039,3990,cPa419,5,102,49
Scaffold1274-1759_1861,cPa425,1,1,1861,1804,cPa425,5,102,57
Scaffold1274-2486_2588,cPa425,1,1,2536,2536,cPa425,1,102,0
Scaffold1274-960_1062,cPa425,0.928571428571429,2,1017,975,cPa205-cPa469-hybrid_cPa425,1_13,102,42
Scaffold1275-2228_2330,cPa356_cPa428,0.5,2,2285,2275,cPa356_cPa428,4_4,102,10
Scaffold1276-1413_1540,cPa182-MLV_Xmv43-hybrid,0.571428571428571,2,1488,1454,cPa182-MLV_Xmv43-hybrid_cPa61,4_3,127,34
Scaffold1276-3053_3155,cPa182-unknown,1,1,3103,3103,cPa182-unknown,1,102,0
Scaffold1277-1680_1782,cPa205,0.5,3,1765,1682,cPa205_cPa419_cPa61,5_1_4,102,83
Scaffold1277-1891_1993,cPa61,0.535714285714286,4,1957,1921,cPa205_cPa419_cPa449-cPa163-hybrid_cPa61,21_4_1_30,102,36
Scaffold1277-3391_3493,cPa61,0.8,2,3480,3401,cPa205_cPa61,2_8,102,79
Scaffold1277-4200_4302,cPa205,0.588235294117647,4,4301,4202,cPa205_cPa419_cPa61_cPa61-cPa205-hybrid,20_2_11_1,102,99
Scaffold1277-4976_5078,cPa61,0.6,2,5075,4990,cPa205_cPa61,2_3,102,85
Scaffold1278-2827_2929,cPa75,1,1,2877,2877,cPa75,1,102,0
Scaffold1279-1684_2091,cPa379-unknown,0.497584541062802,13,2039,1683,cPa228-cPa168-hybrid_cPa228-cPa356-hybrid_cPa228-cPa510-hybrid_cPa228-cPa530-hybrid_cPa228-unknown_cPa379-cPa199-hybrid_cPa379-cPa510-hybrid_cPa379-unknown_cPa419_cPa449-cPa168-hybrid_cPa449-cPa199-hybrid_cPa449-unknown_cPa472-cPa356-hybrid,6_5_3_1_23_1_1_103_1_4_1_57_1,407,356
Scaffold128-10245_10361,cPa428,0.545454545454545,2,10316,10260,cPa356_cPa428,5_6,116,56
Scaffold128-10386_10544,cPa428,0.555555555555556,2,10492,10406,cPa356_cPa428,4_5,158,86
Scaffold128-10669_10795,cPa356_cPa428,0.5,2,10792,10716,cPa356_cPa428,3_3,126,76
Scaffold128-11412_11514,cPa419,0.666666666666667,2,11462,11445,cPa419_cPa419-unknown,2_1,102,17
Scaffold128-14669_14795,cPa425,1,1,14757,14702,cPa425,11,126,55
Scaffold128-1470_1572,cPa356,0.666666666666667,2,1541,1520,cPa356_cPa428,4_2,102,21
Scaffold128-1908_2031,cPa428,0.545454545454545,2,2026,1958,cPa356_cPa428,5_6,123,68
Scaffold128-2063_2165,cPa356,0.571428571428571,2,2162,2062,cPa356_cPa428,4_3,102,100
Scaffold128-21124_21226,rRVRV_JQ303225-cPa61-hybrid,1,1,21174,21174,rRVRV_JQ303225-cPa61-hybrid,1,102,0
Scaffold128-22128_22246,cPa61,0.964285714285714,2,22197,22178,cPa61_cPa61-cPa205-hybrid,27_1,118,19
Scaffold128-2266_2468,cPa356_cPa428,0.5,2,2423,2270,cPa356_cPa428,28_28,202,153
Scaffold128-23610_23878,cPa223-unknown,0.459459459459459,14,23826,23620,cPa223_cPa223-cPa16-hybrid_cPa223-cPa205-hybrid_cPa223-cPa363-hybrid_cPa223-cPa61-hybrid_cPa223-unknown_cPa327_cPa327-cPa205-hybrid_cPa327-cPa61-hybrid_cPa327-unknown_cPa424-cPa16-hybrid_cPa424-cPa363-hybrid_cPa424-unknown_cPa446-cPa16-hybrid,1_4_1_1_2_17_1_1_1_1_1_2_3_1,268,206
Scaffold128-2625_2727,cPa356,0.555555555555556,2,2727,2630,cPa356_cPa428,20_16,102,97
Scaffold128-2750_2861,cPa428,0.52,2,2817,2760,cPa356_cPa428,12_13,111,57
Scaffold128-2879_2981,cPa356_cPa428,0.5,2,2972,2902,cPa356_cPa428,5_5,102,70
Scaffold128-3423_3629,cPa356_cPa428,0.5,2,3604,3459,cPa356_cPa428,8_8,206,145
Scaffold128-3872_4189,cPa428,0.576470588235294,2,4164,3888,cPa356_cPa428,36_49,317,276
Scaffold128-540_642,cPa428,0.666666666666667,2,590,555,cPa356_cPa428,1_2,102,35
Scaffold128-848_954,cPa356,0.571428571428571,2,905,883,cPa356_cPa428,4_3,106,22
Scaffold128-8932_9136,cPa356_cPa428,0.5,2,9084,8951,cPa356_cPa428,20_20,204,133
Scaffold128-9285_9387,cPa356,1,1,9335,9284,cPa356,2,102,51
Scaffold128-9939_10180,cPa356_cPa428,0.488721804511278,3,10132,9982,cPa356_cPa356-cPa419-hybrid_cPa428,65_3_65,241,150
Scaffold1280-1270_1375,cPa51-cPa391-hybrid,0.428571428571429,5,1325,1320,cPa435-cPa391-hybrid_cPa435-cPa475-hybrid_cPa51-cPa168-hybrid_cPa51-cPa391-hybrid_cPa51-cPa475-hybrid,1_1_1_3_1,105,5
Scaffold1284-1556_1704,cPa356,0.512820512820513,2,1704,1556,cPa356_cPa428,40_38,148,148
Scaffold1284-2334_2492,cPa428,0.568965517241379,2,2486,2351,cPa356_cPa428,25_33,158,135
Scaffold1284-2526_2696,cPa428,0.534391534391534,2,2690,2525,cPa356_cPa428,88_101,170,165
Scaffold1284-3614_3716,cPa428,0.909090909090909,2,3691,3614,cPa356_cPa428,1_10,102,77
Scaffold1284-740_842,cPa428,1,1,814,790,cPa428,2,102,24
Scaffold1284-860_978,cPa356,0.538461538461538,2,978,878,cPa356_cPa428,14_12,118,100
Scaffold1285-4423_4525,cPa419,1,1,4473,4426,cPa419,2,102,47
Scaffold1289-2065_2218,cPa434,0.872727272727273,7,2205,2115,cPa113-cPa247-hybrid_cPa174-cPa118-hybrid_cPa434_cPa75-cPa308-hybrid_PtERV1_AC142352-cPa247-hybrid_PtERV1_AC142352-cPa425-hybrid_PtERV1_AC142352-unknown,1_1_48_1_2_1_1,153,90
Scaffold1289-3392_4083,cPa356,0.409433962264151,44,4083,3393,BLV_NC001414-cPa542-hybrid_cPa113-cPa566-hybrid_cPa130_cPa130-cPa14-hybrid_cPa130-cPa247-hybrid_cPa130-cPa392-hybrid_cPa130-cPa419-hybrid_cPa130-cPa478-hybrid_cPa130-cPa566-hybrid_cPa130-cPa67-hybrid_cPa130-unknown_cPa14_cPa264-cPa566-hybrid_cPa339-cPa14-hybrid_cPa356_cPa356-unknown_cPa392-cPa566-hybrid_cPa392-HERV-I_repbase_HERVI_LTR10B-hybrid_cPa402-cPa566-hybrid_cPa419_cPa428-cPa478-hybrid_cPa434_cPa447_cPa447-cPa118-hybrid_cPa447-cPa247-hybrid_cPa447-cPa478-hybrid_cPa447-cPa566-hybrid_cPa447-HERV-I_repbase_HERVI_LTR10B-hybrid_cPa447-unknown_cPa478_cPa511_cPa575_HERV-F_repbase_HERVFH19I_LTR19A-cPa392-hybrid_HERV-I_repbase_HERVI_LTR10B_HERV-I_repbase_HERVI_LTR10B-cPa118-hybrid_HERV-I_repbase_HERVI_LTR10B-cPa478-hybrid_HERV-I_repbase_HERVI_LTR10B-unknown_PtERV1_AC142352-cPa14-hybrid_PtERV1_AC142352-cPa248-hybrid_PtERV1_AC142352-cPa443-hybrid_PtERV1_AC142352-cPa447-hybrid_PtERV1_AC142352-cPa478-hybrid_PtERV1_AC142352-cPa566-hybrid_PtERV1_AC142352-HERV-I_repbase_HERVI_LTR10B-hybrid,1_1_3_1_1_1_1_2_1_1_1_4_1_1_217_1_2_1_2_6_1_215_9_1_1_6_6_3_4_1_1_1_1_6_1_1_1_1_1_1_2_9_7_1,691,690
Scaffold129-4088_4190,cPa224,1,1,4138,4138,cPa224,1,102,0
Scaffold129-8101_8203,cPa356-cPa4-hybrid,1,1,8151,8151,cPa356-cPa4-hybrid,1,102,0
Scaffold129-8541_8643,cPa4,1,1,8601,8544,cPa4,8,102,57
Scaffold1295-4547_4765,cPa425_HERV-I_repbase_HERVI_LTR10B-cPa425-hybrid,0.157894736842105,12,4713,4597,cPa247_cPa424-cPa247-hybrid_cPa425_cPa425-cPa194-hybrid_cPa449-cPa247-hybrid_cPa449-cPa425-hybrid_cPa459-cPa200-hybrid_cPa505_HERV-I_repbase_HERVI_LTR10B-cPa109-hybrid_HERV-I_repbase_HERVI_LTR10B-cPa425-hybrid_HERV-I_repbase_HERVI_LTR10B-FeFV_NC001871-hybrid_HERV-I_repbase_HERVI_LTR10B-unknown,1_1_3_1_1_2_1_2_2_3_1_1,218,116
Scaffold1297-5151_5267,cPa356,0.52,2,5234,5150,cPa356_cPa428,13_12,116,84
Scaffold1297-5282_5384,cPa428,0.642857142857143,2,5378,5319,cPa356_cPa428,5_9,102,59
Scaffold1298-3008_3110,cPa419,1,1,3058,3023,cPa419,2,102,35
Scaffold1298-3172_3274,cPa394-EIAV_NC001450-hybrid_cPa419,0.5,2,3222,3222,cPa394-EIAV_NC001450-hybrid_cPa419,1_1,102,0
Scaffold1298-3542_3777,cPa62-CAEV_NC001463-hybrid,0.461538461538462,8,3769,3592,cPa363_cPa363-CAEV_NC001463-hybrid_cPa394-CAEV_NC001463-hybrid_cPa419_cPa62_cPa62-CAEV_NC001463-hybrid_cPa62-cPa395-hybrid_cPa62-cPa438-hybrid,1_2_1_7_1_12_1_1,235,177
Scaffold1298-5079_5181,cPa118-cPa50-hybrid,1,1,5129,5129,cPa118-cPa50-hybrid,1,102,0
Scaffold1299-3145_3247,cPa246_cPa339-cPa549-hybrid_cPa339-cPa74-hybrid_cPa339-unknown_cPa447-cPa158-hybrid_cPa447-cPa549-hybrid,0.166666666666667,6,3243,3195,cPa246_cPa339-cPa549-hybrid_cPa339-cPa74-hybrid_cPa339-unknown_cPa447-cPa158-hybrid_cPa447-cPa549-hybrid,1_1_1_1_1_1,102,48
Scaffold1299-3916_4018,cPa163-cPa74-hybrid_HTLV2_M10060-cPa74-hybrid,0.285714285714286,5,4010,3946,cPa163-cPa74-hybrid_cPa339-cPa61-hybrid_cPa447_cPa75_HTLV2_M10060-cPa74-hybrid,2_1_1_1_2,102,64
Scaffold1299-4023_4127,cPa61,0.4,4,4075,4032,cPa163-unknown_cPa339-cPa523-hybrid_cPa61_HTLV2_M10060-unknown,1_1_2_1,104,43
Scaffold1299-4323_4425,cPa61,0.285714285714286,6,4373,4354,cPa447-cPa61-hybrid_cPa61_cPa75_cPa75-cPa74-hybrid_HTLV2_M10060-cPa523-hybrid_HTLV2_M10060-cPa61-hybrid,1_2_1_1_1_1,102,19
Scaffold1299-4946_5141,cPa75-cPa74-hybrid_cPa75-unknown,0.19047619047619,11,5140,4996,cPa138-cPa74-hybrid_cPa138-Xen1_AJ506107-hybrid_cPa247-cPa447-hybrid_cPa339-cPa2-hybrid_cPa339-cPa523-hybrid_cPa447-cPa523-hybrid_cPa523_cPa75-cPa158-hybrid_cPa75-cPa549-hybrid_cPa75-cPa74-hybrid_cPa75-unknown,2_1_1_1_1_2_3_1_1_4_4,195,144
Scaffold1299-977_1079,cPa419,0.5,3,1027,1022,cPa106_cPa201-cPa523-hybrid_cPa419,1_1_2,102,5
Scaffold130-15109_15304,cPa270_cPa270-cPa450-hybrid_cPa566_WDSV_NC001867,0.25,4,15252,15146,cPa270_cPa270-cPa450-hybrid_cPa566_WDSV_NC001867,1_1_1_1,195,106
Scaffold130-17376_17546,cPa75,0.727272727272727,7,17537,17408,cPa254-PERV_AJ293656-hybrid_cPa62_cPa75_MoMLV_J02255-cPa75-hybrid_MoMLV_J02255-HERV-W_repbase_HERV17_LTR17-hybrid_MoMLV_J02255-PERV_AJ293656-hybrid_PERV_AJ293656-cPa71-hybrid,1_1_16_1_1_1_1,170,129
Scaffold130-19087_19504,cPa75,0.514285714285714,12,19452,19089,cPa157-cPa75-hybrid_cPa260_cPa260-HERV-W_repbase_HERV17_LTR17-hybrid_cPa293_cPa62-cPa176-hybrid_cPa62-cPa260-hybrid_cPa62-cPa500-hybrid_cPa62-cPa75-hybrid_cPa62-HERV-ADP_repbase_HERVP71A_I_LTR71A-hybrid_cPa62-unknown_cPa75_cPa75-unknown,1_1_1_4_4_1_1_12_2_38_72_3,417,363
Scaffold1304-2481_2627,cPa419,1,1,2624,2509,cPa419,22,146,115
Scaffold1305-1296_1398,cPa428,0.526315789473684,2,1384,1297,cPa356_cPa428,9_10,102,87
Scaffold1305-2500_2602,cPa356,0.571428571428571,2,2550,2499,cPa356_cPa428,4_3,102,51
Scaffold1307-3687_3789,cPa456-cPa363-hybrid,0.5,4,3772,3737,cPa456_cPa456-cPa363-hybrid_cPa563-cPa363-hybrid_cPa587-cPa363-hybrid,1_4_1_2,102,35
Scaffold1307-4669_4771,cPa456_cPa456-cPa363-hybrid,0.5,2,4723,4719,cPa456_cPa456-cPa363-hybrid,1_1,102,4
Scaffold131-10149_10251,cPa428,0.586206896551724,2,10239,10154,cPa356_cPa428,12_17,102,85
Scaffold131-10773_10985,cPa428,0.75,2,10970,10823,cPa356_cPa428,3_9,212,147
Scaffold131-12385_12487,cPa356,1,1,12435,12435,cPa356,1,102,0
Scaffold131-1274_1392,cPa428,0.625,2,1354,1279,cPa356_cPa428,15_25,118,75
Scaffold131-1501_1603,cPa428,0.538461538461538,2,1585,1503,cPa356_cPa428,12_14,102,82
Scaffold131-363_508,cPa428,0.622641509433962,2,501,411,cPa356_cPa428,20_33,145,90
Scaffold131-4514_4616,cPa428,1,1,4578,4564,cPa428,2,102,14
Scaffold131-4721_4823,cPa356_cPa428,0.5,2,4792,4736,cPa356_cPa428,3_3,102,56
Scaffold131-5091_5269,cPa356_cPa428,0.5,2,5259,5109,cPa356_cPa428,11_11,178,150
Scaffold131-5385_5501,cPa428,0.564102564102564,2,5491,5411,cPa356_cPa428,17_22,116,80
Scaffold131-5886_5988,cPa356,0.6,2,5936,5885,cPa356_cPa428,3_2,102,51
Scaffold131-6466_6568,cPa428,1,1,6516,6490,cPa428,2,102,26
Scaffold131-677_793,cPa428,0.666666666666667,2,793,727,cPa356_cPa428,2_4,116,66
Scaffold1310-2889_3052,cPa106,0.229411764705882,24,3052,2894,cPa106_cPa106-cPa109-hybrid_cPa106-cPa201-hybrid_cPa109_cPa152_cPa152-cPa419-hybrid_cPa201_cPa201-cPa106-hybrid_cPa201-cPa109-hybrid_cPa356_cPa363-cPa109-hybrid_cPa391-cPa152-hybrid_cPa402-cPa391-hybrid_cPa402-cPa413-hybrid_cPa402-cPa419-hybrid_cPa402-cPa447-hybrid_cPa402-unknown_cPa419_cPa456-cPa109-hybrid_cPa456-cPa419-hybrid_cPa456-cPa505-hybrid_cPa505_cPa505-cPa109-hybrid_cPa75,39_1_1_20_28_1_24_1_1_1_1_1_2_1_1_1_1_4_1_3_1_34_1_1,163,158
Scaffold1310-3380_4200,cPa391,0.24,58,4194,3392,BIV_NC001413-cPa447-hybrid_cPa106-cPa293-hybrid_cPa106-cPa391-hybrid_cPa106-cPa447-hybrid_cPa106-cPa478-hybrid_cPa106-unknown_cPa15-cPa391-hybrid_cPa152-cPa391-hybrid_cPa152-unknown_cPa174-cPa391-hybrid_cPa201-cPa293-hybrid_cPa201-cPa391-hybrid_cPa201-cPa419-hybrid_cPa201-cPa426-hybrid_cPa201-cPa447-hybrid_cPa201-cPa478-hybrid_cPa201-unknown_cPa254-cPa391-hybrid_cPa293_cPa293-cPa356-hybrid_cPa308-cPa293-hybrid_cPa308-cPa428-hybrid_cPa308-unknown_cPa356_cPa356-cPa109-hybrid_cPa356-cPa293-hybrid_cPa356-cPa391-hybrid_cPa356-cPa426-hybrid_cPa391_cPa391-cPa356-hybrid_cPa394-cPa391-hybrid_cPa402-cPa293-hybrid_cPa402-cPa391-hybrid_cPa402-unknown_cPa419_cPa426_cPa426-cPa356-hybrid_cPa426-cPa447-hybrid_cPa434-cPa293-hybrid_cPa434-cPa391-hybrid_cPa434-cPa426-hybrid_cPa447-cPa109-hybrid_cPa447-cPa293-hybrid_cPa447-cPa426-hybrid_cPa447-cPa75-hybrid_cPa456-cPa293-hybrid_cPa456-unknown_cPa478_cPa478-cPa391-hybrid_cPa478-cPa447-hybrid_cPa505-cPa293-hybrid_cPa505-cPa419-hybrid_cPa505-cPa447-hybrid_cPa505-unknown_cPa75_MDEV_AF053745-cPa293-hybrid_SIV_NC001870-cPa109-hybrid_SMRV_NC001514-cPa391-hybrid,1_3_1_2_2_5_1_1_3_1_5_5_1_2_1_1_8_1_29_1_3_1_1_8_1_6_3_1_60_1_1_6_2_11_10_9_1_2_8_11_1_1_1_1_1_1_6_6_1_1_1_1_1_2_2_1_1_1,820,802
Scaffold1310-4646_4748,cPa356,0.666666666666667,2,4732,4668,cPa356_cPa447,6_3,102,64
Scaffold1310-4783_5177,cPa447,0.468599033816425,17,5177,4801,cPa224-cPa293-hybrid_cPa356_cPa356-cPa293-hybrid_cPa356-cPa391-hybrid_cPa356-cPa447-hybrid_cPa356-cPa478-hybrid_cPa356-unknown_cPa434-cPa293-hybrid_cPa434-cPa391-hybrid_cPa434-cPa447-hybrid_cPa434-cPa478-hybrid_cPa434-MDEV_AF053745-hybrid_cPa434-unknown_cPa447_cPa447-cPa293-hybrid_cPa447-cPa356-hybrid_cPa447-cPa391-hybrid,1_85_1_1_2_2_1_3_2_3_2_1_1_97_1_3_1,394,376
Scaffold1310-5321_5423,cPa356,0.642857142857143,6,5415,5320,cPa356_cPa356-unknown_cPa434-cPa356-hybrid_cPa434-unknown_cPa447_cPa447-cPa356-hybrid,18_1_1_5_2_1,102,95
Scaffold1311-2387_2489,cPa419,1,1,2469,2420,cPa419,12,102,49
Scaffold1311-2512_2614,cPa419,1,1,2562,2554,cPa419,2,102,8
Scaffold1311-3030_3132,cPa419,1,1,3080,3041,cPa419,2,102,39
Scaffold1311-3511_3613,cPa419,1,1,3561,3561,cPa419,1,102,0
Scaffold1315-1409_1536,cPa434,1,1,1531,1459,cPa434,15,127,72
Scaffold1315-1728_1888,cPa434,0.666666666666667,2,1853,1778,cPa356_cPa434,1_2,160,75
Scaffold1316-600_724,cPa390-unknown,0.205128205128205,13,716,606,cPa339-cPa205-hybrid_cPa339-cPa434-hybrid_cPa339-unknown_cPa390_cPa390-cPa434-hybrid_cPa390-unknown_cPa447_cPa447-cPa434-hybrid_cPa447-unknown_cPa566-cPa205-hybrid_cPa566-cPa434-hybrid_cPa566-unknown_cPa62-cPa434-hybrid,2_1_4_6_6_8_1_2_5_1_1_1_1,124,110
Scaffold1317-1130_1593,cPa428,0.56,2,1577,1180,cPa356_cPa428,33_42,463,397
Scaffold1317-2109_2211,cPa428,0.571428571428571,2,2181,2133,cPa356_cPa428,12_16,102,48
Scaffold132-1180_1355,cPa428,0.548387096774194,3,1308,1206,cPa356_cPa428_cPa428-unknown,13_17_1,175,102
Scaffold132-1441_1543,cPa428,0.8,2,1529,1491,cPa356_cPa428,1_4,102,38
Scaffold132-15499_15601,cPa428,0.65,2,15563,15525,cPa356_cPa428,7_13,102,38
Scaffold132-16623_16725,cPa428,0.8,2,16695,16656,cPa356_cPa428,1_4,102,39
Scaffold132-17244_17346,cPa356,0.625,2,17298,17252,cPa356_cPa428,5_3,102,46
Scaffold132-17848_17950,cPa428,0.576923076923077,2,17950,17851,cPa356_cPa428,11_15,102,99
Scaffold132-19846_19948,cPa428,1,1,19896,19896,cPa428,1,102,0
Scaffold132-20785_20930,cPa428,0.666666666666667,2,20878,20835,cPa356_cPa428,2_4,145,43
Scaffold132-21031_21160,cPa428,0.875,2,21149,21067,cPa356_cPa428,1_7,129,82
Scaffold132-21203_21305,cPa428,1,1,21283,21246,cPa428,4,102,37
Scaffold132-21393_21495,cPa428,0.75,2,21465,21398,cPa356_cPa428,2_6,102,67
Scaffold132-21942_22044,cPa428,1,1,21992,21992,cPa428,1,102,0
Scaffold132-22537_22639,cPa356,0.8,2,22590,22587,cPa356_cPa428,4_1,102,3
Scaffold132-23169_23363,cPa428,0.7,2,23315,23219,cPa356_cPa428,3_7,194,96
Scaffold132-23712_23826,cPa428,1,1,23774,23762,cPa428,2,114,12
Scaffold132-23967_24069,cPa428,0.75,2,24038,24005,cPa356_cPa428,2_6,102,33
Scaffold132-24166_24268,cPa428,0.555555555555556,2,24256,24199,cPa356_cPa428,4_5,102,57
Scaffold132-25403_25505,cPa428,0.727272727272727,2,25455,25415,cPa356_cPa428,3_8,102,40
Scaffold132-8963_9065,cPa428,0.636363636363636,2,9014,8974,cPa356_cPa428,4_7,102,40
Scaffold133-1459_1561,cPa428,1,1,1509,1509,cPa428,1,102,0
Scaffold133-15423_15525,cPa428,0.666666666666667,2,15504,15473,cPa356_cPa428,1_2,102,31
Scaffold133-15564_15666,cPa428,0.515151515151515,2,15658,15571,cPa356_cPa428,16_17,102,87
Scaffold133-1627_1729,cPa356,1,1,1677,1677,cPa356,1,102,0
Scaffold133-16411_16608,cPa428,0.590909090909091,2,16597,16413,cPa356_cPa428,27_39,197,184
Scaffold133-17209_17311,cPa428,0.588235294117647,2,17306,17223,cPa356_cPa428,7_10,102,83
Scaffold133-1934_2131,cPa356_cPa428,0.5,2,2079,1949,cPa356_cPa428,4_4,197,130
Scaffold133-3371_3569,cPa428,0.6,2,3551,3398,cPa356_cPa428,2_3,198,153
Scaffold133-3597_3699,cPa356-unknown,1,1,3647,3647,cPa356-unknown,1,102,0
Scaffold133-4738_4840,cPa428,1,1,4835,4788,cPa428,2,102,47
Scaffold133-5623_5725,cPa356_cPa428,0.5,2,5673,5673,cPa356_cPa428,1_1,102,0
Scaffold133-599_701,cPa428,1,1,649,649,cPa428,1,102,0
Scaffold133-6219_6321,cPa428,1,1,6273,6269,cPa428,2,102,4
Scaffold133-6745_6888,cPa356_cPa428,0.5,2,6836,6775,cPa356_cPa428,3_3,143,61
Scaffold133-7018_7120,cPa428,1,1,7068,7068,cPa428,1,102,0
Scaffold133-7322_7424,cPa428,0.666666666666667,2,7420,7372,cPa356_cPa428,1_2,102,48
Scaffold133-7850_7952,cPa428,1,1,7948,7900,cPa428,2,102,48
Scaffold133-841_1042,cPa356_cPa428,0.5,2,990,891,cPa356_cPa428,3_3,201,99
Scaffold133-8696_8798,cPa428,0.666666666666667,2,8761,8746,cPa356_cPa428,1_2,102,15
Scaffold133-9668_9780,cPa356,0.666666666666667,2,9749,9718,cPa356_cPa428,2_1,112,31
Scaffold1333-3400_3513,cPa419,1,1,3461,3439,cPa419,14,113,22
Scaffold1337-3570_3712,cPa363_cPa549,0.5,2,3660,3620,cPa363_cPa549,1_1,142,40
Scaffold1337-4452_4554,HERV-XA34_repbase_HERVFH21I_LTR21A,0.666666666666667,3,4502,4459,cPa482-HERV-XA34_repbase_HERVFH21I_LTR21A-hybrid_HERV-XA34_repbase_HERVFH21I_LTR21A_HML6_repbase_HERVK3I_LTR3,1_4_1,102,43
Scaffold134-1438_1540,cPa356_cPa428,0.5,2,1538,1458,cPa356_cPa428,11_11,102,80
Scaffold134-1684_1786,cPa356,0.666666666666667,2,1752,1685,cPa356_cPa428,2_1,102,67
Scaffold134-1819_1977,cPa356,0.52,2,1961,1826,cPa356_cPa428,13_12,158,135
Scaffold134-18478_18580,cPa428,0.6,2,18528,18495,cPa356_cPa428,2_3,102,33
Scaffold134-18737_18839,cPa428,1,1,18787,18787,cPa428,1,102,0
Scaffold134-19668_19770,cPa356_cPa428,0.5,2,19718,19682,cPa356_cPa428,1_1,102,36
Scaffold134-19966_20068,cPa428,1,1,20016,20016,cPa428,1,102,0
Scaffold134-20646_20748,cPa428,0.75,2,20712,20676,cPa356_cPa428,1_3,102,36
Scaffold134-20973_21198,cPa428,0.571428571428571,2,21177,20975,cPa356_cPa428,18_24,225,202
Scaffold134-2257_2399,cPa428,0.583333333333333,2,2347,2270,cPa356_cPa428,5_7,142,77
Scaffold134-3605_3707,cPa356_cPa428,0.5,2,3659,3655,cPa356_cPa428,1_1,102,4
Scaffold134-6316_6418,cPa428,0.6,2,6388,6366,cPa356_cPa428,2_3,102,22
Scaffold134-9851_9953,cPa428,1,1,9901,9901,cPa428,1,102,0
Scaffold1344-1750_2073,cPa546,0.244897959183673,19,2038,1762,cPa130_cPa257_cPa257-cPa130-hybrid_cPa285_cPa456-BaEV_D10032-hybrid_cPa456-cPa515-hybrid_cPa456-cPa60-hybrid_cPa546_cPa546-cPa104-hybrid_cPa546-cPa130-hybrid_cPa546-cPa257-hybrid_cPa555_cPa555-cPa104-hybrid_cPa555-cPa130-hybrid_cPa555-cPa257-hybrid_cPa60_cPa60-cPa130-hybrid_cPa60-cPa257-hybrid_cPa60-cPa546-hybrid,43_13_1_5_1_1_1_48_1_3_7_8_2_1_1_34_19_6_1,323,276
Scaffold1344-3598_3766,cPa456-cPa101-hybrid,0.342465753424658,12,3745,3597,cPa138-cPa130-hybrid_cPa255-cPa546-hybrid_cPa332-cPa101-hybrid_cPa339-cPa130-hybrid_cPa456_cPa456-cPa101-hybrid_cPa456-cPa130-hybrid_cPa456-cPa257-hybrid_cPa456-cPa285-hybrid_cPa456-cPa546-hybrid_cPa456-cPa555-hybrid_cPa456-unknown,2_1_2_2_1_25_21_12_1_1_1_4,168,148
Scaffold1348-1283_1385,cPa285_cPa381,0.5,2,1333,1317,cPa285_cPa381,1_1,102,16
Scaffold1348-976_1115,cPa75,0.571428571428571,3,1112,979,cPa227_cPa285_cPa75,1_2_4,139,133
Scaffold135-10927_11029,cPa428,0.857142857142857,2,11002,10930,cPa356_cPa428,1_6,102,72
Scaffold135-1577_1683,cPa428,0.636363636363636,2,1661,1590,cPa356_cPa428,4_7,106,71
Scaffold135-23084_23186,cPa356,0.666666666666667,2,23172,23134,cPa356_cPa428,2_1,102,38
Scaffold135-2381_2483,cPa428,1,1,2431,2422,cPa428,2,102,9
Scaffold135-24473_24575,cPa356_cPa356-cPa428-hybrid,0.5,2,24523,24523,cPa356_cPa356-cPa428-hybrid,1_1,102,0
Scaffold135-31121_31223,cPa428,1,1,31171,31171,cPa428,1,102,0
Scaffold135-31340_31442,cPa428,1,1,31393,31367,cPa428,3,102,26
Scaffold135-50963_51065,cPa428,1,1,51013,51013,cPa428,1,102,0
Scaffold135-52626_52728,cPa428,0.56,2,52723,52667,cPa356_cPa428,11_14,102,56
Scaffold135-53701_53803,cPa428,1,1,53751,53721,cPa428,3,102,30
Scaffold135-5993_6095,cPa428,1,1,6043,6043,cPa428,1,102,0
Scaffold135-7870_7972,cPa428,1,1,7920,7920,cPa428,1,102,0
Scaffold135-8280_8386,cPa428,0.8,2,8364,8317,cPa356_cPa428,1_4,106,47
Scaffold135-8555_8657,cPa428,0.666666666666667,2,8605,8576,cPa356_cPa428,1_2,102,29
Scaffold135-9631_9733,cPa428,0.6,2,9685,9670,cPa356_cPa428,2_3,102,15
Scaffold1350-4401_4503,cPa381,0.351351351351351,8,4495,4400,cPa381_cPa381-cPa75-hybrid_cPa381-unknown_cPa398_cPa410_cPa75_cPa75-cPa381-hybrid_cPa75-unknown,13_2_5_2_2_9_1_3,102,95
Scaffold1355-2084_2186,cPa419,1,1,2134,2134,cPa419,1,102,0
Scaffold1355-4673_4775,cPa419,1,1,4761,4676,cPa419,4,102,85
Scaffold1356-1141_1314,cPa428,0.560606060606061,2,1306,1162,cPa356_cPa428,29_37,173,144
Scaffold1356-1373_1475,cPa428,0.625,2,1461,1423,cPa356_cPa428,3_5,102,38
Scaffold1356-1563_1665,cPa356,0.542372881355932,2,1617,1562,cPa356_cPa428,32_27,102,55
Scaffold1356-2286_2485,cPa428,0.542857142857143,2,2479,2304,cPa356_cPa428,16_19,199,175
Scaffold1356-2516_2618,cPa356,0.615384615384615,2,2593,2521,cPa356_cPa428,8_5,102,72
Scaffold1356-2641_2743,cPa428,1,1,2691,2691,cPa428,1,102,0
Scaffold1356-3469_3575,cPa356_cPa428,0.5,2,3523,3469,cPa356_cPa428,30_30,106,54
Scaffold1356-731_833,cPa356,0.7,2,828,752,cPa356_cPa428,7_3,102,76
Scaffold1356-923_1025,cPa428,0.611111111111111,2,995,929,cPa356_cPa428,7_11,102,66
Scaffold136-11084_11186,cPa75,1,1,11134,11134,cPa75,1,102,0
Scaffold136-131643_131745,cPa75,1,1,131693,131693,cPa75,1,102,0
Scaffold136-132418_132520,cPa75,1,1,132468,132468,cPa75,1,102,0
Scaffold136-141003_141165,cPa75,1,1,141113,141053,cPa75,3,162,60
Scaffold136-146156_146258,cPa75,1,1,146206,146206,cPa75,1,102,0
Scaffold136-153475_153577,cPa358-unknown,0.8,2,153566,153521,cPa358-cPa247-hybrid_cPa358-unknown,1_4,102,45
Scaffold136-155081_155183,cPa358-cPa75-hybrid,0.875,2,155143,155110,cPa358-cPa75-hybrid_cPa75,7_1,102,33
Scaffold136-159715_159829,cPa260,1,1,159783,159765,cPa260,3,114,18
Scaffold136-160008_160174,cPa260,0.714285714285714,2,160166,160029,cPa260_cPa75-cPa260-hybrid,5_2,166,137
Scaffold136-188037_188230,cPa75,1,1,188178,188087,cPa75,3,193,91
Scaffold136-188547_188709,cPa75,1,1,188657,188597,cPa75,4,162,60
Scaffold136-188739_188841,cPa75,1,1,188789,188789,cPa75,1,102,0
Scaffold136-188876_188978,cPa75,1,1,188926,188926,cPa75,1,102,0
Scaffold136-251595_251697,HERV-XA34_repbase_HERVFH21I_LTR21A,1,1,251645,251596,HERV-XA34_repbase_HERVFH21I_LTR21A,3,102,49
Scaffold136-251823_251925,cPa394-unknown_HERV-XA34_repbase_HERVFH21I_LTR21A-cPa62-hybrid,0.5,2,251889,251873,cPa394-unknown_HERV-XA34_repbase_HERVFH21I_LTR21A-cPa62-hybrid,1_1,102,16
Scaffold136-252017_252119,HERV-XA34_repbase_HERVFH21I_LTR21A,0.4,4,252085,252053,cPa360_cPa62_HERV-XA34_repbase_HERVFH21I_LTR21A_HERV-XA34_repbase_HERVFH21I_LTR21A-cPa62-hybrid,1_1_2_1,102,32
Scaffold136-252669_252820,cPa62,0.594594594594595,11,252804,252670,cPa254-cPa447-hybrid_cPa254-cPa62-hybrid_cPa285-cPa360-hybrid_cPa285-cPa62-hybrid_cPa293-cPa360-hybrid_cPa447-cPa293-hybrid_cPa447-cPa62-hybrid_cPa62_cPa62-cPa394-hybrid_HERV-XA34_repbase_HERVFH21I_LTR21A-cPa293-hybrid_HIV1_NC001802,1_1_1_1_1_1_1_22_1_1_6,151,134
Scaffold136-257801_257903,cPa290-unknown,1,1,257851,257851,cPa290-unknown,1,102,0
Scaffold136-260608_260710,cPa119,1,1,260658,260658,cPa119,1,102,0
Scaffold136-261492_261594,cPa581,1,1,261592,261507,cPa581,4,102,85
Scaffold136-264045_264154,cPa62,0.6,3,264104,264095,Cer1_U15406_cPa545_cPa62,1_1_3,109,9
Scaffold136-294903_295005,cPa358,0.666666666666667,2,294956,294944,cPa164-cPa75-hybrid_cPa358,1_2,102,12
Scaffold136-296308_296410,cPa164,1,1,296358,296358,cPa164,1,102,0
Scaffold1365-537_639,cPa356,1,1,587,587,cPa356,1,102,0
Scaffold1366-2886_2988,cPa356_cPa428,0.5,2,2936,2936,cPa356_cPa428,1_1,102,0
Scaffold1366-3003_3105,cPa356_cPa428,0.5,2,3054,3053,cPa356_cPa428,1_1,102,1
Scaffold1368-3449_3551,cPa356_cPa428,0.5,2,3513,3499,cPa356_cPa428,1_1,102,14
Scaffold1374-2716_2818,cPa419,1,1,2814,2766,cPa419,11,102,48
Scaffold1378-2180_2389,cPa419,1,1,2388,2215,cPa419,14,209,173
Scaffold1378-2755_2919,cPa419,1,1,2910,2790,cPa419,22,164,120
Scaffold1378-2934_3036,cPa419,1,1,3032,2951,cPa419,10,102,81
Scaffold1378-3416_3518,cPa419,1,1,3466,3424,cPa419,3,102,42
Scaffold1378-4149_4251,cPa419,1,1,4199,4199,cPa419,1,102,0
Scaffold138-2781_2883,cPa75-cPa358-hybrid,1,1,2831,2831,cPa75-cPa358-hybrid,1,102,0
Scaffold138-2909_3204,cPa75,0.642857142857143,4,3152,2926,cPa450-cPa358-hybrid_cPa75_cPa75-cPa358-hybrid_cPa75-unknown,1_9_3_1,295,226
Scaffold138-4786_4888,cPa358-cPa164-hybrid,1,1,4836,4836,cPa358-cPa164-hybrid,1,102,0
Scaffold1381-2368_2470,cPa419,1,1,2418,2418,cPa419,1,102,0
Scaffold1381-356_463,cPa419,1,1,447,406,cPa419,7,107,41
Scaffold1382-2305_2407,cPa428,1,1,2355,2355,cPa428,1,102,0
Scaffold1384-3903_4005,cPa75,1,1,3953,3953,cPa75,1,102,0
Scaffold1388-3393_3495,HERV-W_repbase_HERV17_LTR17-unknown,0.466666666666667,5,3486,3392,cPa241-unknown_cPa95-unknown_HERV-W_repbase_HERV17_LTR17-unknown_S71_repbase_HERVS71_LTR6A-cPa419-hybrid_S71_repbase_HERVS71_LTR6A-unknown,1_3_7_1_3,102,94
Scaffold1388-4190_4292,cPa419,1,1,4251,4240,cPa419,2,102,11
Scaffold1389-622_737,cPa113,0.36,13,725,630,cPa113_cPa199-cPa568-hybrid_cPa323_cPa323-cPa163-hybrid_cPa323-cPa568-hybrid_cPa371-cPa163-hybrid_cPa371-cPa568-hybrid_cPa419_cPa450_cPa542-cPa333-hybrid_cPa553_cPa553-cPa163-hybrid_cPa553-cPa568-hybrid,9_1_1_3_1_1_1_1_3_1_1_1_1,115,95
Scaffold139-2057_2192,cPa62,0.980769230769231,2,2141,2106,cPa254-cPa285-hybrid_cPa62,1_51,135,35
Scaffold1391-3531_3902,cPa395,0.911764705882353,2,3863,3571,cPa395_cPa395-unknown,31_3,371,292
Scaffold1396-3075_3177,cPa356_cPa428,0.5,2,3127,3125,cPa356_cPa428,1_1,102,2
Scaffold1396-4307_4409,cPa428,1,1,4357,4357,cPa428,1,102,0
Scaffold1397-964_1066,cPa419,1,1,1014,1014,cPa419,1,102,0
Scaffold1398-2406_2508,cPa419,1,1,2456,2456,cPa419,1,102,0
Scaffold140-100118_100220,cPa428,0.6,2,100169,100168,cPa356_cPa428,2_3,102,1
Scaffold140-102132_102234,cPa428,0.55,2,102210,102140,cPa356_cPa428,9_11,102,70
Scaffold140-116073_116198,cPa428,0.625,2,116162,116123,cPa356_cPa428,3_5,125,39
Scaffold140-116444_116546,cPa356_cPa428,0.5,2,116501,116494,cPa356_cPa428,1_1,102,7
Scaffold140-116851_116953,cPa356,1,1,116901,116901,cPa356,1,102,0
Scaffold140-117622_117741,cPa428,0.555555555555556,2,117716,117672,cPa356_cPa428,4_5,119,44
Scaffold140-120480_120582,cPa356,0.636363636363636,2,120575,120489,cPa356_cPa428,7_4,102,86
Scaffold140-120586_120688,cPa428,0.625,2,120636,120585,cPa356_cPa428,3_5,102,51
Scaffold140-120824_120926,cPa428,0.571428571428571,2,120913,120874,cPa356_cPa428,3_4,102,39
Scaffold140-122637_122773,cPa356,0.666666666666667,2,122767,122644,cPa356_cPa428,8_4,136,123
Scaffold140-122994_123096,cPa428,0.714285714285714,2,123044,123033,cPa356_cPa428,2_5,102,11
Scaffold140-123442_123558,cPa428,0.51219512195122,2,123553,123441,cPa356_cPa428,40_42,116,112
Scaffold140-124994_125096,cPa356,0.75,2,125062,125044,cPa356_cPa428,3_1,102,18
Scaffold140-125180_125282,cPa428,0.8,2,125246,125202,cPa356_cPa428,1_4,102,44
Scaffold140-125572_125674,cPa428,1,1,125623,125576,cPa428,3,102,47
Scaffold140-127475_127577,cPa428,1,1,127525,127525,cPa428,1,102,0
Scaffold140-128792_128894,cPa356-cPa428-hybrid,1,1,128842,128842,cPa356-cPa428-hybrid,1,102,0
Scaffold140-128960_129062,cPa356,0.8,2,129044,129010,cPa356_cPa428,4_1,102,34
Scaffold140-129577_129713,cPa428,0.636363636363636,2,129661,129583,cPa356_cPa428,8_14,136,78
Scaffold140-130111_130213,cPa428,0.529411764705882,2,130211,130161,cPa356_cPa428,8_9,102,50
Scaffold140-131061_131163,cPa356_cPa428,0.5,2,131111,131111,cPa356_cPa428,1_1,102,0
Scaffold140-131386_131491,cPa428,0.833333333333333,2,131461,131436,cPa356_cPa428,1_5,105,25
Scaffold140-131641_131743,cPa428,1,1,131691,131663,cPa428,2,102,28
Scaffold140-131751_131921,cPa428,1,1,131869,131779,cPa428,3,170,90
Scaffold140-136875_136977,cPa356,1,1,136925,136925,cPa356,1,102,0
Scaffold140-137164_137266,cPa356_cPa428,0.5,2,137214,137214,cPa356_cPa428,1_1,102,0
Scaffold140-137300_137402,cPa428,1,1,137350,137350,cPa428,1,102,0
Scaffold140-137947_138049,cPa428,1,1,137997,137997,cPa428,1,102,0
Scaffold140-141065_141167,cPa428,0.545454545454545,2,141143,141074,cPa356_cPa428,5_6,102,69
Scaffold140-142718_142820,cPa428,0.666666666666667,2,142796,142760,cPa356_cPa428,2_4,102,36
Scaffold140-143151_143253,cPa428,1,1,143201,143201,cPa428,1,102,0
Scaffold140-144488_144590,cPa356,0.666666666666667,2,144538,144532,cPa356_cPa428,2_1,102,6
Scaffold140-145141_145280,cPa428,0.6,2,145240,145152,cPa356_cPa428,6_9,139,88
Scaffold140-145575_145677,cPa428,0.545454545454545,2,145652,145616,cPa356_cPa428,5_6,102,36
Scaffold140-145697_145823,cPa356_cPa428,0.5,2,145793,145699,cPa356_cPa428,9_9,126,94
Scaffold140-145974_146128,cPa428,0.526315789473684,2,146114,145973,cPa356_cPa428,72_80,154,141
Scaffold140-146697_146799,cPa356,0.518518518518518,2,146759,146724,cPa356_cPa428,14_13,102,35
Scaffold140-147144_147246,cPa356,0.51219512195122,2,147214,147148,cPa356_cPa428,21_20,102,66
Scaffold140-152900_153002,cPa356_cPa428,0.5,2,152997,152950,cPa356_cPa428,1_1,102,47
Scaffold140-153200_153302,cPa428,0.545454545454545,2,153254,153213,cPa356_cPa428,15_18,102,41
Scaffold140-153718_153820,cPa356,1,1,153768,153768,cPa356,1,102,0
Scaffold140-154660_154769,cPa428,0.602739726027397,2,154766,154697,cPa356_cPa428,29_44,109,69
Scaffold140-1558_1660,cPa428,1,1,1608,1608,cPa428,1,102,0
Scaffold140-15658_15785,cPa428,0.529411764705882,2,15781,15686,cPa356_cPa428,8_9,127,95
Scaffold140-161146_161331,cPa428,0.53125,2,161279,161160,cPa356_cPa428,15_17,185,119
Scaffold140-161435_161537,cPa428,0.75,2,161485,161477,cPa356_cPa428,1_3,102,8
Scaffold140-161715_161817,cPa428,1,1,161785,161750,cPa428,5,102,35
Scaffold140-162115_162217,cPa428,1,1,162167,162118,cPa428,5,102,49
Scaffold140-171017_171119,cPa428,0.608695652173913,2,171119,171021,cPa356_cPa428,18_28,102,98
Scaffold140-172283_172405,cPa428,0.8,2,172397,172320,cPa356_cPa428,2_8,122,77
Scaffold140-172511_172613,cPa428,0.571428571428571,2,172561,172510,cPa356_cPa428,3_4,102,51
Scaffold140-172816_172918,cPa428,0.6,2,172888,172861,cPa356_cPa428,2_3,102,27
Scaffold140-17418_17520,cPa428,0.666666666666667,2,17468,17456,cPa356_cPa428,1_2,102,12
Scaffold140-174460_174636,cPa428,0.666666666666667,2,174584,174510,cPa356_cPa428,1_2,176,74
Scaffold140-1792_1918,cPa356,0.75,2,1866,1808,cPa356_cPa428,3_1,126,58
Scaffold140-185066_185168,cPa428,1,1,185116,185116,cPa428,1,102,0
Scaffold140-185255_185362,cPa428,0.6,3,185331,185292,cPa356_cPa356-unknown_cPa428,1_1_3,107,39
Scaffold140-185719_185872,cPa428,0.588235294117647,2,185847,185740,cPa356_cPa428,7_10,153,107
Scaffold140-186236_186338,cPa428,0.615384615384615,3,186336,186255,cPa356_cPa428_cPa428-cPa356-hybrid,4_8_1,102,81
Scaffold140-186858_186960,cPa356_cPa428,0.5,2,186922,186908,cPa356_cPa428,1_1,102,14
Scaffold140-1947_2049,cPa428,1,1,1997,1946,cPa428,2,102,51
Scaffold140-194826_194928,cPa356,0.514285714285714,2,194927,194869,cPa356_cPa428,18_17,102,58
Scaffold140-195014_195116,cPa428,0.625,2,195097,195064,cPa356_cPa428,3_5,102,33
Scaffold140-195247_195414,cPa356,0.615384615384615,2,195362,195265,cPa356_cPa428,8_5,167,97
Scaffold140-195537_195649,cPa428,0.551724137931034,2,195597,195546,cPa356_cPa428,26_32,112,51
Scaffold140-195947_196075,cPa428,0.541666666666667,2,196025,195997,cPa356_cPa428,11_13,128,28
Scaffold140-196236_196409,cPa356,0.552631578947368,2,196401,196254,cPa356_cPa428,42_34,173,147
Scaffold140-197985_198087,cPa356,0.571428571428571,2,198047,197993,cPa356_cPa428,4_3,102,54
Scaffold140-198152_198366,cPa428,1,1,198314,198202,cPa428,2,214,112
Scaffold140-198407_198826,cPa356,0.568181818181818,2,198802,198429,cPa356_cPa428,25_19,419,373
Scaffold140-2767_2869,cPa428,0.571428571428571,2,2817,2766,cPa356_cPa428,3_4,102,51
Scaffold140-3388_3490,cPa428,0.526315789473684,2,3469,3387,cPa356_cPa428,9_10,102,82
Scaffold140-50498_50625,cPa356_cPa428,0.5,2,50590,50527,cPa356_cPa428,8_8,127,63
Scaffold140-5111_5258,cPa356_cPa428,0.5,2,5206,5161,cPa356_cPa428,2_2,147,45
Scaffold140-52432_52534,cPa428,1,1,52482,52482,cPa428,1,102,0
Scaffold140-52598_52700,cPa356_cPa428,0.5,2,52679,52648,cPa356_cPa428,2_2,102,31
Scaffold140-54664_54766,cPa428,1,1,54714,54714,cPa428,1,102,0
Scaffold140-98588_98690,cPa428,0.6,2,98653,98593,cPa356_cPa428,4_6,102,60
Scaffold140-98736_98838,cPa356_cPa428,0.5,2,98795,98783,cPa356_cPa428,2_2,102,12
Scaffold140-98932_99058,cPa356_cPa428,0.5,2,99011,98972,cPa356_cPa428,7_7,126,39
Scaffold1402-1550_1698,cPa174,0.222222222222222,17,1650,1599,cPa174_cPa174-cPa392-hybrid_cPa174-cPa425-hybrid_cPa254_cPa254-cPa174-hybrid_cPa254-cPa392-hybrid_cPa254-cPa425-hybrid_cPa254-cPa434-hybrid_cPa254-cPa443-hybrid_cPa254-cPa566-hybrid_cPa254-unknown_cPa356-cPa174-hybrid_cPa392_cPa392-unknown_cPa425_cPa434_cPa434-cPa425-hybrid,6_1_1_1_1_1_1_1_1_2_1_1_3_1_3_1_1,148,51
Scaffold1402-3623_3725,cPa356_cPa434,0.5,2,3725,3673,cPa356_cPa434,3_3,102,52
Scaffold1405-411_513,cPa419,1,1,461,461,cPa419,1,102,0
Scaffold1407-1181_1283,cPa419,1,1,1240,1205,cPa419,4,102,35
Scaffold1407-898_1057,cPa419,1,1,1005,928,cPa419,3,159,77
Scaffold141-103703_103805,cPa419,1,1,103778,103707,cPa419,4,102,71
Scaffold141-10457_10559,cPa419,1,1,10557,10507,cPa419,3,102,50
Scaffold141-105593_105695,cPa419,1,1,105643,105613,cPa419,5,102,30
Scaffold141-107265_107367,cPa419,1,1,107315,107312,cPa419,2,102,3
Scaffold141-110650_110752,cPa419,1,1,110700,110700,cPa419,1,102,0
Scaffold141-123199_123301,cPa419,1,1,123249,123249,cPa419,1,102,0
Scaffold141-130232_130380,cPa419,1,1,130334,130264,cPa419,10,148,70
Scaffold141-132133_132235,cPa419,1,1,132183,132183,cPa419,1,102,0
Scaffold141-132518_132620,cPa419,1,1,132613,132568,cPa419,4,102,45
Scaffold141-132764_132866,cPa419,1,1,132816,132814,cPa419,3,102,2
Scaffold141-135952_136058,cPa419,1,1,136006,135994,cPa419,5,106,12
Scaffold141-136209_136354,cPa419,1,1,136352,136216,cPa419,6,145,136
Scaffold141-136426_136528,cPa419,1,1,136520,136476,cPa419,3,102,44
Scaffold141-136596_136698,cPa419,1,1,136674,136646,cPa419,3,102,28
Scaffold141-138508_138610,cPa419,1,1,138563,138516,cPa419,5,102,47
Scaffold141-139298_139400,cPa419,1,1,139348,139348,cPa419,1,102,0
Scaffold141-139435_139618,cPa419,1,1,139566,139485,cPa419,5,183,81
Scaffold141-141300_141480,cPa419,1,1,141428,141347,cPa419,10,180,81
Scaffold141-142701_142803,cPa419,1,1,142771,142751,cPa419,2,102,20
Scaffold141-146544_146646,cPa419,1,1,146594,146594,cPa419,1,102,0
Scaffold141-146795_146897,cPa419,1,1,146863,146826,cPa419,4,102,37
Scaffold141-147091_147193,cPa419,1,1,147188,147119,cPa419,19,102,69
Scaffold141-150907_151009,cPa419,1,1,150957,150933,cPa419,2,102,24
Scaffold141-151213_151315,cPa419,1,1,151265,151259,cPa419,4,102,6
Scaffold141-151971_152073,cPa419,1,1,152068,151976,cPa419,10,102,92
Scaffold141-152242_152344,cPa419,1,1,152292,152292,cPa419,1,102,0
Scaffold141-152354_152456,cPa419,1,1,152449,152357,cPa419,3,102,92
Scaffold141-154341_154443,cPa419,1,1,154391,154391,cPa419,1,102,0
Scaffold141-155430_155717,cPa419,1,1,155673,155471,cPa419,14,287,202
Scaffold141-18507_18609,cPa419,1,1,18557,18557,cPa419,1,102,0
Scaffold141-22086_22301,cPa419,1,1,22301,22132,cPa419,5,215,169
Scaffold141-22611_22713,cPa419,1,1,22681,22629,cPa419,4,102,52
Scaffold141-33450_33555,cPa419,1,1,33503,33469,cPa419,3,105,34
Scaffold141-41777_41879,cPa419,1,1,41827,41827,cPa419,1,102,0
Scaffold141-54495_54597,cPa419,1,1,54545,54545,cPa419,1,102,0
Scaffold141-5674_5776,cPa419,1,1,5756,5675,cPa419,13,102,81
Scaffold141-58097_58199,cPa419,1,1,58147,58147,cPa419,1,102,0
Scaffold141-61097_61199,cPa419,1,1,61147,61147,cPa419,1,102,0
Scaffold141-62598_62700,cPa419,1,1,62648,62648,cPa419,1,102,0
Scaffold141-79581_79730,cPa419,1,1,79678,79631,cPa419,2,149,47
Scaffold141-89340_89442,cPa419,1,1,89390,89390,cPa419,1,102,0
Scaffold141-94354_94456,cPa419,1,1,94439,94404,cPa419,4,102,35
Scaffold141-95003_95105,cPa419,1,1,95084,95053,cPa419,2,102,31
Scaffold1411-3553_3655,cPa419,1,1,3603,3603,cPa419,1,102,0
Scaffold1412-1043_1231,cPa419,1,1,1180,1066,cPa419,19,188,114
Scaffold1412-1644_1746,cPa419,1,1,1694,1694,cPa419,1,102,0
Scaffold1412-1960_2062,cPa419,1,1,2010,2010,cPa419,1,102,0
Scaffold1412-2704_2806,cPa419,1,1,2772,2754,cPa419,2,102,18
Scaffold1412-3180_3282,cPa419,1,1,3282,3214,cPa419,7,102,68
Scaffold1412-649_751,cPa419,1,1,706,683,cPa419,5,102,23
Scaffold1414-1597_1959,cPa434,0.13953488372093,76,1911,1596,cPa150_cPa150-cPa174-hybrid_cPa150-cPa193-hybrid_cPa150-cPa47-hybrid_cPa150-cPa568-hybrid_cPa174_cPa174-cPa118-hybrid_cPa174-cPa150-hybrid_cPa174-cPa164-hybrid_cPa174-cPa193-hybrid_cPa174-cPa223-hybrid_cPa174-cPa247-hybrid_cPa174-cPa380-hybrid_cPa174-cPa392-hybrid_cPa174-cPa404-hybrid_cPa174-cPa47-hybrid_cPa174-cPa527-hybrid_cPa174-cPa566-hybrid_cPa174-cPa568-hybrid_cPa174-HERV-I_repbase_HERVI_LTR10B-hybrid_cPa174-REV_NC006934-hybrid_cPa174-unknown_cPa223_cPa254_cPa254-cPa164-hybrid_cPa254-cPa174-hybrid_cPa254-cPa193-hybrid_cPa254-cPa247-hybrid_cPa254-cPa380-hybrid_cPa254-REV_NC006934-hybrid_cPa254-unknown_cPa356_cPa356-cPa174-hybrid_cPa356-cPa223-hybrid_cPa356-cPa380-hybrid_cPa356-cPa404-hybrid_cPa356-cPa47-hybrid_cPa392_cPa392-cPa118-hybrid_cPa392-cPa150-hybrid_cPa392-cPa193-hybrid_cPa392-cPa47-hybrid_cPa392-cPa75-hybrid_cPa392-HIV1_NC001802-hybrid_cPa392-HML4_repbase_HERVK13I_LTR13-hybrid_cPa392-REV_NC006934-hybrid_cPa392-unknown_cPa400-cPa380-hybrid_cPa400-cPa568-hybrid_cPa404_cPa404-cPa193-hybrid_cPa404-cPa223-hybrid_cPa404-HERV-I_repbase_HERVI_LTR10B-hybrid_cPa404-unknown_cPa419_cPa425_cPa425-cPa150-hybrid_cPa425-cPa247-hybrid_cPa425-cPa527-hybrid_cPa425-cPa566-hybrid_cPa425-HERV-I_repbase_HERVI_LTR10B-hybrid_cPa425-HIV1_NC001802-hybrid_cPa425-unknown_cPa434_cPa434-cPa174-hybrid_cPa434-cPa193-hybrid_cPa434-cPa254-hybrid_cPa434-cPa47-hybrid_cPa434-cPa568-hybrid_cPa434-REV_NC006934-hybrid_cPa47_cPa47-cPa566-hybrid_cPa47-unknown_cPa527_cPa527-cPa380-hybrid_cPa572,5_1_1_1_1_17_1_2_2_2_2_4_6_1_1_2_2_1_1_2_4_4_1_21_1_1_1_1_1_1_3_1_2_5_9_6_9_11_1_1_6_2_1_1_1_1_2_1_1_1_1_1_1_4_7_35_1_1_3_1_1_1_25_42_1_3_1_4_1_1_5_1_1_1_1_1,362,315
Scaffold1414-1973_2157,cPa434,0.754385964912281,13,2157,1993,cPa257-cPa150-hybrid_cPa257-cPa247-hybrid_cPa257-cPa527-hybrid_cPa356-cPa150-hybrid_cPa356-cPa174-hybrid_cPa356-cPa247-hybrid_cPa356-cPa380-hybrid_cPa356-cPa527-hybrid_cPa392-cPa443-hybrid_cPa419_cPa425_cPa434_cPa434-cPa527-hybrid,1_1_1_1_1_1_1_1_1_2_1_43_2,184,164
Scaffold1414-2239_2341,cPa434,0.75,2,2321,2242,cPa434_cPa447-HERV-I_repbase_HERVI_LTR10B-hybrid,3_1,102,79
Scaffold1414-3299_3401,cPa434,0.474576271186441,5,3383,3300,cPa356_cPa356-unknown_cPa434_cPa434-unknown_cPa447-cPa443-hybrid,11_18_28_1_1,102,83
Scaffold1414-3471_3583,cPa434,0.531914893617021,10,3575,3483,cPa257-cPa443-hybrid_cPa356_cPa356-cPa443-hybrid_cPa356-cPa527-hybrid_cPa356-HERV-I_repbase_HERVI_LTR10B-hybrid_cPa356-unknown_cPa434_cPa434-unknown_cPa447-cPa425-hybrid_cPa447-cPa566-hybrid,1_30_1_1_1_7_50_1_1_1,112,92
Scaffold1419-4056_4158,cPa419,1,1,4106,4106,cPa419,1,102,0
Scaffold142-10720_10822,cPa75,1,1,10816,10770,cPa75,3,102,46
Scaffold142-10843_10993,cPa75,1,1,10943,10891,cPa75,8,150,52
Scaffold142-11462_11583,cPa75,1,1,11574,11512,cPa75,8,121,62
Scaffold142-12756_12858,cPa75,1,1,12806,12766,cPa75,2,102,40
Scaffold142-139939_140154,cPa75,1,1,140102,139989,cPa75,7,215,113
Scaffold142-140511_140613,cPa75,1,1,140561,140561,cPa75,1,102,0
Scaffold142-140652_140919,cPa75,1,1,140867,140702,cPa75,5,267,165
Scaffold142-2287_2389,Xen1_AJ506107,1,1,2337,2337,Xen1_AJ506107,1,102,0
Scaffold142-37028_37130,cPa75,1,1,37078,37078,cPa75,1,102,0
Scaffold142-37759_37882,cPa75,1,1,37830,37809,cPa75,3,123,21
Scaffold142-38266_38368,cPa75,1,1,38316,38316,cPa75,1,102,0
Scaffold142-38454_38556,cPa75,1,1,38504,38504,cPa75,1,102,0
Scaffold142-49864_49966,cPa75,1,1,49914,49914,cPa75,1,102,0
Scaffold142-50026_50149,cPa75,1,1,50097,50058,cPa75,3,123,39
Scaffold142-8321_8607,cPa75,1,1,8555,8337,cPa75,13,286,218
Scaffold142-8623_8725,cPa75,1,1,8673,8673,cPa75,1,102,0
Scaffold142-8876_9060,cPa75,1,1,9008,8905,cPa75,9,184,103
Scaffold142-9165_9267,cPa75,1,1,9246,9209,cPa75,3,102,37
Scaffold142-9315_9417,cPa75,1,1,9384,9365,cPa75,6,102,19
Scaffold142-98374_98476,cPa75,1,1,98424,98424,cPa75,1,102,0
Scaffold142-98510_98705,cPa75,1,1,98653,98560,cPa75,2,195,93
Scaffold142-98734_98836,cPa75,1,1,98784,98784,cPa75,1,102,0
Scaffold142-98851_99053,cPa75,1,1,99001,98901,cPa75,3,202,100
Scaffold1421-1529_1699,cPa356,0.542857142857143,2,1696,1552,cPa356_cPa428,19_16,170,144
Scaffold1421-1861_1963,cPa356,0.666666666666667,2,1941,1860,cPa356_cPa428,6_3,102,81
Scaffold1421-2349_2510,cPa428,0.52,2,2458,2356,cPa356_cPa428,12_13,161,102
Scaffold1421-2629_2762,cPa356,0.530612244897959,2,2745,2643,cPa356_cPa428,26_23,133,102
Scaffold1429-2191_2293,cPa419,1,1,2241,2241,cPa419,1,102,0
Scaffold143-119717_119819,cPa428,1,1,119767,119767,cPa428,1,102,0
Scaffold143-123213_123319,cPa356,0.666666666666667,2,123278,123263,cPa356_cPa428,2_1,106,15
Scaffold143-148718_148820,cPa356,1,1,148768,148768,cPa356,1,102,0
Scaffold143-95740_95842,cPa356,1,1,95790,95790,cPa356,1,102,0
Scaffold1436-2364_2466,cPa428,0.526315789473684,2,2460,2367,cPa356_cPa428,18_20,102,93
Scaffold144-35821_35923,cPa419,1,1,35903,35825,cPa419,5,102,78
Scaffold144-37392_37494,cPa419,1,1,37488,37404,cPa419,6,102,84
Scaffold144-37961_38141,cPa419,1,1,38089,38011,cPa419,5,180,78
Scaffold144-39367_39469,cPa419,1,1,39417,39417,cPa419,1,102,0
Scaffold144-39842_39944,cPa419,1,1,39892,39853,cPa419,2,102,39
Scaffold144-79809_79911,cPa419,1,1,79859,79859,cPa419,1,102,0
Scaffold1444-3345_3460,cPa419,1,1,3420,3378,cPa419,13,115,42
Scaffold1444-3697_3799,cPa419,1,1,3759,3713,cPa419,9,102,46
Scaffold1445-891_993,cPa434-cPa360-hybrid_S71_repbase_HERVS71_LTR6A,0.5,2,963,941,cPa434-cPa360-hybrid_S71_repbase_HERVS71_LTR6A,1_1,102,22
Scaffold145-749_851,cPa419,1,1,799,799,cPa419,1,102,0
Scaffold1452-2468_2570,cPa356_cPa428,0.5,2,2540,2517,cPa356_cPa428,4_4,102,23
Scaffold1461-433_535,cPa419,1,1,498,439,cPa419,5,102,59
Scaffold1463-1484_1586,cPa419,1,1,1541,1534,cPa419,2,102,7
Scaffold1464-1044_1192,cPa419,1,1,1190,1046,cPa419,68,148,144
Scaffold1464-1396_1528,cPa419,1,1,1494,1401,cPa419,89,132,93
Scaffold1464-802_904,cPa419,0.976470588235294,3,879,802,cPa168_cPa168-unknown_cPa419,1_1_83,102,77
Scaffold147-1532_1634,cPa419,1,1,1582,1582,cPa419,1,102,0
Scaffold147-7370_7472,cPa419,1,1,7420,7419,cPa419,8,102,1
Scaffold147-7706_7837,cPa419,1,1,7791,7736,cPa419,13,131,55
Scaffold1472-1428_1530,cPa434,0.952380952380952,2,1478,1431,cPa142_cPa434,1_20,102,47
Scaffold1472-1531_1696,cPa434,0.863636363636364,2,1650,1581,cPa142_cPa434,3_19,165,69
Scaffold1472-1742_1844,cPa434,0.85,2,1801,1770,cPa142_cPa434,3_17,102,31
Scaffold1472-1888_1990,cPa434,0.888888888888889,2,1950,1911,cPa142_cPa434,1_8,102,39
Scaffold1472-2970_3140,cPa434,0.846153846153846,2,3128,2969,cPa142-unknown_cPa434,2_11,170,159
Scaffold1472-677_779,cPa434,1,1,727,727,cPa434,1,102,0
Scaffold148-10644_11077,cPa419,1,1,11058,10664,cPa419,105,433,394
Scaffold148-11619_11721,cPa419,1,1,11719,11629,cPa419,24,102,90
Scaffold148-12201_12351,cPa419,1,1,12343,12205,cPa419,26,150,138
Scaffold148-12380_12482,cPa419,1,1,12482,12383,cPa419,20,102,99
Scaffold148-12712_12814,cPa419,1,1,12762,12762,cPa419,1,102,0
Scaffold148-13302_13404,cPa419,1,1,13352,13302,cPa419,5,102,50
Scaffold148-13800_13902,cPa419,1,1,13850,13850,cPa419,1,102,0
Scaffold148-13975_14077,cPa419,1,1,14071,14025,cPa419,11,102,46
Scaffold148-14176_14295,cPa419,1,1,14276,14181,cPa419,13,119,95
Scaffold148-14464_14566,cPa419,1,1,14514,14514,cPa419,1,102,0
Scaffold148-1511_1807,cPa419,1,1,1798,1531,cPa419,98,296,267
Scaffold148-17251_17525,cPa419,1,1,17516,17251,cPa419,74,274,265
Scaffold148-17666_17881,cPa419,1,1,17836,17668,cPa419,49,215,168
Scaffold148-18052_18185,cPa419,1,1,18133,18102,cPa419,6,133,31
Scaffold148-18460_18562,cPa419,1,1,18510,18460,cPa419,2,102,50
Scaffold148-19140_19242,cPa419,1,1,19190,19190,cPa419,1,102,0
Scaffold148-1920_2106,cPa419,1,1,2065,1952,cPa419,55,186,113
Scaffold148-20335_20437,cPa419,1,1,20385,20385,cPa419,2,102,0
Scaffold148-20609_20711,cPa419,1,1,20659,20659,cPa419,1,102,0
Scaffold148-21953_22055,cPa419,1,1,22029,22003,cPa419,9,102,26
Scaffold148-22604_22706,cPa419,1,1,22699,22606,cPa419,23,102,93
Scaffold148-23121_23223,cPa419,1,1,23223,23171,cPa419,54,102,52
Scaffold148-23505_23607,cPa419,1,1,23607,23521,cPa419,6,102,86
Scaffold148-23687_23818,cPa419,1,1,23811,23693,cPa419,20,131,118
Scaffold148-23838_23972,cPa419,1,1,23961,23843,cPa419,27,134,118
Scaffold148-3805_4019,cPa419,1,1,4003,3855,cPa419,21,214,148
Scaffold148-4068_4208,cPa419,1,1,4208,4081,cPa419,14,140,127
Scaffold148-4428_4530,cPa419,1,1,4478,4473,cPa419,3,102,5
Scaffold148-5564_5666,cPa419,1,1,5614,5614,cPa419,1,102,0
Scaffold148-6302_6604,cPa419,0.907692307692308,2,6602,6321,cPa419_cPa456-unknown,59_6,302,281
Scaffold148-6689_6791,cPa419,1,1,6788,6688,cPa419,21,102,100
Scaffold148-7152_7254,cPa419,1,1,7252,7186,cPa419,7,102,66
Scaffold148-7497_7599,cPa419,1,1,7594,7501,cPa419,23,102,93
Scaffold148-7607_7709,cPa419,1,1,7686,7625,cPa419,9,102,61
Scaffold148-7753_7954,cPa419,1,1,7917,7765,cPa419,23,201,152
Scaffold148-7975_8104,cPa419,1,1,8103,8025,cPa419,18,129,78
Scaffold148-8252_8399,cPa419,1,1,8381,8254,cPa419,27,147,127
Scaffold148-8573_8675,cPa419,1,1,8632,8591,cPa419,8,102,41
Scaffold148-8811_8913,cPa419,1,1,8873,8811,cPa419,8,102,62
Scaffold148-8984_9130,cPa419,1,1,9118,8987,cPa419,22,146,131
Scaffold148-9169_9338,cPa419,1,1,9299,9174,cPa419,25,169,125
Scaffold148-9491_9923,cPa419,1,1,9915,9500,cPa419,52,432,415
Scaffold148-9941_10082,cPa419,1,1,10071,9948,cPa419,14,141,123
Scaffold1480-832_939,cPa392,1,1,887,841,cPa392,12,107,46
Scaffold1486-1026_1128,cPa428,0.578947368421053,2,1124,1027,cPa356_cPa428,8_11,102,97
Scaffold1488-1781_1883,cPa419,1,1,1840,1822,cPa419,9,102,18
Scaffold1488-1948_2050,cPa419,1,1,1998,1998,cPa419,1,102,0
Scaffold1488-2553_2655,cPa419,1,1,2612,2599,cPa419,5,102,13
Scaffold1489-1494_1599,cPa419,1,1,1586,1538,cPa419,7,105,48
Scaffold1492-2695_2797,cPa419,1,1,2795,2712,cPa419,19,102,83
Scaffold1494-1096_1198,cPa419,1,1,1146,1146,cPa419,1,102,0
Scaffold15-1008720_1008822,cPa75,1,1,1008770,1008770,cPa75,1,102,0
Scaffold15-1008879_1008981,cPa75,1,1,1008929,1008929,cPa75,1,102,0
Scaffold15-1009034_1009198,cPa75,1,1,1009146,1009084,cPa75,2,164,62
Scaffold15-1009652_1009754,cPa75,1,1,1009702,1009702,cPa75,1,102,0
Scaffold15-1009926_1010128,cPa75,1,1,1010076,1009976,cPa75,2,202,100
Scaffold15-10135_10237,cPa75-unknown,1,1,10185,10185,cPa75-unknown,1,102,0
Scaffold15-102387_102489,cPa75,1,1,102437,102437,cPa75,1,102,0
Scaffold15-102681_102797,cPa75-unknown,1,1,102745,102696,cPa75-unknown,5,116,49
Scaffold15-1028071_1028198,cPa75,1,1,1028146,1028121,cPa75,2,127,25
Scaffold15-1028223_1028497,cPa75,1,1,1028445,1028256,cPa75,24,274,189
Scaffold15-1049530_1049632,cPa75,1,1,1049580,1049580,cPa75,1,102,0
Scaffold15-1049709_1049811,cPa75,1,1,1049759,1049759,cPa75,1,102,0
Scaffold15-1049832_1049934,cPa75,1,1,1049882,1049882,cPa75,1,102,0
Scaffold15-1049992_1050610,cPa75,1,1,1050567,1050042,cPa75,31,618,525
Scaffold15-1054586_1054688,cPa75,1,1,1054636,1054636,cPa75,1,102,0
Scaffold15-1073219_1073321,cPa75,1,1,1073269,1073269,cPa75,1,102,0
Scaffold15-1074173_1074275,cPa75,1,1,1074223,1074223,cPa75,1,102,0
Scaffold15-1074575_1074677,cPa75,1,1,1074625,1074625,cPa75,1,102,0
Scaffold15-1082899_1083001,cPa75,1,1,1083001,1082949,cPa75,2,102,52
Scaffold15-1083404_1083506,cPa75,1,1,1083454,1083442,cPa75,2,102,12
Scaffold15-1083694_1084702,cPa75,1,1,1084691,1083716,cPa75,41,1008,975
Scaffold15-1085061_1085283,cPa75,1,1,1085233,1085111,cPa75,10,222,122
Scaffold15-109518_109620,cPa75,1,1,109568,109568,cPa75,1,102,0
Scaffold15-1095709_1095841,cPa75,1,1,1095789,1095759,cPa75,2,132,30
Scaffold15-1095895_1095997,cPa75,1,1,1095945,1095945,cPa75,1,102,0
Scaffold15-109755_109923,cPa75,1,1,109871,109805,cPa75,2,168,66
Scaffold15-1102371_1102784,cPa75,1,1,1102732,1102421,cPa75,27,413,311
Scaffold15-1102869_1102981,cPa75,1,1,1102929,1102919,cPa75,3,112,10
Scaffold15-1102992_1103195,cPa75,1,1,1103143,1103042,cPa75,2,203,101
Scaffold15-1103294_1103502,cPa75,1,1,1103450,1103344,cPa75,12,208,106
Scaffold15-1103544_1103663,cPa75,1,1,1103611,1103594,cPa75,2,119,17
Scaffold15-1103741_1103843,cPa75,1,1,1103791,1103791,cPa75,1,102,0
Scaffold15-1111325_1111427,cPa75,1,1,1111375,1111375,cPa75,1,102,0
Scaffold15-1112174_1112276,cPa75,1,1,1112224,1112224,cPa75,1,102,0
Scaffold15-1122483_1122585,cPa75,1,1,1122563,1122533,cPa75,2,102,30
Scaffold15-1122712_1122840,cPa75,1,1,1122800,1122721,cPa75,9,128,79
Scaffold15-1122960_1123216,cPa75,1,1,1123164,1123010,cPa75,13,256,154
Scaffold15-1123241_1123623,cPa75,1,1,1123571,1123291,cPa75,11,382,280
Scaffold15-1123656_1123790,cPa75,1,1,1123738,1123706,cPa75,3,134,32
Scaffold15-1124758_1124860,cPa75,1,1,1124808,1124802,cPa75,4,102,6
Scaffold15-1125183_1125285,cPa75,1,1,1125233,1125221,cPa75,2,102,12
Scaffold15-1128984_1129144,cPa75,1,1,1129112,1129034,cPa75,4,160,78
Scaffold15-1129463_1129624,cPa75,1,1,1129572,1129513,cPa75,6,161,59
Scaffold15-1129673_1130041,cPa75,1,1,1129989,1129723,cPa75,14,368,266
Scaffold15-1130117_1130284,cPa75,1,1,1130232,1130167,cPa75,4,167,65
Scaffold15-1130387_1130489,cPa75,1,1,1130437,1130437,cPa75,1,102,0
Scaffold15-1130550_1130667,cPa75,1,1,1130615,1130600,cPa75,2,117,15
Scaffold15-1131973_1132227,cPa75,1,1,1132191,1132023,cPa75,9,254,168
Scaffold15-1132229_1132331,cPa75,1,1,1132279,1132279,cPa75,1,102,0
Scaffold15-1132357_1132686,cPa75,1,1,1132654,1132407,cPa75,21,329,247
Scaffold15-1132710_1133180,cPa75,1,1,1133159,1132760,cPa75,27,470,399
Scaffold15-1135579_1135681,cPa75,1,1,1135629,1135629,cPa75,1,102,0
Scaffold15-1137946_1138090,cPa75,1,1,1138038,1137996,cPa75,3,144,42
Scaffold15-1138125_1138227,cPa75,1,1,1138175,1138175,cPa75,1,102,0
Scaffold15-1138372_1138474,cPa75,1,1,1138422,1138385,cPa75,2,102,37
Scaffold15-1139205_1139418,cPa75,1,1,1139417,1139237,cPa75,6,213,180
Scaffold15-1139489_1139618,cPa75,1,1,1139606,1139520,cPa75,5,129,86
Scaffold15-1139679_1139917,cPa75,1,1,1139915,1139691,cPa75,16,238,224
Scaffold15-1141617_1141719,cPa75,1,1,1141667,1141667,cPa75,1,102,0
Scaffold15-114400_114505,cPa75,1,1,114453,114411,cPa75,3,105,42
Scaffold15-114711_114952,cPa75,1,1,114900,114761,cPa75,7,241,139
Scaffold15-1148369_1148571,cPa75,1,1,1148519,1148419,cPa75,3,202,100
Scaffold15-1148631_1148733,cPa75,1,1,1148681,1148681,cPa75,1,102,0
Scaffold15-1148848_1149049,cPa75,1,1,1148997,1148898,cPa75,2,201,99
Scaffold15-114968_115716,cPa75,1,1,115664,115018,cPa75,41,748,646
Scaffold15-115893_115995,cPa75,1,1,115943,115907,cPa75,3,102,36
Scaffold15-1170794_1171228,cPa75,1,1,1171176,1170844,cPa75,41,434,332
Scaffold15-1171253_1171369,cPa75,1,1,1171317,1171303,cPa75,2,116,14
Scaffold15-1171458_1172017,cPa75,1,1,1171965,1171508,cPa75,15,559,457
Scaffold15-1173658_1173851,cPa428,0.555555555555556,4,1173810,1173708,cPa356_cPa356-cPa428-hybrid_cPa428_cPa428-cPa356-hybrid,6_1_10_1,193,102
Scaffold15-1174195_1174415,cPa428,0.536585365853659,2,1174363,1174245,cPa356_cPa428,19_22,220,118
Scaffold15-1174470_1174574,cPa428,0.666666666666667,2,1174522,1174520,cPa356_cPa428,1_2,104,2
Scaffold15-1174578_1174847,cPa356,0.578947368421053,4,1174820,1174604,cPa356_cPa356-cPa428-hybrid_cPa428_cPa428-cPa356-hybrid,88_4_59_1,269,216
Scaffold15-1175117_1175245,cPa428,0.6,2,1175193,1175167,cPa356_cPa428,2_3,128,26
Scaffold15-1175414_1175675,cPa356,0.6,3,1175640,1175464,cPa356_cPa356-cPa428-hybrid_cPa428,9_1_5,261,176
Scaffold15-1179003_1179105,cPa75,1,1,1179053,1179053,cPa75,1,102,0
Scaffold15-1179262_1179489,cPa75,1,1,1179437,1179312,cPa75,6,227,125
Scaffold15-1179834_1180001,cPa75,1,1,1179949,1179884,cPa75,10,167,65
Scaffold15-1180447_1180693,cPa75,1,1,1180641,1180497,cPa75,11,246,144
Scaffold15-118342_118444,cPa4_cPa425_cPa447,0.333333333333333,3,118409,118392,cPa4_cPa425_cPa447,1_1_1,102,17
Scaffold15-1185760_1185992,cPa75,1,1,1185940,1185786,cPa75,7,232,154
Scaffold15-1186043_1186677,cPa75,1,1,1186632,1186090,cPa75,47,634,542
Scaffold15-1186738_1186960,cPa75,1,1,1186908,1186745,cPa75,6,222,163
Scaffold15-1189871_1190125,cPa75,1,1,1190073,1189921,cPa75,9,254,152
Scaffold15-1190305_1190495,cPa75,1,1,1190477,1190355,cPa75,4,190,122
Scaffold15-1190521_1190754,cPa75,1,1,1190702,1190571,cPa75,30,233,131
Scaffold15-1196516_1196704,cPa75,1,1,1196652,1196566,cPa75,2,188,86
Scaffold15-1196726_1197318,cPa75,1,1,1197266,1196749,cPa75,43,592,517
Scaffold15-1197399_1197501,cPa75,1,1,1197449,1197449,cPa75,1,102,0
Scaffold15-1197733_1197835,cPa75,1,1,1197783,1197783,cPa75,1,102,0
Scaffold15-1197876_1197978,cPa75,1,1,1197928,1197926,cPa75,2,102,2
Scaffold15-1245914_1246016,cPa75,1,1,1245964,1245964,cPa75,1,102,0
Scaffold15-1246586_1246871,cPa75,1,1,1246819,1246636,cPa75,4,285,183
Scaffold15-1252453_1252715,cPa75,1,1,1252663,1252503,cPa75,6,262,160
Scaffold15-1252760_1252877,cPa75,1,1,1252825,1252810,cPa75,3,117,15
Scaffold15-1261666_1261772,cPa75,1,1,1261720,1261716,cPa75,2,106,4
Scaffold15-1261852_1261954,cPa75,1,1,1261902,1261902,cPa75,1,102,0
Scaffold15-1262259_1262361,cPa75,1,1,1262309,1262309,cPa75,1,102,0
Scaffold15-1262372_1262615,cPa75,1,1,1262563,1262422,cPa75,13,243,141
Scaffold15-126353_126455,cPa75,1,1,126403,126398,cPa75,5,102,5
Scaffold15-126604_127124,cPa75,0.956521739130435,2,127074,126654,cPa75_cPa75-unknown,22_1,520,420
Scaffold15-1267899_1268001,cPa75,1,1,1267949,1267949,cPa75,1,102,0
Scaffold15-1268425_1268527,cPa75,1,1,1268475,1268475,cPa75,1,102,0
Scaffold15-1270767_1270869,cPa75,1,1,1270817,1270817,cPa75,1,102,0
Scaffold15-1272914_1273016,cPa75,1,1,1272964,1272964,cPa75,1,102,0
Scaffold15-1279060_1279162,cPa75,1,1,1279110,1279110,cPa75,1,102,0
Scaffold15-1279172_1279274,cPa75,1,1,1279222,1279222,cPa75,1,102,0
Scaffold15-1279343_1279445,cPa75,1,1,1279393,1279393,cPa75,1,102,0
Scaffold15-1279481_1279583,cPa75,1,1,1279531,1279531,cPa75,10,102,0
Scaffold15-1280034_1280256,cPa75,1,1,1280204,1280084,cPa75,21,222,120
Scaffold15-1280813_1280915,cPa75,1,1,1280863,1280863,cPa75,1,102,0
Scaffold15-1288443_1288545,cPa75,1,1,1288493,1288493,cPa75,1,102,0
Scaffold15-1288724_1288877,cPa75,1,1,1288825,1288774,cPa75,5,153,51
Scaffold15-1297755_1297857,cPa75,1,1,1297820,1297805,cPa75,2,102,15
Scaffold15-130032_130134,cPa75,1,1,130082,130082,cPa75,1,102,0
Scaffold15-1300515_1300617,cPa75,1,1,1300565,1300565,cPa75,1,102,0
Scaffold15-1303731_1303833,cPa75,1,1,1303781,1303781,cPa75,2,102,0
Scaffold15-1304214_1304419,cPa75,1,1,1304367,1304264,cPa75,5,205,103
Scaffold15-1304439_1304749,cPa75,1,1,1304697,1304489,cPa75,9,310,208
Scaffold15-1304776_1304888,cPa75,1,1,1304836,1304826,cPa75,2,112,10
Scaffold15-130480_130582,cPa75,1,1,130530,130530,cPa75,1,102,0
Scaffold15-1304909_1305021,cPa257-cPa75-hybrid_cPa75,0.5,2,1304969,1304959,cPa257-cPa75-hybrid_cPa75,1_1,112,10
Scaffold15-130605_131318,cPa75,1,1,131266,130655,cPa75,52,713,611
Scaffold15-131320_131520,cPa75,1,1,131487,131370,cPa75,8,200,117
Scaffold15-131533_131635,cPa75,1,1,131583,131583,cPa75,1,102,0
Scaffold15-1315378_1315480,cPa75,1,1,1315464,1315428,cPa75,2,102,36
Scaffold15-1315672_1315774,cPa75,1,1,1315722,1315722,cPa75,1,102,0
Scaffold15-1315793_1315909,cPa75,1,1,1315857,1315843,cPa75,3,116,14
Scaffold15-1316085_1316187,cPa75,1,1,1316135,1316135,cPa75,1,102,0
Scaffold15-1320435_1320593,cPa75,1,1,1320588,1320474,cPa75,7,158,114
Scaffold15-1320740_1320891,cPa75,1,1,1320889,1320753,cPa75,11,151,136
Scaffold15-1323160_1323279,cPa75,1,1,1323227,1323210,cPa75,10,119,17
Scaffold15-1323409_1323511,cPa75,1,1,1323459,1323459,cPa75,1,102,0
Scaffold15-132379_132715,cPa75,1,1,132673,132426,cPa75,33,336,247
Scaffold15-1325754_1325856,cPa75,1,1,1325804,1325804,cPa75,1,102,0
Scaffold15-1338665_1338767,cPa75,1,1,1338715,1338666,cPa75,10,102,49
Scaffold15-1338808_1338977,cPa75,0.75,2,1338925,1338858,cPa75_cPa75-unknown,3_1,169,67
Scaffold15-1338991_1339217,cPa75,0.84,2,1339169,1339041,cPa75_cPa75-unknown,21_4,226,128
Scaffold15-1343694_1343971,cPa75,1,1,1343919,1343742,cPa75,15,277,177
Scaffold15-1343998_1344791,cPa75,1,1,1344739,1344047,cPa75,54,793,692
Scaffold15-1351596_1351727,cPa75,1,1,1351675,1351646,cPa75,2,131,29
Scaffold15-1351849_1352435,cPa75,1,1,1352383,1351899,cPa75,14,586,484
Scaffold15-1354197_1354299,cPa75,1,1,1354247,1354247,cPa75,1,102,0
Scaffold15-1354517_1354816,cPa75,1,1,1354764,1354567,cPa75,8,299,197
Scaffold15-1354974_1355076,cPa75,1,1,1355024,1355024,cPa75,1,102,0
Scaffold15-1355080_1355182,cPa75,1,1,1355130,1355130,cPa75,1,102,0
Scaffold15-1358600_1358702,cPa75,1,1,1358650,1358650,cPa75,1,102,0
Scaffold15-1358868_1359071,cPa75,1,1,1359019,1358918,cPa75,4,203,101
Scaffold15-1359157_1359370,cPa75,1,1,1359318,1359207,cPa75,4,213,111
Scaffold15-1360001_1360103,cPa75,1,1,1360051,1360051,cPa75,1,102,0
Scaffold15-1376713_1376815,cPa75,1,1,1376813,1376744,cPa75,10,102,69
Scaffold15-1384086_1384188,cPa75,1,1,1384136,1384136,cPa75,1,102,0
Scaffold15-1384228_1384358,cPa75,1,1,1384306,1384278,cPa75,2,130,28
Scaffold15-1384361_1384504,cPa75,1,1,1384452,1384411,cPa75,2,143,41
Scaffold15-1384673_1384775,cPa75,1,1,1384723,1384695,cPa75,2,102,28
Scaffold15-1385019_1385121,cPa75,1,1,1385069,1385069,cPa75,1,102,0
Scaffold15-1385130_1385353,cPa75,1,1,1385301,1385180,cPa75,8,223,121
Scaffold15-1391465_1391605,cPa75,1,1,1391553,1391515,cPa75,2,140,38
Scaffold15-1405319_1405421,cPa75,1,1,1405369,1405357,cPa75,4,102,12
Scaffold15-1405470_1405602,cPa75,1,1,1405550,1405520,cPa75,2,132,30
Scaffold15-1405707_1406120,cPa75,1,1,1406068,1405752,cPa75,14,413,316
Scaffold15-1406178_1406401,cPa75,1,1,1406375,1406228,cPa75,9,223,147
Scaffold15-1408600_1408702,cPa75,1,1,1408650,1408650,cPa75,1,102,0
Scaffold15-1409114_1409216,cPa75,1,1,1409164,1409164,cPa75,1,102,0
Scaffold15-1409240_1409342,cPa75,1,1,1409290,1409290,cPa75,1,102,0
Scaffold15-1411361_1411463,cPa75,1,1,1411411,1411411,cPa75,1,102,0
Scaffold15-1411518_1411620,cPa75,1,1,1411568,1411568,cPa75,1,102,0
Scaffold15-1411626_1411728,cPa75,1,1,1411676,1411676,cPa75,1,102,0
Scaffold15-1411788_1411899,cPa75,1,1,1411847,1411838,cPa75,2,111,9
Scaffold15-1412442_1412644,cPa75,1,1,1412592,1412492,cPa75,3,202,100
Scaffold15-1412682_1412784,cPa75,1,1,1412732,1412732,cPa75,1,102,0
Scaffold15-1413740_1413842,cPa75,1,1,1413790,1413790,cPa75,1,102,0
Scaffold15-1413856_1414050,cPa75,1,1,1413998,1413906,cPa75,2,194,92
Scaffold15-1414108_1414305,cPa75,1,1,1414253,1414139,cPa75,5,197,114
Scaffold15-1414488_1414590,cPa75,1,1,1414538,1414538,cPa75,1,102,0
Scaffold15-1428033_1428208,cPa75,1,1,1428156,1428083,cPa75,2,175,73
Scaffold15-1428218_1429030,cPa75,1,1,1428978,1428268,cPa75,36,812,710
Scaffold15-1431867_1432004,cPa75,1,1,1431952,1431917,cPa75,2,137,35
Scaffold15-1432026_1432199,cPa75,1,1,1432172,1432076,cPa75,13,173,96
Scaffold15-1432252_1432388,cPa75,1,1,1432336,1432302,cPa75,2,136,34
Scaffold15-1432390_1432508,cPa75,1,1,1432474,1432440,cPa75,7,118,34
Scaffold15-1432636_1432805,cPa75,1,1,1432753,1432686,cPa75,7,169,67
Scaffold15-1433207_1433336,cPa75,1,1,1433284,1433257,cPa75,2,129,27
Scaffold15-1435961_1436344,cPa75,1,1,1436333,1436011,cPa75,33,383,322
Scaffold15-1438255_1438357,cPa75,1,1,1438316,1438305,cPa75,2,102,11
Scaffold15-1438381_1438488,cPa75,1,1,1438460,1438430,cPa75,5,107,30
Scaffold15-1438661_1438763,cPa75,1,1,1438711,1438711,cPa75,1,102,0
Scaffold15-1438810_1438912,cPa75,1,1,1438860,1438860,cPa75,1,102,0
Scaffold15-1439302_1439438,cPa75,1,1,1439407,1439352,cPa75,4,136,55
Scaffold15-1439439_1439541,cPa75,1,1,1439503,1439457,cPa75,3,102,46
Scaffold15-1439672_1439791,cPa75,1,1,1439739,1439722,cPa75,2,119,17
Scaffold15-1439983_1440182,cPa75,1,1,1440130,1440033,cPa75,4,199,97
Scaffold15-1440878_1440980,cPa75,1,1,1440973,1440894,cPa75,6,102,79
Scaffold15-1441063_1441165,cPa75,1,1,1441121,1441099,cPa75,3,102,22
Scaffold15-1441232_1441334,cPa75,1,1,1441282,1441282,cPa75,1,102,0
Scaffold15-1443913_1444265,cPa75,1,1,1444213,1443963,cPa75,8,352,250
Scaffold15-1444285_1445049,cPa75,1,1,1444997,1444335,cPa75,25,764,662
Scaffold15-1447244_1447346,cPa75,1,1,1447310,1447294,cPa75,2,102,16
Scaffold15-1447431_1447533,cPa75,1,1,1447481,1447481,cPa75,1,102,0
Scaffold15-1448830_1448932,cPa75_cPa75-cPa545-hybrid,0.5,2,1448880,1448851,cPa75_cPa75-cPa545-hybrid,1_1,102,29
Scaffold15-1449779_1449881,cPa75,1,1,1449829,1449820,cPa75,2,102,9
Scaffold15-1449913_1450354,cPa75,1,1,1450302,1449963,cPa75,19,441,339
Scaffold15-1450379_1451037,cPa75,1,1,1450985,1450388,cPa75,35,658,597
Scaffold15-1451078_1451411,cPa75,1,1,1451371,1451128,cPa75,13,333,243
Scaffold15-1452813_1452915,cPa75,1,1,1452863,1452863,cPa75,1,102,0
Scaffold15-1452942_1453044,cPa75,1,1,1452992,1452986,cPa75,3,102,6
Scaffold15-1453057_1453173,cPa75,1,1,1453167,1453107,cPa75,6,116,60
Scaffold15-1453243_1453345,cPa75,1,1,1453306,1453293,cPa75,4,102,13
Scaffold15-1455816_1455918,cPa75,1,1,1455866,1455819,cPa75,2,102,47
Scaffold15-1456230_1456332,cPa75,1,1,1456280,1456280,cPa75,1,102,0
Scaffold15-1456586_1456693,cPa75,1,1,1456641,1456636,cPa75,2,107,5
Scaffold15-1456753_1456855,cPa75,1,1,1456803,1456803,cPa75,1,102,0
Scaffold15-1457080_1457182,cPa75,1,1,1457130,1457130,cPa75,1,102,0
Scaffold15-1459077_1459183,cPa75,1,1,1459161,1459127,cPa75,32,106,34
Scaffold15-1459226_1459328,cPa75,1,1,1459276,1459276,cPa75,1,102,0
Scaffold15-1459334_1459436,cPa75,1,1,1459384,1459384,cPa75,1,102,0
Scaffold15-1459949_1460051,cPa75,1,1,1459999,1459999,cPa75,2,102,0
Scaffold15-1462794_1462995,cPa75,1,1,1462943,1462844,cPa75,3,201,99
Scaffold15-1463012_1463738,cPa75,1,1,1463692,1463062,cPa75,37,726,630
Scaffold15-1465480_1465582,cPa75,1,1,1465530,1465530,cPa75,1,102,0
Scaffold15-1465589_1465691,cPa75,1,1,1465639,1465639,cPa75,1,102,0
Scaffold15-147013_147165,cPa75,1,1,147117,147063,cPa75,7,152,54
Scaffold15-1471288_1471403,cPa75,1,1,1471378,1471323,cPa75,10,115,55
Scaffold15-147171_147992,cPa75,1,1,147940,147221,cPa75,35,821,719
Scaffold15-148154_148275,cPa75,1,1,148256,148154,cPa75,7,121,102
Scaffold15-1482217_1482470,cPa75,1,1,1482418,1482267,cPa75,6,253,151
Scaffold15-1482519_1482689,cPa75,1,1,1482637,1482569,cPa75,3,170,68
Scaffold15-1482700_1482868,cPa75,1,1,1482816,1482750,cPa75,3,168,66
Scaffold15-1482905_1483095,cPa75,1,1,1483043,1482915,cPa75,10,190,128
Scaffold15-1483134_1483381,cPa75,1,1,1483329,1483184,cPa75,10,247,145
Scaffold15-1483402_1483504,cPa75,1,1,1483452,1483452,cPa75,1,102,0
Scaffold15-148492_148594,cPa75,1,1,148586,148526,cPa75,9,102,60
Scaffold15-1490958_1491074,cPa75,1,1,1491022,1491008,cPa75,3,116,14
Scaffold15-1491126_1491228,cPa75,1,1,1491176,1491176,cPa75,1,102,0
Scaffold15-1491417_1491519,cPa75,1,1,1491467,1491465,cPa75,6,102,2
Scaffold15-1491621_1491723,cPa75,1,1,1491671,1491671,cPa75,1,102,0
Scaffold15-1491803_1491966,cPa75,1,1,1491921,1491853,cPa75,5,163,68
Scaffold15-1492676_1492838,cPa75,1,1,1492786,1492726,cPa75,5,162,60
Scaffold15-1493020_1493122,cPa75,1,1,1493070,1493070,cPa75,1,102,0
Scaffold15-1499408_1499510,cPa75,1,1,1499458,1499458,cPa75,1,102,0
Scaffold15-1501378_1501480,cPa75,1,1,1501428,1501428,cPa75,1,102,0
Scaffold15-1514136_1514366,cPa75,1,1,1514314,1514186,cPa75,3,230,128
Scaffold15-1514462_1514847,cPa75,1,1,1514795,1514512,cPa75,10,385,283
Scaffold15-1514947_1515268,cPa75,1,1,1515216,1514969,cPa75,9,321,247
Scaffold15-1515330_1515437,cPa75,1,1,1515385,1515380,cPa75,2,107,5
Scaffold15-1515543_1515945,cPa75,1,1,1515904,1515593,cPa75,7,402,311
Scaffold15-1526848_1526992,cPa75,1,1,1526958,1526850,cPa75,4,144,108
Scaffold15-1527038_1527275,cPa75,1,1,1527223,1527088,cPa75,5,237,135
Scaffold15-1527293_1527545,cPa75,1,1,1527493,1527343,cPa75,5,252,150
Scaffold15-1527640_1528037,cPa75,1,1,1527985,1527690,cPa75,11,397,295
Scaffold15-1528174_1528276,cPa75,1,1,1528224,1528224,cPa75,1,102,0
Scaffold15-1528322_1528499,cPa75,1,1,1528486,1528372,cPa75,4,177,114
Scaffold15-1528578_1528694,cPa75,1,1,1528642,1528628,cPa75,2,116,14
Scaffold15-1528783_1528885,cPa75,1,1,1528838,1528833,cPa75,2,102,5
Scaffold15-1532123_1532288,cPa75,1,1,1532236,1532173,cPa75,7,165,63
Scaffold15-1532470_1533090,cPa75,1,1,1533038,1532520,cPa75,46,620,518
Scaffold15-1533236_1533342,cPa75,1,1,1533290,1533262,cPa75,3,106,28
Scaffold15-1533954_1534056,cPa75,1,1,1534004,1534004,cPa75,1,102,0
Scaffold15-1540207_1540335,cPa75,1,1,1540283,1540257,cPa75,2,128,26
Scaffold15-1540381_1540483,cPa75,1,1,1540431,1540431,cPa75,1,102,0
Scaffold15-1540484_1540622,cPa75,1,1,1540570,1540534,cPa75,4,138,36
Scaffold15-1541097_1541199,cPa75,1,1,1541147,1541147,cPa75,1,102,0
Scaffold15-1541443_1541776,cPa75,1,1,1541724,1541493,cPa75,18,333,231
Scaffold15-1547994_1548096,cPa75,1,1,1548044,1548044,cPa75,1,102,0
Scaffold15-1548165_1548518,cPa75,1,1,1548466,1548215,cPa75,16,353,251
Scaffold15-1548863_1548965,cPa75,1,1,1548913,1548913,cPa75,1,102,0
Scaffold15-1549042_1549148,cPa75,1,1,1549096,1549057,cPa75,6,106,39
Scaffold15-1549302_1549437,cPa75,1,1,1549385,1549352,cPa75,3,135,33
Scaffold15-1554263_1554365,cPa75,1,1,1554358,1554313,cPa75,2,102,45
Scaffold15-1554372_1554474,cPa75,1,1,1554422,1554422,cPa75,2,102,0
Scaffold15-1554569_1554677,cPa75,1,1,1554648,1554576,cPa75,6,108,72
Scaffold15-1554691_1555216,cPa75,1,1,1555213,1554741,cPa75,20,525,472
Scaffold15-1560082_1560269,cPa75,1,1,1560217,1560132,cPa75,5,187,85
Scaffold15-1560305_1560412,cPa75,1,1,1560380,1560348,cPa75,8,107,32
Scaffold15-1560413_1561016,cPa75,1,1,1560999,1560463,cPa75,29,603,536
Scaffold15-1568382_1568484,cPa75-unknown,1,1,1568432,1568432,cPa75-unknown,1,102,0
Scaffold15-1568750_1568852,cPa75,1,1,1568800,1568800,cPa75,1,102,0
Scaffold15-1568855_1568966,cPa75,1,1,1568914,1568905,cPa75,2,111,9
Scaffold15-1569437_1569581,cPa75,1,1,1569556,1569487,cPa75,3,144,69
Scaffold15-1576668_1576778,cPa75,1,1,1576726,1576718,cPa75,2,110,8
Scaffold15-1579051_1579153,cPa75,1,1,1579130,1579097,cPa75,4,102,33
Scaffold15-1579795_1579897,cPa75,1,1,1579867,1579845,cPa75,5,102,22
Scaffold15-1583000_1583102,cPa75,1,1,1583056,1583034,cPa75,5,102,22
Scaffold15-1583165_1583269,cPa75,1,1,1583247,1583197,cPa75,8,104,50
Scaffold15-1583376_1583652,cPa75,1,1,1583600,1583426,cPa75,9,276,174
Scaffold15-1601664_1601953,cPa75,1,1,1601901,1601714,cPa75,10,289,187
Scaffold15-1602184_1602338,cPa75,1,1,1602286,1602220,cPa75,12,154,66
Scaffold15-1602370_1602476,cPa75,1,1,1602424,1602420,cPa75,2,106,4
Scaffold15-1602657_1602759,cPa75,1,1,1602707,1602707,cPa75,1,102,0
Scaffold15-1608836_1609003,cPa75,1,1,1609003,1608886,cPa75,3,167,117
Scaffold15-1609264_1609366,cPa75,1,1,1609314,1609314,cPa75,1,102,0
Scaffold15-1609861_1609963,cPa75,1,1,1609911,1609911,cPa75,1,102,0
Scaffold15-1615496_1615918,cPa75,1,1,1615869,1615513,cPa75,15,422,356
Scaffold15-1615928_1616030,cPa75,1,1,1615978,1615978,cPa75,1,102,0
Scaffold15-1616065_1616167,cPa75,1,1,1616154,1616115,cPa75,3,102,39
Scaffold15-1618290_1618577,cPa75,1,1,1618576,1618290,cPa75,21,287,286
Scaffold15-1618653_1618764,cPa75,1,1,1618712,1618686,cPa75,9,111,26
Scaffold15-1618921_1619023,cPa75,1,1,1619003,1618926,cPa75,18,102,77
Scaffold15-1619062_1619164,cPa75,1,1,1619112,1619077,cPa75,3,102,35
Scaffold15-1620368_1620777,cPa75,1,1,1620777,1620374,cPa75,28,409,403
Scaffold15-1620812_1620920,cPa75,1,1,1620874,1620827,cPa75,9,108,47
Scaffold15-1620951_1621095,cPa75,1,1,1621043,1620971,cPa75,7,144,72
Scaffold15-1621120_1621309,cPa75,1,1,1621257,1621170,cPa75,18,189,87
Scaffold15-1623743_1623899,cPa75,1,1,1623847,1623777,cPa75,6,156,70
Scaffold15-1623915_1624112,cPa75,1,1,1624060,1623945,cPa75,6,197,115
Scaffold15-1624121_1624652,cPa75,1,1,1624600,1624171,cPa75,51,531,429
Scaffold15-1625234_1625336,cPa75,1,1,1625284,1625284,cPa75,1,102,0
Scaffold15-1625438_1625540,cPa75,1,1,1625488,1625488,cPa75,1,102,0
Scaffold15-1625926_1626028,cPa75,1,1,1625992,1625968,cPa75,3,102,24
Scaffold15-1626125_1626227,cPa75,1,1,1626175,1626175,cPa75,1,102,0
Scaffold15-1626349_1626475,cPa75,1,1,1626423,1626358,cPa75,5,126,65
Scaffold15-1627875_1627977,cPa75,1,1,1627925,1627925,cPa75,1,102,0
Scaffold15-1628030_1628414,cPa75,1,1,1628413,1628080,cPa75,12,384,333
Scaffold15-1628417_1628519,cPa75,1,1,1628493,1628432,cPa75,6,102,61
Scaffold15-1640357_1640459,cPa75,1,1,1640407,1640407,cPa75,1,102,0
Scaffold15-1641144_1641246,cPa75,1,1,1641194,1641194,cPa75,1,102,0
Scaffold15-1641319_1641442,cPa75,1,1,1641390,1641369,cPa75,2,123,21
Scaffold15-1641446_1641597,cPa75,1,1,1641545,1641496,cPa75,3,151,49
Scaffold15-1642195_1642297,cPa75,1,1,1642245,1642245,cPa75,1,102,0
Scaffold15-1643168_1643270,cPa75,1,1,1643218,1643191,cPa75,3,102,27
Scaffold15-1643444_1643546,cPa75,1,1,1643494,1643491,cPa75,2,102,3
Scaffold15-1643962_1644064,cPa75,1,1,1644012,1644012,cPa75,1,102,0
Scaffold15-1646176_1646278,cPa75,1,1,1646273,1646226,cPa75,2,102,47
Scaffold15-1646674_1646850,cPa75,1,1,1646798,1646724,cPa75,2,176,74
Scaffold15-1647193_1647519,cPa75,1,1,1647467,1647243,cPa75,7,326,224
Scaffold15-1656974_1657076,cPa75,1,1,1657024,1657024,cPa75,1,102,0
Scaffold15-1657636_1658052,cPa75,1,1,1658000,1657665,cPa75,27,416,335
Scaffold15-1658068_1658271,cPa75,1,1,1658219,1658076,cPa75,6,203,143
Scaffold15-1658274_1658481,cPa75,1,1,1658429,1658324,cPa75,3,207,105
Scaffold15-1658536_1658672,cPa75,1,1,1658624,1658586,cPa75,4,136,38
Scaffold15-1658686_1658945,cPa75,1,1,1658893,1658736,cPa75,11,259,157
Scaffold15-1672521_1672623,cPa75,1,1,1672581,1672533,cPa75,4,102,48
Scaffold15-1675826_1675928,cPa75,1,1,1675876,1675876,cPa75,1,102,0
Scaffold15-1680470_1680572,cPa75,1,1,1680520,1680520,cPa75,1,102,0
Scaffold15-1680740_1680842,cPa75,1,1,1680790,1680790,cPa75,1,102,0
Scaffold15-1680974_1681246,cPa75,1,1,1681194,1681024,cPa75,11,272,170
Scaffold15-1681254_1681492,cPa75,1,1,1681440,1681263,cPa75,7,238,177
Scaffold15-1681509_1681621,cPa75,1,1,1681569,1681559,cPa75,2,112,10
Scaffold15-1682276_1682378,cPa75,1,1,1682326,1682291,cPa75,2,102,35
Scaffold15-1682854_1682956,cPa75,1,1,1682904,1682904,cPa75,1,102,0
Scaffold15-1683033_1683135,cPa75,1,1,1683083,1683083,cPa75,1,102,0
Scaffold15-1684473_1684672,cPa75,1,1,1684643,1684523,cPa75,6,199,120
Scaffold15-1685087_1685189,cPa75,1,1,1685144,1685137,cPa75,2,102,7
Scaffold15-1685414_1686139,cPa75,1,1,1686120,1685464,cPa75,36,725,656
Scaffold15-16858_16960,cPa75,1,1,16908,16908,cPa75,1,102,0
Scaffold15-1686254_1686356,cPa75,1,1,1686348,1686296,cPa75,5,102,52
Scaffold15-1686445_1686547,cPa75,1,1,1686537,1686495,cPa75,6,102,42
Scaffold15-1689141_1689243,cPa75,1,1,1689191,1689191,cPa75,1,102,0
Scaffold15-1690320_1690422,cPa75,1,1,1690414,1690370,cPa75,3,102,44
Scaffold15-1691535_1691721,cPa75,1,1,1691705,1691585,cPa75,4,186,120
Scaffold15-1697341_1697463,cPa75,1,1,1697411,1697391,cPa75,3,122,20
Scaffold15-1697526_1697933,cPa75,1,1,1697881,1697576,cPa75,11,407,305
Scaffold15-1697960_1698062,cPa75,1,1,1698029,1697997,cPa75,3,102,32
Scaffold15-1698119_1698295,cPa75,1,1,1698243,1698169,cPa75,6,176,74
Scaffold15-169848_170020,cPa75,1,1,169989,169898,cPa75,7,172,91
Scaffold15-1698487_1698593,cPa75,1,1,1698545,1698537,cPa75,3,106,8
Scaffold15-1701240_1701342,cPa75,1,1,1701290,1701290,cPa75,1,102,0
Scaffold15-1701360_1701564,cPa75,1,1,1701512,1701410,cPa75,3,204,102
Scaffold15-170137_170276,cPa75,1,1,170266,170187,cPa75,4,139,79
Scaffold15-1701688_1701790,cPa75,1,1,1701738,1701738,cPa75,1,102,0
Scaffold15-170345_170447,cPa75,1,1,170395,170395,cPa75,1,102,0
Scaffold15-170497_170611,cPa75,1,1,170559,170547,cPa75,2,114,12
Scaffold15-1705234_1705336,cPa75,1,1,1705284,1705284,cPa75,1,102,0
Scaffold15-1705353_1705455,cPa75,1,1,1705403,1705403,cPa75,1,102,0
Scaffold15-170615_171092,cPa75,1,1,171040,170665,cPa75,27,477,375
Scaffold15-1706425_1706527,cPa75,1,1,1706516,1706475,cPa75,2,102,41
Scaffold15-1706541_1706643,cPa75,1,1,1706591,1706591,cPa75,1,102,0
Scaffold15-1706828_1706975,cPa75,1,1,1706923,1706859,cPa75,3,147,64
Scaffold15-1717566_1717668,cPa75,1,1,1717616,1717616,cPa75,1,102,0
Scaffold15-1717725_1717827,cPa75,1,1,1717775,1717775,cPa75,1,102,0
Scaffold15-1717893_1717995,cPa75,1,1,1717943,1717927,cPa75,2,102,16
Scaffold15-1718042_1718350,cPa75,1,1,1718298,1718092,cPa75,12,308,206
Scaffold15-1718536_1718638,cPa75,1,1,1718586,1718586,cPa75,1,102,0
Scaffold15-1718684_1718786,cPa75,1,1,1718734,1718734,cPa75,2,102,0
Scaffold15-1719948_1720050,cPa75,1,1,1720039,1719998,cPa75,2,102,41
Scaffold15-1720093_1720195,cPa75,1,1,1720143,1720143,cPa75,1,102,0
Scaffold15-172079_172213,cPa75,1,1,172161,172129,cPa75,2,134,32
Scaffold15-1721742_1721956,cPa75,1,1,1721904,1721792,cPa75,12,214,112
Scaffold15-1722002_1722785,cPa75,1,1,1722733,1722052,cPa75,46,783,681
Scaffold15-1722825_1722970,cPa75,1,1,1722918,1722875,cPa75,3,145,43
Scaffold15-172396_172991,cPa75,1,1,172939,172446,cPa75,64,595,493
Scaffold15-1724712_1724814,cPa75,1,1,1724762,1724762,cPa75,1,102,0
Scaffold15-1724927_1725238,cPa75,1,1,1725186,1724977,cPa75,8,311,209
Scaffold15-1725682_1725860,cPa75,1,1,1725808,1725732,cPa75,14,178,76
Scaffold15-1725981_1726083,cPa75,1,1,1726078,1726029,cPa75,3,102,49
Scaffold15-1726274_1726390,cPa75,1,1,1726347,1726324,cPa75,8,116,23
Scaffold15-1727517_1727670,cPa75,1,1,1727652,1727567,cPa75,5,153,85
Scaffold15-1729221_1729743,cPa75,1,1,1729691,1729236,cPa75,47,522,455
Scaffold15-1729943_1730089,cPa75,1,1,1730037,1729970,cPa75,5,146,67
Scaffold15-173034_173176,cPa75,1,1,173124,173084,cPa75,6,142,40
Scaffold15-1731342_1731444,cPa75,1,1,1731392,1731392,cPa75,1,102,0
Scaffold15-1733037_1733195,cPa75,1,1,1733143,1733087,cPa75,3,158,56
Scaffold15-1733219_1733539,cPa75,1,1,1733518,1733239,cPa75,11,320,279
Scaffold15-1733606_1733708,cPa75,1,1,1733656,1733638,cPa75,2,102,18
Scaffold15-1734425_1735170,cPa75,1,1,1735131,1734450,cPa75,42,745,681
Scaffold15-1735214_1735316,cPa75,1,1,1735264,1735234,cPa75,3,102,30
Scaffold15-1739079_1739181,cPa75,1,1,1739129,1739129,cPa75,1,102,0
Scaffold15-1739317_1739419,cPa75,1,1,1739392,1739366,cPa75,3,102,26
Scaffold15-1739704_1739806,cPa75,1,1,1739754,1739754,cPa75,1,102,0
Scaffold15-1739826_1739928,cPa75,1,1,1739884,1739876,cPa75,2,102,8
Scaffold15-1743360_1743464,cPa75,1,1,1743428,1743370,cPa75,7,104,58
Scaffold15-1744202_1744304,cPa75,1,1,1744301,1744238,cPa75,11,102,63
Scaffold15-1744799_1744901,cPa75,1,1,1744870,1744843,cPa75,9,102,27
Scaffold15-1745703_1745870,cPa75,1,1,1745845,1745745,cPa75,12,167,100
Scaffold15-1745950_1746149,cPa75,1,1,1746097,1746000,cPa75,6,199,97
Scaffold15-1746560_1746662,cPa75,1,1,1746610,1746610,cPa75,1,102,0
Scaffold15-1747637_1747739,cPa75,1,1,1747721,1747669,cPa75,5,102,52
Scaffold15-1751518_1751855,cPa75,1,1,1751803,1751568,cPa75,10,337,235
Scaffold15-1753329_1753431,cPa75,1,1,1753379,1753379,cPa75,1,102,0
Scaffold15-1755354_1755456,cPa75,1,1,1755404,1755404,cPa75,1,102,0
Scaffold15-1757106_1757208,cPa75,1,1,1757156,1757134,cPa75,2,102,22
Scaffold15-1760319_1760703,cPa75,1,1,1760651,1760333,cPa75,14,384,318
Scaffold15-1760705_1760807,cPa75,1,1,1760755,1760755,cPa75,1,102,0
Scaffold15-1760820_1761644,cPa75,0.978723404255319,2,1761592,1760870,cPa75_cPa75-unknown,46_1,824,722
Scaffold15-1762504_1762606,cPa75,1,1,1762554,1762554,cPa75,1,102,0
Scaffold15-1762951_1763159,cPa75,1,1,1763107,1763001,cPa75,6,208,106
Scaffold15-1763250_1763457,cPa75,1,1,1763405,1763300,cPa75,5,207,105
Scaffold15-1765318_1765420,cPa75,1,1,1765368,1765368,cPa75,1,102,0
Scaffold15-1767120_1767222,cPa75,1,1,1767214,1767124,cPa75,14,102,90
Scaffold15-1770711_1770813,cPa75,1,1,1770767,1770730,cPa75,5,102,37
Scaffold15-1771331_1771500,cPa75,1,1,1771490,1771335,cPa75,11,169,155
Scaffold15-1772626_1772807,cPa75,1,1,1772791,1772676,cPa75,6,181,115
Scaffold15-1773014_1773178,cPa75,1,1,1773126,1773064,cPa75,3,164,62
Scaffold15-1778037_1778139,cPa75,1,1,1778124,1778087,cPa75,3,102,37
Scaffold15-1778608_1779147,cPa75,1,1,1779095,1778658,cPa75,13,539,437
Scaffold15-1779187_1779489,cPa75,1,1,1779440,1779237,cPa75,7,302,203
Scaffold15-1779509_1779723,cPa75,1,1,1779671,1779559,cPa75,7,214,112
Scaffold15-1785060_1785235,cPa75,1,1,1785183,1785110,cPa75,12,175,73
Scaffold15-1785495_1785597,cPa75,1,1,1785545,1785545,cPa75,1,102,0
Scaffold15-1785806_1785908,cPa75,1,1,1785856,1785856,cPa75,1,102,0
Scaffold15-1787624_1787726,cPa75,1,1,1787674,1787674,cPa75,1,102,0
Scaffold15-1791947_1792354,cPa75,1,1,1792302,1791997,cPa75,16,407,305
Scaffold15-1792388_1792593,cPa75,1,1,1792541,1792438,cPa75,18,205,103
Scaffold15-1792603_1792803,cPa75,1,1,1792751,1792653,cPa75,4,200,98
Scaffold15-1793815_1794185,cPa75,1,1,1794154,1793865,cPa75,7,370,289
Scaffold15-1794209_1794887,cPa75,1,1,1794835,1794259,cPa75,28,678,576
Scaffold15-1799709_1799811,cPa75,1,1,1799759,1799759,cPa75,1,102,0
Scaffold15-1800004_1800106,cPa75,1,1,1800054,1800054,cPa75,1,102,0
Scaffold15-1809645_1809747,cPa75,1,1,1809695,1809683,cPa75,2,102,12
Scaffold15-1815241_1815343,cPa75,1,1,1815291,1815291,cPa75,1,102,0
Scaffold15-1815430_1815592,cPa75,1,1,1815545,1815480,cPa75,3,162,65
Scaffold15-1815750_1815852,cPa75,1,1,1815800,1815800,cPa75,2,102,0
Scaffold15-1815911_1816013,cPa75,1,1,1815961,1815961,cPa75,1,102,0
Scaffold15-1816133_1816235,cPa75,1,1,1816183,1816183,cPa75,1,102,0
Scaffold15-1816277_1816433,cPa75,1,1,1816381,1816327,cPa75,2,156,54
Scaffold15-1822321_1822423,cPa75,1,1,1822371,1822371,cPa75,1,102,0
Scaffold15-1823155_1823257,cPa75,1,1,1823205,1823205,cPa75,1,102,0
Scaffold15-1838897_1839041,cPa75,1,1,1838989,1838905,cPa75,5,144,84
Scaffold15-1839168_1839478,cPa75,1,1,1839426,1839218,cPa75,5,310,208
Scaffold15-1839694_1839796,cPa75,1,1,1839744,1839744,cPa75,1,102,0
Scaffold15-1839884_1839986,cPa75,1,1,1839934,1839907,cPa75,2,102,27
Scaffold15-1840078_1840180,cPa75,1,1,1840128,1840128,cPa75,1,102,0
Scaffold15-1840223_1840325,cPa75,1,1,1840273,1840273,cPa75,1,102,0
Scaffold15-1843227_1843419,cPa62_cPa62-cPa75-hybrid,0.5,2,1843367,1843277,cPa62_cPa62-cPa75-hybrid,1_1,192,90
Scaffold15-1849140_1849242,cPa75,1,1,1849190,1849190,cPa75,1,102,0
Scaffold15-1855408_1855510,cPa75,1,1,1855458,1855458,cPa75,1,102,0
Scaffold15-1857737_1857839,cPa75,1,1,1857787,1857740,cPa75,3,102,47
Scaffold15-1858777_1858935,cPa75,1,1,1858883,1858827,cPa75,6,158,56
Scaffold15-1859077_1859392,cPa75,0.9,3,1859391,1859121,cPa492_cPa492-cPa75-hybrid_cPa75,1_1_18,315,270
Scaffold15-1862162_1862344,cPa75,1,1,1862292,1862212,cPa75,3,182,80
Scaffold15-1862612_1862714,cPa75,1,1,1862662,1862624,cPa75,4,102,38
Scaffold15-1863008_1863110,cPa75,1,1,1863058,1863024,cPa75,3,102,34
Scaffold15-1863338_1863526,cPa75,0.964285714285714,2,1863500,1863347,cPa75_cPa75-unknown,27_1,188,153
Scaffold15-186464_186566,cPa75,1,1,186536,186488,cPa75,4,102,48
Scaffold15-186694_186873,cPa75,1,1,186834,186693,cPa75,11,179,141
Scaffold15-1868886_1868988,cPa75,1,1,1868936,1868936,cPa75,1,102,0
Scaffold15-186901_187197,cPa75,1,1,187145,186951,cPa75,7,296,194
Scaffold15-187224_187859,cPa75,1,1,187807,187274,cPa75,33,635,533
Scaffold15-1876324_1876426,cPa75,1,1,1876374,1876374,cPa75,1,102,0
Scaffold15-1879664_1879766,cPa75,1,1,1879714,1879714,cPa75,1,102,0
Scaffold15-1880156_1880258,cPa75,1,1,1880206,1880206,cPa75,1,102,0
Scaffold15-1881437_1881619,cPa75,1,1,1881611,1881454,cPa75,14,182,157
Scaffold15-1882007_1882109,cPa75,1,1,1882057,1882037,cPa75,3,102,20
Scaffold15-1886091_1886298,cPa75,1,1,1886246,1886141,cPa75,3,207,105
Scaffold15-1886334_1886764,cPa75,1,1,1886712,1886384,cPa75,22,430,328
Scaffold15-1886906_1887008,cPa75,1,1,1886956,1886919,cPa75,2,102,37
Scaffold15-1890489_1890748,cPa75,1,1,1890696,1890522,cPa75,5,259,174
Scaffold15-1890782_1891104,cPa75,1,1,1891052,1890832,cPa75,18,322,220
Scaffold15-1900128_1900330,cPa75,1,1,1900278,1900178,cPa75,3,202,100
Scaffold15-1900626_1900933,cPa75,1,1,1900930,1900676,cPa75,9,307,254
Scaffold15-1900959_1901070,cPa75,1,1,1901018,1901009,cPa75,2,111,9
Scaffold15-1901079_1901193,cPa75,1,1,1901141,1901129,cPa75,2,114,12
Scaffold15-1901218_1901525,cPa75,1,1,1901473,1901224,cPa75,6,307,249
Scaffold15-1906326_1906497,cPa75,1,1,1906445,1906376,cPa75,3,171,69
Scaffold15-1906507_1906609,cPa75,1,1,1906557,1906512,cPa75,23,102,45
Scaffold15-1906801_1906903,cPa75,1,1,1906903,1906817,cPa75,9,102,86
Scaffold15-1906976_1907147,cPa75,1,1,1907095,1906978,cPa75,10,171,117
Scaffold15-1908657_1908778,cPa75,1,1,1908726,1908707,cPa75,2,121,19
Scaffold15-1917747_1917849,cPa75,1,1,1917797,1917797,cPa75,1,102,0
Scaffold15-1920737_1920839,cPa75,1,1,1920787,1920744,cPa75,2,102,43
Scaffold15-1921037_1921204,cPa75,1,1,1921152,1921087,cPa75,7,167,65
Scaffold15-1921227_1921774,cPa75,1,1,1921722,1921277,cPa75,37,547,445
Scaffold15-1921874_1921976,cPa75,1,1,1921924,1921924,cPa75,1,102,0
Scaffold15-1925586_1925750,cPa75,1,1,1925720,1925633,cPa75,4,164,87
Scaffold15-1925921_1926023,cPa75,1,1,1926017,1925971,cPa75,2,102,46
Scaffold15-1926040_1926165,cPa75,1,1,1926113,1926090,cPa75,5,125,23
Scaffold15-1931290_1931392,cPa75,1,1,1931340,1931340,cPa75,1,102,0
Scaffold15-1940710_1940812,cPa75,1,1,1940760,1940760,cPa75,1,102,0
Scaffold15-1944505_1944607,cPa75,1,1,1944555,1944555,cPa75,1,102,0
Scaffold15-194485_194587,cPa419_cPa446,0.5,2,194535,194535,cPa419_cPa446,1_1,102,0
Scaffold15-1949081_1949308,cPa75-unknown,0.714285714285714,2,1949256,1949131,cPa75_cPa75-unknown,2_5,227,125
Scaffold15-1949350_1949452,cPa75-unknown,1,1,1949400,1949400,cPa75-unknown,1,102,0
Scaffold15-1955658_1955834,cPa75,1,1,1955782,1955708,cPa75,2,176,74
Scaffold15-1957735_1957933,cPa75,0.823529411764706,2,1957886,1957751,cPa75_cPa75-unknown,14_3,198,135
Scaffold15-198971_199073,cPa16,0.6,3,199054,198976,cPa16_cPa71_cPa75,3_1_1,102,78
Scaffold15-1997403_1997797,cPa62,0.666666666666667,4,1997787,1997453,cPa62_cPa75_cPa75-cPa62-hybrid_cPa75-unknown,22_5_4_2,394,334
Scaffold15-2000666_2000830,cPa75,1,1,2000778,2000716,cPa75,2,164,62
Scaffold15-2005257_2005359,cPa75,1,1,2005307,2005307,cPa75,1,102,0
Scaffold15-2031716_2031818,cPa75,1,1,2031766,2031766,cPa75,1,102,0
Scaffold15-2034000_2034132,cPa75,1,1,2034080,2034050,cPa75,3,132,30
Scaffold15-2034376_2034478,cPa75,1,1,2034426,2034426,cPa75,1,102,0
Scaffold15-2037694_2037826,cPa75,1,1,2037774,2037744,cPa75,2,132,30
Scaffold15-2038041_2039149,cPa75,1,1,2039097,2038091,cPa75,55,1108,1006
Scaffold15-2039210_2039312,cPa75,1,1,2039260,2039260,cPa75,1,102,0
Scaffold15-2039512_2039614,cPa75,1,1,2039562,2039562,cPa75,1,102,0
Scaffold15-2051680_2051782,cPa75,1,1,2051730,2051703,cPa75,3,102,27
Scaffold15-2051824_2051926,cPa75,1,1,2051920,2051874,cPa75,4,102,46
Scaffold15-2052008_2052172,cPa75,1,1,2052120,2052056,cPa75,4,164,64
Scaffold15-2052213_2052315,cPa75,1,1,2052286,2052241,cPa75,4,102,45
Scaffold15-2052377_2052551,cPa75,1,1,2052499,2052423,cPa75,25,174,76
Scaffold15-2052605_2052707,cPa75,1,1,2052655,2052655,cPa75,1,102,0
Scaffold15-205427_205529,cPa260-cPa62-hybrid_cPa260-unknown,0.5,2,205477,205465,cPa260-cPa62-hybrid_cPa260-unknown,1_1,102,12
Scaffold15-2055873_2055975,cPa75,1,1,2055923,2055923,cPa75,1,102,0
Scaffold15-2056153_2056340,cPa75,0.875,2,2056289,2056203,cPa308-cPa75-hybrid_cPa75,2_14,187,86
Scaffold15-2074211_2074313,cPa75,1,1,2074261,2074261,cPa75,1,102,0
Scaffold15-2087513_2087615,cPa75_cPa75-unknown,0.5,2,2087603,2087563,cPa75_cPa75-unknown,1_1,102,40
Scaffold15-2087648_2087750,cPa75,1,1,2087698,2087698,cPa75,1,102,0
Scaffold15-2087823_2087962,cPa75,1,1,2087910,2087873,cPa75,2,139,37
Scaffold15-2088095_2088203,cPa75,1,1,2088151,2088145,cPa75,2,108,6
Scaffold15-2088298_2088526,cPa75,1,1,2088474,2088348,cPa75,4,228,126
Scaffold15-2125331_2126001,cPa75,1,1,2125960,2125356,cPa75,23,670,604
Scaffold15-2126452_2126554,cPa75,1,1,2126502,2126502,cPa75,1,102,0
Scaffold15-2126735_2126998,cPa75,1,1,2126946,2126785,cPa75,6,263,161
Scaffold15-2127391_2127493,cPa75,1,1,2127451,2127441,cPa75,3,102,10
Scaffold15-2151970_2152072,cPa75,1,1,2152020,2152020,cPa75,1,102,0
Scaffold15-2152255_2152427,cPa75,1,1,2152375,2152305,cPa75,3,172,70
Scaffold15-2158305_2158407,cPa75,1,1,2158355,2158355,cPa75,1,102,0
Scaffold15-2158418_2158772,cPa75,1,1,2158765,2158468,cPa75,12,354,297
Scaffold15-2158838_2159034,cPa75,1,1,2158984,2158888,cPa75,5,196,96
Scaffold15-2160328_2160430,cPa75,1,1,2160378,2160378,cPa75,1,102,0
Scaffold15-2160914_2161137,cPa75,1,1,2161085,2160964,cPa75,4,223,121
Scaffold15-2161192_2161311,cPa75,1,1,2161259,2161242,cPa75,6,119,17
Scaffold15-2162262_2162376,cPa75,1,1,2162347,2162283,cPa75,5,114,64
Scaffold15-2162415_2162538,cPa75,1,1,2162513,2162418,cPa75,5,123,95
Scaffold15-2162706_2162808,cPa75,1,1,2162756,2162719,cPa75,3,102,37
Scaffold15-2176484_2176667,cPa75,1,1,2176615,2176534,cPa75,8,183,81
Scaffold15-2179718_2179820,cPa75,1,1,2179768,2179768,cPa75,2,102,0
Scaffold15-2179898_2180091,cPa75,1,1,2180039,2179948,cPa75,2,193,91
Scaffold15-2180535_2180637,cPa75,1,1,2180585,2180585,cPa75,1,102,0
Scaffold15-2180975_2181077,cPa75,1,1,2181025,2181025,cPa75,1,102,0
Scaffold15-2181177_2181279,cPa75,1,1,2181227,2181227,cPa75,1,102,0
Scaffold15-2181339_2181441,cPa75,1,1,2181389,2181389,cPa75,1,102,0
Scaffold15-2193998_2194202,cPa75,1,1,2194150,2194048,cPa75,2,204,102
Scaffold15-2194349_2194451,cPa75,1,1,2194399,2194399,cPa75,1,102,0
Scaffold15-2200656_2200801,cPa75,1,1,2200749,2200706,cPa75,2,145,43
Scaffold15-2201445_2201547,cPa75,1,1,2201495,2201495,cPa75,1,102,0
Scaffold15-2202997_2203613,cPa75,1,1,2203601,2203047,cPa75,24,616,554
Scaffold15-2203640_2203742,cPa75,1,1,2203690,2203690,cPa75,1,102,0
Scaffold15-2209061_2209250,cPa75,1,1,2209198,2209111,cPa75,2,189,87
Scaffold15-2209363_2209465,cPa75,1,1,2209413,2209413,cPa75,1,102,0
Scaffold15-2209593_2209827,cPa75,1,1,2209775,2209643,cPa75,10,234,132
Scaffold15-2209830_2209979,cPa75,1,1,2209927,2209880,cPa75,2,149,47
Scaffold15-2210081_2210255,cPa75,1,1,2210203,2210131,cPa75,4,174,72
Scaffold15-2217676_2217778,cPa75_cPa75-unknown,0.5,2,2217750,2217726,cPa75_cPa75-unknown,1_1,102,24
Scaffold15-2221854_2221956,cPa75,1,1,2221904,2221904,cPa75,1,102,0
Scaffold15-2222909_2223034,cPa75,1,1,2222990,2222959,cPa75,4,125,31
Scaffold15-2223262_2223515,cPa75,0.857142857142857,2,2223463,2223312,cPa75_cPa75-unknown,6_1,253,151
Scaffold15-2223531_2223695,cPa75,0.8,2,2223643,2223581,cPa75_cPa75-unknown,4_1,164,62
Scaffold15-2223881_2223984,cPa75,1,1,2223932,2223931,cPa75,2,103,1
Scaffold15-2224032_2224142,cPa75,1,1,2224090,2224082,cPa75,2,110,8
Scaffold15-2233769_2233871,cPa75,1,1,2233819,2233819,cPa75,1,102,0
Scaffold15-2233944_2234046,cPa75,1,1,2233994,2233994,cPa75,1,102,0
Scaffold15-2234440_2234542,cPa75,1,1,2234490,2234490,cPa75,1,102,0
Scaffold15-2237292_2237394,cPa75,1,1,2237342,2237342,cPa75,1,102,0
Scaffold15-2238293_2238395,cPa75,1,1,2238392,2238343,cPa75,3,102,49
Scaffold15-2238495_2238597,cPa75,1,1,2238547,2238545,cPa75,2,102,2
Scaffold15-2239015_2239117,cPa75,1,1,2239065,2239059,cPa75,2,102,6
Scaffold15-2239135_2239336,cPa75,1,1,2239297,2239185,cPa75,5,201,112
Scaffold15-2239404_2239506,cPa75,1,1,2239454,2239454,cPa75,1,102,0
Scaffold15-2239615_2239958,cPa75,1,1,2239906,2239665,cPa75,10,343,241
Scaffold15-22411_22567,cPa75,1,1,22515,22461,cPa75,3,156,54
Scaffold15-2243860_2243962,cPa75,1,1,2243951,2243888,cPa75,5,102,63
Scaffold15-2244051_2244232,cPa75,1,1,2244180,2244101,cPa75,3,181,79
Scaffold15-2244305_2244482,cPa75,1,1,2244430,2244355,cPa75,9,177,75
Scaffold15-2244497_2244623,cPa75,1,1,2244571,2244547,cPa75,2,126,24
Scaffold15-2244776_2245267,cPa75,1,1,2245215,2244826,cPa75,17,491,389
Scaffold15-2245280_2245456,cPa75,1,1,2245404,2245330,cPa75,2,176,74
Scaffold15-2245731_2245833,cPa75,1,1,2245781,2245776,cPa75,2,102,5
Scaffold15-2246071_2246173,cPa75,1,1,2246121,2246121,cPa75,1,102,0
Scaffold15-2248346_2248448,cPa75,1,1,2248396,2248385,cPa75,3,102,11
Scaffold15-2248675_2249367,cPa75,1,1,2249315,2248725,cPa75,46,692,590
Scaffold15-2249371_2249479,cPa75,1,1,2249427,2249379,cPa75,3,108,48
Scaffold15-2249506_2249608,cPa75,1,1,2249572,2249505,cPa75,9,102,67
Scaffold15-22600_22702,cPa75,1,1,22651,22650,cPa75,2,102,1
Scaffold15-22931_23054,cPa75,1,1,23002,22981,cPa75,8,123,21
Scaffold15-245145_246368,cPa75,1,1,246316,245156,cPa75,38,1223,1160
Scaffold15-275253_275355,cPa75,1,1,275303,275303,cPa75,1,102,0
Scaffold15-280265_280367,cPa75,1,1,280315,280315,cPa75,1,102,0
Scaffold15-280444_280546,cPa75,1,1,280494,280494,cPa75,1,102,0
Scaffold15-280606_280748,cPa75,1,1,280696,280656,cPa75,5,142,40
Scaffold15-280772_281022,cPa75,1,1,280970,280822,cPa75,8,250,148
Scaffold15-285905_286007,cPa75-cPa285-hybrid,1,1,285955,285955,cPa75-cPa285-hybrid,1,102,0
Scaffold15-29161_29308,PERVE_NC003059-cPa75-hybrid,0.666666666666667,2,29256,29211,cPa223-cPa75-hybrid_PERVE_NC003059-cPa75-hybrid,1_2,147,45
Scaffold15-293635_293854,cPa75,1,1,293802,293685,cPa75,5,219,117
Scaffold15-293869_294185,cPa75,0.9,2,294133,293919,cPa447-cPa75-hybrid_cPa75,1_9,316,214
Scaffold15-294321_294529,cPa75,1,1,294477,294371,cPa75,8,208,106
Scaffold15-294986_295088,cPa75,1,1,295036,295036,cPa75,1,102,0
Scaffold15-302348_302735,cPa75,1,1,302683,302398,cPa75,8,387,285
Scaffold15-302768_302870,cPa75,1,1,302818,302818,cPa75,1,102,0
Scaffold15-302879_303314,cPa75,1,1,303262,302902,cPa75,33,435,360
Scaffold15-303378_303978,cPa75,1,1,303937,303407,cPa75,28,600,530
Scaffold15-30447_30549,cPa223-cPa75-hybrid,1,1,30497,30497,cPa223-cPa75-hybrid,1,102,0
Scaffold15-318948_319050,cPa285,1,1,319033,318982,cPa285,5,102,51
Scaffold15-319445_319570,cPa285_cPa293_cPa293-cPa285-hybrid,0.333333333333333,3,319518,319495,cPa285_cPa293_cPa293-cPa285-hybrid,1_1_1,125,23
Scaffold15-319889_319991,cPa293,1,1,319939,319939,cPa293,1,102,0
Scaffold15-327883_327985,cPa62,1,1,327933,327933,cPa62,1,102,0
Scaffold15-36029_36141,cPa75,1,1,36121,36079,cPa75,5,112,42
Scaffold15-36164_36266,cPa75,1,1,36214,36214,cPa75,2,102,0
Scaffold15-36280_36448,cPa75,1,1,36396,36330,cPa75,2,168,66
Scaffold15-36565_36805,cPa75,1,1,36753,36615,cPa75,5,240,138
Scaffold15-36827_37030,cPa75,1,1,36978,36830,cPa75,4,203,148
Scaffold15-37058_37201,cPa75,1,1,37149,37108,cPa75,4,143,41
Scaffold15-37340_37920,cPa75,1,1,37868,37390,cPa75,20,580,478
Scaffold15-414728_414830,cPa75,1,1,414778,414778,cPa75,1,102,0
Scaffold15-423890_424136,cPa75,1,1,424093,423920,cPa75,10,246,173
Scaffold15-424271_424684,cPa75,1,1,424632,424321,cPa75,19,413,311
Scaffold15-424775_424919,cPa75,1,1,424867,424825,cPa75,9,144,42
Scaffold15-430404_430506,cPa75,1,1,430454,430454,cPa75,1,102,0
Scaffold15-438138_438240,cPa75,1,1,438231,438188,cPa75,2,102,43
Scaffold15-438955_439057,cPa75,1,1,439005,438987,cPa75,3,102,18
Scaffold15-439111_439213,cPa75,1,1,439161,439161,cPa75,1,102,0
Scaffold15-439666_439804,cPa75,1,1,439783,439716,cPa75,3,138,67
Scaffold15-440519_440646,cPa75,1,1,440594,440569,cPa75,12,127,25
Scaffold15-440695_440797,cPa75,1,1,440745,440745,cPa75,1,102,0
Scaffold15-444678_444780,cPa75,1,1,444728,444728,cPa75,1,102,0
Scaffold15-445241_445580,cPa75,1,1,445561,445254,cPa75,37,339,307
Scaffold15-447947_448049,cPa75,1,1,447997,447997,cPa75,1,102,0
Scaffold15-448102_448204,cPa75,1,1,448152,448152,cPa75,1,102,0
Scaffold15-448717_448819,cPa75,1,1,448767,448767,cPa75,1,102,0
Scaffold15-448893_449070,cPa75,1,1,449018,448915,cPa75,15,177,103
Scaffold15-46286_46388,cPa75,1,1,46336,46336,cPa75,1,102,0
Scaffold15-478766_478868,cPa75,1,1,478816,478816,cPa75,1,102,0
Scaffold15-510552_510654,cPa75-unknown,1,1,510602,510602,cPa75-unknown,1,102,0
Scaffold15-510711_510813,cPa75-unknown,1,1,510761,510761,cPa75-unknown,1,102,0
Scaffold15-51656_51758,cPa75,1,1,51706,51706,cPa75,1,102,0
Scaffold15-518849_518951,cPa75,1,1,518899,518899,cPa75,1,102,0
Scaffold15-519689_519800,cPa75,1,1,519748,519739,cPa75,2,111,9
Scaffold15-519855_519957,cPa75,1,1,519905,519905,cPa75,1,102,0
Scaffold15-52459_52561,cPa75,1,1,52509,52509,cPa75,1,102,0
Scaffold15-5262_5389,cPa75,1,1,5337,5312,cPa75,2,127,25
Scaffold15-52815_52917,cPa75,1,1,52865,52865,cPa75,1,102,0
Scaffold15-528718_528963,cPa75,1,1,528911,528768,cPa75,4,245,143
Scaffold15-53092_53194,cPa75,1,1,53142,53142,cPa75,1,102,0
Scaffold15-534119_534263,cPa75,1,1,534211,534169,cPa75,3,144,42
Scaffold15-5416_5616,cPa75,1,1,5564,5466,cPa75,3,200,98
Scaffold15-5627_5820,cPa75,1,1,5768,5666,cPa75,10,193,102
Scaffold15-571366_571468,cPa75,1,1,571416,571416,cPa75,1,102,0
Scaffold15-577194_577332,cPa75,1,1,577280,577244,cPa75,3,138,36
Scaffold15-577482_577704,cPa75,1,1,577652,577532,cPa75,4,222,120
Scaffold15-577833_578024,cPa75,1,1,577972,577883,cPa75,3,191,89
Scaffold15-5830_6187,cPa75,1,1,6143,5880,cPa75,20,357,263
Scaffold15-594281_594383,cPa75,1,1,594331,594303,cPa75,2,102,28
Scaffold15-594556_594658,cPa75,1,1,594615,594606,cPa75,2,102,9
Scaffold15-594680_595002,cPa75,1,1,594950,594730,cPa75,7,322,220
Scaffold15-601900_602002,cPa75,1,1,601950,601950,cPa75,1,102,0
Scaffold15-602321_602423,cPa75,1,1,602371,602371,cPa75,1,102,0
Scaffold15-602628_602730,cPa75,1,1,602678,602678,cPa75,1,102,0
Scaffold15-602889_603075,cPa75,1,1,603023,602939,cPa75,4,186,84
Scaffold15-603836_603938,cPa75,1,1,603886,603886,cPa75,1,102,0
Scaffold15-608046_608203,cPa75,1,1,608151,608062,cPa75,9,157,89
Scaffold15-608229_608919,cPa75,1,1,608867,608279,cPa75,44,690,588
Scaffold15-61274_61376,cPa75,1,1,61324,61324,cPa75,1,102,0
Scaffold15-6208_6348,cPa75,1,1,6296,6258,cPa75,5,140,38
Scaffold15-629494_629596,cPa75,1,1,629544,629544,cPa75,1,102,0
Scaffold15-662333_662435,cPa75,1,1,662383,662383,cPa75,1,102,0
Scaffold15-662528_662654,cPa75,1,1,662602,662578,cPa75,3,126,24
Scaffold15-664291_664592,cPa75,0.818181818181818,2,664540,664341,cPa75_cPa75-unknown,9_2,301,199
Scaffold15-681943_682045,cPa75,1,1,681993,681993,cPa75,1,102,0
Scaffold15-685765_685867,cPa75,1,1,685843,685815,cPa75,2,102,28
Scaffold15-685950_686057,cPa75,1,1,686005,686000,cPa75,2,107,5
Scaffold15-686154_686256,cPa75,1,1,686205,686204,cPa75,2,102,1
Scaffold15-686387_686489,cPa75,1,1,686437,686437,cPa75,1,102,0
Scaffold15-686572_686682,cPa75,1,1,686665,686622,cPa75,5,110,43
Scaffold15-688093_688195,cPa75,1,1,688143,688143,cPa75,1,102,0
Scaffold15-697893_698002,cPa75,1,1,697950,697943,cPa75,2,109,7
Scaffold15-698016_698503,cPa75,1,1,698451,698066,cPa75,17,487,385
Scaffold15-698597_698703,cPa75,1,1,698651,698647,cPa75,2,106,4
Scaffold15-70061_70163,cPa75,1,1,70148,70106,cPa75,5,102,42
Scaffold15-70241_70376,cPa75,1,1,70355,70260,cPa75,10,135,95
Scaffold15-713197_713299,cPa75,1,1,713247,713247,cPa75,1,102,0
Scaffold15-713535_713637,cPa75,1,1,713585,713585,cPa75,1,102,0
Scaffold15-71938_72040,cPa75,1,1,71988,71988,cPa75,1,102,0
Scaffold15-721606_721708,cPa75,1,1,721656,721656,cPa75,1,102,0
Scaffold15-721710_721870,cPa75,1,1,721818,721760,cPa75,2,160,58
Scaffold15-735751_735892,cPa75,1,1,735840,735801,cPa75,2,141,39
Scaffold15-73940_74042,cPa75,1,1,74012,73986,cPa75,4,102,26
Scaffold15-74046_74661,cPa75,1,1,74660,74049,cPa75,64,615,611
Scaffold15-744767_744941,cPa75,1,1,744889,744817,cPa75,3,174,72
Scaffold15-746294_746478,cPa75,1,1,746426,746344,cPa75,4,184,82
Scaffold15-746721_746893,cPa75,1,1,746841,746771,cPa75,11,172,70
Scaffold15-747298_747400,cPa75,1,1,747356,747348,cPa75,2,102,8
Scaffold15-749792_749945,cPa75,1,1,749893,749842,cPa75,2,153,51
Scaffold15-750816_750918,cPa75,1,1,750866,750866,cPa75,1,102,0
Scaffold15-750934_751067,cPa75,1,1,751015,750984,cPa75,2,133,31
Scaffold15-762477_762579,cPa75,1,1,762527,762527,cPa75,1,102,0
Scaffold15-770630_770732,cPa75,1,1,770713,770651,cPa75,3,102,62
Scaffold15-771069_771171,cPa75,1,1,771119,771119,cPa75,1,102,0
Scaffold15-771187_771299,cPa75,1,1,771247,771212,cPa75,4,112,35
Scaffold15-771341_771443,cPa75,1,1,771417,771364,cPa75,4,102,53
Scaffold15-771608_771710,cPa75,1,1,771658,771634,cPa75,2,102,24
Scaffold15-777240_777426,cPa75,1,1,777374,777290,cPa75,6,186,84
Scaffold15-777459_777831,cPa75,1,1,777779,777509,cPa75,22,372,270
Scaffold15-777879_778250,cPa75,1,1,778198,777929,cPa75,18,371,269
Scaffold15-778349_778451,cPa75,1,1,778399,778399,cPa75,1,102,0
Scaffold15-778487_778711,cPa75,1,1,778659,778537,cPa75,3,224,122
Scaffold15-786527_786750,cPa75,1,1,786698,786577,cPa75,4,223,121
Scaffold15-786769_786871,cPa75,1,1,786819,786819,cPa75,1,102,0
Scaffold15-786945_787262,cPa75,1,1,787210,786995,cPa75,10,317,215
Scaffold15-787441_787588,cPa75,1,1,787536,787491,cPa75,2,147,45
Scaffold15-787611_787894,cPa75,1,1,787842,787661,cPa75,5,283,181
Scaffold15-787979_788081,cPa75,1,1,788029,788029,cPa75,1,102,0
Scaffold15-790796_790898,cPa75,1,1,790854,790846,cPa75,2,102,8
Scaffold15-790933_791088,cPa75,1,1,791036,790983,cPa75,6,155,53
Scaffold15-791101_791237,cPa75,1,1,791185,791137,cPa75,7,136,48
Scaffold15-791351_791453,cPa75,1,1,791401,791394,cPa75,3,102,7
Scaffold15-791491_791670,cPa75,1,1,791657,791541,cPa75,6,179,116
Scaffold15-791692_791799,cPa75,1,1,791747,791742,cPa75,3,107,5
Scaffold15-813251_813726,cPa75,1,1,813674,813301,cPa75,34,475,373
Scaffold15-813796_814356,cPa75,1,1,814304,813835,cPa75,24,560,469
Scaffold15-814471_814573,cPa75,1,1,814521,814521,cPa75,1,102,0
Scaffold15-81559_81789,cPa75,1,1,81737,81609,cPa75,4,230,128
Scaffold15-81834_82033,cPa75,1,1,81981,81884,cPa75,2,199,97
Scaffold15-82062_82215,cPa75,1,1,82209,82112,cPa75,4,153,97
Scaffold15-82261_82363,cPa75,1,1,82311,82311,cPa75,1,102,0
Scaffold15-82439_82677,cPa75,1,1,82625,82489,cPa75,3,238,136
Scaffold15-827300_827762,cPa75,1,1,827710,827350,cPa75,17,462,360
Scaffold15-827778_827880,cPa75,1,1,827828,827828,cPa75,1,102,0
Scaffold15-827891_828140,cPa75,1,1,828132,827941,cPa75,12,249,191
Scaffold15-833020_833167,cPa75,1,1,833115,833070,cPa75,3,147,45
Scaffold15-833420_834138,cPa75,1,1,834086,833470,cPa75,33,718,616
Scaffold15-836145_836260,cPa75,1,1,836237,836177,cPa75,9,115,60
Scaffold15-836286_836479,cPa75,1,1,836465,836305,cPa75,18,193,160
Scaffold15-842962_843064,cPa75,1,1,843012,843012,cPa75,1,102,0
Scaffold15-843387_843489,cPa551-cPa75-hybrid,1,1,843437,843437,cPa551-cPa75-hybrid,1,102,0
Scaffold15-843701_843920,cPa75,1,1,843868,843751,cPa75,4,219,117
Scaffold15-843954_844134,cPa75,1,1,844082,844004,cPa75,4,180,78
Scaffold15-844285_844595,cPa75,1,1,844543,844335,cPa75,8,310,208
Scaffold15-851011_851113,cPa75,1,1,851061,851061,cPa75,1,102,0
Scaffold15-851613_851715,cPa75,1,1,851663,851663,cPa75,1,102,0
Scaffold15-854974_855076,cPa75,1,1,855024,855024,cPa75,1,102,0
Scaffold15-855124_855226,cPa75,1,1,855174,855174,cPa75,1,102,0
Scaffold15-855559_855661,cPa75,1,1,855609,855609,cPa75,1,102,0
Scaffold15-855850_856135,cPa75,1,1,856083,855900,cPa75,3,285,183
Scaffold15-863315_863417,cPa75,1,1,863365,863365,cPa75,1,102,0
Scaffold15-863592_863779,cPa75,1,1,863727,863642,cPa75,2,187,85
Scaffold15-866199_866301,cPa75,1,1,866249,866249,cPa75,1,102,0
Scaffold15-869894_870547,cPa75,1,1,870547,869944,cPa75,31,653,603
Scaffold15-870598_870837,cPa75,1,1,870785,870614,cPa75,13,239,171
Scaffold15-871395_871497,cPa75,1,1,871445,871445,cPa75,1,102,0
Scaffold15-871811_872053,cPa75,1,1,872019,871840,cPa75,13,242,179
Scaffold15-876005_876126,cPa75,1,1,876080,876009,cPa75,6,121,71
Scaffold15-876257_876359,cPa75,1,1,876315,876278,cPa75,3,102,37
Scaffold15-876453_876555,cPa75,1,1,876503,876503,cPa75,1,102,0
Scaffold15-876593_876717,cPa75,1,1,876706,876598,cPa75,7,124,108
Scaffold15-876817_877585,cPa75,1,1,877533,876867,cPa75,58,768,666
Scaffold15-877836_877938,cPa75,1,1,877926,877886,cPa75,2,102,40
Scaffold15-878252_878354,cPa75,1,1,878302,878302,cPa75,1,102,0
Scaffold15-879943_880045,cPa75,1,1,879993,879993,cPa75,1,102,0
Scaffold15-892520_892622,cPa75,1,1,892570,892570,cPa75,1,102,0
Scaffold15-893719_893821,cPa75,1,1,893769,893769,cPa75,1,102,0
Scaffold15-894351_894453,cPa75,1,1,894401,894401,cPa75,1,102,0
Scaffold15-902263_902422,cPa75,1,1,902370,902313,cPa75,4,159,57
Scaffold15-902467_903245,cPa75,1,1,903193,902517,cPa75,43,778,676
Scaffold15-926806_926908,cPa75,1,1,926856,926856,cPa75,1,102,0
Scaffold15-929887_929995,cPa75,1,1,929943,929937,cPa75,2,108,6
Scaffold15-930397_930499,cPa75,1,1,930447,930447,cPa75,1,102,0
Scaffold15-930745_930847,cPa75,1,1,930795,930795,cPa75,1,102,0
Scaffold15-934639_934990,cPa75-unknown,0.916666666666667,2,934938,934642,cPa75_cPa75-unknown,1_11,351,296
Scaffold15-935135_935237,cPa75,1,1,935185,935185,cPa75,1,102,0
Scaffold15-935242_935626,cPa75,1,1,935574,935292,cPa75,8,384,282
Scaffold15-936096_936198,cPa75,1,1,936146,936140,cPa75,2,102,6
Scaffold15-963854_963979,cPa75,1,1,963927,963873,cPa75,3,125,54
Scaffold15-966078_966180,cPa75,1,1,966128,966128,cPa75,2,102,0
Scaffold15-966519_966621,cPa75,1,1,966569,966569,cPa75,1,102,0
Scaffold15-966919_967021,cPa75,1,1,966969,966969,cPa75,1,102,0
Scaffold15-98791_99743,cPa75,1,1,99691,98802,cPa75,43,952,889
Scaffold15-989097_989199,cPa254,1,1,989147,989147,cPa254,1,102,0
Scaffold15-993075_993177,cPa75,1,1,993125,993125,cPa75,1,102,0
Scaffold151-106129_106231,cPa428,1,1,106179,106179,cPa428,1,102,0
Scaffold151-109175_109277,cPa356_cPa428,0.5,2,109225,109225,cPa356_cPa428,1_1,102,0
Scaffold151-109957_110059,cPa428,1,1,110007,110007,cPa428,1,102,0
Scaffold151-110061_110163,cPa428,1,1,110111,110111,cPa428,1,102,0
Scaffold151-110500_110602,cPa428,0.666666666666667,2,110550,110515,cPa356_cPa428,1_2,102,35
Scaffold151-110995_111097,cPa356,0.6,2,111096,111001,cPa356_cPa428,3_2,102,95
Scaffold151-113433_113535,cPa428,0.6,2,113483,113442,cPa356_cPa428,8_12,102,41
Scaffold151-24130_24232,cPa428,1,1,24180,24180,cPa428,1,102,0
Scaffold151-26413_26515,cPa428,1,1,26463,26463,cPa428,1,102,0
Scaffold151-32798_32934,cPa428,0.5,3,32894,32835,cPa356_cPa356-unknown_cPa428,13_1_14,136,59
Scaffold151-32954_33065,cPa428,0.714285714285714,3,33013,33004,cPa356_cPa356-cPa428-hybrid_cPa428,1_1_5,111,9
Scaffold151-33073_33186,cPa428,0.666666666666667,2,33174,33123,cPa356_cPa428,3_6,113,51
Scaffold151-45443_45545,cPa428,1,1,45493,45493,cPa428,1,102,0
Scaffold151-46373_46475,cPa428,0.833333333333333,2,46439,46401,cPa356_cPa428,1_5,102,38
Scaffold151-46586_46688,cPa356,0.666666666666667,2,46671,46592,cPa356_cPa428,4_2,102,79
Scaffold151-46701_46803,cPa428,0.666666666666667,2,46761,46708,cPa356_cPa428,3_6,102,53
Scaffold151-47137_47239,cPa356_cPa428,0.5,2,47189,47187,cPa356_cPa428,1_1,102,2
Scaffold151-47350_47452,cPa428,0.6,2,47431,47369,cPa356_cPa428,2_3,102,62
Scaffold151-53938_54040,cPa356,1,1,53988,53988,cPa356,1,102,0
Scaffold151-5462_5564,cPa356_cPa428,0.5,2,5538,5512,cPa356_cPa428,1_1,102,26
Scaffold152-20727_20829,cPa428,0.6,2,20785,20745,cPa356_cPa428,2_3,102,40
Scaffold152-31884_31986,cPa356,0.625,2,31934,31911,cPa356_cPa428,5_3,102,23
Scaffold152-32266_32371,cPa356_cPa428,0.5,2,32319,32309,cPa356_cPa428,3_3,105,10
Scaffold152-32427_32540,cPa356,0.5625,2,32498,32453,cPa356_cPa428,9_7,113,45
Scaffold152-3308_3410,cPa356_cPa428,0.5,2,3410,3316,cPa356_cPa428,9_9,102,94
Scaffold152-3510_3690,cPa428,0.513513513513513,2,3644,3526,cPa356_cPa428,18_19,180,118
Scaffold152-36587_36689,cPa428,0.538461538461538,2,36686,36637,cPa356_cPa428,6_7,102,49
Scaffold152-37440_37544,cPa428,0.714285714285714,2,37492,37486,cPa356_cPa428,2_5,104,6
Scaffold152-38676_38819,cPa428,0.625,2,38767,38726,cPa356_cPa428,3_5,143,41
Scaffold152-39082_39184,cPa356,1,1,39132,39090,cPa356,2,102,42
Scaffold152-40227_40329,cPa356_cPa428,0.5,2,40317,40226,cPa356_cPa428,8_8,102,91
Scaffold152-40413_40602,cPa356,0.506849315068493,2,40593,40412,cPa356_cPa428,37_36,189,181
Scaffold152-40696_40798,cPa428,0.526315789473684,2,40778,40696,cPa356_cPa428,18_20,102,82
Scaffold152-4080_4215,cPa428,0.517857142857143,2,4214,4128,cPa356_cPa428,27_29,135,86
Scaffold152-4275_4377,cPa428,0.625,2,4374,4325,cPa356_cPa428,3_5,102,49
Scaffold152-4896_5065,cPa428,0.6,2,5051,4899,cPa356_cPa428,6_9,169,152
Scaffold152-5092_5339,cPa428,0.529411764705882,2,5311,5136,cPa356_cPa428,8_9,247,175
Scaffold152-54024_54126,cPa428,1,1,54074,54074,cPa428,1,102,0
Scaffold152-72249_72357,cPa428,0.666666666666667,2,72306,72299,cPa356_cPa428,1_2,108,7
Scaffold152-72766_72868,cPa428,1,1,72816,72816,cPa428,1,102,0
Scaffold152-73176_73278,cPa356_cPa428,0.5,2,73228,73226,cPa356_cPa428,1_1,102,2
Scaffold152-73846_73948,cPa428-cPa356-hybrid,1,1,73896,73896,cPa428-cPa356-hybrid,1,102,0
Scaffold152-95318_95505,cPa428,0.615384615384615,2,95458,95328,cPa356_cPa428,5_8,187,130
Scaffold152-97531_97653,cPa428,0.666666666666667,2,97601,97532,cPa356_cPa428,2_4,122,69
Scaffold152-97683_97785,cPa428,0.75,2,97778,97687,cPa356_cPa428,1_3,102,91
Scaffold1527-1752_1854,cPa356_cPa428,0.5,2,1802,1802,cPa356_cPa428,1_1,102,0
Scaffold1527-2017_2119,cPa428,0.666666666666667,2,2075,2067,cPa356_cPa428,2_4,102,8
Scaffold153-100402_100922,cPa425,0.206060606060606,31,100870,100411,cPa205_cPa205-cPa101-hybrid_cPa205-cPa107-hybrid_cPa205-cPa174-hybrid_cPa205-cPa254-hybrid_cPa205-cPa379-hybrid_cPa205-cPa4-hybrid_cPa205-cPa463-hybrid_cPa205-cPa539-hybrid_cPa205-cPa75-hybrid_cPa254-cPa463-hybrid_cPa315-cPa419-hybrid_cPa333-cPa428-hybrid_cPa333-cPa75-hybrid_cPa419_cPa425_cPa425-cPa117-hybrid_cPa425-cPa419-hybrid_cPa425-cPa463-hybrid_cPa425-cPa581-hybrid_cPa425-cPa75-hybrid_cPa428_cPa465-cPa101-hybrid_cPa465-cPa107-hybrid_cPa465-cPa174-hybrid_cPa465-cPa200-hybrid_cPa465-cPa379-hybrid_cPa465-cPa4-hybrid_cPa465-cPa463-hybrid_cPa492-cPa463-hybrid_cPa75,10_3_1_1_1_1_7_18_1_1_1_1_1_15_18_34_2_1_1_1_14_3_3_1_2_2_1_1_10_1_8,520,459
Scaffold153-100984_101086,cPa333-cPa75-hybrid_cPa419_cPa465-cPa463-hybrid_cPa75,0.166666666666667,8,101049,100999,cPa205_cPa205-cPa463-hybrid_cPa333-cPa75-hybrid_cPa419_cPa425-cPa419-hybrid_cPa465-cPa463-hybrid_cPa465-cPa539-hybrid_cPa75,1_1_2_2_1_2_1_2,102,50
Scaffold153-101778_102049,cPa205-cPa486-hybrid,0.333333333333333,13,102023,101778,cPa199-cPa205-hybrid_cPa199-cPa61-hybrid_cPa205-cPa419-hybrid_cPa205-cPa486-hybrid_cPa205-cPa75-hybrid_cPa254-cPa75-hybrid_cPa272-cPa61-hybrid_cPa419_cPa465-cPa486-hybrid_cPa465-cPa75-hybrid_cPa465-unknown_cPa492-cPa486-hybrid_cPa75,1_1_1_15_1_1_1_7_12_1_1_1_2,271,245
Scaffold153-105350_105452,cPa391-cPa75-hybrid,0.5,5,105452,105400,cPa298_cPa391-cPa75-hybrid_cPa450-cPa75-hybrid_cPa500-cPa419-hybrid_cPa500-cPa75-hybrid,1_13_1_1_10,102,52
Scaffold153-10649_10879,cPa308-unknown,0.51937984496124,19,10852,10699,cPa308_cPa308-cPa107-hybrid_cPa308-cPa254-hybrid_cPa308-cPa424-hybrid_cPa308-cPa433-hybrid_cPa308-cPa452-hybrid_cPa308-cPa459-hybrid_cPa308-cPa486-hybrid_cPa308-unknown_cPa315-MoMLV_J02255-hybrid_cPa381_cPa381-cPa424-hybrid_cPa381-cPa452-hybrid_cPa381-cPa486-hybrid_cPa381-MoMLV_J02255-hybrid_cPa381-unknown_cPa419_cPa486_cPa486-cPa424-hybrid,11_5_1_13_2_1_4_1_67_1_1_1_1_3_1_12_1_1_2,230,153
Scaffold153-12078_12180,cPa308-cPa424-hybrid,0.75,2,12166,12128,cPa308_cPa308-cPa424-hybrid,1_3,102,38
Scaffold153-12325_12428,cPa419,0.444444444444444,3,12376,12326,cPa254-unknown_cPa308-cPa424-hybrid_cPa419,3_2_4,103,50
Scaffold153-13044_13208,STLV2_NC001815-unknown,1,1,13156,13094,STLV2_NC001815-unknown,2,164,62
Scaffold153-14607_14895,cPa109,0.210526315789474,11,14889,14657,cPa109_cPa109-cPa163-hybrid_cPa201_cPa363_cPa419_cPa452_cPa452-cPa109-hybrid_cPa452-cPa71-hybrid_cPa505_cPa71_HERV-F_repbase_HERVFH19I_LTR19A-cPa163-hybrid,4_1_1_3_1_2_3_1_1_1_1,288,232
Scaffold153-19842_19956,cPa308,1,1,19904,19892,cPa308,3,114,12
Scaffold153-26841_26943,cPa61,0.555555555555556,2,26903,26841,cPa419_cPa61,4_5,102,62
Scaffold153-27598_27932,cPa15,0.133689839572193,83,27932,27648,cPa118_cPa119_cPa125_cPa140_cPa15_cPa174_cPa196-cPa118-hybrid_cPa196-cPa119-hybrid_cPa196-cPa125-hybrid_cPa196-cPa140-hybrid_cPa196-cPa15-hybrid_cPa196-cPa174-hybrid_cPa196-cPa248-hybrid_cPa196-cPa264-hybrid_cPa196-cPa268-hybrid_cPa196-cPa391-hybrid_cPa196-cPa404-hybrid_cPa196-cPa425-hybrid_cPa196-cPa443-hybrid_cPa196-cPa61-hybrid_cPa248_cPa248-cPa119-hybrid_cPa248-cPa140-hybrid_cPa248-cPa174-hybrid_cPa254-cPa119-hybrid_cPa254-cPa125-hybrid_cPa254-cPa140-hybrid_cPa254-cPa356-hybrid_cPa254-cPa425-hybrid_cPa260-cPa125-hybrid_cPa260-cPa140-hybrid_cPa260-cPa61-hybrid_cPa264_cPa264-cPa119-hybrid_cPa264-cPa140-hybrid_cPa264-cPa174-hybrid_cPa264-cPa248-hybrid_cPa268_cPa268-cPa140-hybrid_cPa327-cPa174-hybrid_cPa356_cPa404_cPa404-cPa125-hybrid_cPa404-cPa140-hybrid_cPa404-cPa248-hybrid_cPa419_cPa419-cPa119-hybrid_cPa419-cPa140-hybrid_cPa425_cPa425-cPa140-hybrid_cPa425-cPa443-hybrid_cPa428_cPa434-cPa118-hybrid_cPa434-cPa119-hybrid_cPa434-cPa140-hybrid_cPa434-cPa248-hybrid_cPa434-cPa268-hybrid_cPa434-cPa404-hybrid_cPa443_cPa456-cPa119-hybrid_cPa459-cPa140-hybrid_cPa459-cPa174-hybrid_cPa459-cPa268-hybrid_cPa459-cPa61-hybrid_cPa47_cPa47-cPa119-hybrid_cPa47-cPa125-hybrid_cPa47-cPa174-hybrid_cPa47-cPa248-hybrid_cPa47-cPa268-hybrid_cPa566-cPa425-hybrid_cPa61-cPa118-hybrid_cPa61-cPa119-hybrid_cPa61-cPa125-hybrid_cPa61-cPa140-hybrid_cPa61-cPa248-hybrid_cPa61-cPa264-hybrid_cPa61-cPa268-hybrid_cPa61-cPa443-hybrid_cPa75-cPa119-hybrid_cPa75-cPa125-hybrid_cPa75-cPa15-hybrid_cPa75-cPa248-hybrid,70_10_55_15_100_52_9_13_11_12_4_12_9_3_9_1_3_2_4_5_28_1_1_1_1_1_3_1_1_1_2_1_14_2_1_1_1_47_1_1_2_32_1_1_1_26_1_1_11_1_1_1_1_1_2_1_3_1_95_2_1_1_1_1_3_3_1_1_1_1_1_9_18_2_1_1_1_2_1_1_1_1_1,334,284
Scaffold153-28671_28773,cPa264_cPa425,0.192307692307692,11,28736,28680,cPa118_cPa125_cPa15_cPa174_cPa196-cPa404-hybrid_cPa264_cPa264-cPa174-hybrid_cPa419_cPa425_cPa443_cPa47,2_2_1_2_1_5_1_3_5_3_1,102,56
Scaffold153-28880_29455,cPa15_cPa443,0.206521739130435,58,29453,28884,cPa118_cPa119_cPa125_cPa15_cPa174_cPa196-cPa117-hybrid_cPa196-cPa118-hybrid_cPa196-cPa119-hybrid_cPa196-cPa125-hybrid_cPa196-cPa15-hybrid_cPa196-cPa174-hybrid_cPa196-cPa248-hybrid_cPa196-cPa264-hybrid_cPa196-cPa268-hybrid_cPa196-cPa428-hybrid_cPa196-cPa443-hybrid_cPa196-cPa47-hybrid_cPa196-cPa61-hybrid_cPa254-cPa118-hybrid_cPa260-cPa248-hybrid_cPa260-cPa47-hybrid_cPa264_cPa264-cPa47-hybrid_cPa268_cPa327-cPa248-hybrid_cPa356_cPa419_cPa419-cPa452-hybrid_cPa424-cPa125-hybrid_cPa425_cPa428_cPa434-cPa15-hybrid_cPa434-cPa264-hybrid_cPa434-cPa425-hybrid_cPa443_cPa456-cPa125-hybrid_cPa456-cPa443-hybrid_cPa456-cPa516-hybrid_cPa459-cPa117-hybrid_cPa459-cPa118-hybrid_cPa459-cPa119-hybrid_cPa459-cPa140-hybrid_cPa459-cPa174-hybrid_cPa459-cPa205-hybrid_cPa459-cPa248-hybrid_cPa459-cPa434-hybrid_cPa459-cPa452-hybrid_cPa459-cPa47-hybrid_cPa47-cPa118-hybrid_cPa47-cPa264-hybrid_cPa47-cPa268-hybrid_cPa516-cPa140-hybrid_cPa516-cPa264-hybrid_cPa566_cPa566-cPa118-hybrid_cPa61-cPa140-hybrid_cPa67-cPa15-hybrid_cPa75-cPa140-hybrid,25_1_27_57_4_2_3_3_4_1_1_2_4_1_1_2_1_1_1_1_1_27_1_3_1_1_8_1_1_1_1_1_1_1_57_1_1_1_2_1_2_1_1_1_2_1_1_1_1_2_1_1_1_2_1_1_1_1,575,569
Scaffold153-30330_30620,cPa67,0.303370786516854,25,30619,30330,cPa248_cPa248-cPa117-hybrid_cPa260-cPa452-hybrid_cPa315_cPa339-cPa117-hybrid_cPa363_cPa363-cPa117-hybrid_cPa363-cPa15-hybrid_cPa413-cPa363-hybrid_cPa419_cPa433_cPa433-cPa363-hybrid_cPa450-cPa363-hybrid_cPa456_cPa456-cPa117-hybrid_cPa456-cPa15-hybrid_cPa456-cPa248-hybrid_cPa456-cPa264-hybrid_cPa456-cPa363-hybrid_cPa456-cPa452-hybrid_cPa459-cPa452-hybrid_cPa516-cPa452-hybrid_cPa67_cPa75-cPa315-hybrid_cPa75-cPa452-hybrid,1_1_1_10_2_8_1_1_1_4_1_1_1_11_3_1_1_1_1_7_1_1_27_1_1,290,289
Scaffold153-37207_37309,cPa391,0.931818181818182,4,37309,37206,cPa199_cPa199-MoMLV_J02255-hybrid_cPa391_cPa492-MoMLV_J02255-hybrid,1_1_41_1,102,103
Scaffold153-43450_43642,cPa257,0.5,3,43590,43498,cPa257_cPa257-unknown_cPa419,2_1_1,192,92
Scaffold153-43665_43767,HERV-Fb_repbase_HERVH48I_MER48-cPa205-hybrid,1,1,43715,43715,HERV-Fb_repbase_HERVH48I_MER48-cPa205-hybrid,1,102,0
Scaffold153-43909_44015,cPa205,0.4,4,43970,43957,cPa205_cPa285_cPa75-cPa205-hybrid_HERV-Fb_repbase_HERVH48I_MER48-cPa205-hybrid,2_1_1_1,106,13
Scaffold153-4542_5065,cPa391,0.479087452471483,10,5062,4592,cPa199_cPa298_cPa298-cPa199-hybrid_cPa298-cPa391-hybrid_cPa298-HTLV1_NC001436-hybrid_cPa298-unknown_cPa391_cPa391-cPa199-hybrid_cPa391-unknown_cPa552-HTLV1_NC001436-hybrid,30_89_2_1_1_1_126_5_7_1,523,470
Scaffold153-45844_46028,HML6_repbase_HERVK3I_LTR3,0.477272727272727,5,45976,45847,cPa145-cPa205-hybrid_HERV-XA34_repbase_HERVFH21I_LTR21A-cPa205-hybrid_HML6_repbase_HERVK3I_LTR3_HML6_repbase_HERVK3I_LTR3-cPa205-hybrid_HML6_repbase_HERVK3I_LTR3-unknown,3_6_21_2_12,184,129
Scaffold153-46585_46754,HML6_repbase_HERVK3I_LTR3,0.75,3,46702,46621,cPa199-unknown_HERV-XA34_repbase_HERVFH21I_LTR21A-unknown_HML6_repbase_HERVK3I_LTR3,1_2_9,169,81
Scaffold153-52640_52742,cPa505,1,1,52742,52690,cPa505,4,102,52
Scaffold153-52773_52875,cPa505,1,1,52870,52815,cPa505,4,102,55
Scaffold153-53442_53693,cPa505,0.908163265306122,3,53655,53444,cPa425_cPa505_cPa75,2_89_7,251,211
Scaffold153-53697_53799,cPa505,1,1,53775,53705,cPa505,9,102,70
Scaffold153-54007_54195,cPa505,0.903225806451613,4,54171,54037,cPa425_cPa505_cPa75_cPa75-cPa505-hybrid,1_28_1_1,188,134
Scaffold153-54291_54479,cPa505,0.95,2,54432,54325,cPa505_cPa75-cPa425-hybrid,19_1,188,107
Scaffold153-54538_54640,cPa505,0.869565217391304,3,54630,54538,cPa425_cPa505_cPa75,2_20_1,102,92
Scaffold153-6388_6577,cPa391,0.333333333333333,6,6547,6438,cPa199-HTLV1_NC001436-hybrid_cPa298-HTLV1_NC001436-hybrid_cPa391_cPa391-cPa205-hybrid_cPa391-HTLV1_NC001436-hybrid_cPa482-HTLV1_NC001436-hybrid,1_1_4_2_3_1,189,109
Scaffold153-79551_79672,cPa505,0.774193548387097,8,79627,79555,cPa201-cPa75-hybrid_cPa425_cPa505_cPa505-cPa75-hybrid_cPa505-unknown_cPa75_FeFV_NC001871-cPa75-hybrid_MoMLV_J02255,1_1_24_1_1_1_1_1,121,72
Scaffold153-79703_79810,cPa505,1,1,79774,79747,cPa505,9,107,27
Scaffold153-79939_80045,cPa505,0.846153846153846,4,80026,79938,cPa425_cPa505_cPa75_cPa75-cPa106-hybrid,4_33_1_1,106,88
Scaffold153-80235_80907,cPa505,0.876712328767123,8,80892,80244,cPa109-cPa75-hybrid_cPa109-MoMLV_J02255-hybrid_cPa168-MoMLV_J02255-hybrid_cPa425_cPa505_cPa505-cPa75-hybrid_cPa75_MoMLV_J02255,1_1_1_8_128_1_3_3,672,648
Scaffold153-81766_82019,cPa505,0.76,9,82019,81765,cPa109-cPa75-hybrid_cPa425_cPa469-cPa75-hybrid_cPa505_cPa531-MoMLV_J02255-hybrid_cPa549_cPa75_cPa75-cPa168-hybrid_MoMLV_J02255,1_14_1_76_1_1_4_1_1,253,254
Scaffold153-82070_82172,cPa505,0.805970149253731,5,82172,82069,cPa168-MoMLV_J02255-hybrid_cPa425_cPa505_cPa75_REV_NC006934-cPa505-hybrid,1_8_54_2_2,102,103
Scaffold153-82371_82876,cPa505,0.491358024691358,51,82846,82370,cPa109_cPa109-cPa152-hybrid_cPa109-cPa581-hybrid_cPa109-MoMLV_J02255-hybrid_cPa152_cPa152-MoMLV_J02255-hybrid_cPa168_cPa168-MoMLV_J02255-hybrid_cPa201_cPa201-cPa425-hybrid_cPa201-cPa505-hybrid_cPa201-cPa549-hybrid_cPa201-cPa75-hybrid_cPa201-ENTV_NC004994-hybrid_cPa201-MoMLV_J02255-hybrid_cPa201-unknown_cPa419-cPa469-hybrid_cPa419-cPa531-hybrid_cPa419-unknown_cPa425_cPa425-cPa201-hybrid_cPa425-cPa75-hybrid_cPa425-MoMLV_J02255-hybrid_cPa469_cPa469-cPa531-hybrid_cPa469-unknown_cPa472-cPa75-hybrid_cPa505_cPa531_cPa531-cPa201-hybrid_cPa531-cPa425-hybrid_cPa531-MoMLV_J02255-hybrid_cPa531-unknown_cPa549_cPa549-MoMLV_J02255-hybrid_cPa581_cPa75_cPa75-cPa505-hybrid_ENTV_NC004994-MoMLV_J02255-hybrid_MoMLV_J02255_REV_NC006934_REV_NC006934-cPa152-hybrid_REV_NC006934-cPa168-hybrid_REV_NC006934-cPa273-hybrid_REV_NC006934-cPa425-hybrid_REV_NC006934-cPa469-hybrid_REV_NC006934-cPa505-hybrid_REV_NC006934-cPa531-hybrid_REV_NC006934-MoMLV_J02255-hybrid_REV_NC006934-unknown_SMRV_NC001514-cPa469-hybrid,6_2_1_3_8_1_4_2_14_2_1_1_1_1_2_3_1_1_1_35_1_1_2_5_1_1_1_199_26_1_1_3_1_4_1_3_4_1_1_19_15_3_1_1_1_1_2_1_6_7_1,505,476
Scaffold153-82889_83101,cPa505,0.432432432432432,14,83100,82891,cPa109_cPa109-cPa469-hybrid_cPa109-MoMLV_J02255-hybrid_cPa152_cPa201_cPa419_cPa425_cPa505_cPa531_cPa531-cPa152-hybrid_cPa75_MoMLV_J02255_REV_NC006934_REV_NC006934-cPa581-hybrid,2_1_3_1_1_1_3_16_2_1_1_3_1_1,212,209
Scaffold153-8546_8649,cPa196-unknown,0.533333333333333,6,8600,8594,cPa196-cPa452-hybrid_cPa196-cPa47-hybrid_cPa196-MoMLV_J02255-hybrid_cPa196-unknown_cPa308-unknown_cPa424,1_1_3_8_1_1,103,6
Scaffold153-8817_8931,cPa196-MoMLV_J02255-hybrid,0.533333333333333,4,8879,8846,cPa196-cPa254-hybrid_cPa196-cPa47-hybrid_cPa196-MoMLV_J02255-hybrid_cPa196-unknown,1_1_8_5,114,33
Scaffold153-91463_91565,cPa391,0.891891891891892,5,91562,91463,cPa290-cPa106-hybrid_cPa391_cPa391-cPa106-hybrid_cPa391-unknown_cPa500,1_33_1_1_1,102,99
Scaffold153-91778_91880,cPa391,0.818181818181818,3,91831,91777,cPa199_cPa298-unknown_cPa391,1_1_9,102,54
Scaffold153-92076_92178,cPa391,1,1,92126,92079,cPa391,7,102,47
Scaffold153-9449_9571,cPa196-cPa47-hybrid,1,1,9519,9499,cPa196-cPa47-hybrid,2,122,20
Scaffold153-95104_95210,cPa199_cPa308-unknown_cPa360_cPa419,0.25,4,95158,95153,cPa199_cPa308-unknown_cPa360_cPa419,1_1_1_1,106,5
Scaffold153-95618_95720,cPa419,0.75,2,95706,95668,cPa308-cPa254-hybrid_cPa419,1_3,102,38
Scaffold153-97955_98140,cPa419,0.529411764705882,9,98095,97986,cPa333-cPa419-hybrid_cPa333-cPa62-hybrid_cPa419_cPa527-cPa425-hybrid_cPa527-cPa47-hybrid_cPa527-cPa543-hybrid_cPa527-cPa585-hybrid_SnRV_NC001724_SnRV_NC001724-cPa293-hybrid,1_1_9_1_1_1_1_1_1,185,109
Scaffold153-98218_98320,cPa419,0.571428571428571,4,98288,98229,cPa419_cPa527-cPa254-hybrid_cPa527-cPa47-hybrid_SnRV_NC001724-cPa117-hybrid,4_1_1_1,102,59
Scaffold1547-709_811,cPa419,1,1,782,759,cPa419,2,102,23
Scaffold155-71255_71357,cPa360,1,1,71320,71305,cPa360,2,102,15
Scaffold156-12342_12466,cPa400-cPa75-hybrid,0.8,2,12414,12390,cPa400_cPa400-cPa75-hybrid,1_4,124,24
Scaffold156-3737_3839,cPa419,1,1,3787,3787,cPa419,1,102,0
Scaffold156-3845_3955,cPa199_cPa223-cPa542-hybrid_cPa356-cPa273-hybrid,0.333333333333333,3,3950,3895,cPa199_cPa223-cPa542-hybrid_cPa356-cPa273-hybrid,1_1_1,110,55
Scaffold156-7110_7212,cPa75,1,1,7160,7160,cPa75,1,102,0
Scaffold157-14010_14217,cPa419,1,1,14214,14060,cPa419,123,207,154
Scaffold157-14235_14349,cPa419,1,1,14349,14247,cPa419,106,114,102
Scaffold157-14476_14578,cPa419,1,1,14566,14485,cPa419,25,102,81
Scaffold157-15099_15201,cPa419,1,1,15190,15130,cPa419,53,102,60
Scaffold157-16603_16705,cPa419,1,1,16676,16604,cPa419,14,102,72
Scaffold157-16720_16822,cPa419,1,1,16808,16723,cPa419,22,102,85
Scaffold157-16942_17044,cPa419,1,1,16992,16992,cPa419,1,102,0
Scaffold157-17375_17512,cPa419,1,1,17461,17394,cPa419,5,137,67
Scaffold157-17588_17763,cPa419,1,1,17711,17591,cPa419,8,175,120
Scaffold157-21221_21323,cPa419,1,1,21271,21271,cPa419,1,102,0
Scaffold157-865_1278,HERV-W_repbase_HERV17_LTR17,0.34965034965035,14,1240,875,cPa542_cPa62_cPa62-cPa419-hybrid_cPa62-cPa554-hybrid_cPa62-cPa75-hybrid_cPa62-HERV-W_repbase_HERV17_LTR17-hybrid_cPa75_cPa75-cPa554-hybrid_cPa75-HERV-W_repbase_HERV17_LTR17-hybrid_HERV-W_repbase_HERV17_LTR17_HERV-W_repbase_HERV17_LTR17-cPa419-hybrid_HERV-W_repbase_HERV17_LTR17-cPa554-hybrid_HERV-W_repbase_HERV17_LTR17-cPa75-hybrid_HERV-W_repbase_HERV17_LTR17-unknown,1_22_11_34_4_8_57_23_2_100_2_20_1_1,413,365
Scaffold158-10983_11085,cPa419,1,1,11046,10983,cPa419,32,102,63
Scaffold158-14388_14521,cPa419,1,1,14485,14438,cPa419,6,133,47
Scaffold158-15451_15553,cPa419,1,1,15530,15501,cPa419,3,102,29
Scaffold158-4295_4397,cPa419,1,1,4345,4345,cPa419,1,102,0
Scaffold158-4593_4695,cPa419,1,1,4643,4643,cPa419,1,102,0
Scaffold158-4961_5063,cPa419,1,1,5062,5011,cPa419,2,102,51
Scaffold158-5071_5173,cPa419,1,1,5124,5121,cPa419,2,102,3
Scaffold158-5193_5368,cPa419,1,1,5316,5239,cPa419,6,175,77
Scaffold158-6113_6215,cPa419,1,1,6171,6150,cPa419,4,102,21
Scaffold158-6243_6439,cPa419,1,1,6387,6260,cPa419,35,196,127
Scaffold158-6506_6802,cPa419,1,1,6783,6556,cPa419,42,296,227
Scaffold158-7335_7437,cPa419,1,1,7385,7347,cPa419,10,102,38
Scaffold158-7709_7865,cPa419,1,1,7859,7711,cPa419,32,156,148
Scaffold158-7901_8232,cPa419,1,1,8216,7927,cPa419,36,331,289
Scaffold158-8421_8523,cPa419,1,1,8518,8429,cPa419,8,102,89
Scaffold158-8599_8713,cPa419,1,1,8705,8599,cPa419,38,114,106
Scaffold158-8793_8969,cPa419,1,1,8969,8804,cPa419,37,176,165
Scaffold158-8992_9125,cPa419,1,1,9121,8994,cPa419,36,133,127
Scaffold158-9231_9512,cPa419,1,1,9503,9230,cPa419,49,281,273
Scaffold158-9523_9625,cPa419,1,1,9595,9547,cPa419,9,102,48
Scaffold158-9822_9924,cPa419,1,1,9876,9872,cPa419,2,102,4
Scaffold159-21205_21307,cPa75,0.5,3,21295,21220,cPa381_cPa381-cPa205-hybrid_cPa75,1_1_2,102,75
Scaffold159-21411_21513,cPa273-cPa456-hybrid_cPa381_cPa75_cPa75-cPa456-hybrid,0.25,4,21507,21461,cPa273-cPa456-hybrid_cPa381_cPa75_cPa75-cPa456-hybrid,1_1_1_1,102,46
Scaffold159-21524_21687,cPa75,0.571428571428571,3,21635,21574,cPa381-cPa224-hybrid_cPa75_cPa75-cPa285-hybrid,1_4_2,163,61
Scaffold159-21723_21886,cPa75,0.636363636363636,4,21845,21725,cPa285_cPa381_cPa381-cPa224-hybrid_cPa75,1_2_1_7,163,120
Scaffold159-21935_22121,cPa75,0.692307692307692,7,22116,21985,cPa224_cPa224-cPa456-hybrid_cPa273_cPa381_cPa75_cPa75-cPa224-hybrid_cPa75-cPa390-hybrid,1_1_1_2_18_2_1,186,131
Scaffold159-22550_22652,cPa75,1,1,22642,22557,cPa75,6,102,85
Scaffold159-27430_27538,HIV1_NC001802_MSFV_NC010819_MSFV_NC010819-cPa449-hybrid,0.333333333333333,3,27487,27480,HIV1_NC001802_MSFV_NC010819_MSFV_NC010819-cPa449-hybrid,1_1_1,108,7
Scaffold159-30948_31092,cPa205_cPa339,0.5,2,31040,30998,cPa205_cPa339,1_1,144,42
Scaffold159-36423_36585,cPa381,1,1,36533,36473,cPa381,2,162,60
Scaffold159-3673_3775,cPa75_cPa75-cPa390-hybrid,0.5,2,3723,3702,cPa75_cPa75-cPa390-hybrid,1_1,102,21
Scaffold159-36894_36996,cPa381_cPa456-cPa475-hybrid,0.5,2,36984,36944,cPa381_cPa456-cPa475-hybrid,1_1,102,40
Scaffold159-45533_45635,cPa62,1,1,45583,45583,cPa62,1,102,0
Scaffold159-4650_4752,cPa75_cPa75-cPa390-hybrid,0.5,2,4700,4697,cPa75_cPa75-cPa390-hybrid,1_1,102,3
Scaffold159-50418_50520,cPa381,1,1,50468,50463,cPa381,2,102,5
Scaffold159-52925_53027,cPa285,1,1,52975,52975,cPa285,1,102,0
Scaffold159-53357_53459,cPa285,1,1,53407,53407,cPa285,1,102,0
Scaffold159-57025_57159,cPa75,1,1,57107,57075,cPa75,5,134,32
Scaffold159-58719_58821,cPa224-cPa456-hybrid,1,1,58769,58769,cPa224-cPa456-hybrid,1,102,0
Scaffold159-58850_58952,cPa381_cPa75,0.285714285714286,5,58938,58872,cPa273-cPa379-hybrid_cPa379_cPa381_cPa583-cPa381-hybrid_cPa75,1_1_2_1_2,102,66
Scaffold159-97027_97338,cPa75-unknown,0.714285714285714,3,97286,97057,cPa273-unknown_cPa75-cPa390-hybrid_cPa75-unknown,1_1_5,311,229
Scaffold16-1001714_1001816,cPa75,1,1,1001764,1001764,cPa75,1,102,0
Scaffold16-1003503_1003605,cPa75,1,1,1003553,1003553,cPa75,1,102,0
Scaffold16-1012599_1012701,cPa75,1,1,1012649,1012649,cPa75,1,102,0
Scaffold16-1012737_1012839,cPa75,1,1,1012787,1012787,cPa75,1,102,0
Scaffold16-1050787_1050949,cPa75,0.571428571428571,3,1050949,1050792,cPa62-cPa75-hybrid_cPa62-unknown_cPa75,14_16_40,162,157
Scaffold16-1068286_1068388,cPa356-cPa199-hybrid,1,1,1068336,1068336,cPa356-cPa199-hybrid,1,102,0
Scaffold16-1068398_1068500,cPa356-cPa199-hybrid,1,1,1068448,1068448,cPa356-cPa199-hybrid,1,102,0
Scaffold16-11091_11195,cPa75,1,1,11143,11141,cPa75,2,104,2
Scaffold16-11304_11576,cPa75,1,1,11524,11354,cPa75,5,272,170
Scaffold16-1144010_1144112,cPa75,1,1,1144060,1144060,cPa75,1,102,0
Scaffold16-1144210_1144312,cPa75,1,1,1144260,1144260,cPa75,1,102,0
Scaffold16-1151392_1151494,cPa75,1,1,1151442,1151442,cPa75,1,102,0
Scaffold16-11625_11794,cPa75,1,1,11749,11675,cPa75,5,169,74
Scaffold16-1168884_1169019,cPa428,0.517241379310345,4,1169006,1168919,cPa356_cPa356-unknown_cPa419_cPa428,12_1_1_15,135,87
Scaffold16-1169045_1169532,cPa428,0.485875706214689,8,1169524,1169046,cPa356_cPa356-cPa413-hybrid_cPa356-unknown_cPa419_cPa428_cPa428-cPa356-hybrid_cPa428-cPa413-hybrid_cPa428-unknown,83_2_2_1_86_1_1_1,487,478
Scaffold16-1169689_1169791,cPa356,0.5,3,1169758,1169694,cPa356_cPa356-cPa413-hybrid_cPa428,5_1_4,102,64
Scaffold16-1169951_1170053,cPa356-cPa199-hybrid,1,1,1170001,1170001,cPa356-cPa199-hybrid,1,102,0
Scaffold16-11816_11918,cPa75,1,1,11866,11866,cPa75,1,102,0
Scaffold16-1186628_1186732,cPa75,1,1,1186711,1186678,cPa75,3,104,33
Scaffold16-1186829_1187204,cPa75,1,1,1187152,1186879,cPa75,13,375,273
Scaffold16-1187298_1187402,cPa75,1,1,1187402,1187348,cPa75,7,104,54
Scaffold16-1187446_1187548,cPa75,1,1,1187540,1187496,cPa75,4,102,44
Scaffold16-1213219_1213321,cPa75,1,1,1213269,1213269,cPa75,1,102,0
Scaffold16-1213390_1213694,cPa75,1,1,1213642,1213440,cPa75,9,304,202
Scaffold16-1213762_1214304,cPa75,1,1,1214252,1213812,cPa75,23,542,440
Scaffold16-1214423_1214537,cPa75,1,1,1214509,1214473,cPa75,4,114,36
Scaffold16-1240070_1240172,cPa75,1,1,1240120,1240120,cPa75,1,102,0
Scaffold16-1244988_1245090,cPa75,1,1,1245038,1245038,cPa75,1,102,0
Scaffold16-1245281_1245639,cPa75,1,1,1245587,1245331,cPa75,10,358,256
Scaffold16-1245809_1245951,cPa75,1,1,1245917,1245816,cPa75,6,142,101
Scaffold16-1246240_1246342,cPa75,1,1,1246317,1246290,cPa75,3,102,27
Scaffold16-1249360_1249891,cPa75,1,1,1249839,1249410,cPa75,17,531,429
Scaffold16-126261_126438,cPa285,1,1,126405,126309,cPa285,5,177,96
Scaffold16-1278533_1278635,cPa75,1,1,1278591,1278583,cPa75,2,102,8
Scaffold16-1326391_1326493,cPa75,1,1,1326441,1326441,cPa75,1,102,0
Scaffold16-1326632_1326734,cPa75,1,1,1326682,1326682,cPa75,1,102,0
Scaffold16-1326775_1326877,cPa75,1,1,1326825,1326825,cPa75,1,102,0
Scaffold16-13500_13602,cPa75,1,1,13550,13550,cPa75,1,102,0
Scaffold16-1362316_1362419,cPa75,1,1,1362367,1362366,cPa75,2,103,1
Scaffold16-1362670_1362772,cPa75,1,1,1362720,1362720,cPa75,1,102,0
Scaffold16-1362775_1362877,cPa75,1,1,1362825,1362825,cPa75,2,102,0
Scaffold16-1363146_1363248,cPa75,1,1,1363196,1363196,cPa75,1,102,0
Scaffold16-1363263_1363448,cPa75,1,1,1363396,1363313,cPa75,4,185,83
Scaffold16-1363734_1363836,cPa75,1,1,1363784,1363784,cPa75,1,102,0
Scaffold16-1388108_1388269,cPa75,1,1,1388262,1388158,cPa75,6,161,104
Scaffold16-1388351_1388707,cPa75,1,1,1388655,1388401,cPa75,12,356,254
Scaffold16-1405346_1405449,cPa75-unknown,1,1,1405397,1405396,cPa75-unknown,2,103,1
Scaffold16-1466836_1466938,cPa75,1,1,1466886,1466886,cPa75,1,102,0
Scaffold16-1473439_1473541,cPa75,1,1,1473489,1473489,cPa75,1,102,0
Scaffold16-1473733_1473835,cPa75,1,1,1473783,1473783,cPa75,1,102,0
Scaffold16-1498007_1498132,cPa75,1,1,1498123,1498055,cPa75,4,125,68
Scaffold16-1498141_1499100,cPa75,1,1,1499048,1498191,cPa75,40,959,857
Scaffold16-1499171_1499273,cPa75,1,1,1499221,1499221,cPa75,1,102,0
Scaffold16-1499365_1499575,cPa75,1,1,1499523,1499415,cPa75,5,210,108
Scaffold16-1513375_1513477,cPa75,1,1,1513425,1513425,cPa75,1,102,0
Scaffold16-1525972_1526074,cPa62,1,1,1526022,1526022,cPa62,1,102,0
Scaffold16-1530541_1530643,cPa75,1,1,1530591,1530591,cPa75,1,102,0
Scaffold16-1530935_1531037,cPa75,1,1,1530985,1530985,cPa75,2,102,0
Scaffold16-1531226_1531459,cPa75,1,1,1531407,1531276,cPa75,4,233,131
Scaffold16-1531844_1531946,cPa75,1,1,1531894,1531894,cPa75,1,102,0
Scaffold16-1531966_1532170,cPa75,1,1,1532118,1532016,cPa75,3,204,102
Scaffold16-1535245_1535369,cPa75,1,1,1535317,1535295,cPa75,2,124,22
Scaffold16-1535540_1535642,cPa75,1,1,1535590,1535590,cPa75,1,102,0
Scaffold16-1535692_1535794,cPa75,1,1,1535742,1535742,cPa75,1,102,0
Scaffold16-1535909_1536267,cPa75,1,1,1536215,1535959,cPa75,9,358,256
Scaffold16-1539608_1539710,cPa75,1,1,1539658,1539658,cPa75,1,102,0
Scaffold16-1539832_1540094,cPa75,1,1,1540042,1539882,cPa75,6,262,160
Scaffold16-1540519_1540621,cPa75,1,1,1540569,1540569,cPa75,1,102,0
Scaffold16-1581617_1581719,cPa75,1,1,1581667,1581667,cPa75,1,102,0
Scaffold16-1582067_1582169,cPa75,1,1,1582117,1582117,cPa75,1,102,0
Scaffold16-1583171_1583913,cPa75,1,1,1583861,1583190,cPa75,48,742,671
Scaffold16-1583932_1584102,cPa75,1,1,1584084,1583982,cPa75,6,170,102
Scaffold16-1584216_1584334,cPa75,1,1,1584317,1584266,cPa75,4,118,51
Scaffold16-1584436_1584538,cPa75,1,1,1584486,1584486,cPa75,1,102,0
Scaffold16-1586099_1586201,cPa75,1,1,1586149,1586149,cPa75,1,102,0
Scaffold16-1586384_1586551,cPa75,1,1,1586499,1586434,cPa75,4,167,65
Scaffold16-1586751_1587001,cPa75,1,1,1586949,1586801,cPa75,10,250,148
Scaffold16-1587079_1587260,cPa75,1,1,1587208,1587129,cPa75,2,181,79
Scaffold16-1587274_1587526,cPa75,1,1,1587486,1587324,cPa75,8,252,162
Scaffold16-1587577_1587679,cPa75,1,1,1587627,1587627,cPa75,1,102,0
Scaffold16-1588000_1588102,cPa75,1,1,1588050,1588050,cPa75,1,102,0
Scaffold16-1588315_1588417,cPa75,1,1,1588365,1588365,cPa75,1,102,0
Scaffold16-1595298_1595442,cPa75,1,1,1595390,1595348,cPa75,4,144,42
Scaffold16-1598472_1598574,cPa75,1,1,1598522,1598522,cPa75,1,102,0
Scaffold16-1598672_1598774,cPa75,1,1,1598722,1598722,cPa75,1,102,0
Scaffold16-1598865_1598967,cPa75,1,1,1598915,1598915,cPa75,1,102,0
Scaffold16-1605040_1605142,cPa75,1,1,1605090,1605090,cPa75,1,102,0
Scaffold16-1606985_1607087,cPa75,1,1,1607035,1607035,cPa75,1,102,0
Scaffold16-1607169_1607271,cPa75,1,1,1607219,1607219,cPa75,1,102,0
Scaffold16-1607325_1607432,cPa75,1,1,1607380,1607375,cPa75,2,107,5
Scaffold16-1607508_1607610,cPa75,1,1,1607566,1607535,cPa75,4,102,31
Scaffold16-1616691_1616837,cPa75,1,1,1616804,1616741,cPa75,10,146,63
Scaffold16-1617093_1617195,cPa75,1,1,1617143,1617143,cPa75,1,102,0
Scaffold16-1618761_1618863,cPa75,1,1,1618811,1618811,cPa75,1,102,0
Scaffold16-1636915_1637195,cPa75,1,1,1637143,1636965,cPa75,8,280,178
Scaffold16-1641379_1641481,cPa75,1,1,1641429,1641429,cPa75,1,102,0
Scaffold16-1644331_1644433,cPa260,1,1,1644381,1644355,cPa260,3,102,26
Scaffold16-1644637_1644739,cPa260,0.75,2,1644727,1644687,cPa260_cPa260-cPa273-hybrid,3_1,102,40
Scaffold16-1646043_1646145,cPa224,1,1,1646093,1646093,cPa224,1,102,0
Scaffold16-1652268_1652370,cPa75,1,1,1652318,1652318,cPa75,1,102,0
Scaffold16-1653713_1653815,cPa75,1,1,1653763,1653763,cPa75,1,102,0
Scaffold16-1658647_1658798,cPa75,1,1,1658746,1658697,cPa75,2,151,49
Scaffold16-1661564_1661666,cPa75,1,1,1661614,1661614,cPa75,1,102,0
Scaffold16-1661857_1661959,cPa75,1,1,1661907,1661907,cPa75,1,102,0
Scaffold16-1661968_1662108,cPa75,1,1,1662056,1662018,cPa75,2,140,38
Scaffold16-1662244_1662346,cPa75,1,1,1662294,1662294,cPa75,1,102,0
Scaffold16-1671416_1671518,cPa75,1,1,1671507,1671466,cPa75,2,102,41
Scaffold16-1671791_1671893,cPa75,1,1,1671842,1671841,cPa75,2,102,1
Scaffold16-1676971_1677074,cPa75,1,1,1677022,1677021,cPa75,2,103,1
Scaffold16-1677415_1677645,cPa75,1,1,1677593,1677465,cPa75,5,230,128
Scaffold16-1678071_1678173,cPa75,1,1,1678121,1678121,cPa75,1,102,0
Scaffold16-1686719_1686821,cPa75,1,1,1686780,1686766,cPa75,3,102,14
Scaffold16-1686870_1687007,cPa75,1,1,1686955,1686887,cPa75,4,137,68
Scaffold16-1687028_1687995,cPa75,1,1,1687943,1687078,cPa75,26,967,865
Scaffold16-1688027_1688193,cPa75,1,1,1688141,1688077,cPa75,3,166,64
Scaffold16-1692027_1692129,cPa75,1,1,1692077,1692077,cPa75,1,102,0
Scaffold16-1708777_1708879,cPa75,1,1,1708827,1708827,cPa75,1,102,0
Scaffold16-1709306_1709408,cPa75,1,1,1709356,1709356,cPa75,1,102,0
Scaffold16-1717730_1717832,cPa75,1,1,1717780,1717780,cPa75,1,102,0
Scaffold16-1717866_1718070,cPa75,1,1,1718018,1717916,cPa75,2,204,102
Scaffold16-1718340_1718529,cPa75,1,1,1718477,1718390,cPa75,4,189,87
Scaffold16-1723910_1724060,cPa75,1,1,1724008,1723927,cPa75,6,150,81
Scaffold16-1724341_1724471,cPa75,1,1,1724419,1724342,cPa75,7,130,77
Scaffold16-1724532_1724713,cPa75,1,1,1724661,1724582,cPa75,6,181,79
Scaffold16-1724778_1725049,cPa75,1,1,1724997,1724828,cPa75,6,271,169
Scaffold16-1725446_1725564,cPa75,1,1,1725512,1725496,cPa75,3,118,16
Scaffold16-1738497_1738599,cPa75,1,1,1738547,1738536,cPa75,4,102,11
Scaffold16-1738628_1738919,cPa75,1,1,1738878,1738671,cPa75,22,291,207
Scaffold16-1739484_1739601,cPa75,1,1,1739549,1739534,cPa75,2,117,15
Scaffold16-1739611_1739873,cPa75,1,1,1739870,1739634,cPa75,21,262,236
Scaffold16-1739892_1740091,cPa75,1,1,1740049,1739901,cPa75,11,199,148
Scaffold16-1741710_1741927,cPa75,0.714285714285714,2,1741876,1741760,cPa273_cPa75,2_5,217,116
Scaffold16-1741981_1742116,cPa75,0.692307692307692,5,1742069,1742019,cPa109-cPa152-hybrid_cPa109-cPa273-hybrid_cPa152_cPa158_cPa75,1_1_1_1_9,135,50
Scaffold16-1742126_1742259,cPa75,0.5,3,1742220,1742176,cPa371-cPa224-hybrid_cPa371-cPa273-hybrid_cPa75,2_1_3,133,44
Scaffold16-1743278_1743474,cPa323,0.5,5,1743466,1743319,cPa205-cPa273-hybrid_cPa323_cPa371_cPa371-cPa273-hybrid_cPa371-cPa323-hybrid,1_4_1_1_1,196,147
Scaffold16-1743499_1743932,cPa323,0.647058823529412,5,1743929,1743511,cPa323_cPa371_cPa371-cPa323-hybrid_cPa371-cPa75-hybrid_cPa61-cPa152-hybrid,33_14_2_1_1,433,418
Scaffold16-1769820_1769937,cPa15_cPa15-cPa443-hybrid_cPa15-unknown_cPa174_cPa196-cPa268-hybrid_cPa459,0.166666666666667,6,1769933,1769851,cPa15_cPa15-cPa443-hybrid_cPa15-unknown_cPa174_cPa196-cPa268-hybrid_cPa459,1_1_1_1_1_1,117,82
Scaffold16-1771161_1771371,cPa443,0.315789473684211,15,1771346,1771187,cPa118_cPa118-cPa174-hybrid_cPa118-cPa566-hybrid_cPa125_cPa140_cPa15_cPa15-cPa268-hybrid_cPa174_cPa248-cPa125-hybrid_cPa264_cPa264-cPa125-hybrid_cPa268_cPa268-cPa174-hybrid_cPa404-cPa15-hybrid_cPa443,6_1_1_10_1_2_1_6_1_6_1_1_1_1_18,210,159
Scaffold16-1775185_1775287,cPa47,0.714285714285714,3,1775235,1775215,cPa254_cPa254-cPa47-hybrid_cPa47,1_1_5,102,20
Scaffold16-1775291_1775393,cPa47,1,1,1775341,1775341,cPa47,1,102,0
Scaffold16-1776691_1776793,cPa254-cPa177-hybrid,0.388888888888889,8,1776778,1776733,cPa174-cPa177-hybrid_cPa254-cPa177-hybrid_cPa360-cPa177-hybrid_cPa381-cPa177-hybrid_cPa392-cPa177-hybrid_cPa419_cPa419-cPa177-hybrid_cPa425-cPa177-hybrid,2_7_1_1_1_4_1_1,102,45
Scaffold16-1778258_1778360,cPa360-cPa18-hybrid_cPa381_cPa75_cPa75-cPa18-hybrid,0.25,4,1778353,1778277,cPa360-cPa18-hybrid_cPa381_cPa75_cPa75-cPa18-hybrid,1_1_1_1,102,76
Scaffold16-1778465_1778617,cPa75-cPa18-hybrid,0.411764705882353,8,1778572,1778466,cPa381-cPa425-hybrid_cPa419_cPa51-cPa177-hybrid_cPa75_cPa75-cPa177-hybrid_cPa75-cPa18-hybrid_cPa75-cPa518-hybrid_cPa75-cPa61-hybrid,1_4_1_1_1_7_1_1,152,106
Scaffold16-1778817_1778945,cPa518_cPa518-cPa18-hybrid_cPa518-cPa61-hybrid,0.333333333333333,3,1778893,1778862,cPa518_cPa518-cPa18-hybrid_cPa518-cPa61-hybrid,1_1_1,128,31
Scaffold16-1779016_1779135,cPa518-cPa18-hybrid,0.333333333333333,5,1779106,1779066,cPa518-cPa18-hybrid_cPa518-cPa61-hybrid_cPa518-unknown_cPa75-cPa18-hybrid_cPa75-cPa61-hybrid,3_2_1_1_2,119,40
Scaffold16-1779277_1779383,cPa518-cPa18-hybrid_cPa518-cPa61-hybrid,0.5,2,1779334,1779327,cPa518-cPa18-hybrid_cPa518-cPa61-hybrid,2_2,106,7
Scaffold16-1781920_1782022,cPa425-cPa113-hybrid,1,1,1781997,1781970,cPa425-cPa113-hybrid,2,102,27
Scaffold16-1782513_1782615,cPa113-cPa356-hybrid_cPa113-cPa363-hybrid_cPa434,0.333333333333333,3,1782583,1782537,cPa113-cPa356-hybrid_cPa113-cPa363-hybrid_cPa434,1_1_1,102,46
Scaffold16-1782796_1782911,cPa434,0.6,2,1782910,1782846,cPa356_cPa434,2_3,115,64
Scaffold16-1782927_1783029,cPa113-cPa363-hybrid_cPa356_cPa434-cPa356-hybrid_cPa523,0.25,4,1783021,1782928,cPa113-cPa363-hybrid_cPa356_cPa434-cPa356-hybrid_cPa523,1_1_1_1,102,93
Scaffold16-1783828_1784129,cPa452,0.685714285714286,4,1784087,1783834,cPa113-cPa452-hybrid_cPa363_cPa434-cPa363-hybrid_cPa452,1_9_1_24,301,253
Scaffold16-1790088_1790190,cPa15,1,1,1790166,1790138,cPa15,4,102,28
Scaffold16-1799702_1799941,cPa34,0.402173913043478,11,1799940,1799720,cPa121_cPa121-cPa34-hybrid_cPa121-unknown_cPa188_cPa188-cPa34-hybrid_cPa188-cPa434-hybrid_cPa188-unknown_cPa194-cPa34-hybrid_cPa34_cPa500_cPa500-unknown,10_2_4_25_3_1_7_1_37_1_1,239,220
Scaffold16-1800034_1800161,cPa188_cPa34,0.384615384615385,5,1800113,1800076,cPa121_cPa121-unknown_cPa188_cPa34_cPa500,1_1_5_5_1,127,37
Scaffold16-1800275_1800515,cPa121,0.571428571428571,3,1800463,1800303,cPa121_cPa121-unknown_cPa500,4_1_2,240,160
Scaffold16-1806832_1807022,cPa15,0.413793103448276,10,1807008,1806834,cPa118_cPa118-cPa15-hybrid_cPa118-cPa268-hybrid_cPa15_cPa174_cPa174-cPa268-hybrid_cPa425_cPa425-cPa268-hybrid_cPa425-unknown_cPa47,1_1_1_12_1_1_8_1_1_2,190,174
Scaffold16-1808764_1808897,cPa174,0.333333333333333,5,1808861,1808814,cPa118-cPa174-hybrid_cPa174_cPa392_cPa425_cPa47-cPa118-hybrid,1_3_2_2_1,133,47
Scaffold16-1810821_1810923,cPa194-unknown,1,1,1810923,1810871,cPa194-unknown,4,102,52
Scaffold16-1823019_1823121,cPa434-unknown,1,1,1823069,1823069,cPa434-unknown,1,102,0
Scaffold16-1859716_1859818,cPa196_cPa424-cPa196-hybrid,0.5,2,1859794,1859766,cPa196_cPa424-cPa196-hybrid,1_1,102,28
Scaffold16-1862399_1862501,HERV-F_repbase_HERVFH19I_LTR19A-unknown,1,1,1862449,1862449,HERV-F_repbase_HERVFH19I_LTR19A-unknown,1,102,0
Scaffold16-1872250_1872492,cPa223-cPa512-hybrid_cPa223-HFV_NC001736-hybrid_cPa308-cPa512-hybrid_cPa482-HFV_NC001736-hybrid,0.133333333333333,11,1872440,1872300,cPa118-cPa512-hybrid_cPa200-HFV_NC001736-hybrid_cPa223-cPa512-hybrid_cPa223-HFV_NC001736-hybrid_cPa254-cPa512-hybrid_cPa308-cPa512-hybrid_cPa308-PERV_AJ293656-hybrid_cPa482_cPa482-cPa512-hybrid_cPa482-HFV_NC001736-hybrid_HERV-W_repbase_HERV17_LTR17-cPa512-hybrid,1_1_2_2_1_2_1_1_1_2_1,242,140
Scaffold16-1874403_1874656,cPa315-unknown,0.235294117647059,9,1874604,1874453,cPa15_cPa315-cPa118-hybrid_cPa315-cPa15-hybrid_cPa315-unknown_cPa75_cPa75-cPa512-hybrid_cPa75-HERV-W_repbase_HERV17_LTR17-hybrid_cPa75-unknown_SnRV_NC001724-PERV_AJ293656-hybrid,3_2_2_4_2_1_1_1_1,253,151
Scaffold16-188589_188691,cPa75,1,1,188639,188639,cPa75,1,102,0
Scaffold16-1920253_1920355,cPa419,1,1,1920303,1920303,cPa419,1,102,0
Scaffold16-1921972_1922167,cPa585,0.56,6,1922115,1921977,cPa400_cPa419_cPa452_cPa554_cPa554-cPa223-hybrid_cPa585,2_2_3_3_1_14,195,138
Scaffold16-1922237_1922339,cPa585,0.636363636363636,4,1922329,1922262,cPa111-cPa452-hybrid_cPa452_cPa554_cPa585,1_1_2_7,102,67
Scaffold16-1922377_1922479,cPa585,0.714285714285714,4,1922477,1922393,cPa452_cPa554_cPa585_cPa585-unknown,1_1_10_2,102,84
Scaffold16-1925767_1925869,MPMVs_NC001550,0.796875,5,1925818,1925776,cPa194_cPa345_cPa428-unknown_cPa67-cPa75-hybrid_MPMVs_NC001550,1_10_1_1_51,102,42
Scaffold16-1938151_1938253,cPa118-cPa119-hybrid_cPa15_cPa15-cPa119-hybrid_cPa174-cPa119-hybrid_cPa248_cPa268_cPa268-cPa119-hybrid_cPa268-cPa15-hybrid,0.125,8,1938225,1938200,cPa118-cPa119-hybrid_cPa15_cPa15-cPa119-hybrid_cPa174-cPa119-hybrid_cPa248_cPa268_cPa268-cPa119-hybrid_cPa268-cPa15-hybrid,1_1_1_1_1_1_1_1,102,25
Scaffold16-1944864_1945018,cPa75,1,1,1944966,1944914,cPa75,2,154,52
Scaffold16-225473_225575,cPa75,1,1,225523,225523,cPa75,1,102,0
Scaffold16-225722_225824,cPa75,1,1,225772,225772,cPa75,1,102,0
Scaffold16-22817_22919,cPa62,0.75,2,22910,22821,cPa62_cPa75,3_1,102,89
Scaffold16-22976_23119,cPa62_cPa75-cPa62-hybrid,0.5,2,23067,23026,cPa62_cPa75-cPa62-hybrid,1_1,143,41
Scaffold16-23125_23336,cPa62,0.583333333333333,4,23335,23140,cPa285-unknown_cPa62_cPa75_cPa75-cPa62-hybrid,1_7_3_1,211,195
Scaffold16-232004_232106,cPa75,1,1,232054,232054,cPa75,1,102,0
Scaffold16-233312_233414,cPa75,1,1,233362,233362,cPa75,1,102,0
Scaffold16-23636_23738,cPa62,0.625,3,23716,23636,cPa62_cPa75_cPa75-cPa62-hybrid,5_2_1,102,80
Scaffold16-23859_24253,cPa62,0.973684210526316,2,24250,23878,cPa402-cPa75-hybrid_cPa62,1_37,394,372
Scaffold16-252453_252555,cPa75,1,1,252503,252503,cPa75,1,102,0
Scaffold16-252614_252716,cPa75,1,1,252664,252664,cPa75,1,102,0
Scaffold16-255652_255754,cPa75,1,1,255702,255702,cPa75,1,102,0
Scaffold16-255857_255959,cPa75,1,1,255907,255907,cPa75,1,102,0
Scaffold16-269505_269607,cPa75,1,1,269555,269555,cPa75,1,102,0
Scaffold16-276042_276159,cPa75,1,1,276107,276092,cPa75,2,117,15
Scaffold16-276231_276333,cPa75,1,1,276281,276281,cPa75,1,102,0
Scaffold16-276348_276524,cPa75,1,1,276472,276398,cPa75,2,176,74
Scaffold16-276715_276907,cPa75,1,1,276855,276765,cPa75,3,192,90
Scaffold16-277079_277181,cPa75,1,1,277129,277129,cPa75,1,102,0
Scaffold16-287008_287110,cPa75,1,1,287058,287033,cPa75,2,102,25
Scaffold16-287154_287533,cPa75,1,1,287481,287157,cPa75,9,379,324
Scaffold16-287559_287746,cPa75,1,1,287694,287609,cPa75,2,187,85
Scaffold16-287818_288070,cPa75,1,1,288018,287844,cPa75,9,252,174
Scaffold16-288596_288698,cPa75,1,1,288646,288646,cPa75,1,102,0
Scaffold16-291852_292179,cPa75,1,1,292127,291902,cPa75,37,327,225
Scaffold16-292183_292629,cPa75,0.966666666666667,2,292577,292233,cPa543-cPa75-hybrid_cPa75,1_29,446,344
Scaffold16-296926_297028,cPa75,1,1,296976,296976,cPa75,1,102,0
Scaffold16-316599_316701,cPa75,1,1,316649,316649,cPa75,1,102,0
Scaffold16-316747_316849,cPa75,1,1,316797,316797,cPa75,1,102,0
Scaffold16-317182_317488,cPa75,1,1,317436,317232,cPa75,7,306,204
Scaffold16-317735_317837,cPa75,1,1,317785,317779,cPa75,2,102,6
Scaffold16-352827_352929,cPa75-unknown,1,1,352877,352877,cPa75-unknown,1,102,0
Scaffold16-353257_353359,cPa75,1,1,353307,353307,cPa75,1,102,0
Scaffold16-353396_353633,cPa75-unknown,0.6,2,353581,353446,cPa75_cPa75-unknown,2_3,237,135
Scaffold16-353637_353739,cPa75,1,1,353687,353687,cPa75,1,102,0
Scaffold16-355111_355213,cPa552-cPa75-hybrid,1,1,355161,355161,cPa552-cPa75-hybrid,1,102,0
Scaffold16-355468_355570,cPa552-cPa75-hybrid,1,1,355518,355518,cPa552-cPa75-hybrid,1,102,0
Scaffold16-355738_355840,cPa552-cPa75-hybrid,1,1,355788,355788,cPa552-cPa75-hybrid,1,102,0
Scaffold16-360955_361153,cPa75,1,1,361101,361005,cPa75,3,198,96
Scaffold16-361254_361356,cPa75,1,1,361309,361301,cPa75,3,102,8
Scaffold16-361448_361650,cPa75,1,1,361598,361498,cPa75,3,202,100
Scaffold16-364472_364574,cPa75,1,1,364522,364522,cPa75,1,102,0
Scaffold16-364610_364712,cPa75,1,1,364660,364635,cPa75,2,102,25
Scaffold16-364785_364887,cPa75,1,1,364842,364835,cPa75,2,102,7
Scaffold16-364891_364993,cPa75,1,1,364941,364902,cPa75,2,102,39
Scaffold16-367062_367164,cPa254-cPa75-hybrid,1,1,367112,367112,cPa254-cPa75-hybrid,1,102,0
Scaffold16-392947_393243,cPa75,1,1,393191,392960,cPa75,11,296,231
Scaffold16-393293_393541,cPa75,1,1,393501,393326,cPa75,18,248,175
Scaffold16-408549_408666,cPa75,1,1,408614,408599,cPa75,3,117,15
Scaffold16-408668_408770,cPa75,1,1,408718,408718,cPa75,1,102,0
Scaffold16-408862_409029,cPa75,1,1,408977,408912,cPa75,3,167,65
Scaffold16-412494_412658,cPa75,1,1,412606,412544,cPa75,6,164,62
Scaffold16-412680_412810,cPa75,0.666666666666667,2,412758,412730,cPa15-cPa75-hybrid_cPa75,1_2,130,28
Scaffold16-412979_413200,cPa75,1,1,413148,413029,cPa75,3,221,119
Scaffold16-413739_413841,cPa15-cPa75-hybrid,1,1,413789,413789,cPa15-cPa75-hybrid,1,102,0
Scaffold16-418382_418484,cPa75,1,1,418432,418432,cPa75,1,102,0
Scaffold16-422800_423033,cPa75,1,1,422981,422850,cPa75,4,233,131
Scaffold16-423047_423281,cPa75,1,1,423229,423097,cPa75,13,234,132
Scaffold16-427053_427155,cPa539,1,1,427103,427103,cPa539,1,102,0
Scaffold16-42859_42995,cPa75,1,1,42943,42909,cPa75,3,136,34
Scaffold16-438263_438365,cPa75,1,1,438313,438313,cPa75,1,102,0
Scaffold16-438502_438604,cPa75,1,1,438552,438552,cPa75,1,102,0
Scaffold16-438839_438941,cPa75,1,1,438889,438889,cPa75,1,102,0
Scaffold16-440436_440623,cPa75,1,1,440571,440486,cPa75,3,187,85
Scaffold16-443892_443994,cPa75,1,1,443942,443942,cPa75,1,102,0
Scaffold16-444061_444163,cPa75,1,1,444111,444111,cPa75,1,102,0
Scaffold16-446531_446633,cPa75,1,1,446581,446581,cPa75,1,102,0
Scaffold16-446698_446800,cPa75-unknown,1,1,446748,446748,cPa75-unknown,1,102,0
Scaffold16-453847_453949,cPa75,1,1,453897,453897,cPa75,1,102,0
Scaffold16-454715_454817,cPa482_cPa539,0.5,2,454798,454765,cPa482_cPa539,1_1,102,33
Scaffold16-455374_455482,cPa109-cPa75-hybrid_cPa199-cPa75-hybrid_cPa482-cPa75-hybrid,0.333333333333333,3,455430,455400,cPa109-cPa75-hybrid_cPa199-cPa75-hybrid_cPa482-cPa75-hybrid,1_1_1,108,30
Scaffold16-460236_460395,cPa75,1,1,460343,460286,cPa75,2,159,57
Scaffold16-460426_460528,cPa75,1,1,460476,460476,cPa75,1,102,0
Scaffold16-462504_462606,cPa75,1,1,462588,462538,cPa75,6,102,50
Scaffold16-462712_462814,cPa75,1,1,462798,462762,cPa75,3,102,36
Scaffold16-463103_463205,cPa75,1,1,463153,463153,cPa75,1,102,0
Scaffold16-463361_463463,cPa75,1,1,463461,463380,cPa75,4,102,81
Scaffold16-471461_471648,cPa75,1,1,471596,471511,cPa75,2,187,85
Scaffold16-472051_472153,cPa75,1,1,472101,472101,cPa75,1,102,0
Scaffold16-472270_472372,cPa75,1,1,472320,472320,cPa75,1,102,0
Scaffold16-472473_472711,cPa75,1,1,472659,472523,cPa75,4,238,136
Scaffold16-472730_473187,cPa75,1,1,473135,472780,cPa75,19,457,355
Scaffold16-473256_473388,cPa75,1,1,473358,473306,cPa75,4,132,52
Scaffold16-485088_485190,cPa75,1,1,485138,485138,cPa75,1,102,0
Scaffold16-501023_501181,cPa75,1,1,501129,501073,cPa75,2,158,56
Scaffold16-502261_502363,cPa75,1,1,502311,502311,cPa75,1,102,0
Scaffold16-506444_506546,cPa75,1,1,506494,506494,cPa75,1,102,0
Scaffold16-507119_507361,cPa75,0.923076923076923,2,507309,507169,cPa308_cPa75,1_12,242,140
Scaffold16-507380_507575,cPa75,1,1,507523,507430,cPa75,2,195,93
Scaffold16-507674_507776,cPa75,1,1,507724,507724,cPa75,1,102,0
Scaffold16-539147_539375,cPa285,0.5,3,539323,539197,cPa285_cPa293_cPa62-cPa285-hybrid,2_1_1,228,126
Scaffold16-540765_540867,CAEV_NC001463,1,1,540815,540815,CAEV_NC001463,1,102,0
Scaffold16-545968_546070,cPa75,1,1,546018,546018,cPa75,1,102,0
Scaffold16-554961_555063,cPa75,1,1,555043,554982,cPa75,4,102,61
Scaffold16-555201_555406,cPa75,1,1,555359,555210,cPa75,14,205,149
Scaffold16-555435_555537,cPa75,1,1,555533,555455,cPa75,16,102,78
Scaffold16-555565_555667,cPa75,1,1,555653,555597,cPa75,4,102,56
Scaffold16-555736_555838,cPa75,1,1,555794,555744,cPa75,3,102,50
Scaffold16-556861_557030,cPa75,1,1,556978,556911,cPa75,3,169,67
Scaffold16-557229_557331,cPa75,1,1,557279,557248,cPa75,4,102,31
Scaffold16-562261_562363,cPa75,1,1,562311,562311,cPa75,1,102,0
Scaffold16-562521_562671,cPa75,1,1,562640,562571,cPa75,5,150,69
Scaffold16-562899_563081,cPa75,1,1,563059,562949,cPa75,3,182,110
Scaffold16-565757_565945,cPa75,1,1,565893,565775,cPa75,4,188,118
Scaffold16-566445_566547,cPa75,1,1,566495,566495,cPa75,1,102,0
Scaffold16-566571_566989,cPa75,1,1,566937,566621,cPa75,10,418,316
Scaffold16-567359_567461,cPa75,1,1,567409,567409,cPa75,1,102,0
Scaffold16-567538_567659,cPa75,1,1,567622,567588,cPa75,4,121,34
Scaffold16-567685_567873,cPa75,1,1,567821,567735,cPa75,8,188,86
Scaffold16-568083_568185,cPa75,1,1,568142,568131,cPa75,3,102,11
Scaffold16-579761_579863,cPa75,1,1,579811,579811,cPa75,1,102,0
Scaffold16-582210_582857,cPa75,1,1,582826,582260,cPa75,28,647,566
Scaffold16-599269_599395,cPa75,1,1,599343,599319,cPa75,2,126,24
Scaffold16-599877_600166,cPa75,1,1,600114,599927,cPa75,10,289,187
Scaffold16-600317_600433,cPa75,1,1,600381,600367,cPa75,2,116,14
Scaffold16-600437_600539,cPa75,1,1,600487,600487,cPa75,1,102,0
Scaffold16-600649_600751,cPa75,1,1,600699,600699,cPa75,1,102,0
Scaffold16-600830_600997,cPa75,1,1,600960,600860,cPa75,7,167,100
Scaffold16-601042_601144,cPa75,1,1,601115,601090,cPa75,4,102,25
Scaffold16-602626_602728,cPa75,1,1,602676,602676,cPa75,1,102,0
Scaffold16-602735_602837,cPa75,1,1,602785,602776,cPa75,3,102,9
Scaffold16-604778_605191,cPa75,1,1,605139,604828,cPa75,21,413,311
Scaffold16-605221_605323,cPa75,1,1,605271,605224,cPa75,4,102,47
Scaffold16-605359_605461,cPa75,1,1,605409,605409,cPa75,1,102,0
Scaffold16-630005_630285,cPa75-unknown,0.4375,5,630233,630045,cPa380_cPa527_cPa527-cPa380-hybrid_cPa75-cPa380-hybrid_cPa75-unknown,6_1_1_1_7,280,188
Scaffold16-640681_640783,cPa75,1,1,640731,640731,cPa75,1,102,0
Scaffold16-642010_642112,cPa75,1,1,642060,642060,cPa75,1,102,0
Scaffold16-673379_673637,cPa75,1,1,673585,673429,cPa75,7,258,156
Scaffold16-673893_674339,cPa75,1,1,674287,673943,cPa75,9,446,344
Scaffold16-674359_675220,cPa75,1,1,675168,674409,cPa75,33,861,759
Scaffold16-67474_67576,cPa75-cPa273-hybrid,1,1,67567,67524,cPa75-cPa273-hybrid,2,102,43
Scaffold16-675296_675398,cPa75,1,1,675346,675346,cPa75,1,102,0
Scaffold16-675599_675701,cPa75,1,1,675683,675649,cPa75,2,102,34
Scaffold16-678940_679042,cPa75,1,1,679041,678975,cPa75,9,102,66
Scaffold16-679139_679241,cPa75,1,1,679240,679138,cPa75,6,102,102
Scaffold16-679242_679422,cPa75,1,1,679413,679244,cPa75,21,180,169
Scaffold16-679595_680016,cPa75,1,1,679964,679641,cPa75,27,421,323
Scaffold16-680018_680596,cPa75,1,1,680544,680068,cPa75,47,578,476
Scaffold16-682144_682246,cPa75,1,1,682204,682194,cPa75,2,102,10
Scaffold16-686162_686264,cPa75,1,1,686212,686212,cPa75,1,102,0
Scaffold16-692159_692314,cPa75,1,1,692311,692196,cPa75,5,155,115
Scaffold16-707122_707224,cPa75,1,1,707172,707172,cPa75,1,102,0
Scaffold16-709289_709419,cPa75,1,1,709414,709339,cPa75,3,130,75
Scaffold16-709532_709746,cPa75,1,1,709694,709582,cPa75,4,214,112
Scaffold16-710632_710734,cPa75,1,1,710682,710682,cPa75,1,102,0
Scaffold16-711125_711227,cPa75,1,1,711175,711175,cPa75,1,102,0
Scaffold16-711255_711443,cPa75,1,1,711391,711305,cPa75,2,188,86
Scaffold16-711476_711660,cPa75,1,1,711608,711526,cPa75,4,184,82
Scaffold16-711681_711783,cPa75,1,1,711731,711731,cPa75,1,102,0
Scaffold16-719208_719310,cPa75,1,1,719258,719258,cPa75,2,102,0
Scaffold16-719522_719624,cPa75,1,1,719575,719539,cPa75,3,102,36
Scaffold16-720279_720381,cPa75,1,1,720329,720329,cPa75,1,102,0
Scaffold16-721148_721296,cPa75,0.75,2,721244,721198,cPa387-cPa75-hybrid_cPa75,1_3,148,46
Scaffold16-722477_722579,cPa75,1,1,722527,722527,cPa75,1,102,0
Scaffold16-723070_723172,cPa75,1,1,723120,723120,cPa75,1,102,0
Scaffold16-730299_730401,cPa75,1,1,730349,730349,cPa75,1,102,0
Scaffold16-730698_730800,cPa75,1,1,730748,730748,cPa75,1,102,0
Scaffold16-731281_731383,cPa75,1,1,731331,731331,cPa75,1,102,0
Scaffold16-732778_732880,cPa75,1,1,732867,732828,cPa75,5,102,39
Scaffold16-733169_733271,cPa75,1,1,733219,733219,cPa75,1,102,0
Scaffold16-733276_733378,cPa75,1,1,733326,733326,cPa75,1,102,0
Scaffold16-733437_733539,cPa75,1,1,733487,733487,cPa75,1,102,0
Scaffold16-733736_733892,cPa75,1,1,733840,733786,cPa75,7,156,54
Scaffold16-735567_735669,cPa75,1,1,735617,735617,cPa75,1,102,0
Scaffold16-735682_735784,cPa75,1,1,735746,735732,cPa75,3,102,14
Scaffold16-740286_740405,cPa75,1,1,740353,740336,cPa75,2,119,17
Scaffold16-740599_740836,cPa75,0.888888888888889,2,740784,740649,cPa62_cPa75,1_8,237,135
Scaffold16-740877_740979,cPa62_cPa75,0.5,2,740972,740927,cPa62_cPa75,1_1,102,45
Scaffold16-742251_742362,cPa75,1,1,742311,742293,cPa75,6,111,18
Scaffold16-742644_742809,cPa75,1,1,742757,742694,cPa75,19,165,63
Scaffold16-742851_742971,cPa75,1,1,742919,742901,cPa75,3,120,18
Scaffold16-759107_759209,cPa75,1,1,759157,759157,cPa75,1,102,0
Scaffold16-759710_759949,cPa75,1,1,759897,759760,cPa75,27,239,137
Scaffold16-766382_766484,cPa75,1,1,766432,766432,cPa75,1,102,0
Scaffold16-766640_766742,cPa75,1,1,766690,766653,cPa75,2,102,37
Scaffold16-768744_768846,cPa75,1,1,768794,768794,cPa75,1,102,0
Scaffold16-772521_772665,cPa75,1,1,772613,772571,cPa75,3,144,42
Scaffold16-772673_772775,cPa75,1,1,772723,772678,cPa75,4,102,45
Scaffold16-774352_774540,cPa75,1,1,774488,774402,cPa75,3,188,86
Scaffold16-774608_774734,cPa75,1,1,774682,774658,cPa75,2,126,24
Scaffold16-774769_774961,cPa75,1,1,774909,774819,cPa75,6,192,90
Scaffold16-775085_775212,cPa75,1,1,775160,775135,cPa75,3,127,25
Scaffold16-775253_775355,cPa75,1,1,775303,775303,cPa75,1,102,0
Scaffold16-775986_776088,cPa75,1,1,776036,776036,cPa75,1,102,0
Scaffold16-777768_777870,cPa75,1,1,777847,777818,cPa75,2,102,29
Scaffold16-778029_779190,cPa75,1,1,779190,778079,cPa75,59,1161,1111
Scaffold16-779350_779457,cPa75,1,1,779405,779359,cPa75,4,107,46
Scaffold16-779802_779904,cPa75,1,1,779896,779805,cPa75,7,102,91
Scaffold16-780728_780830,cPa75,1,1,780778,780745,cPa75,2,102,33
Scaffold16-787075_787237,cPa75,1,1,787185,787125,cPa75,5,162,60
Scaffold16-787611_787827,cPa75,1,1,787775,787661,cPa75,7,216,114
Scaffold16-787897_788024,cPa75,1,1,787972,787947,cPa75,2,127,25
Scaffold16-788117_788301,cPa75,1,1,788249,788167,cPa75,9,184,82
Scaffold16-788333_788435,cPa75,1,1,788383,788383,cPa75,1,102,0
Scaffold16-829664_829766,cPa75,1,1,829714,829710,cPa75,2,102,4
Scaffold16-829831_829986,cPa75,1,1,829949,829842,cPa75,7,155,107
Scaffold16-859994_860101,cPa75,1,1,860060,860044,cPa75,10,107,16
Scaffold16-860113_860362,cPa75,1,1,860310,860163,cPa75,6,249,147
Scaffold16-860385_860559,cPa75,1,1,860507,860435,cPa75,9,174,72
Scaffold16-901294_901414,cPa75,1,1,901408,901344,cPa75,5,120,64
Scaffold16-901826_901957,cPa75,1,1,901909,901876,cPa75,4,131,33
Scaffold16-902564_903226,cPa75,1,1,903174,902614,cPa75,35,662,560
Scaffold16-903668_903770,cPa75,1,1,903719,903707,cPa75,5,102,12
Scaffold16-910816_910918,cPa356,0.578947368421053,2,910872,910817,cPa356_cPa428,11_8,102,55
Scaffold16-910974_911145,cPa356_cPa428,0.5,2,911093,911014,cPa356_cPa428,4_4,171,79
Scaffold16-911741_911885,cPa356,0.611111111111111,2,911883,911786,cPa356_cPa428,11_7,144,97
Scaffold16-912092_912194,cPa428,0.529411764705882,2,912181,912093,cPa356_cPa428,8_9,102,88
Scaffold16-912334_912436,cPa428,0.75,2,912406,912339,cPa356_cPa428,1_3,102,67
Scaffold16-912793_912895,cPa356-cPa109-hybrid,1,1,912843,912843,cPa356-cPa109-hybrid,1,102,0
Scaffold16-913376_913490,cPa428-cPa109-hybrid,0.571428571428571,3,913438,913426,cPa356-cPa109-hybrid_cPa356-HERV30_repbase_HERV30I_LTR30-hybrid_cPa428-cPa109-hybrid,2_1_4,114,12
Scaffold16-915822_915924,cPa75,1,1,915872,915872,cPa75,1,102,0
Scaffold16-916058_916160,cPa75,1,1,916108,916108,cPa75,1,102,0
Scaffold16-917791_917893,cPa75,1,1,917841,917841,cPa75,1,102,0
Scaffold16-918044_918287,cPa75,1,1,918235,918094,cPa75,5,243,141
Scaffold16-918291_918560,cPa75,1,1,918508,918296,cPa75,8,269,212
Scaffold16-918774_918876,cPa75,1,1,918824,918824,cPa75,1,102,0
Scaffold16-925786_925888,cPa75,1,1,925836,925836,cPa75,1,102,0
Scaffold16-926138_926300,cPa75,1,1,926248,926188,cPa75,3,162,60
Scaffold16-926389_926626,cPa75,1,1,926574,926439,cPa75,9,237,135
Scaffold16-926696_926905,cPa75,1,1,926853,926746,cPa75,7,209,107
Scaffold16-926939_927452,cPa75,1,1,927400,926989,cPa75,18,513,411
Scaffold16-927478_927580,cPa75,1,1,927528,927528,cPa75,1,102,0
Scaffold16-933634_933770,cPa75,1,1,933718,933684,cPa75,2,136,34
Scaffold16-933931_934033,cPa75,1,1,933981,933981,cPa75,1,102,0
Scaffold16-934096_934475,cPa75,1,1,934423,934146,cPa75,4,379,277
Scaffold16-934504_934606,cPa75,1,1,934554,934554,cPa75,1,102,0
Scaffold16-934615_935215,cPa75,1,1,935163,934665,cPa75,19,600,498
Scaffold16-937291_937393,cPa75,1,1,937341,937341,cPa75,1,102,0
Scaffold16-937413_937515,cPa75,1,1,937509,937463,cPa75,2,102,46
Scaffold16-940304_941162,cPa75,1,1,941110,940354,cPa75,36,858,756
Scaffold16-941318_941426,cPa75,1,1,941374,941368,cPa75,2,108,6
Scaffold16-966869_967213,cPa75,1,1,967161,966919,cPa75,6,344,242
Scaffold16-992316_992418,cPa75,1,1,992366,992366,cPa75,1,102,0
Scaffold16-992640_992805,cPa75,1,1,992753,992690,cPa75,2,165,63
Scaffold16-993114_993356,cPa75,1,1,993304,993164,cPa75,5,242,140
Scaffold16-993655_993757,cPa75,1,1,993705,993705,cPa75,1,102,0
Scaffold16-993769_993952,cPa75,1,1,993900,993819,cPa75,3,183,81
Scaffold16-999256_999358,cPa75,1,1,999306,999306,cPa75,1,102,0
Scaffold160-54890_55125,cPa428,0.508771929824561,2,55108,54889,cPa356_cPa428,28_29,235,219
Scaffold160-55150_55252,cPa356,0.5,3,55251,55151,cPa356_cPa356-unknown_cPa428,25_1_24,102,100
Scaffold160-55256_55466,cPa356,0.507936507936508,2,55463,55273,cPa356_cPa428,32_31,210,190
Scaffold160-55591_55693,cPa356_cPa428,0.5,2,55685,55641,cPa356_cPa428,4_4,102,44
Scaffold161-41187_41423,cPa75-cPa425-hybrid,1,1,41371,41237,cPa75-cPa425-hybrid,3,236,134
Scaffold161-41426_41528,cPa425_cPa75-HML3_repbase_HERVK9I_MER9-hybrid,0.5,2,41476,41468,cPa425_cPa75-HML3_repbase_HERVK9I_MER9-hybrid,1_1,102,8
Scaffold161-59319_59421,cPa75,1,1,59369,59369,cPa75,1,102,0
Scaffold161-59681_59783,cPa75,1,1,59731,59731,cPa75,1,102,0
Scaffold163-6177_6279,cPa428,1,1,6227,6193,cPa428,2,102,34
Scaffold163-6714_6816,cPa428,1,1,6764,6764,cPa428,1,102,0
Scaffold165-15779_15881,cPa356,1,1,15829,15829,cPa356,1,102,0
Scaffold165-15908_16010,cPa428,0.75,2,15971,15958,cPa356_cPa428,1_3,102,13
Scaffold165-22211_22332,cPa356_cPa428,0.5,2,22280,22261,cPa356_cPa428,1_1,121,19
Scaffold165-2918_3020,cPa356,0.7,2,3016,2938,cPa356_cPa428,7_3,102,78
Scaffold165-3048_3150,cPa428,1,1,3098,3098,cPa428,1,102,0
Scaffold165-3704_3927,cPa356,0.508196721311475,2,3926,3704,cPa356_cPa428,31_30,223,222
Scaffold165-3991_4093,cPa356,0.555555555555556,2,4086,4039,cPa356_cPa428,5_4,102,47
Scaffold165-4581_4726,cPa356,0.540540540540541,2,4698,4587,cPa356_cPa428,20_17,145,111
Scaffold165-48947_49058,cPa428,0.542857142857143,2,49015,48981,cPa356_cPa428,16_19,111,34
Scaffold165-5267_5369,cPa356,0.5,3,5318,5267,cPa356_cPa356-unknown_cPa428,5_1_4,102,51
Scaffold165-56857_56959,cPa428,1,1,56907,56907,cPa428,1,102,0
Scaffold165-57132_57234,cPa428,0.666666666666667,2,57186,57170,cPa356_cPa428,2_4,102,16
Scaffold165-57424_57526,cPa356_cPa428,0.5,2,57493,57474,cPa356_cPa428,2_2,102,19
Scaffold165-59099_59201,cPa356,0.666666666666667,2,59168,59137,cPa356_cPa428,2_1,102,31
Scaffold165-64374_64518,cPa356_cPa428,0.5,2,64466,64424,cPa356_cPa428,2_2,144,42
Scaffold165-64553_64655,cPa356,0.666666666666667,2,64608,64599,cPa356_cPa428,2_1,102,9
Scaffold165-72081_72183,cPa428,1,1,72131,72131,cPa428,1,102,0
Scaffold165-75198_75300,cPa428,1,1,75248,75248,cPa428,1,102,0
Scaffold165-77324_77426,cPa428,1,1,77374,77374,cPa428,1,102,0
Scaffold165-77551_77726,cPa356,0.555555555555556,2,77722,77587,cPa356_cPa428,10_8,175,135
Scaffold165-78830_78932,cPa356_cPa428,0.5,2,78880,78861,cPa356_cPa428,1_1,102,19
Scaffold165-80164_80266,cPa356_cPa428,0.5,2,80236,80166,cPa356_cPa428,3_3,102,70
Scaffold165-80414_80516,cPa428,0.666666666666667,2,80464,80444,cPa356_cPa428,1_2,102,20
Scaffold165-80556_80658,cPa356_cPa428,0.5,2,80606,80571,cPa356_cPa428,3_3,102,35
Scaffold1657-1207_1309,cPa75,1,1,1257,1257,cPa75,1,102,0
Scaffold1657-1549_1748,cPa75,1,1,1696,1599,cPa75,6,199,97
Scaffold1658-21577_21679,cPa223,0.409090909090909,9,21677,21587,cPa15_cPa199_cPa223_cPa223-cPa15-hybrid_cPa223-cPa268-hybrid_cPa363-cPa199-hybrid_cPa413-cPa223-hybrid_cPa450-cPa15-hybrid_cPa450-cPa268-hybrid,6_1_9_1_1_1_1_1_1,102,90
Scaffold166-27073_27175,cPa199,1,1,27123,27123,cPa199,1,102,0
Scaffold166-27318_27420,cPa199,1,1,27368,27368,cPa199,1,102,0
Scaffold166-28383_28485,CAEV_NC001463_WDSV_NC001867,0.5,2,28470,28433,CAEV_NC001463_WDSV_NC001867,1_1,102,37
Scaffold166-30562_30664,cPa539,1,1,30648,30600,cPa539,3,102,48
Scaffold166-30769_30871,cPa539,1,1,30870,30815,cPa539,3,102,55
Scaffold166-30945_31094,cPa539,1,1,31063,30995,cPa539,10,149,68
Scaffold166-41697_41799,cPa585,1,1,41747,41747,cPa585,1,102,0
Scaffold166-41853_41955,cPa585-cPa313-hybrid_cPa585-cPa75-hybrid,0.5,2,41903,41860,cPa585-cPa313-hybrid_cPa585-cPa75-hybrid,1_1,102,43
Scaffold166-4629_4731,cPa75,1,1,4679,4679,cPa75,1,102,0
Scaffold166-56667_56769,WDSV_NC001867,0.75,2,56754,56701,cPa260_WDSV_NC001867,1_3,102,53
Scaffold166-60036_60279,cPa199,0.714285714285714,3,60239,60068,cPa199_cPa201-unknown_cPa482,5_1_1,243,171
Scaffold166-60293_60455,cPa199,0.666666666666667,2,60421,60343,cPa199_cPa199-unknown,2_1,162,78
Scaffold166-6494_6596,cPa75,1,1,6544,6544,cPa75,1,102,0
Scaffold166-6825_6958,cPa75,1,1,6906,6875,cPa75,2,133,31
Scaffold166-86242_86344,cPa199,1,1,86292,86292,cPa199,1,102,0
Scaffold166-86689_86954,cPa199,0.833333333333333,3,86937,86698,cPa199_cPa199-cPa505-hybrid_cPa505,10_1_1,265,239
Scaffold166-86994_87096,cPa199,0.833333333333333,2,87092,87012,cPa199_cPa505-cPa260-hybrid,5_1,102,80
Scaffold1660-18938_19040,cPa360_cPa75-unknown,0.5,2,18988,18988,cPa360_cPa75-unknown,1_1,102,0
Scaffold1660-19668_19872,WDSV_NC001867,0.4375,6,19821,19718,cPa62_cPa62-unknown_cPa62-WDSV_NC001867-hybrid_cPa75-WDSV_NC001867-hybrid_WDSV_NC001867_WDSV_NC001867-unknown,3_12_1_1_14_1,204,103
Scaffold1660-19953_20145,WDSV_NC001867,0.4,4,20137,19981,cPa62-unknown_cPa62-WDSV_NC001867-hybrid_WDSV_NC001867_WDSV_NC001867-cPa456-hybrid,1_1_2_1,192,156
Scaffold1660-29090_29192,cPa75,1,1,29140,29140,cPa75,1,102,0
Scaffold1660-39406_39547,cPa75,1,1,39495,39456,cPa75,4,141,39
Scaffold1660-39625_39727,cPa75,1,1,39675,39675,cPa75,1,102,0
Scaffold1660-39755_40060,cPa75,1,1,40008,39805,cPa75,12,305,203
Scaffold1660-44786_44888,cPa75,1,1,44836,44836,cPa75,1,102,0
Scaffold1660-45336_45438,cPa75,1,1,45386,45386,cPa75,1,102,0
Scaffold1660-48352_48507,cPa75,0.8,2,48475,48402,cPa75_cPa75-unknown,4_1,155,73
Scaffold1660-48513_48701,cPa75_cPa75-unknown,0.5,2,48689,48563,cPa75_cPa75-unknown,3_3,188,126
Scaffold1660-540_642,WDSV_NC001867,1,1,591,590,WDSV_NC001867,2,102,1
Scaffold1660-74089_74191,cPa75,1,1,74139,74139,cPa75,1,102,0
Scaffold1660-74519_74621,cPa75,1,1,74569,74569,cPa75,1,102,0
Scaffold1660-78473_78575,cPa75,1,1,78523,78523,cPa75,1,102,0
Scaffold1660-78696_78798,cPa75,1,1,78746,78746,cPa75,1,102,0
Scaffold1660-931_1033,WDSV_NC001867,1,1,981,981,WDSV_NC001867,1,102,0
Scaffold1661-10069_10171,cPa75-cPa223-hybrid_cPa75-cPa315-hybrid,0.5,2,10129,10119,cPa75-cPa223-hybrid_cPa75-cPa315-hybrid,1_1,102,10
Scaffold1661-12684_12862,cPa75,0.545454545454545,3,12810,12713,cPa223-cPa75-hybrid_cPa425-cPa75-hybrid_cPa75,4_1_6,178,97
Scaffold1661-24836_24938,cPa117,0.785714285714286,3,24935,24866,cPa117_cPa456-cPa223-hybrid_cPa81,11_1_2,102,69
Scaffold1661-25024_25126,cPa117,0.444444444444444,4,25114,25054,cPa117_cPa419-cPa81-hybrid_cPa456_cPa81,4_1_1_3,102,60
Scaffold1661-25232_25415,cPa456,0.3,10,25383,25251,cPa117_cPa117-cPa75-hybrid_cPa419-cPa223-hybrid_cPa452_cPa452-cPa223-hybrid_cPa456_cPa456-cPa223-hybrid_cPa456-cPa587-hybrid_cPa456-cPa75-hybrid_cPa81,4_1_1_1_1_6_2_2_1_1,183,132
Scaffold1661-25479_25632,cPa456-cPa223-hybrid,0.461538461538462,6,25608,25524,cPa117-cPa315-hybrid_cPa117-cPa425-hybrid_cPa223_cPa456-cPa223-hybrid_cPa456-cPa315-hybrid_cPa456-cPa75-hybrid,1_1_3_6_1_1,153,84
Scaffold1661-25640_25742,cPa223,1,1,25736,25666,cPa223,3,102,70
Scaffold1661-26022_26124,cPa223,1,1,26072,26072,cPa223,1,102,0
Scaffold1661-31240_31342,cPa199,0.571428571428571,3,31323,31290,cPa199_cPa356_cPa356-cPa199-hybrid,4_2_1,102,33
Scaffold1661-31956_32058,cPa356,1,1,32006,32006,cPa356,1,102,0
Scaffold1661-32067_32223,cPa356,0.846153846153846,2,32171,32067,cPa356_cPa419,11_2,156,104
Scaffold1662-12079_12186,cPa61-cPa449-hybrid,0.5,3,12141,12111,cPa61-cPa229-hybrid_cPa61-cPa313-hybrid_cPa61-cPa449-hybrid,1_1_2,107,30
Scaffold1662-13424_13611,cPa75-cPa315-hybrid_cPa75-unknown,0.411764705882353,3,13603,13436,cPa75-cPa223-hybrid_cPa75-cPa315-hybrid_cPa75-unknown,3_7_7,187,167
Scaffold1662-25268_25370,HFV_NC001736-cPa419-hybrid,1,1,25318,25318,HFV_NC001736-cPa419-hybrid,1,102,0
Scaffold1662-32646_32911,cPa75-cPa219-hybrid,0.625,4,32859,32660,cPa395-cPa450-hybrid_cPa75_cPa75-cPa121-hybrid_cPa75-cPa219-hybrid,1_4_1_10,265,199
Scaffold1662-32967_33276,cPa75_cPa75-cPa219-hybrid,0.428571428571429,3,33224,33017,cPa546-cPa121-hybrid_cPa75_cPa75-cPa219-hybrid,1_3_3,309,207
Scaffold1662-33533_33686,cPa75-cPa219-hybrid,0.625,4,33654,33545,cPa219_cPa404-cPa174-hybrid_cPa546-cPa219-hybrid_cPa75-cPa219-hybrid,1_1_1_5,153,109
Scaffold1662-39066_39168,cPa419,1,1,39116,39101,cPa419,2,102,15
Scaffold1662-51730_51832,cPa323-cPa482-hybrid_cPa333-unknown_cPa419,0.333333333333333,3,51831,51753,cPa323-cPa482-hybrid_cPa333-unknown_cPa419,1_1_1,102,78
Scaffold1662-60405_60631,cPa308,0.705882352941177,8,60579,60419,cPa205-cPa121-hybrid_cPa205-unknown_cPa308_cPa363-cPa121-hybrid_cPa363-cPa173-hybrid_cPa363-unknown_VISNA_S55323-cPa121-hybrid_VISNA_S55323-unknown,1_1_36_1_1_9_1_1,226,160
Scaffold1662-60693_60847,cPa308,0.886363636363636,5,60795,60734,cPa205-cPa308-hybrid_cPa308_cPa363-cPa290-hybrid_cPa363-cPa308-hybrid_VISNA_S55323-unknown,1_39_1_2_1,154,61
Scaffold1662-61090_61192,cPa308,1,1,61140,61140,cPa308,1,102,0
Scaffold1662-61465_61567,cPa308,1,1,61565,61515,cPa308,2,102,50
Scaffold1662-9751_9853,cPa419,0.4,4,9830,9776,cPa199_cPa223-cPa449-hybrid_cPa419_cPa449,1_1_2_1,102,54
Scaffold1663-11716_11818,cPa145-unknown,1,1,11766,11766,cPa145-unknown,1,102,0
Scaffold1666-16761_16898,cPa193,0.777777777777778,3,16846,16794,cPa193_cPa260-cPa193-hybrid_cPa67-cPa193-hybrid,7_1_1,137,52
Scaffold1666-19834_19936,cPa546-cPa450-hybrid_cPa566-cPa542-hybrid,0.5,2,19884,19882,cPa546-cPa450-hybrid_cPa566-cPa542-hybrid,1_1,102,2
Scaffold1666-19945_20047,cPa566-cPa542-hybrid_cPa61-cPa75-hybrid,0.5,2,19995,19984,cPa566-cPa542-hybrid_cPa61-cPa75-hybrid,1_1,102,11
Scaffold1666-47342_47444,cPa413-cPa410-hybrid,1,1,47392,47392,cPa413-cPa410-hybrid,1,102,0
Scaffold1666-8213_8315,cPa583-cPa379-hybrid,1,1,8302,8246,cPa583-cPa379-hybrid,3,102,56
Scaffold1667-21249_21426,cPa308,1,1,21375,21285,cPa308,8,177,90
Scaffold1667-21545_21663,cPa308,1,1,21614,21595,cPa308,5,118,19
Scaffold1668-36642_36749,cPa456,0.490909090909091,7,36744,36686,cPa117-cPa363-hybrid_cPa363_cPa452_cPa452-cPa456-hybrid_cPa452-REV_NC006934-hybrid_cPa452-unknown_cPa456,1_4_20_1_1_1_27,107,58
Scaffold1668-41529_41631,cPa339-unknown,0.555555555555556,3,41612,41579,cPa339-cPa425-hybrid_cPa339-SIV_NC001870-hybrid_cPa339-unknown,1_3_5,102,33
Scaffold1668-81398_81511,cPa113-cPa199-hybrid,0.75,2,81469,81445,cPa113-cPa199-hybrid_cPa332-cPa199-hybrid,3_1,113,24
Scaffold1668-81615_81728,cPa113-cPa199-hybrid,0.4,4,81685,81652,cPa113-cPa199-hybrid_cPa113-cPa439-hybrid_cPa332-cPa199-hybrid_cPa419,4_3_1_2,113,33
Scaffold1668-81785_81887,cPa439,0.666666666666667,2,81840,81808,cPa113-cPa425-hybrid_cPa439,1_2,102,32
Scaffold1668-82061_82163,cPa439,1,1,82111,82111,cPa439,1,102,0
Scaffold1668-85682_85833,cPa308-cPa446-hybrid,0.4,4,85781,85732,cPa145_cPa145-cPa308-hybrid_cPa308-cPa446-hybrid_cPa446,1_1_2_1,151,49
Scaffold1668-85904_86067,cPa199-unknown,0.428571428571429,5,86053,85906,cPa158-cPa302-hybrid_cPa158-cPa446-hybrid_cPa199-cPa109-hybrid_cPa199-unknown_cPa419,1_1_1_3_1,163,147
Scaffold1668-88800_88992,cPa413-unknown,0.839285714285714,4,88949,88824,cPa413-cPa145-hybrid_cPa413-cPa419-hybrid_cPa413-unknown_cPa419,2_1_47_6,192,125
Scaffold1668-91779_91904,cPa543,0.777777777777778,3,91853,91829,cPa419-cPa543-hybrid_cPa543_cPa543-MDEV_AF053745-hybrid,1_7_1,125,24
Scaffold1668-92890_93191,cPa268-MDEV_AF053745-hybrid,0.26530612244898,12,93139,92919,cPa268-cPa4-hybrid_cPa268-KWERV_GQ222416-hybrid_cPa268-MDEV_AF053745-hybrid_cPa308_cPa308-KWERV_GQ222416-hybrid_cPa308-MDEV_AF053745-hybrid_cPa381-cPa293-hybrid_cPa381-MDEV_AF053745-hybrid_cPa419_cPa434-cPa543-hybrid_cPa486-MDEV_AF053745-hybrid_MDEV_AF053745,1_6_13_2_2_7_1_9_2_1_2_3,301,220
Scaffold1668-93451_93557,cPa308-MDEV_AF053745-hybrid,0.2,10,93548,93459,cPa268-KWERV_GQ222416-hybrid_cPa268-MDEV_AF053745-hybrid_cPa308-cPa356-hybrid_cPa308-MDEV_AF053745-hybrid_cPa353-MDEV_AF053745-hybrid_cPa356_cPa381-KWERV_GQ222416-hybrid_cPa381-MDEV_AF053745-hybrid_cPa419_cPa486-MDEV_AF053745-hybrid,2_3_1_4_1_2_2_3_1_1,106,89
Scaffold1668-93585_93689,cPa356,0.413793103448276,13,93676,93600,cPa268-cPa447-hybrid_cPa268-MDEV_AF053745-hybrid_cPa308-cPa447-hybrid_cPa308-MDEV_AF053745-hybrid_cPa356_cPa381-cPa356-hybrid_cPa381-cPa447-hybrid_cPa381-KWERV_GQ222416-hybrid_cPa381-MDEV_AF053745-hybrid_cPa425-cPa447-hybrid_cPa434-cPa387-hybrid_cPa447_cPa486-cPa356-hybrid,2_1_3_1_12_3_1_1_1_1_1_1_1,104,76
Scaffold1668-94960_95066,cPa308-cPa34-hybrid_cPa381-cPa34-hybrid,0.5,2,95014,95010,cPa308-cPa34-hybrid_cPa381-cPa34-hybrid,1_1,106,4
Scaffold167-88283_88385,cPa419,1,1,88334,88313,cPa419,3,102,21
Scaffold167-88459_88586,cPa419,1,1,88564,88459,cPa419,8,127,105
Scaffold1670-33101_33203,cPa419,1,1,33151,33151,cPa419,1,102,0
Scaffold1670-34410_34743,cPa145,0.552631578947368,10,34691,34428,cPa145_cPa145-cPa308-hybrid_cPa145-unknown_cPa15-cPa145-hybrid_cPa15-cPa177-hybrid_cPa216-cPa145-hybrid_cPa308_cPa446-cPa145-hybrid_cPa446-cPa308-hybrid_cPa543-cPa308-hybrid,21_1_6_1_1_1_3_2_1_1,333,263
Scaffold1670-36515_36718,cPa15-ALVE_FJ793550-hybrid,1,1,36666,36565,cPa15-ALVE_FJ793550-hybrid,4,203,101
Scaffold1670-38445_38643,cPa356,0.454545454545455,11,38643,38460,Cer1_U15406-cPa308-hybrid_cPa356_cPa356-cPa387-hybrid_cPa419_cPa447_cPa447-ALVE_FJ793550-hybrid_cPa447-cPa308-hybrid_cPa447-cPa387-hybrid_cPa447-unknown_cPa62_PERVA_AY099323,1_10_1_1_3_1_1_1_1_1_1,198,183
Scaffold1670-38652_39073,cPa356,0.55,13,39055,38669,Cer1_U15406-cPa356-hybrid_cPa308_cPa356_cPa356-ALVE_FJ793550-hybrid_cPa356-cPa447-hybrid_cPa356-unknown_cPa419_cPa447_cPa447-ALVE_FJ793550-hybrid_cPa447-cPa356-hybrid_cPa447-cPa387-hybrid_cPa447-unknown_PERVA_AY099323-cPa356-hybrid,2_1_88_2_1_3_1_55_1_3_1_1_1,421,386
Scaffold1670-39088_39247,cPa356,0.307692307692308,7,39234,39123,cPa199-cPa447-hybrid_cPa356_cPa356-cPa447-hybrid_cPa419_cPa434_cPa447_cPa447-unknown,1_4_1_1_1_2_3,159,111
Scaffold1670-42432_42534,cPa425-cPa121-hybrid,0.714285714285714,2,42482,42462,cPa425_cPa425-cPa121-hybrid,2_5,102,20
Scaffold1670-42950_43180,cPa402,0.451612903225806,7,43128,43000,cPa285-cPa121-hybrid_cPa293-cPa121-hybrid_cPa293-cPa402-hybrid_cPa402_cPa402-cPa121-hybrid_cPa425-cPa121-hybrid_cPa425-cPa158-hybrid,1_1_1_14_1_12_1,230,128
Scaffold1671-1147_1257,cPa75-cPa16-hybrid,0.340425531914894,17,1227,1167,cPa138-cPa16-hybrid_cPa205-HERV-W_repbase_HERV17_LTR17-hybrid_cPa419_cPa587_cPa587-HERV-XA34_repbase_HERVFH21I_LTR21A-hybrid_cPa75-cPa16-hybrid_cPa75-cPa227-hybrid_HERV-F_repbase_HERVFH19I_LTR19A_HERV-F_repbase_HERVFH19I_LTR19A-cPa138-hybrid_HERV-F_repbase_HERVFH19I_LTR19A-cPa16-hybrid_HERV-W_repbase_HERV17_LTR17_HERV-W_repbase_HERV17_LTR17-cPa16-hybrid_HERV-W_repbase_HERV17_LTR17-HERV-XA34_repbase_HERVFH21I_LTR21A-hybrid_HERV-XA34_repbase_HERVFH21I_LTR21A_HERV-XA34_repbase_HERVFH21I_LTR21A-cPa16-hybrid_HERV-XA34_repbase_HERVFH21I_LTR21A-cPa339-hybrid_HERV-XA34_repbase_HERVFH21I_LTR21A-HERV-W_repbase_HERV17_LTR17-hybrid,1_1_1_2_1_32_1_22_1_2_21_1_1_4_1_1_1,110,60
Scaffold1671-2019_2126,cPa75-cPa339-hybrid,0.233333333333333,18,2074,2027,cPa138_cPa138-cPa339-hybrid_cPa285-HERV-W_repbase_HERV17_LTR17-hybrid_cPa363-cPa205-hybrid_cPa363-HERV-F_repbase_HERVFH19I_LTR19A-hybrid_cPa419_cPa475-cPa168-hybrid_cPa475-HERV-F_repbase_HERVFH19I_LTR19A-hybrid_cPa56-HERV-F_repbase_HERVFH19I_LTR19A-hybrid_cPa62-cPa205-hybrid_cPa62-cPa308-hybrid_cPa62-HERV-W_repbase_HERV17_LTR17-hybrid_cPa75_cPa75-cPa16-hybrid_cPa75-cPa339-hybrid_cPa75-HERV-F_repbase_HERVFH19I_LTR19A-hybrid_HERV-W_repbase_HERV17_LTR17-cPa138-hybrid_HERV-W_repbase_HERV17_LTR17-cPa339-hybrid,3_2_1_1_2_1_1_1_1_1_1_1_2_2_7_1_1_1,107,47
Scaffold1671-2146_2312,cPa138,0.315789473684211,14,2293,2159,cPa138_cPa138-cPa339-hybrid_cPa138-cPa449-hybrid_cPa419_cPa419-cPa138-hybrid_cPa475-HERV-W_repbase_HERV17_LTR17-hybrid_cPa62-cPa205-hybrid_cPa62-HERV-F_repbase_HERVFH19I_LTR19A-hybrid_cPa62-HERV-W_repbase_HERV17_LTR17-hybrid_cPa75-cPa138-hybrid_cPa75-cPa339-hybrid_cPa75-cPa419-hybrid_cPa75-cPa449-hybrid_HERVHcons-cPa587-hybrid,12_3_1_1_1_1_2_2_3_1_8_1_1_1,166,134
Scaffold1671-2532_2634,cPa75-cPa339-hybrid,0.666666666666667,2,2606,2542,cPa419_cPa75-cPa339-hybrid,1_2,102,64
Scaffold1671-2823_2925,cPa62-cPa339-hybrid,0.470588235294118,7,2874,2831,cPa475-cPa339-hybrid_cPa62-cPa308-hybrid_cPa62-cPa339-hybrid_cPa62-unknown_HERVHcons_HERVHcons-cPa339-hybrid_HERVHcons-unknown,2_1_8_1_2_1_2,102,43
Scaffold1671-3107_3281,cPa62-cPa339-hybrid,0.230769230769231,13,3237,3157,cPa228-cPa138-hybrid_cPa254-cPa339-hybrid_cPa363-cPa339-hybrid_cPa419_cPa56-cPa339-hybrid_cPa62-cPa339-hybrid_cPa62-cPa449-hybrid_cPa62-unknown_cPa75-cPa449-hybrid_HERVHcons-cPa339-hybrid_HERVHcons-cPa449-hybrid_HML2_Pheonix-cPa339-hybrid_HML2_Pheonix-cPa419-hybrid,1_1_2_1_1_6_3_3_2_3_1_1_1,174,80
Scaffold1672-13258_13360,cPa511-unknown,1,1,13308,13308,cPa511-unknown,1,102,0
Scaffold1672-49397_49499,cPa308,1,1,49447,49397,cPa308,3,102,50
Scaffold1672-49512_49690,cPa425,0.444444444444444,5,49677,49562,cPa308_cPa308-PERVE_NC003059-hybrid_cPa308-unknown_cPa425_cPa425-unknown,5_1_3_8_1,178,115
Scaffold1672-50586_50845,cPa425,0.416666666666667,7,50793,50591,cPa356_cPa381-cPa425-hybrid_cPa419_cPa425_cPa425-PERVE_NC003059-hybrid_cPa425-unknown_cPa434-HERVHcons-hybrid,1_1_1_5_1_2_1,259,202
Scaffold1672-51356_51458,HERV-I_repbase_HERVI_LTR10B-cPa356-hybrid_S71_repbase_HERVS71_LTR6A-cPa356-hybrid,0.5,2,51406,51405,HERV-I_repbase_HERVI_LTR10B-cPa356-hybrid_S71_repbase_HERVS71_LTR6A-cPa356-hybrid,1_1,102,1
Scaffold1672-52368_52470,cPa356,0.571428571428571,4,52418,52373,cPa15_cPa268-cPa15-hybrid_cPa356_cPa434-cPa356-hybrid,1_1_4_1,102,45
Scaffold1672-52538_52640,cPa356,1,1,52629,52588,cPa356,2,102,41
Scaffold1672-54058_54389,cPa425,0.297297297297297,15,54354,54108,cPa118_cPa118-cPa443-hybrid_cPa15_cPa174-cPa425-hybrid_cPa264-cPa15-hybrid_cPa356-cPa425-hybrid_cPa425_cPa425-cPa118-hybrid_cPa425-cPa15-hybrid_cPa443_cPa62-cPa443-hybrid_MDEV_AF053745-cPa118-hybrid_MDEV_AF053745-cPa15-hybrid_MDEV_AF053745-cPa425-hybrid_MDEV_AF053745-cPa443-hybrid,1_1_4_1_1_1_11_2_1_3_1_1_5_1_3,331,246
Scaffold1672-55975_56077,cPa15,0.235294117647059,9,56061,55980,cPa118_cPa125_cPa125-cPa118-hybrid_cPa125-cPa47-hybrid_cPa140_cPa140-cPa47-hybrid_cPa15_cPa268_cPa443,1_1_3_2_3_1_4_1_1,102,81
Scaffold1672-56380_56482,cPa118-cPa47-hybrid_cPa125_cPa268,0.333333333333333,3,56430,56391,cPa118-cPa47-hybrid_cPa125_cPa268,1_1_1,102,39
Scaffold1672-57004_57115,cPa15,0.590909090909091,9,57105,57003,cPa118_cPa125_cPa125-cPa15-hybrid_cPa125-cPa268-hybrid_cPa140_cPa15_cPa248_cPa268_cPa443,1_1_1_1_1_13_1_2_1,111,102
Scaffold1672-58138_58288,cPa15,0.581395348837209,13,58288,58144,cPa118_cPa118-cPa248-hybrid_cPa125_cPa140_cPa15_cPa248_cPa264-cPa15-hybrid_cPa268_cPa443_cPa443-cPa119-hybrid_cPa443-cPa248-hybrid_cPa516-cPa15-hybrid_cPa516-unknown,3_1_1_1_25_2_1_1_2_1_1_1_3,150,144
Scaffold1672-58374_58476,cPa15,0.702702702702703,9,58469,58387,cPa118_cPa125_cPa140_cPa15_cPa248_cPa264_cPa443-cPa119-hybrid_cPa47-cPa248-hybrid_cPa516-cPa248-hybrid,1_2_2_26_2_1_1_1_1,102,82
Scaffold1672-59355_59457,cPa15,0.444444444444444,5,59444,59362,cPa118_cPa15_cPa404-cPa248-hybrid_cPa443_cPa443-cPa264-hybrid,1_4_2_1_1,102,82
Scaffold1672-62179_62290,cPa106-unknown,0.666666666666667,2,62238,62186,cPa106-unknown_cPa109-unknown,2_1,111,52
Scaffold1672-9684_9786,cPa425,1,1,9734,9734,cPa425,1,102,0
Scaffold1672-9836_10057,cPa425-unknown,0.533333333333333,6,10036,9877,cPa248-cPa308-hybrid_cPa419_cPa425_cPa425-cPa308-hybrid_cPa425-cPa81-hybrid_cPa425-unknown,1_2_2_1_1_8,221,159
Scaffold1673-1986_2088,cPa425,0.857142857142857,2,2037,2023,cPa425_cPa425-cPa308-hybrid,6_1,102,14
Scaffold1673-29310_29434,PERVE_NC003059-cPa425-hybrid,0.6,5,29383,29344,cPa425_PERVE_NC003059-cPa168-hybrid_PERVE_NC003059-cPa425-hybrid_PERVE_NC003059-cPa446-hybrid_PERVE_NC003059-HERV-Fb_repbase_HERVH48I_MER48-hybrid,1_1_15_1_7,124,39
Scaffold1673-29510_29614,PERVE_NC003059-cPa425-hybrid,1,1,29562,29560,PERVE_NC003059-cPa425-hybrid,2,104,2
Scaffold1673-29620_29722,PERVE_NC003059-cPa168-hybrid_PERVE_NC003059-cPa425-hybrid,0.5,2,29672,29670,PERVE_NC003059-cPa168-hybrid_PERVE_NC003059-cPa425-hybrid,1_1,102,2
Scaffold1673-29814_29916,cPa419_cPa425_PERVE_NC003059-cPa425-hybrid,0.333333333333333,3,29905,29864,cPa419_cPa425_PERVE_NC003059-cPa425-hybrid,1_1_1,102,41
Scaffold1673-31701_31914,cPa121-cPa75-hybrid,0.222222222222222,8,31910,31751,cPa121-cPa323-hybrid_cPa121-cPa75-hybrid_cPa121-ENTV_NC004994-hybrid_cPa199-cPa75-hybrid_cPa34_cPa34-HERV-Fb_repbase_HERVH48I_MER48-hybrid_cPa402_cPa402-cPa42-hybrid,1_2_1_1_1_1_1_1,213,159
Scaffold1673-32002_32104,cPa121-cPa241-hybrid,0.333333333333333,5,32055,32033,cPa121-cPa241-hybrid_cPa121-cPa323-hybrid_cPa121-cPa75-hybrid_cPa402-cPa158-hybrid_cPa75,2_1_1_1_1,102,22
Scaffold1673-32606_32709,cPa121-cPa241-hybrid,0.384615384615385,7,32660,32624,cPa121-cPa241-hybrid_cPa121-cPa285-hybrid_cPa308-cPa158-hybrid_cPa34-cPa241-hybrid_cPa402-cPa241-hybrid_cPa402-cPa285-hybrid_cPa62-cPa75-hybrid,5_1_1_1_1_3_1,103,36
Scaffold1673-33825_34009,cPa75,0.181818181818182,14,34005,33838,cPa224_cPa224-cPa241-hybrid_cPa224-cPa75-hybrid_cPa224-unknown_cPa273-cPa285-hybrid_cPa273-cPa486-hybrid_cPa308-cPa62-hybrid_cPa308-cPa75-hybrid_cPa360-unknown_cPa62_cPa62-cPa75-hybrid_cPa62-unknown_cPa75_cPa75-cPa164-hybrid,1_1_4_2_1_3_1_3_1_5_2_2_6_1,184,167
Scaffold1673-34025_34218,cPa224-cPa75-hybrid,0.272727272727273,7,34166,34075,cPa224-cPa75-hybrid_cPa224-unknown_cPa308-unknown_cPa360-cPa75-hybrid_cPa62-cPa75-hybrid_cPa62-unknown_cPa75,3_2_1_1_1_1_2,193,91
Scaffold1673-417_519,cPa34-cPa356-hybrid_cPa67,0.193548387096774,12,512,416,cPa194_cPa34-cPa111-hybrid_cPa34-cPa194-hybrid_cPa34-cPa356-hybrid_cPa34-cPa434-hybrid_cPa34-HERV-I_repbase_HERVI_LTR10B-hybrid_cPa425-cPa356-hybrid_cPa434_cPa583-cPa356-hybrid_cPa583-cPa434-hybrid_cPa67_HERV-I_repbase_HERVI_LTR10B-cPa111-hybrid,4_1_1_6_4_2_1_2_2_1_6_1,102,96
Scaffold1673-655_758,cPa67,0.527777777777778,12,754,665,cPa194_cPa34-cPa111-hybrid_cPa34-cPa194-hybrid_cPa34-cPa356-hybrid_cPa34-cPa434-hybrid_cPa34-HERV-I_repbase_HERVI_LTR10B-hybrid_cPa425-cPa434-hybrid_cPa425-cPa523-hybrid_cPa434_cPa583-cPa356-hybrid_cPa67_HERV-I_repbase_HERVI_LTR10B-cPa434-hybrid,16_1_2_3_4_2_1_1_1_1_38_2,103,89
Scaffold1673-890_992,cPa34-cPa111-hybrid,0.203703703703704,24,990,889,cPa111_cPa194_cPa34-cPa111-hybrid_cPa34-cPa194-hybrid_cPa34-cPa356-hybrid_cPa34-cPa425-hybrid_cPa34-cPa434-hybrid_cPa34-cPa67-hybrid_cPa34-S71_repbase_HERVS71_LTR6A-hybrid_cPa356_cPa425-cPa194-hybrid_cPa425-cPa356-hybrid_cPa425-cPa434-hybrid_cPa425-cPa67-hybrid_cPa583-cPa111-hybrid_cPa583-cPa194-hybrid_cPa583-cPa356-hybrid_cPa583-cPa425-hybrid_cPa583-cPa434-hybrid_cPa583-cPa67-hybrid_cPa583-S71_repbase_HERVS71_LTR6A-hybrid_cPa583-unknown_cPa67_HERV-I_repbase_HERVI_LTR10B-cPa67-hybrid,14_8_33_19_3_1_1_3_1_1_11_2_2_1_25_10_3_1_2_2_1_1_16_1,102,101
Scaffold1674-10360_10471,cPa434_cPa566,0.157894736842105,19,10421,10393,cPa140-unknown_cPa264_cPa264-cPa356-hybrid_cPa264-unknown_cPa410_cPa410-cPa308-hybrid_cPa410-cPa434-hybrid_cPa410-unknown_cPa434_cPa434-unknown_cPa443-cPa308-hybrid_cPa447_cPa447-cPa356-hybrid_cPa566_cPa566-cPa308-hybrid_cPa566-cPa356-hybrid_cPa566-cPa410-hybrid_cPa566-unknown_HIV2_NC001722-cPa356-hybrid,2_2_1_4_2_2_1_8_9_1_1_4_2_9_1_2_1_4_1,111,28
Scaffold1674-10794_10896,cPa447_cPa447-unknown_HIV2_NC001722-unknown,0.333333333333333,3,10855,10793,cPa447_cPa447-unknown_HIV2_NC001722-unknown,1_1_1,102,62
Scaffold1674-1268_1370,cPa42,1,1,1318,1318,cPa42,1,102,0
Scaffold1674-12875_13422,cPa75-unknown,0.659090909090909,7,13377,12925,cPa107_cPa75-cPa200-hybrid_cPa75-cPa272-hybrid_cPa75-cPa357-hybrid_cPa75-cPa510-hybrid_cPa75-cPa544-hybrid_cPa75-unknown,4_1_5_2_1_2_29,547,452
Scaffold1674-1392_1494,cPa419_cPa443_cPa62,0.333333333333333,3,1465,1442,cPa419_cPa443_cPa62,1_1_1,102,23
Scaffold1674-14946_15048,cPa107,1,1,15046,14996,cPa107,2,102,50
Scaffold1674-4608_4710,cPa224-HERVHcons-hybrid_cPa75,0.5,2,4658,4648,cPa224-HERVHcons-hybrid_cPa75,1_1,102,10
Scaffold1674-4728_4830,cPa360-unknown,1,1,4778,4778,cPa360-unknown,1,102,0
Scaffold1674-5804_5916,cPa425,1,1,5866,5829,cPa425,32,112,37
Scaffold1674-6825_7062,cPa75-cPa199-hybrid,0.6,3,7010,6875,cPa193-cPa425-hybrid_cPa425-cPa16-hybrid_cPa75-cPa199-hybrid,1_1_3,237,135
Scaffold1674-7593_7695,cPa199_HERV-XA34_repbase_HERVFH21I_LTR21A,0.5,2,7695,7643,cPa199_HERV-XA34_repbase_HERVFH21I_LTR21A,1_1,102,52
Scaffold1674-9058_9160,cPa356,0.666666666666667,3,9145,9061,cPa356_cPa447_cPa75-cPa356-hybrid,4_1_1,102,84
Scaffold1674-9189_9328,cPa356,0.515463917525773,14,9324,9215,cPa125-cPa356-hybrid_cPa199-cPa356-hybrid_cPa356_cPa387-cPa47-hybrid_cPa410-cPa356-hybrid_cPa419_cPa447_cPa447-cPa199-hybrid_cPa447-cPa308-hybrid_cPa447-cPa356-hybrid_cPa447-cPa47-hybrid_cPa447-cPa566-hybrid_cPa447-unknown_cPa566-cPa356-hybrid,1_1_50_1_4_1_23_1_2_1_1_1_4_6,139,109
Scaffold1675-10672_10780,cPa75-unknown,1,1,10728,10722,cPa75-unknown,2,108,6
Scaffold1675-1438_1540,cPa75_cPa75-unknown,0.5,2,1540,1488,cPa75_cPa75-unknown,1_1,102,52
Scaffold1675-1628_1991,cPa75,0.5,9,1989,1678,cPa224_cPa273_cPa308-cPa224-hybrid_cPa419_cPa419-cPa273-hybrid_cPa75_cPa75-cPa224-hybrid_cPa75-cPa273-hybrid_cPa75-unknown,3_2_1_2_1_18_3_2_4,363,311
Scaffold1675-17557_17661,cPa419_cPa62-cPa425-hybrid,0.5,2,17610,17599,cPa419_cPa62-cPa425-hybrid,2_2,104,11
Scaffold1675-27859_27961,cPa50,1,1,27909,27909,cPa50,1,102,0
Scaffold1675-27983_28116,cPa568-cPa50-hybrid,0.5,3,28106,28033,cPa333_cPa50_cPa568-cPa50-hybrid,1_1_2,133,73
Scaffold1675-2803_3148,cPa425,0.894736842105263,9,3147,2818,cPa152-HERV-Fb_repbase_HERVH48I_MER48-hybrid_cPa201-cPa75-hybrid_cPa273-unknown_cPa419_cPa425_cPa75_cPa75-cPa425-hybrid_cPa75-HERV-Fb_repbase_HERVH48I_MER48-hybrid_HERV-Fb_repbase_HERVH48I_MER48,1_1_1_2_187_5_3_8_1,345,329
Scaffold1675-4479_4630,cPa425,0.8,2,4626,4529,cPa177_cPa425,1_4,151,97
Scaffold1675-48994_49096,cPa47,0.545454545454545,4,49089,49018,cPa174_cPa404_cPa425_cPa47,5_4_1_12,102,71
Scaffold1675-49211_49313,cPa47,0.4,5,49268,49213,cPa140-cPa425-hybrid_cPa174_cPa404_cPa425_cPa47,1_5_2_1_6,102,55
Scaffold1675-52010_52112,cPa425,0.666666666666667,3,52098,52059,cPa174_cPa425_cPa47,1_4_1,102,39
Scaffold1675-65503_65605,cPa444-cPa381-hybrid,1,1,65553,65553,cPa444-cPa381-hybrid,1,102,0
Scaffold1675-6807_6977,cPa356,0.4,8,6975,6857,cPa293-cPa356-hybrid_cPa356_cPa356-cPa447-hybrid_cPa356-cPa566-hybrid_cPa356-unknown_cPa447_cPa447-cPa356-hybrid_cPa447-cPa410-hybrid,1_12_5_2_3_5_1_1,170,118
Scaffold1675-68930_69032,cPa390,1,1,69029,68980,cPa390,2,102,49
Scaffold1675-6985_7284,cPa356,0.37037037037037,15,7232,6985,cPa260-cPa356-hybrid_cPa264-cPa356-hybrid_cPa293-cPa356-hybrid_cPa293-cPa387-hybrid_cPa293-cPa447-hybrid_cPa293-unknown_cPa356_cPa356-cPa447-hybrid_cPa356-cPa566-hybrid_cPa356-unknown_cPa447_cPa447-cPa566-hybrid_cPa566-cPa356-hybrid_cPa566-cPa387-hybrid_cPa75-cPa356-hybrid,1_1_3_1_4_3_30_3_3_3_22_2_3_1_1,299,247
Scaffold1675-7291_7532,cPa566,0.210526315789474,20,7519,7334,cPa125-cPa356-hybrid_cPa125-cPa419-hybrid_cPa140-cPa447-hybrid_cPa264-cPa356-hybrid_cPa264-cPa447-hybrid_cPa293-cPa356-hybrid_cPa293-cPa566-hybrid_cPa356_cPa356-cPa566-hybrid_cPa410_cPa410-cPa447-hybrid_cPa410-cPa566-hybrid_cPa410-HERV-Fb_repbase_HERVH48I_MER48-hybrid_cPa419_cPa443-cPa447-hybrid_cPa447_cPa566_cPa566-cPa356-hybrid_cPa566-cPa447-hybrid_cPa75-cPa447-hybrid,1_1_4_1_2_2_1_5_1_2_7_1_1_2_1_7_12_1_3_2,241,185
Scaffold1675-7602_7704,cPa566,0.545454545454545,6,7703,7602,cPa193-cPa566-hybrid_cPa264-cPa447-hybrid_cPa264-unknown_cPa356_cPa410-unknown_cPa566,1_1_1_1_1_6,102,101
Scaffold1675-85103_85280,cPa333_cPa50-cPa323-hybrid,0.272727272727273,5,85233,85128,cPa333_cPa419_cPa50-cPa323-hybrid_cPa568-cPa323-hybrid_cPa75,3_2_3_2_1,177,105
Scaffold1675-9182_9284,HERV-Fb_repbase_HERVH48I_MER48,1,1,9248,9232,HERV-Fb_repbase_HERVH48I_MER48,2,102,16
Scaffold1675-9413_9515,HERV-Fb_repbase_HERVH48I_MER48,1,1,9507,9463,HERV-Fb_repbase_HERVH48I_MER48,2,102,44
Scaffold1676-10926_11095,cPa75,1,1,11043,10955,cPa75,18,169,88
Scaffold1676-11137_11260,cPa75,1,1,11208,11146,cPa75,7,123,62
Scaffold1676-1123_1225,cPa443,0.227272727272727,11,1214,1149,cPa224_cPa308_cPa308-cPa255-hybrid_cPa360-cPa255-hybrid_cPa419_cPa443_cPa443-cPa15-hybrid_cPa443-cPa75-hybrid_cPa62-cPa224-hybrid_cPa62-cPa255-hybrid_MoMLV_J02255-cPa255-hybrid,2_1_1_4_1_5_1_1_1_3_2,102,65
Scaffold1676-11322_11452,cPa75,1,1,11438,11347,cPa75,4,130,91
Scaffold1676-12253_12355,cPa75,1,1,12314,12303,cPa75,2,102,11
Scaffold1676-1230_1478,cPa62-cPa255-hybrid,0.146341463414634,24,1426,1238,cPa164-cPa255-hybrid_cPa194_cPa194-cPa101-hybrid_cPa224_cPa308_cPa308-cPa224-hybrid_cPa308-cPa255-hybrid_cPa360_cPa360-cPa255-hybrid_cPa419_cPa443-cPa101-hybrid_cPa469-cPa443-hybrid_cPa62_cPa62-cPa224-hybrid_cPa62-cPa255-hybrid_cPa62-unknown_cPa75_cPa75-cPa194-hybrid_cPa75-cPa224-hybrid_MoMLV_J02255_MoMLV_J02255-cPa224-hybrid_MoMLV_J02255-cPa255-hybrid_MoMLV_J02255-cPa273-hybrid_MoMLV_J02255-unknown,1_1_1_2_2_1_2_1_2_2_1_1_1_1_6_1_3_1_1_1_1_4_1_3,248,188
Scaffold1676-1513_1628,cPa308_cPa62-cPa255-hybrid_cPa75,0.181818181818182,8,1586,1543,cPa164-cPa255-hybrid_cPa308_cPa308-cPa101-hybrid_cPa308-cPa145-hybrid_cPa62-cPa255-hybrid_cPa75_MoMLV_J02255-cPa190-hybrid_MoMLV_J02255-unknown,1_2_1_1_2_2_1_1,115,43
Scaffold1676-2031_2133,cPa224_cPa308,0.176470588235294,11,2133,2040,cPa190-cPa273-hybrid_cPa224_cPa224-cPa190-hybrid_cPa308_cPa360_cPa425-cPa255-hybrid_cPa75_cPa75-cPa190-hybrid_MoMLV_J02255-cPa224-hybrid_MoMLV_J02255-cPa273-hybrid_MoMLV_J02255-cPa308-hybrid,1_3_1_3_1_1_1_1_2_1_2,102,93
Scaffold1676-2174_2276,cPa224_cPa308,0.25,8,2262,2179,cPa194-cPa224-hybrid_cPa224_cPa308_cPa419_cPa62-cPa224-hybrid_cPa62-cPa273-hybrid_cPa75_MoMLV_J02255-cPa400-hybrid,1_3_3_1_1_1_1_1,102,83
Scaffold1676-2395_2875,cPa75-unknown,0.349397590361446,19,2870,2445,cPa224_cPa273_cPa273-cPa255-hybrid_cPa293-cPa255-hybrid_cPa308_cPa308-cPa224-hybrid_cPa360-cPa224-hybrid_cPa419_cPa425-cPa224-hybrid_cPa425-cPa255-hybrid_cPa469-cPa145-hybrid_cPa469-cPa194-hybrid_cPa62-cPa273-hybrid_cPa75_cPa75-cPa190-hybrid_cPa75-cPa224-hybrid_cPa75-cPa273-hybrid_cPa75-cPa308-hybrid_cPa75-unknown,2_10_1_1_3_1_1_2_1_1_1_1_2_15_2_5_4_1_29,480,425
Scaffold1676-30054_30156,cPa75,1,1,30104,30104,cPa75,1,102,0
Scaffold1676-30231_30424,cPa75,1,1,30372,30281,cPa75,3,193,91
Scaffold1676-31032_31134,cPa75,1,1,31082,31082,cPa75,1,102,0
Scaffold1676-34104_34748,cPa75,1,1,34696,34154,cPa75,12,644,542
Scaffold1676-34755_35142,cPa75,1,1,35090,34805,cPa75,8,387,285
Scaffold1676-35179_35396,cPa75,1,1,35344,35229,cPa75,5,217,115
Scaffold1676-49941_50043,cPa285-unknown,1,1,49991,49991,cPa285-unknown,1,102,0
Scaffold1676-6358_6548,cPa425,0.652173913043478,11,6520,6358,cPa111-cPa356-hybrid_cPa111-unknown_cPa200-cPa356-hybrid_cPa356_cPa425_cPa434-cPa356-hybrid_cPa47-cPa356-hybrid_cPa47-HERVHcons-hybrid_cPa75_SMRV_NC001514-cPa75-hybrid_SMRV_NC001514-unknown,1_1_1_3_30_1_1_1_5_1_1,190,162
Scaffold1676-8768_8870,cPa356-cPa140-hybrid,0.666666666666667,3,8850,8813,cPa182-cPa566-hybrid_cPa264_cPa356-cPa140-hybrid,1_1_4,102,37
Scaffold1677-1538_1926,cPa413-unknown,1,1,1874,1588,cPa413-unknown,9,388,286
Scaffold1678-6437_6935,cPa394,0.429319371727749,29,6933,6437,cPa199-cPa308-hybrid_cPa199-cPa443-hybrid_cPa199-cPa553-hybrid_cPa199-cPa566-hybrid_cPa199-unknown_cPa223-cPa566-hybrid_cPa223-unknown_cPa227-cPa308-hybrid_cPa227-unknown_cPa273-cPa308-hybrid_cPa273-cPa566-hybrid_cPa273-unknown_cPa345-cPa308-hybrid_cPa345-cPa566-hybrid_cPa345-unknown_cPa394_cPa394-cPa566-hybrid_cPa419_cPa450-cPa308-hybrid_cPa450-unknown_cPa539-cPa443-hybrid_cPa539-cPa566-hybrid_cPa539-unknown_cPa542-cPa419-hybrid_cPa542-cPa566-hybrid_cPa542-unknown_cPa553-cPa308-hybrid_cPa553-cPa566-hybrid_cPa553-unknown,1_2_1_10_93_1_17_1_16_2_1_17_1_3_10_164_1_1_1_9_1_1_1_1_1_22_1_1_1,498,496
Scaffold1678-7339_7442,cPa394,1,1,7390,7389,cPa394,2,103,1
Scaffold1678-9782_9884,cPa394,0.4,5,9843,9832,cPa223-cPa542-hybrid_cPa223-unknown_cPa394_cPa450_cPa553,1_1_4_3_1,102,11
Scaffold1679-12649_12796,cPa75,1,1,12752,12666,cPa75,5,147,86
Scaffold1679-12819_12921,cPa75,1,1,12892,12847,cPa75,4,102,45
Scaffold1679-12946_13938,cPa75,1,1,13886,12961,cPa75,38,992,925
Scaffold1679-14057_14159,cPa75,1,1,14107,14080,cPa75,4,102,27
Scaffold1679-23507_23609,cPa75,1,1,23557,23557,cPa75,1,102,0
Scaffold1679-23802_23905,cPa75,1,1,23853,23852,cPa75,2,103,1
Scaffold1679-24032_24134,cPa75,1,1,24082,24082,cPa75,1,102,0
Scaffold1679-24171_24273,cPa75,1,1,24221,24221,cPa75,1,102,0
Scaffold1679-24358_24460,cPa75,1,1,24408,24408,cPa75,1,102,0
Scaffold1679-24492_24764,cPa75,1,1,24712,24542,cPa75,5,272,170
Scaffold1679-24809_24911,cPa75,1,1,24859,24859,cPa75,1,102,0
Scaffold1679-4496_4645,cPa75,1,1,4593,4543,cPa75,3,149,50
Scaffold1679-4841_5515,cPa75,1,1,5463,4891,cPa75,17,674,572
Scaffold1679-5664_5766,cPa75,1,1,5745,5714,cPa75,2,102,31
Scaffold168-1456_1558,cPa428,1,1,1506,1506,cPa428,1,102,0
Scaffold168-64089_64191,cPa428,1,1,64139,64139,cPa428,1,102,0
Scaffold168-71092_71240,cPa356_cPa428,0.5,2,71188,71142,cPa356_cPa428,3_3,148,46
Scaffold168-72076_72178,cPa356,0.6,2,72144,72096,cPa356_cPa428,3_2,102,48
Scaffold1680-12137_12239,cPa75,1,1,12187,12187,cPa75,1,102,0
Scaffold1680-22708_22810,cPa75,1,1,22758,22758,cPa75,1,102,0
Scaffold1680-23369_23471,cPa75,1,1,23419,23419,cPa75,1,102,0
Scaffold1680-4574_4676,cPa425,0.5,3,4674,4589,cPa400-cPa387-hybrid_cPa419_cPa425,1_2_3,102,85
Scaffold1680-7153_7255,cPa118-cPa71-hybrid,1,1,7203,7203,cPa118-cPa71-hybrid,1,102,0
Scaffold1680-7318_7566,cPa15-cPa71-hybrid_cPa71,0.4,3,7514,7368,cPa15-cPa71-hybrid_cPa379_cPa71,2_1_2,248,146
Scaffold1680-7647_7864,cPa71,0.625,3,7812,7697,cPa16_cPa16-cPa71-hybrid_cPa71,2_1_5,217,115
Scaffold1680-7899_8001,cPa118-cPa71-hybrid,1,1,7949,7949,cPa118-cPa71-hybrid,1,102,0
Scaffold1680-8148_8310,cPa16,1,1,8258,8198,cPa16,2,162,60
Scaffold1681-14147_14249,cPa75,1,1,14197,14197,cPa75,1,102,0
Scaffold1682-24059_24161,cPa201,1,1,24109,24109,cPa201,1,102,0
Scaffold1682-25000_25102,cPa75,1,1,25050,25050,cPa75,1,102,0
Scaffold1682-25796_25969,cPa75,1,1,25917,25846,cPa75,2,173,71
Scaffold1682-26080_26217,cPa75,1,1,26165,26130,cPa75,2,137,35
Scaffold1682-26413_26515,cPa75,1,1,26463,26463,cPa75,1,102,0
Scaffold1682-4147_4249,cPa305-cPa360-hybrid,1,1,4197,4197,cPa305-cPa360-hybrid,1,102,0
Scaffold1684-1385_1555,cPa15,0.375,5,1554,1420,cPa118_cPa15_cPa387-cPa118-hybrid_cPa47-cPa118-hybrid_cPa47-cPa516-hybrid,1_3_1_2_1,170,134
Scaffold1684-6273_6401,cPa434,0.545454545454545,2,6349,6301,cPa356_cPa434,5_6,128,48
Scaffold1684-6480_6582,cPa434,0.545454545454545,3,6531,6483,cPa356_cPa434_cPa434-unknown,7_12_3,102,48
Scaffold1684-6918_7020,cPa434,1,1,7009,6920,cPa434,11,102,89
Scaffold1684-7704_7806,cPa434,1,1,7754,7754,cPa434,1,102,0
Scaffold1684-8323_8425,cPa434,1,1,8373,8373,cPa434,1,102,0
Scaffold1685-15040_15142,cPa371,0.947368421052632,2,15100,15060,cPa371_cPa371-cPa75-hybrid,18_1,102,40
Scaffold1685-15755_15873,cPa391-cPa75-hybrid,0.888888888888889,2,15825,15793,cPa371-cPa75-hybrid_cPa391-cPa75-hybrid,1_8,118,32
Scaffold1685-18657_18759,cPa163-cPa182-hybrid_cPa182_cPa549-cPa182-hybrid,0.333333333333333,3,18742,18663,cPa163-cPa182-hybrid_cPa182_cPa549-cPa182-hybrid,1_1_1,102,79
Scaffold1685-18842_18944,cPa182,1,1,18905,18892,cPa182,2,102,13
Scaffold1685-7246_7348,cPa511-unknown,1,1,7296,7296,cPa511-unknown,1,102,0
Scaffold1685-8491_8593,FrMuLV_NC001362-cPa75-hybrid,1,1,8562,8541,FrMuLV_NC001362-cPa75-hybrid,2,102,21
Scaffold1686-10396_10498,cPa62,1,1,10446,10446,cPa62,1,102,0
Scaffold1688-21210_21312,cPa356,0.6,3,21260,21239,cPa356_cPa356-unknown_cPa428,6_1_3,102,21
Scaffold1688-22709_22811,cPa428,1,1,22759,22759,cPa428,1,102,0
Scaffold169-24845_24947,cPa356,1,1,24895,24895,cPa356,1,102,0
Scaffold169-29616_29718,cPa356_cPa428,0.5,2,29666,29662,cPa356_cPa428,1_1,102,4
Scaffold169-29763_29865,cPa428,0.6,2,29857,29781,cPa356_cPa428,4_6,102,76
Scaffold169-31444_31546,cPa428,0.608695652173913,2,31531,31456,cPa356_cPa428,9_14,102,75
Scaffold169-32079_32215,cPa428,0.619047619047619,2,32187,32096,cPa356_cPa428,8_13,136,91
Scaffold169-32304_32500,cPa428,0.631578947368421,2,32494,32354,cPa356_cPa428,7_12,196,140
Scaffold169-32731_32905,cPa428,1,1,32863,32760,cPa428,6,174,103
Scaffold169-33109_33220,cPa428,1,1,33168,33130,cPa428,4,111,38
Scaffold169-33470_33778,cPa428,0.580645161290323,2,33756,33476,cPa356_cPa428,26_36,308,280
Scaffold169-34591_34701,cPa428,0.75,2,34667,34641,cPa356_cPa428,1_3,110,26
Scaffold169-37989_38091,cPa428,0.666666666666667,2,38080,38029,cPa356_cPa428,3_6,102,51
Scaffold169-38461_38563,cPa428,1,1,38549,38511,cPa428,2,102,38
Scaffold169-40224_40326,cPa356_cPa428,0.5,2,40280,40273,cPa356_cPa428,3_3,102,7
Scaffold169-40350_40452,cPa428,0.62962962962963,3,40431,40350,cPa356_cPa428_cPa428-unknown,9_17_1,102,81
Scaffold169-52139_52241,cPa428,1,1,52189,52189,cPa428,1,102,0
Scaffold169-53822_53924,cPa356_cPa428,0.5,2,53872,53872,cPa356_cPa428,1_1,102,0
Scaffold169-59512_59614,cPa428,1,1,59562,59561,cPa428,2,102,1
Scaffold169-59802_59913,cPa428,0.571428571428571,2,59898,59847,cPa356_cPa428,3_4,111,51
Scaffold169-60860_61049,cPa356_cPa428,0.5,2,60997,60868,cPa356_cPa428,13_13,189,129
Scaffold169-61296_61398,cPa428,0.75,2,61397,61313,cPa356_cPa428,2_6,102,84
Scaffold169-62076_62186,cPa428,0.5625,2,62150,62111,cPa356_cPa428,7_9,110,39
Scaffold169-65013_65115,cPa356_cPa428,0.5,2,65063,65047,cPa356_cPa428,1_1,102,16
Scaffold169-65180_65282,cPa428,0.8,2,65279,65190,cPa356_cPa428,1_4,102,89
Scaffold169-65326_65428,cPa428,0.5625,2,65428,65331,cPa356_cPa428,7_9,102,97
Scaffold169-67210_67312,cPa356,1,1,67260,67260,cPa356,1,102,0
Scaffold169-67611_67725,cPa428,0.571428571428571,2,67681,67661,cPa356_cPa428,3_4,114,20
Scaffold169-69678_69784,cPa428,0.583333333333333,2,69749,69698,cPa356_cPa428,15_21,106,51
Scaffold169-69814_69916,cPa428,0.785714285714286,2,69904,69817,cPa356_cPa428,3_11,102,87
Scaffold169-70263_70469,cPa428,0.705882352941177,2,70448,70313,cPa356_cPa428,5_12,206,135
Scaffold169-71459_71561,cPa356_cPa428,0.5,2,71538,71509,cPa356_cPa428,1_1,102,29
Scaffold169-74245_74356,cPa428,0.75,2,74304,74281,cPa356_cPa428,1_3,111,23
Scaffold169-74386_74502,cPa428,0.6,2,74482,74420,cPa356_cPa428,4_6,116,62
Scaffold169-74894_75145,cPa428,0.547945205479452,2,75138,74894,cPa356_cPa428,66_80,251,244
Scaffold169-75497_75599,cPa428,0.692307692307692,2,75579,75505,cPa356_cPa428,4_9,102,74
Scaffold169-75799_75901,cPa356,0.571428571428571,2,75860,75799,cPa356_cPa428,4_3,102,61
Scaffold169-76277_76379,cPa428,0.818181818181818,2,76379,76288,cPa356_cPa428,2_9,102,91
Scaffold169-76489_76591,cPa428,0.615384615384615,2,76589,76500,cPa356_cPa428,5_8,102,89
Scaffold169-76628_76730,cPa356,0.545454545454545,2,76722,76678,cPa356_cPa428,6_5,102,44
Scaffold169-76990_77092,cPa428,0.6,2,77092,76991,cPa356_cPa428,34_51,102,101
Scaffold169-77898_78000,cPa428,0.666666666666667,2,77994,77897,cPa356_cPa428,3_6,102,97
Scaffold1690-100455_100557,cPa285-cPa75-hybrid,1,1,100505,100505,cPa285-cPa75-hybrid,1,102,0
Scaffold1690-103425_103527,cPa75,1,1,103475,103475,cPa75,1,102,0
Scaffold1690-103830_103932,cPa75,1,1,103880,103880,cPa75,1,102,0
Scaffold1690-106125_106227,cPa75,1,1,106175,106175,cPa75,1,102,0
Scaffold1690-112619_112721,cPa75,1,1,112669,112669,cPa75,1,102,0
Scaffold1690-112959_113262,cPa75,1,1,113228,113009,cPa75,19,303,219
Scaffold1690-113276_113545,cPa75,1,1,113538,113326,cPa75,13,269,212
Scaffold1690-113556_113658,cPa75,1,1,113606,113606,cPa75,1,102,0
Scaffold1690-1250_1352,cPa75,1,1,1303,1300,cPa75,2,102,3
Scaffold1690-131051_131153,cPa75,1,1,131101,131101,cPa75,1,102,0
Scaffold1690-13205_13311,cPa75,1,1,13270,13215,cPa75,4,106,55
Scaffold1690-133348_133450,cPa75,1,1,133398,133398,cPa75,1,102,0
Scaffold1690-13380_13493,cPa75,1,1,13441,13430,cPa75,4,113,11
Scaffold1690-134614_134716,cPa75,1,1,134664,134664,cPa75,1,102,0
Scaffold1690-134787_134939,cPa75,1,1,134887,134837,cPa75,2,152,50
Scaffold1690-135191_135484,cPa75,1,1,135452,135241,cPa75,12,293,211
Scaffold1690-135548_135736,cPa75,1,1,135688,135567,cPa75,9,188,121
Scaffold1690-135842_135944,cPa75,1,1,135934,135892,cPa75,4,102,42
Scaffold1690-13646_13822,cPa75,1,1,13770,13696,cPa75,7,176,74
Scaffold1690-137093_137268,cPa75,1,1,137232,137143,cPa75,11,175,89
Scaffold1690-137304_137423,cPa75,1,1,137383,137351,cPa75,8,119,32
Scaffold1690-137433_137535,cPa75,1,1,137483,137476,cPa75,2,102,7
Scaffold1690-137718_137820,cPa75,1,1,137780,137764,cPa75,5,102,16
Scaffold1690-13831_14101,cPa75,1,1,14049,13881,cPa75,26,270,168
Scaffold1690-14194_14424,cPa75,1,1,14372,14215,cPa75,8,230,157
Scaffold1690-162174_162276,cPa75,1,1,162224,162224,cPa75,1,102,0
Scaffold1690-168638_168740,cPa75,1,1,168688,168688,cPa75,1,102,0
Scaffold1690-168763_168945,cPa75,1,1,168893,168813,cPa75,17,182,80
Scaffold1690-168981_169113,cPa75,1,1,169061,169031,cPa75,2,132,30
Scaffold1690-178316_178518,cPa75,1,1,178466,178366,cPa75,5,202,100
Scaffold1690-179057_179159,cPa75,1,1,179107,179107,cPa75,1,102,0
Scaffold1690-183307_183786,cPa75,1,1,183746,183357,cPa75,19,479,389
Scaffold1690-188830_188932,cPa75,1,1,188880,188880,cPa75,1,102,0
Scaffold1690-192888_192990,cPa75,0.8,2,192938,192916,cPa75_cPa75-unknown,4_1,102,22
Scaffold1690-193912_194014,cPa75,1,1,193991,193962,cPa75,2,102,29
Scaffold1690-194056_194158,cPa75,1,1,194106,194106,cPa75,1,102,0
Scaffold1690-212581_212683,cPa75,1,1,212631,212631,cPa75,1,102,0
Scaffold1690-212731_212833,cPa75,1,1,212781,212781,cPa75,1,102,0
Scaffold1690-21408_21551,cPa75,1,1,21499,21458,cPa75,2,143,41
Scaffold1690-21803_21974,cPa75,1,1,21947,21853,cPa75,4,171,94
Scaffold1690-253196_253298,cPa75,1,1,253246,253246,cPa75,1,102,0
Scaffold1690-253494_253684,cPa75,1,1,253632,253532,cPa75,3,190,100
Scaffold1690-256859_257060,cPa75,1,1,257008,256909,cPa75,4,201,99
Scaffold1690-257095_257304,cPa75,1,1,257252,257094,cPa75,8,209,158
Scaffold1690-257463_257565,cPa75,1,1,257513,257513,cPa75,1,102,0
Scaffold1690-257647_257749,cPa75,1,1,257697,257697,cPa75,1,102,0
Scaffold1690-258414_258516,cPa75,1,1,258464,258464,cPa75,1,102,0
Scaffold1690-272369_272471,cPa75,1,1,272426,272414,cPa75,5,102,12
Scaffold1690-278750_278852,cPa62-cPa75-hybrid,1,1,278800,278800,cPa62-cPa75-hybrid,1,102,0
Scaffold1690-278937_279346,cPa75,0.925925925925926,2,279294,278987,cPa62-cPa75-hybrid_cPa75,2_25,409,307
Scaffold1690-279449_279573,cPa75,0.666666666666667,2,279521,279483,cPa62-cPa75-hybrid_cPa75,1_2,124,38
Scaffold1690-279585_279717,cPa75,0.777777777777778,2,279687,279590,cPa62-cPa75-hybrid_cPa75,2_7,132,97
Scaffold1690-2933_3071,cPa75,1,1,3019,2983,cPa75,4,138,36
Scaffold1690-3075_3177,cPa75,1,1,3125,3125,cPa75,2,102,0
Scaffold1690-308368_308470,cPa75,1,1,308418,308418,cPa75,1,102,0
Scaffold1690-308534_308636,cPa75,1,1,308584,308584,cPa75,1,102,0
Scaffold1690-308674_308777,cPa75,1,1,308725,308724,cPa75,2,103,1
Scaffold1690-308813_309127,cPa75,1,1,309075,308863,cPa75,9,314,212
Scaffold1690-309211_309413,cPa75,1,1,309361,309261,cPa75,4,202,100
Scaffold1690-309504_309606,cPa75,1,1,309554,309532,cPa75,2,102,22
Scaffold1690-31241_31343,cPa75,1,1,31291,31291,cPa75,1,102,0
Scaffold1690-335582_335684,cPa419,1,1,335632,335632,cPa419,1,102,0
Scaffold1690-364561_364700,cPa75,1,1,364648,364611,cPa75,2,139,37
Scaffold1690-365527_365629,cPa75,1,1,365577,365577,cPa75,1,102,0
Scaffold1690-375251_375353,cPa62,1,1,375301,375301,cPa62,1,102,0
Scaffold1690-37798_38056,cPa75,1,1,38004,37848,cPa75,6,258,156
Scaffold1690-38089_38270,cPa75,1,1,38218,38139,cPa75,4,181,79
Scaffold1690-383519_383621,cPa75,1,1,383569,383569,cPa75,1,102,0
Scaffold1690-391432_391534,cPa75,1,1,391482,391482,cPa75,1,102,0
Scaffold1690-391631_391733,cPa285,1,1,391707,391681,cPa285,3,102,26
Scaffold1690-415922_416024,cPa75,1,1,415972,415972,cPa75,1,102,0
Scaffold1690-416183_416338,cPa75,1,1,416286,416233,cPa75,6,155,53
Scaffold1690-416407_416509,cPa75,1,1,416457,416457,cPa75,1,102,0
Scaffold1690-416587_416821,cPa75,1,1,416784,416637,cPa75,9,234,147
Scaffold1690-418612_418867,cPa425,0.833333333333333,4,418833,418662,cPa425_cPa425-cPa75-hybrid_cPa425-MLV_Pmv4-hybrid_cPa425-unknown,20_2_1_1,255,171
Scaffold1690-419981_420083,cPa62,1,1,420031,420031,cPa62,1,102,0
Scaffold1690-43968_44070,cPa75,1,1,44018,44018,cPa75,1,102,0
Scaffold1690-440163_440265,cPa75,1,1,440223,440200,cPa75,5,102,23
Scaffold1690-44071_44264,cPa75,1,1,44212,44121,cPa75,6,193,91
Scaffold1690-440823_440983,cPa75,1,1,440971,440873,cPa75,6,160,98
Scaffold1690-441470_441610,cPa75,1,1,441558,441520,cPa75,2,140,38
Scaffold1690-441696_441964,cPa75,1,1,441935,441746,cPa75,20,268,189
Scaffold1690-442073_442307,cPa75,0.962962962962963,2,442279,442108,cPa75_cPa75-unknown,26_1,234,171
Scaffold1690-44301_44403,cPa75,1,1,44351,44351,cPa75,1,102,0
Scaffold1690-45418_45520,cPa75,1,1,45468,45468,cPa75,1,102,0
Scaffold1690-458773_458875,cPa75,1,1,458823,458823,cPa75,1,102,0
Scaffold1690-48979_49138,cPa425_cPa446,0.5,2,49086,49029,cPa425_cPa446,1_1,159,57
Scaffold1690-49553_49735,cPa425_cPa447_cPa75,0.333333333333333,3,49683,49603,cPa425_cPa447_cPa75,1_1_1,182,80
Scaffold1690-52553_52655,cPa75,1,1,52603,52603,cPa75,1,102,0
Scaffold1690-53060_53162,cPa75,1,1,53110,53110,cPa75,1,102,0
Scaffold1690-5490_5608,cPa75,1,1,5556,5540,cPa75,2,118,16
Scaffold1690-54931_55097,cPa75,1,1,55054,54981,cPa75,4,166,73
Scaffold1690-55397_55673,cPa75,1,1,55621,55447,cPa75,4,276,174
Scaffold1690-55708_55843,cPa75,1,1,55791,55739,cPa75,5,135,52
Scaffold1690-55867_56121,cPa75,1,1,56069,55917,cPa75,9,254,152
Scaffold1690-57843_57945,cPa75,1,1,57893,57893,cPa75,1,102,0
Scaffold1690-65182_65284,cPa75,1,1,65232,65196,cPa75,4,102,36
Scaffold1690-65615_65826,cPa75,1,1,65774,65634,cPa75,4,211,140
Scaffold1690-65904_66006,cPa75,1,1,65966,65954,cPa75,2,102,12
Scaffold1690-67202_67304,cPa75,1,1,67252,67252,cPa75,1,102,0
Scaffold1690-67356_67848,cPa75,1,1,67796,67406,cPa75,26,492,390
Scaffold1690-68364_68466,cPa75,1,1,68414,68414,cPa75,1,102,0
Scaffold1690-76780_76882,cPa345_HML3_repbase_HERVK9I_MER9,0.5,2,76830,76830,cPa345_HML3_repbase_HERVK9I_MER9,1_1,102,0
Scaffold1690-81718_81937,cPa75,1,1,81885,81735,cPa75,7,219,150
Scaffold1690-81996_82759,cPa75,1,1,82743,82046,cPa75,47,763,697
Scaffold1690-8207_8418,cPa75,1,1,8366,8257,cPa75,5,211,109
Scaffold1690-8464_8566,cPa75,1,1,8514,8514,cPa75,1,102,0
Scaffold1690-8590_8774,cPa75,1,1,8722,8640,cPa75,7,184,82
Scaffold1690-87317_87419,cPa75,1,1,87367,87367,cPa75,1,102,0
Scaffold1690-87523_87670,cPa75,1,1,87618,87573,cPa75,2,147,45
Scaffold1690-87676_87778,cPa75,1,1,87726,87726,cPa75,1,102,0
Scaffold1690-88247_88349,cPa75,1,1,88297,88297,cPa75,1,102,0
Scaffold1690-90944_91145,cPa75,1,1,91093,90994,cPa75,7,201,99
Scaffold1690-91338_91953,cPa75,1,1,91901,91388,cPa75,31,615,513
Scaffold1690-96572_96699,cPa75,1,1,96647,96622,cPa75,3,127,25
Scaffold1690-96707_96823,cPa75,1,1,96771,96757,cPa75,5,116,14
Scaffold1690-96874_96976,cPa75,1,1,96966,96919,cPa75,4,102,47
Scaffold1691-132568_132725,cPa75,1,1,132673,132618,cPa75,3,157,55
Scaffold1691-135976_136078,cPa75,1,1,136026,136026,cPa75,1,102,0
Scaffold1691-137085_137187,cPa75-unknown,1,1,137135,137135,cPa75-unknown,1,102,0
Scaffold1691-137248_137350,cPa75,1,1,137324,137298,cPa75,2,102,26
Scaffold1691-137823_137925,cPa75,1,1,137873,137873,cPa75,1,102,0
Scaffold1691-138040_138142,cPa75,1,1,138090,138090,cPa75,1,102,0
Scaffold1691-138317_138419,cPa75,1,1,138367,138367,cPa75,1,102,0
Scaffold1691-138441_138543,cPa75,1,1,138491,138491,cPa75,1,102,0
Scaffold1691-138589_138691,cPa75,1,1,138639,138639,cPa75,1,102,0
Scaffold1691-138729_138831,cPa75,1,1,138779,138779,cPa75,1,102,0
Scaffold1691-169250_169352,cPa75,1,1,169300,169300,cPa75,1,102,0
Scaffold1691-170656_170758,cPa75,1,1,170706,170706,cPa75,1,102,0
Scaffold1691-20054_20156,cPa75,1,1,20104,20104,cPa75,1,102,0
Scaffold1691-28215_28317,cPa75,1,1,28265,28265,cPa75,1,102,0
Scaffold1691-59282_59384,cPa75-unknown,1,1,59332,59332,cPa75-unknown,1,102,0
Scaffold1691-59629_59731,cPa75-unknown,1,1,59679,59679,cPa75-unknown,1,102,0
Scaffold1691-84718_84889,cPa75,1,1,84837,84768,cPa75,4,171,69
Scaffold1691-85258_85480,cPa75,1,1,85428,85270,cPa75,5,222,158
Scaffold1691-85584_86142,cPa75,1,1,86090,85634,cPa75,38,558,456
Scaffold1691-86165_86291,cPa75,1,1,86239,86202,cPa75,3,126,37
Scaffold1691-86297_86432,cPa75,1,1,86380,86347,cPa75,4,135,33
Scaffold1691-86456_86589,cPa75,1,1,86541,86506,cPa75,3,133,35
Scaffold1691-97353_97463,cPa75,1,1,97411,97403,cPa75,2,110,8
Scaffold1691-97511_97613,cPa75,1,1,97561,97561,cPa75,1,102,0
Scaffold1693-1086_1188,cPa75-SMRV_NC001514-hybrid,1,1,1136,1136,cPa75-SMRV_NC001514-hybrid,1,102,0
Scaffold1694-108021_108123,cPa75,1,1,108071,108071,cPa75,1,102,0
Scaffold1694-116168_116270,cPa75,1,1,116218,116218,cPa75,1,102,0
Scaffold1694-116746_116974,cPa75,1,1,116922,116796,cPa75,5,228,126
Scaffold1694-117073_117267,cPa75,1,1,117215,117116,cPa75,12,194,99
Scaffold1694-117461_117563,cPa75,1,1,117511,117511,cPa75,1,102,0
Scaffold1694-118968_119070,cPa75,1,1,119018,119018,cPa75,1,102,0
Scaffold1694-162983_163085,cPa75,1,1,163033,163033,cPa75,1,102,0
Scaffold1694-168093_168195,cPa75,1,1,168143,168143,cPa75,1,102,0
Scaffold1694-177231_177333,cPa75,1,1,177281,177281,cPa75,1,102,0
Scaffold1694-177934_178036,cPa75,1,1,177984,177984,cPa75,1,102,0
Scaffold1694-178152_178254,cPa75,1,1,178202,178202,cPa75,1,102,0
Scaffold1694-178352_178454,cPa75,1,1,178402,178402,cPa75,1,102,0
Scaffold1694-182988_183109,cPa75,1,1,183057,183038,cPa75,4,121,19
Scaffold1694-183736_184138,cPa75,1,1,184086,183744,cPa75,12,402,342
Scaffold1694-184158_184380,cPa75,1,1,184328,184164,cPa75,19,222,164
Scaffold1694-184398_184790,cPa75,1,1,184739,184412,cPa75,14,392,327
Scaffold1694-196590_196692,cPa75,1,1,196640,196599,cPa75,3,102,41
Scaffold1694-196997_197172,cPa75,1,1,197120,197047,cPa75,3,175,73
Scaffold1694-217415_217517,cPa75,1,1,217478,217465,cPa75,2,102,13
Scaffold1694-217559_217807,cPa75,1,1,217800,217609,cPa75,9,248,191
Scaffold1694-217835_218063,cPa75,1,1,218059,217838,cPa75,27,228,221
Scaffold1694-218077_218302,cPa75,1,1,218285,218078,cPa75,11,225,207
Scaffold1694-222751_222853,cPa75,1,1,222801,222801,cPa75,1,102,0
Scaffold1694-225446_225548,cPa75,1,1,225496,225496,cPa75,1,102,0
Scaffold1694-225568_225981,cPa75,0.956521739130435,2,225929,225618,cPa75_cPa75-unknown,22_1,413,311
Scaffold1694-230143_230245,cPa75,1,1,230193,230193,cPa75,1,102,0
Scaffold1694-235168_235322,cPa75,1,1,235270,235218,cPa75,5,154,52
Scaffold1694-235330_235432,cPa75,1,1,235380,235380,cPa75,1,102,0
Scaffold1694-235525_235734,cPa75,1,1,235682,235575,cPa75,3,209,107
Scaffold1694-235742_235881,cPa75,1,1,235829,235792,cPa75,5,139,37
Scaffold1694-236022_236130,cPa75,1,1,236078,236072,cPa75,2,108,6
Scaffold1694-236152_236255,cPa75,1,1,236203,236202,cPa75,2,103,1
Scaffold1694-236419_236521,cPa75,1,1,236476,236469,cPa75,2,102,7
Scaffold1694-261694_261796,cPa75,1,1,261744,261744,cPa75,1,102,0
Scaffold1694-261822_262134,cPa75,1,1,262082,261872,cPa75,12,312,210
Scaffold1694-262172_262287,cPa75,1,1,262235,262222,cPa75,3,115,13
Scaffold1694-262484_262586,cPa75,1,1,262534,262534,cPa75,1,102,0
Scaffold1694-262597_262699,cPa75,1,1,262647,262647,cPa75,1,102,0
Scaffold1694-290018_290120,cPa75,1,1,290068,290068,cPa75,1,102,0
Scaffold1694-302250_302397,cPa75,1,1,302372,302275,cPa75,6,147,97
Scaffold1694-303029_303131,cPa75,1,1,303079,303079,cPa75,1,102,0
Scaffold1694-30855_30989,cPa75,1,1,30937,30905,cPa75,9,134,32
Scaffold1694-30997_31099,cPa75,1,1,31047,31047,cPa75,1,102,0
Scaffold1694-31155_31623,cPa75,1,1,31571,31197,cPa75,30,468,374
Scaffold1694-317467_317569,cPa75,1,1,317517,317517,cPa75,1,102,0
Scaffold1694-317804_317906,cPa75,1,1,317854,317854,cPa75,1,102,0
Scaffold1694-318002_318104,cPa75,1,1,318052,318052,cPa75,1,102,0
Scaffold1694-318386_318488,cPa75,1,1,318436,318436,cPa75,1,102,0
Scaffold1694-324994_325096,cPa75,1,1,325044,325044,cPa75,2,102,0
Scaffold1694-332686_332834,cPa75,1,1,332782,332736,cPa75,7,148,46
Scaffold1694-332926_333058,cPa75,1,1,333015,332976,cPa75,4,132,39
Scaffold1694-333334_333436,cPa75,1,1,333384,333384,cPa75,1,102,0
Scaffold1694-333645_333863,cPa75,1,1,333811,333695,cPa75,5,218,116
Scaffold1694-343138_343263,cPa75,1,1,343211,343188,cPa75,2,125,23
Scaffold1694-343313_343511,cPa75,1,1,343459,343363,cPa75,5,198,96
Scaffold1694-343524_344274,cPa75,0.983606557377049,2,344222,343574,cPa285-cPa75-hybrid_cPa75,1_60,750,648
Scaffold1694-344579_344681,cPa75,1,1,344629,344629,cPa75,1,102,0
Scaffold1694-351203_351305,cPa75,1,1,351253,351253,cPa75,1,102,0
Scaffold1694-359740_359842,cPa62,1,1,359790,359790,cPa62,1,102,0
Scaffold1694-38898_39000,cPa75,1,1,38948,38948,cPa75,1,102,0
Scaffold1694-39038_39154,cPa75,1,1,39102,39088,cPa75,2,116,14
Scaffold1694-39183_39314,cPa75,1,1,39262,39233,cPa75,2,131,29
Scaffold1694-39361_39463,cPa75,1,1,39411,39411,cPa75,1,102,0
Scaffold1694-39774_39876,cPa75,1,1,39824,39824,cPa75,1,102,0
Scaffold1694-39911_40020,cPa75,1,1,39998,39961,cPa75,4,109,37
Scaffold1694-40025_40151,cPa75,1,1,40099,40075,cPa75,4,126,24
Scaffold1694-40238_40340,cPa75,1,1,40288,40288,cPa75,1,102,0
Scaffold1694-41935_42037,cPa75,1,1,41985,41985,cPa75,1,102,0
Scaffold1694-52385_52487,cPa75,1,1,52435,52435,cPa75,1,102,0
Scaffold1694-52549_52651,cPa75,1,1,52599,52599,cPa75,1,102,0
Scaffold1694-52977_53080,cPa75,1,1,53028,53027,cPa75,2,103,1
Scaffold1694-53082_53232,cPa75,1,1,53180,53132,cPa75,2,150,48
Scaffold1694-69915_70079,cPa75,1,1,70027,69965,cPa75,3,164,62
Scaffold1694-70087_70288,cPa75,1,1,70236,70137,cPa75,2,201,99
Scaffold1694-70311_70413,cPa75,1,1,70361,70361,cPa75,1,102,0
Scaffold1694-70424_70526,cPa75,1,1,70474,70474,cPa75,1,102,0
Scaffold1694-70579_71083,cPa75,1,1,71031,70629,cPa75,13,504,402
Scaffold1694-88934_89042,cPa75,1,1,89013,88984,cPa75,4,108,29
Scaffold1694-89261_89789,cPa75,1,1,89737,89311,cPa75,11,528,426
Scaffold1695-11405_11507,cPa75,1,1,11460,11455,cPa75,2,102,5
Scaffold1695-11566_11798,cPa75,1,1,11746,11616,cPa75,9,232,130
Scaffold1695-11816_12006,cPa75,1,1,11954,11834,cPa75,9,190,120
Scaffold1695-12243_12414,cPa75,1,1,12362,12293,cPa75,8,171,69
Scaffold1695-12466_12568,cPa75,1,1,12521,12516,cPa75,2,102,5
Scaffold1695-12767_12869,cPa75,1,1,12820,12817,cPa75,2,102,3
Scaffold1695-402_504,cPa75,1,1,452,452,cPa75,2,102,0
Scaffold1695-518_620,cPa75,1,1,568,568,cPa75,1,102,0
Scaffold1695-805_915,cPa75,1,1,863,855,cPa75,4,110,8
Scaffold1696-26610_26820,cPa75,1,1,26768,26660,cPa75,3,210,108
Scaffold1696-2854_2956,WDSV_NC001867-cPa285-hybrid,1,1,2904,2904,WDSV_NC001867-cPa285-hybrid,1,102,0
Scaffold1696-53112_53214,cPa75,1,1,53162,53162,cPa75,1,102,0
Scaffold1697-11573_11675,cPa75,1,1,11623,11623,cPa75,1,102,0
Scaffold1697-12110_12212,cPa75,1,1,12160,12160,cPa75,1,102,0
Scaffold1697-28513_28615,cPa75,1,1,28563,28563,cPa75,1,102,0
Scaffold1697-28921_29023,cPa75,1,1,28971,28971,cPa75,1,102,0
Scaffold1697-29266_29382,cPa75,1,1,29330,29311,cPa75,5,116,19
Scaffold1697-29390_29492,cPa75,1,1,29440,29418,cPa75,2,102,22
Scaffold1698-109032_109200,cPa75,1,1,109148,109082,cPa75,3,168,66
Scaffold1698-109232_109334,cPa75,1,1,109282,109282,cPa75,1,102,0
Scaffold1698-109703_109805,cPa75,1,1,109753,109753,cPa75,1,102,0
Scaffold1698-122476_122578,cPa75-cPa62-hybrid,1,1,122526,122526,cPa75-cPa62-hybrid,1,102,0
Scaffold1698-129643_129746,WDSV_NC001867,1,1,129743,129693,WDSV_NC001867,4,103,50
Scaffold1698-129775_129971,WDSV_NC001867,1,1,129955,129825,WDSV_NC001867,17,196,130
Scaffold1698-145404_145506,cPa285,1,1,145454,145454,cPa285,1,102,0
Scaffold1698-39216_39318,cPa75,1,1,39266,39266,cPa75,1,102,0
Scaffold1698-39453_39600,cPa75,1,1,39548,39501,cPa75,3,147,47
Scaffold1698-5945_6047,cPa75,1,1,5995,5995,cPa75,1,102,0
Scaffold1698-6054_6180,cPa75,1,1,6128,6104,cPa75,3,126,24
Scaffold1698-6216_6813,cPa75,1,1,6761,6266,cPa75,29,597,495
Scaffold1698-65564_65685,cPa75,1,1,65633,65614,cPa75,2,121,19
Scaffold1698-66055_66157,cPa75,1,1,66105,66105,cPa75,1,102,0
Scaffold1698-66205_66356,cPa75,1,1,66304,66255,cPa75,18,151,49
Scaffold1698-66453_66639,cPa75,1,1,66587,66493,cPa75,4,186,94
Scaffold1698-82684_82786,cPa419,0.4,4,82743,82691,cPa419_cPa472_cPa75_FrMuLV_NC001362,2_1_1_1,102,52
Scaffold1698-82893_82995,cPa419,1,1,82943,82943,cPa419,1,102,0
Scaffold1698-88650_88752,cPa15-cPa585-hybrid_cPa224_cPa585,0.333333333333333,3,88722,88700,cPa15-cPa585-hybrid_cPa224_cPa585,1_1_1,102,22
Scaffold1698-94119_94221,cPa75,1,1,94169,94169,cPa75,1,102,0
Scaffold1698-96362_96464,cPa75,1,1,96446,96361,cPa75,14,102,85
Scaffold1698-96570_96672,cPa75,1,1,96620,96602,cPa75,2,102,18
Scaffold1699-101908_102010,cPa75,1,1,101958,101958,cPa75,1,102,0
Scaffold1699-102228_102411,cPa75,1,1,102359,102278,cPa75,3,183,81
Scaffold1699-102804_102906,cPa75,1,1,102854,102854,cPa75,1,102,0
Scaffold1699-10284_10386,cPa75,1,1,10373,10334,cPa75,2,102,39
Scaffold1699-103060_103258,cPa75,1,1,103206,103110,cPa75,13,198,96
Scaffold1699-103587_103689,cPa75,1,1,103637,103637,cPa75,1,102,0
Scaffold1699-10418_10681,cPa75,1,1,10629,10434,cPa75,5,263,195
Scaffold1699-111959_112061,cPa15,1,1,112009,112009,cPa15,1,102,0
Scaffold1699-127860_128035,cPa75,1,1,127983,127910,cPa75,2,175,73
Scaffold1699-134378_134480,cPa75,1,1,134428,134428,cPa75,1,102,0
Scaffold1699-140335_140788,cPa75,1,1,140736,140385,cPa75,8,453,351
Scaffold1699-140792_141020,cPa75,1,1,140968,140842,cPa75,5,228,126
Scaffold1699-141122_141253,cPa75,1,1,141201,141172,cPa75,2,131,29
Scaffold1699-141473_141741,cPa75,1,1,141689,141523,cPa75,6,268,166
Scaffold1699-154991_155093,cPa75,1,1,155041,155041,cPa75,1,102,0
Scaffold1699-156781_156893,cPa450_cPa542,0.5,2,156841,156831,cPa450_cPa542,1_1,112,10
Scaffold1699-161155_161257,cPa358,0.666666666666667,2,161224,161188,cPa251_cPa358,1_2,102,36
Scaffold1699-167837_167940,cPa400,1,1,167939,167848,cPa400,33,103,91
Scaffold1699-168373_168475,cPa400,1,1,168461,168381,cPa400,47,102,80
Scaffold1699-169088_169190,cPa400,1,1,169187,169092,cPa400,20,102,95
Scaffold1699-169826_169928,cPa400,1,1,169906,169835,cPa400,16,102,71
Scaffold1699-171160_171263,cPa400,1,1,171248,171174,cPa400,8,103,74
Scaffold1699-171477_171579,cPa400,1,1,171567,171521,cPa400,3,102,46
Scaffold1699-174289_174436,cPa390-unknown,0.6,13,174430,174327,cPa107-cPa273-hybrid_cPa107-unknown_cPa390-cPa174-hybrid_cPa390-cPa273-hybrid_cPa390-MLV_Pmv4-hybrid_cPa390-unknown_cPa444-cPa163-hybrid_cPa444-cPa511-hybrid_cPa444-unknown_cPa75-cPa107-hybrid_cPa75-cPa163-hybrid_cPa75-cPa511-hybrid_cPa75-cPa62-hybrid,1_2_1_2_1_21_1_1_1_1_1_1_1,147,103
Scaffold1699-176627_176770,cPa75,1,1,176718,176677,cPa75,2,143,41
Scaffold1699-181191_181768,cPa75,1,1,181716,181241,cPa75,15,577,475
Scaffold1699-193265_193367,cPa75,1,1,193359,193315,cPa75,2,102,44
Scaffold1699-19532_19634,cPa75,1,1,19582,19582,cPa75,1,102,0
Scaffold1699-19644_19746,cPa75,1,1,19694,19694,cPa75,1,102,0
Scaffold1699-19920_20022,cPa75,1,1,19970,19970,cPa75,1,102,0
Scaffold1699-215460_215562,cPa254-cPa174-hybrid,1,1,215510,215510,cPa254-cPa174-hybrid,1,102,0
Scaffold1699-217988_218090,cPa15,0.5,4,218038,218013,cPa118-cPa248-hybrid_cPa118-cPa434-hybrid_cPa118-cPa443-hybrid_cPa15,1_1_1_3,102,25
Scaffold1699-226187_226289,cPa419,1,1,226237,226237,cPa419,1,102,0
Scaffold1699-247085_247187,cPa75,1,1,247135,247135,cPa75,1,102,0
Scaffold1699-247390_247492,cPa75,1,1,247440,247440,cPa75,1,102,0
Scaffold1699-247516_248030,cPa75,1,1,247978,247566,cPa75,22,514,412
Scaffold1699-249814_249960,cPa75,1,1,249925,249864,cPa75,3,146,61
Scaffold1699-250049_250151,cPa75,1,1,250099,250099,cPa75,1,102,0
Scaffold1699-260279_260441,cPa75,1,1,260389,260329,cPa75,9,162,60
Scaffold1699-260522_260874,cPa75,1,1,260822,260572,cPa75,21,352,250
Scaffold1699-260921_261103,cPa75,1,1,261051,260971,cPa75,2,182,80
Scaffold1699-262520_262622,MLV_Pmv4-cPa107-hybrid,1,1,262570,262570,MLV_Pmv4-cPa107-hybrid,1,102,0
Scaffold1699-264255_264503,HTLV2_M10060,0.472972972972973,13,264451,264305,cPa227_cPa227-cPa107-hybrid_cPa227-cPa273-hybrid_cPa227-cPa447-hybrid_cPa227-cPa511-hybrid_cPa227-cPa62-hybrid_cPa227-HTLV2_M10060-hybrid_cPa419_cPa566-cPa107-hybrid_cPa566-cPa447-hybrid_cPa75_HTLV2_M10060_HTLV2_M10060-cPa227-hybrid,26_2_1_1_1_1_1_2_1_1_1_35_1,248,146
Scaffold1699-264527_264685,HTLV2_M10060,0.598360655737705,12,264685,264577,cPa223-cPa227-hybrid_cPa227_cPa227-cPa273-hybrid_cPa227-cPa419-hybrid_cPa227-cPa75-hybrid_cPa400-cPa227-hybrid_cPa400-HTLV2_M10060-hybrid_cPa419_cPa566-cPa107-hybrid_cPa566-cPa227-hybrid_cPa566-HTLV2_M10060-hybrid_HTLV2_M10060,2_22_1_1_2_10_3_3_1_2_2_73,158,108
Scaffold1699-265999_266191,cPa400-cPa75-hybrid,0.3,7,266139,266049,cPa400-cPa227-hybrid_cPa400-cPa447-hybrid_cPa400-cPa75-hybrid_cPa518-cPa227-hybrid_cPa566-cPa447-hybrid_cPa566-cPa75-hybrid_cPa566-HTLV2_M10060-hybrid,1_1_3_1_1_2_1,192,90
Scaffold1699-267488_267613,cPa75,1,1,267561,267538,cPa75,4,125,23
Scaffold1699-268017_268119,cPa75,1,1,268067,268067,cPa75,1,102,0
Scaffold1699-268288_268390,cPa75,1,1,268338,268338,cPa75,1,102,0
Scaffold1699-281116_281558,cPa75,0.973684210526316,2,281526,281136,cPa75_cPa75-unknown,37_1,442,390
Scaffold1699-284155_284257,cPa118_cPa248-cPa254-hybrid,0.5,2,284209,284205,cPa118_cPa248-cPa254-hybrid,1_1,102,4
Scaffold1699-284626_284747,cPa118-cPa404-hybrid_cPa248-cPa443-hybrid,0.5,2,284695,284676,cPa118-cPa404-hybrid_cPa248-cPa443-hybrid,1_1,121,19
Scaffold1699-285794_285896,cPa248-cPa254-hybrid_cPa404,0.5,2,285890,285844,cPa248-cPa254-hybrid_cPa404,1_1,102,46
Scaffold1699-286876_286978,cPa47,1,1,286926,286926,cPa47,1,102,0
Scaffold1699-28688_28790,cPa75,1,1,28738,28738,cPa75,1,102,0
Scaffold1699-287046_287148,cPa47,1,1,287096,287086,cPa47,3,102,10
Scaffold1699-287198_287300,cPa47,1,1,287248,287248,cPa47,1,102,0
Scaffold1699-287384_287486,cPa47_cPa47-cPa264-hybrid,0.5,2,287434,287426,cPa47_cPa47-cPa264-hybrid,1_1,102,8
Scaffold1699-289767_289894,cPa15,0.55,6,289869,289767,cPa15_cPa248_cPa264_cPa268_cPa516_cPa516-cPa15-hybrid,11_1_2_1_4_1,127,102
Scaffold1699-290542_290718,cPa248,0.246376811594203,19,290707,290559,cPa118_cPa125_cPa125-cPa15-hybrid_cPa15_cPa15-cPa118-hybrid_cPa248_cPa264_cPa264-cPa118-hybrid_cPa264-cPa15-hybrid_cPa268_cPa268-cPa118-hybrid_cPa268-cPa516-hybrid_cPa443_cPa443-cPa15-hybrid_cPa443-cPa205-hybrid_cPa443-cPa264-hybrid_cPa443-cPa268-hybrid_cPa516-cPa125-hybrid_cPa516-cPa15-hybrid,15_6_1_9_1_17_2_1_1_1_1_1_4_1_1_1_1_2_3,176,148
Scaffold1699-29381_29553,cPa75,1,1,29501,29431,cPa75,2,172,70
Scaffold1699-340927_341029,cPa113-unknown_cPa293_cPa75,0.333333333333333,3,341020,340977,cPa113-unknown_cPa293_cPa75,1_1_1,102,43
Scaffold1699-341053_341155,cPa113_cPa293,0.333333333333333,4,341109,341103,cPa113_cPa113-cPa75-hybrid_cPa293_cPa62,2_1_2_1,102,6
Scaffold1699-51860_51962,cPa75,1,1,51910,51910,cPa75,1,102,0
Scaffold1699-52120_52222,cPa75,1,1,52170,52170,cPa75,1,102,0
Scaffold1699-52427_52529,cPa75,1,1,52477,52477,cPa75,1,102,0
Scaffold1699-61723_61825,cPa75,1,1,61773,61773,cPa75,1,102,0
Scaffold1699-842_956,cPa75,1,1,904,892,cPa75,2,114,12
Scaffold1699-86182_86284,cPa75-cPa285-hybrid,1,1,86232,86232,cPa75-cPa285-hybrid,1,102,0
Scaffold17-1008846_1009180,cPa75,1,1,1009128,1008896,cPa75,5,334,232
Scaffold17-1009362_1009588,cPa75,1,1,1009536,1009412,cPa75,10,226,124
Scaffold17-1021264_1022088,cPa75,1,1,1022036,1021314,cPa75,41,824,722
Scaffold17-1040379_1040481,cPa75,1,1,1040429,1040429,cPa75,1,102,0
Scaffold17-108118_108220,cPa75,1,1,108196,108168,cPa75,2,102,28
Scaffold17-108275_108620,cPa75,1,1,108568,108325,cPa75,7,345,243
Scaffold17-108655_108757,cPa75,1,1,108743,108705,cPa75,3,102,38
Scaffold17-1096097_1096326,cPa75,1,1,1096274,1096147,cPa75,4,229,127
Scaffold17-1096506_1096683,cPa75,1,1,1096631,1096556,cPa75,3,177,75
Scaffold17-1096704_1096965,cPa75,1,1,1096913,1096754,cPa75,27,261,159
Scaffold17-1096978_1097264,cPa75,1,1,1097212,1097028,cPa75,18,286,184
Scaffold17-1097308_1097410,cPa75,1,1,1097358,1097313,cPa75,2,102,45
Scaffold17-1097455_1097557,cPa75,1,1,1097505,1097505,cPa75,1,102,0
Scaffold17-1097568_1097670,cPa75,1,1,1097618,1097618,cPa75,1,102,0
Scaffold17-1099701_1099803,cPa75,1,1,1099771,1099751,cPa75,2,102,20
Scaffold17-1102741_1102843,cPa75,1,1,1102791,1102791,cPa75,1,102,0
Scaffold17-1109094_1109226,cPa75,1,1,1109174,1109144,cPa75,3,132,30
Scaffold17-1109423_1109573,cPa75,1,1,1109521,1109473,cPa75,2,150,48
Scaffold17-1109608_1109773,cPa75,1,1,1109721,1109658,cPa75,5,165,63
Scaffold17-1109934_1110321,cPa75,1,1,1110269,1109984,cPa75,11,387,285
Scaffold17-1110748_1110850,cPa75,1,1,1110798,1110788,cPa75,2,102,10
Scaffold17-1120732_1120834,cPa75,1,1,1120782,1120782,cPa75,1,102,0
Scaffold17-1120982_1121311,cPa75,1,1,1121259,1121032,cPa75,11,329,227
Scaffold17-1121651_1121804,cPa75,1,1,1121752,1121701,cPa75,6,153,51
Scaffold17-1121848_1122020,cPa75,1,1,1121968,1121898,cPa75,5,172,70
Scaffold17-1125910_1126043,cPa75_cPa75-unknown,0.5,2,1125991,1125960,cPa75_cPa75-unknown,1_1,133,31
Scaffold17-1128862_1128964,cPa75,1,1,1128912,1128912,cPa75,1,102,0
Scaffold17-1129254_1129396,cPa75,1,1,1129344,1129304,cPa75,5,142,40
Scaffold17-1129621_1129811,cPa75,1,1,1129759,1129671,cPa75,2,190,88
Scaffold17-1132011_1132113,cPa75,1,1,1132061,1132036,cPa75,2,102,25
Scaffold17-11409_11645,cPa75,1,1,11593,11459,cPa75,3,236,134
Scaffold17-1159864_1160040,cPa75,1,1,1159988,1159914,cPa75,2,176,74
Scaffold17-1160143_1160245,cPa75,1,1,1160193,1160193,cPa75,1,102,0
Scaffold17-1168804_1168924,cPa75,1,1,1168872,1168854,cPa75,3,120,18
Scaffold17-1169440_1169609,cPa75,1,1,1169577,1169490,cPa75,4,169,87
Scaffold17-1169773_1169875,cPa75,1,1,1169823,1169823,cPa75,1,102,0
Scaffold17-1174370_1174507,cPa75,1,1,1174506,1174408,cPa75,14,137,98
Scaffold17-1174564_1174666,cPa75,1,1,1174614,1174592,cPa75,2,102,22
Scaffold17-1174748_1174850,cPa75,1,1,1174798,1174751,cPa75,4,102,47
Scaffold17-117500_117602,cPa425,1,1,117550,117516,cPa425,2,102,34
Scaffold17-1177102_1177204,cPa75,1,1,1177152,1177152,cPa75,1,102,0
Scaffold17-1184431_1184666,cPa75,1,1,1184614,1184481,cPa75,18,235,133
Scaffold17-1184984_1185276,cPa75,1,1,1185224,1185034,cPa75,5,292,190
Scaffold17-1185508_1185610,cPa75,1,1,1185558,1185558,cPa75,1,102,0
Scaffold17-1185749_1185851,cPa75,1,1,1185799,1185799,cPa75,1,102,0
Scaffold17-1209465_1209567,cPa75,1,1,1209515,1209515,cPa75,1,102,0
Scaffold17-1210019_1210121,cPa75,1,1,1210069,1210069,cPa75,1,102,0
Scaffold17-1210195_1210297,cPa75,1,1,1210245,1210245,cPa75,1,102,0
Scaffold17-1210701_1210884,cPa75,1,1,1210832,1210751,cPa75,2,183,81
Scaffold17-1227040_1227142,cPa75,1,1,1227090,1227090,cPa75,1,102,0
Scaffold17-1227292_1227477,cPa75,1,1,1227425,1227342,cPa75,5,185,83
Scaffold17-1227661_1227763,cPa75,1,1,1227718,1227711,cPa75,2,102,7
Scaffold17-1227776_1227878,cPa75,1,1,1227826,1227788,cPa75,2,102,38
Scaffold17-1234121_1234223,cPa224_cPa285,0.5,2,1234171,1234171,cPa224_cPa285,1_1,102,0
Scaffold17-1253682_1253784,cPa75,1,1,1253732,1253732,cPa75,1,102,0
Scaffold17-1279836_1279980,cPa75,1,1,1279928,1279886,cPa75,2,144,42
Scaffold17-128007_128109,cPa447-cPa75-hybrid,1,1,128057,128057,cPa447-cPa75-hybrid,1,102,0
Scaffold17-1280534_1280636,cPa75,1,1,1280584,1280584,cPa75,1,102,0
Scaffold17-1281093_1281195,cPa75,1,1,1281143,1281143,cPa75,1,102,0
Scaffold17-128198_128300,cPa356-cPa75-hybrid,1,1,128248,128248,cPa356-cPa75-hybrid,1,102,0
Scaffold17-1289332_1289439,cPa75,1,1,1289387,1289382,cPa75,2,107,5
Scaffold17-1289597_1289708,cPa75,1,1,1289656,1289647,cPa75,2,111,9
Scaffold17-1289859_1289961,cPa75,1,1,1289909,1289909,cPa75,1,102,0
Scaffold17-1290253_1290355,cPa75,0.666666666666667,2,1290335,1290255,cPa224_cPa75,1_2,102,80
Scaffold17-1290440_1290542,cPa75,1,1,1290490,1290490,cPa75,1,102,0
Scaffold17-1310990_1311092,cPa75,1,1,1311040,1311040,cPa75,1,102,0
Scaffold17-1311120_1311222,cPa75,1,1,1311173,1311156,cPa75,3,102,17
Scaffold17-1312066_1312168,cPa75,1,1,1312116,1312068,cPa75,2,102,48
Scaffold17-1312327_1312429,cPa75,0.666666666666667,2,1312399,1312343,cPa75_cPa75-cPa308-hybrid,2_1,102,56
Scaffold17-1312453_1312610,cPa75,0.9,2,1312593,1312495,cPa75_cPa75-unknown,9_1,157,98
Scaffold17-1322490_1322661,cPa75,1,1,1322609,1322540,cPa75,2,171,69
Scaffold17-1322697_1323059,cPa75,1,1,1323007,1322747,cPa75,28,362,260
Scaffold17-1324232_1324334,cPa75,1,1,1324298,1324279,cPa75,4,102,19
Scaffold17-1324363_1324529,cPa75,1,1,1324477,1324413,cPa75,6,166,64
Scaffold17-1324798_1324900,cPa75,1,1,1324848,1324848,cPa75,1,102,0
Scaffold17-1340035_1340137,cPa75,1,1,1340085,1340085,cPa75,1,102,0
Scaffold17-1340386_1340488,cPa75,1,1,1340436,1340436,cPa75,1,102,0
Scaffold17-1340616_1340718,cPa75,1,1,1340666,1340666,cPa75,1,102,0
Scaffold17-1345384_1345486,cPa75,1,1,1345434,1345434,cPa75,1,102,0
Scaffold17-1345516_1345618,cPa75,1,1,1345566,1345566,cPa75,1,102,0
Scaffold17-1346368_1346470,cPa75,1,1,1346418,1346418,cPa75,1,102,0
Scaffold17-1349826_1349928,cPa75,1,1,1349876,1349876,cPa75,1,102,0
Scaffold17-1373073_1373175,cPa75,1,1,1373123,1373123,cPa75,1,102,0
Scaffold17-1373499_1373693,cPa75,0.8,2,1373641,1373549,cPa75_cPa75-unknown,4_1,194,92
Scaffold17-1373729_1374284,cPa75,1,1,1374232,1373779,cPa75,33,555,453
Scaffold17-1374352_1374511,cPa75,1,1,1374476,1374402,cPa75,3,159,74
Scaffold17-1377052_1377154,cPa75,1,1,1377102,1377102,cPa75,1,102,0
Scaffold17-1378003_1378105,cPa75,1,1,1378053,1378053,cPa75,1,102,0
Scaffold17-1381037_1381139,cPa75,1,1,1381101,1381039,cPa75,4,102,62
Scaffold17-1381666_1381768,cPa75,1,1,1381716,1381716,cPa75,1,102,0
Scaffold17-1381790_1381974,cPa75,1,1,1381922,1381840,cPa75,8,184,82
Scaffold17-1382059_1382668,cPa75,1,1,1382616,1382109,cPa75,50,609,507
Scaffold17-1382765_1382976,cPa75,1,1,1382924,1382815,cPa75,10,211,109
Scaffold17-1385466_1385571,cPa308-cPa75-hybrid_cPa75,0.5,2,1385519,1385516,cPa308-cPa75-hybrid_cPa75,1_1,105,3
Scaffold17-1386108_1386216,cPa308-cPa75-hybrid_cPa75,0.5,2,1386164,1386158,cPa308-cPa75-hybrid_cPa75,1_1,108,6
Scaffold17-1389749_1390005,cPa75,0.785714285714286,2,1389953,1389799,cPa75_cPa75-unknown,11_3,256,154
Scaffold17-1390166_1390396,cPa75,1,1,1390344,1390216,cPa75,5,230,128
Scaffold17-1394377_1394479,cPa75,1,1,1394427,1394427,cPa75,1,102,0
Scaffold17-1399300_1399402,cPa75,1,1,1399350,1399350,cPa75,1,102,0
Scaffold17-1402574_1402771,cPa75,1,1,1402719,1402589,cPa75,5,197,130
Scaffold17-1402777_1402899,cPa75,1,1,1402847,1402785,cPa75,4,122,62
Scaffold17-1405052_1405183,cPa75,1,1,1405131,1405102,cPa75,2,131,29
Scaffold17-1405311_1405448,cPa75,1,1,1405396,1405358,cPa75,6,137,38
Scaffold17-1409673_1409775,cPa75,1,1,1409723,1409723,cPa75,1,102,0
Scaffold17-1410425_1410527,cPa75,1,1,1410475,1410475,cPa75,1,102,0
Scaffold17-1410851_1410953,cPa75,1,1,1410901,1410901,cPa75,1,102,0
Scaffold17-1410993_1411095,cPa75,1,1,1411043,1411043,cPa75,1,102,0
Scaffold17-1411099_1411394,cPa75,1,1,1411342,1411121,cPa75,6,295,221
Scaffold17-1411797_1411989,cPa75,1,1,1411937,1411823,cPa75,3,192,114
Scaffold17-1412033_1412155,cPa75,1,1,1412103,1412083,cPa75,2,122,20
Scaffold17-1422504_1422635,cPa75,1,1,1422605,1422507,cPa75,6,131,98
Scaffold17-1422660_1422811,cPa75,1,1,1422789,1422664,cPa75,14,151,125
Scaffold17-1422886_1423058,cPa75,1,1,1423006,1422908,cPa75,19,172,98
Scaffold17-1425883_1425985,cPa75,1,1,1425933,1425933,cPa75,1,102,0
Scaffold17-1438844_1438946,cPa75,1,1,1438894,1438894,cPa75,1,102,0
Scaffold17-1438954_1439056,cPa75,1,1,1439004,1439004,cPa75,1,102,0
Scaffold17-1439072_1439174,cPa75,1,1,1439122,1439122,cPa75,2,102,0
Scaffold17-1439180_1439445,cPa75,1,1,1439393,1439230,cPa75,3,265,163
Scaffold17-1439466_1440094,cPa75,1,1,1440042,1439516,cPa75,22,628,526
Scaffold17-1440413_1440515,cPa75,1,1,1440463,1440463,cPa75,1,102,0
Scaffold17-1442635_1442737,cPa75,1,1,1442685,1442685,cPa75,1,102,0
Scaffold17-1450378_1450480,cPa75,1,1,1450428,1450428,cPa75,1,102,0
Scaffold17-1450646_1450945,cPa75,1,1,1450893,1450696,cPa75,6,299,197
Scaffold17-1450993_1451178,cPa75,1,1,1451126,1451043,cPa75,3,185,83
Scaffold17-1451212_1451314,cPa75,1,1,1451262,1451262,cPa75,1,102,0
Scaffold17-1451585_1451687,cPa75,1,1,1451635,1451635,cPa75,1,102,0
Scaffold17-1453496_1453598,cPa75,1,1,1453546,1453537,cPa75,2,102,9
Scaffold17-1453620_1454405,cPa75,1,1,1454353,1453670,cPa75,65,785,683
Scaffold17-1455269_1455464,cPa62-cPa75-hybrid,0.666666666666667,2,1455412,1455319,cPa62-cPa75-hybrid_cPa75,2_1,195,93
Scaffold17-1455495_1455597,cPa75,0.75,2,1455589,1455545,cPa62-cPa75-hybrid_cPa75,1_3,102,44
Scaffold17-1455627_1455868,cPa62-cPa75-hybrid,1,1,1455844,1455677,cPa62-cPa75-hybrid,7,241,167
Scaffold17-1458663_1458765,cPa75,1,1,1458713,1458713,cPa75,1,102,0
Scaffold17-1468789_1468912,cPa75,1,1,1468888,1468839,cPa75,6,123,49
Scaffold17-1469007_1469337,cPa75,1,1,1469285,1469057,cPa75,8,330,228
Scaffold17-1469342_1469562,cPa75,1,1,1469510,1469392,cPa75,3,220,118
Scaffold17-1469690_1469939,cPa75,1,1,1469887,1469740,cPa75,5,249,147
Scaffold17-1469985_1470174,cPa75,1,1,1470122,1470035,cPa75,5,189,87
Scaffold17-1470239_1470341,cPa75,1,1,1470289,1470289,cPa75,1,102,0
Scaffold17-1470549_1470651,cPa75,1,1,1470599,1470599,cPa75,1,102,0
Scaffold17-147277_147379,cPa75,1,1,147327,147327,cPa75,1,102,0
Scaffold17-1476439_1476541,cPa62,0.666666666666667,2,1476489,1476478,cPa62_cPa62-cPa254-hybrid,2_1,102,11
Scaffold17-1476565_1476783,cPa62,0.714285714285714,2,1476731,1476615,cPa62_cPa62-unknown,5_2,218,116
Scaffold17-1477974_1478172,cPa75,1,1,1478120,1478024,cPa75,25,198,96
Scaffold17-1478185_1478413,cPa75,1,1,1478361,1478235,cPa75,5,228,126
Scaffold17-147821_148030,cPa75,1,1,148008,147871,cPa75,6,209,137
Scaffold17-1484031_1484133,cPa75,1,1,1484081,1484081,cPa75,1,102,0
Scaffold17-1486251_1486353,cPa75,1,1,1486301,1486301,cPa75,1,102,0
Scaffold17-1489550_1489652,cPa75,1,1,1489600,1489600,cPa75,1,102,0
Scaffold17-1489684_1489867,cPa75,1,1,1489815,1489734,cPa75,3,183,81
Scaffold17-1496876_1496996,cPa428,0.571428571428571,2,1496995,1496926,cPa356_cPa428,3_4,120,69
Scaffold17-1497059_1497284,cPa356,0.55,2,1497256,1497063,cPa356_cPa428,33_27,225,193
Scaffold17-1497452_1497803,cPa356,0.559701492537313,3,1497763,1497452,cPa356_cPa428_cPa428-cPa356-hybrid,75_58_1,351,311
Scaffold17-1498067_1498234,cPa428,0.6,2,1498182,1498075,cPa356_cPa428,4_6,167,107
Scaffold17-1502824_1502957,cPa356,0.666666666666667,2,1502905,1502874,cPa356_cPa428,2_1,133,31
Scaffold17-1503061_1503163,cPa356,0.666666666666667,2,1503126,1503111,cPa356_cPa428,2_1,102,15
Scaffold17-1503572_1503674,cPa428,0.75,2,1503622,1503582,cPa356_cPa428,1_3,102,40
Scaffold17-1503748_1503860,cPa428,0.5625,2,1503859,1503794,cPa356_cPa428,7_9,112,65
Scaffold17-1504248_1504350,cPa356,0.666666666666667,2,1504345,1504266,cPa356_cPa428,4_2,102,79
Scaffold17-1504521_1504648,cPa356,0.6,2,1504598,1504571,cPa356_cPa428,3_2,127,27
Scaffold17-1504763_1504890,cPa428,0.545454545454545,2,1504889,1504808,cPa356_cPa428,15_18,127,81
Scaffold17-1504891_1504993,cPa428,0.666666666666667,2,1504941,1504891,cPa356_cPa428,1_2,102,50
Scaffold17-1505126_1505251,cPa356,0.5625,2,1505204,1505127,cPa356_cPa428,9_7,125,77
Scaffold17-1505279_1505406,cPa356,0.714285714285714,2,1505375,1505289,cPa356_cPa428,10_4,127,86
Scaffold17-1506347_1506449,cPa356_cPa428,0.5,2,1506397,1506359,cPa356_cPa428,1_1,102,38
Scaffold17-1509277_1509389,cPa356,0.666666666666667,2,1509378,1509327,cPa356_cPa428,2_1,112,51
Scaffold17-1510491_1510593,cPa356,0.6,2,1510578,1510498,cPa356_cPa428,9_6,102,80
Scaffold17-1511574_1511676,cPa428,0.555555555555556,2,1511640,1511574,cPa356_cPa428,4_5,102,66
Scaffold17-1512140_1512278,cPa356,0.511111111111111,2,1512277,1512171,cPa356_cPa428,23_22,138,106
Scaffold17-1512298_1512400,cPa428,0.52,2,1512350,1512332,cPa356_cPa428,12_13,102,18
Scaffold17-1512407_1512518,cPa356,0.592592592592593,2,1512505,1512406,cPa356_cPa428,16_11,111,99
Scaffold17-171105_171351,cPa75,1,1,171299,171155,cPa75,4,246,144
Scaffold17-171385_171710,cPa75,1,1,171658,171435,cPa75,8,325,223
Scaffold17-171970_172072,cPa75,1,1,172020,172020,cPa75,1,102,0
Scaffold17-179073_179175,cPa356-cPa75-hybrid,1,1,179123,179114,cPa356-cPa75-hybrid,2,102,9
Scaffold17-183542_183644,cPa356,1,1,183592,183576,cPa356,2,102,16
Scaffold17-183787_183889,cPa413_cPa447,0.5,2,183837,183829,cPa413_cPa447,1_1,102,8
Scaffold17-189388_190261,cPa75,1,1,190209,189438,cPa75,46,873,771
Scaffold17-190265_190367,cPa75,1,1,190315,190315,cPa75,1,102,0
Scaffold17-19628_19730,cPa118,1,1,19678,19678,cPa118,1,102,0
Scaffold17-257695_257797,cPa425,1,1,257745,257745,cPa425,1,102,0
Scaffold17-312235_312337,cPa118,1,1,312285,312285,cPa118,1,102,0
Scaffold17-312580_312682,cPa15,1,1,312630,312630,cPa15,1,102,0
Scaffold17-345586_345826,cPa75,1,1,345774,345636,cPa75,4,240,138
Scaffold17-346034_346426,cPa75,1,1,346374,346084,cPa75,7,392,290
Scaffold17-346476_346660,cPa75,1,1,346608,346526,cPa75,2,184,82
Scaffold17-354831_354933,cPa285,1,1,354881,354881,cPa285,1,102,0
Scaffold17-381195_381297,cPa75,1,1,381245,381242,cPa75,2,102,3
Scaffold17-382810_382912,cPa75,1,1,382860,382860,cPa75,1,102,0
Scaffold17-383024_383126,cPa75,1,1,383100,383048,cPa75,3,102,52
Scaffold17-383717_383819,cPa75,1,1,383767,383767,cPa75,1,102,0
Scaffold17-392724_393110,cPa75,1,1,393104,392774,cPa75,16,386,330
Scaffold17-393226_393882,cPa75,1,1,393830,393276,cPa75,35,656,554
Scaffold17-393896_394048,cPa75,1,1,394013,393946,cPa75,5,152,67
Scaffold17-394445_394547,cPa75,1,1,394523,394452,cPa75,4,102,71
Scaffold17-398496_398598,cPa75,1,1,398546,398546,cPa75,1,102,0
Scaffold17-398740_398843,cPa75,1,1,398791,398790,cPa75,2,103,1
Scaffold17-398969_399071,cPa75,1,1,399019,399019,cPa75,1,102,0
Scaffold17-399180_399282,cPa75,1,1,399230,399230,cPa75,1,102,0
Scaffold17-399345_399498,cPa75,1,1,399446,399395,cPa75,4,153,51
Scaffold17-399592_399808,cPa75,1,1,399761,399642,cPa75,5,216,119
Scaffold17-517187_517289,cPa75,1,1,517237,517237,cPa75,1,102,0
Scaffold17-517351_517860,cPa75,1,1,517857,517401,cPa75,14,509,456
Scaffold17-518020_518122,cPa75,1,1,518070,518070,cPa75,1,102,0
Scaffold17-580853_580955,cPa75-cPa15-hybrid,1,1,580903,580903,cPa75-cPa15-hybrid,1,102,0
Scaffold17-592267_592369,cPa75,1,1,592317,592317,cPa75,1,102,0
Scaffold17-596324_596426,cPa75,1,1,596374,596337,cPa75,4,102,37
Scaffold17-609610_609712,cPa75,1,1,609660,609660,cPa75,1,102,0
Scaffold17-609983_610086,cPa75,1,1,610034,610033,cPa75,2,103,1
Scaffold17-610235_610371,cPa75,1,1,610319,610285,cPa75,7,136,34
Scaffold17-610469_610650,cPa75,1,1,610598,610519,cPa75,27,181,79
Scaffold17-610668_610908,cPa75,1,1,610856,610718,cPa75,23,240,138
Scaffold17-610966_611068,cPa75,1,1,611016,611016,cPa75,1,102,0
Scaffold17-611074_611176,cPa75,1,1,611124,611124,cPa75,1,102,0
Scaffold17-614902_615004,cPa75,1,1,614952,614952,cPa75,1,102,0
Scaffold17-632465_632567,cPa75,1,1,632515,632515,cPa75,1,102,0
Scaffold17-652251_652353,cPa75,1,1,652301,652301,cPa75,1,102,0
Scaffold17-655862_656147,cPa75,1,1,656095,655912,cPa75,4,285,183
Scaffold17-656174_656432,cPa75,1,1,656380,656224,cPa75,8,258,156
Scaffold17-656532_656634,cPa75,1,1,656582,656582,cPa75,1,102,0
Scaffold17-656878_656980,cPa75,1,1,656928,656928,cPa75,1,102,0
Scaffold17-665979_666122,cPa293,0.6,2,666070,666029,cPa285_cPa293,2_3,143,41
Scaffold17-666249_666663,cPa293,0.62962962962963,3,666611,666296,cPa285_cPa285-cPa293-hybrid_cPa293,9_1_17,414,315
Scaffold17-672520_672622,cPa75,1,1,672570,672570,cPa75,1,102,0
Scaffold17-678846_678948,cPa75,1,1,678896,678860,cPa75,3,102,36
Scaffold17-679014_679226,cPa75,1,1,679174,679064,cPa75,5,212,110
Scaffold17-679247_679539,cPa75,1,1,679487,679281,cPa75,6,292,206
Scaffold17-679588_679690,cPa75,1,1,679643,679638,cPa75,2,102,5
Scaffold17-679871_679973,cPa75,1,1,679921,679921,cPa75,1,102,0
Scaffold17-680135_680237,cPa75,1,1,680185,680185,cPa75,1,102,0
Scaffold17-684668_684860,cPa75,1,1,684808,684718,cPa75,3,192,90
Scaffold17-691223_691395,cPa75,1,1,691343,691273,cPa75,3,172,70
Scaffold17-691417_691707,cPa75,1,1,691655,691420,cPa75,4,290,235
Scaffold17-691796_691969,cPa75,1,1,691917,691846,cPa75,4,173,71
Scaffold17-692128_692260,cPa75,1,1,692208,692178,cPa75,2,132,30
Scaffold17-694294_694396,cPa75,1,1,694344,694344,cPa75,1,102,0
Scaffold17-696729_696831,cPa75,1,1,696779,696779,cPa75,1,102,0
Scaffold17-697189_697291,cPa75,1,1,697239,697239,cPa75,1,102,0
Scaffold17-697348_697463,cPa75,1,1,697411,697398,cPa75,3,115,13
Scaffold17-709665_710832,cPa75,1,1,710780,709715,cPa75,49,1167,1065
Scaffold17-710913_711015,cPa75,1,1,710963,710963,cPa75,1,102,0
Scaffold17-718710_719007,cPa75,1,1,718991,718760,cPa75,9,297,231
Scaffold17-719072_719343,cPa75,1,1,719291,719108,cPa75,14,271,183
Scaffold17-720246_720373,cPa75,1,1,720321,720296,cPa75,2,127,25
Scaffold17-721172_721274,cPa75,1,1,721222,721222,cPa75,1,102,0
Scaffold17-727653_727755,cPa75,1,1,727703,727703,cPa75,1,102,0
Scaffold17-728053_728155,cPa75,1,1,728103,728103,cPa75,1,102,0
Scaffold17-728161_728263,cPa75,1,1,728211,728211,cPa75,1,102,0
Scaffold17-728351_728453,cPa75,1,1,728401,728401,cPa75,1,102,0
Scaffold17-810911_811013,cPa75,1,1,810961,810961,cPa75,1,102,0
Scaffold17-817228_817330,cPa62-WDSV_NC001867-hybrid_WDSV_NC001867,0.5,2,817278,817228,cPa62-WDSV_NC001867-hybrid_WDSV_NC001867,1_1,102,50
Scaffold17-830910_831244,cPa75,0.875,2,831192,830960,ALV_NC001408-cPa75-hybrid_cPa75,1_7,334,232
Scaffold17-831312_831509,cPa75,1,1,831457,831362,cPa75,7,197,95
Scaffold17-831606_831744,ALV_NC001408-cPa75-hybrid_cPa75,0.5,2,831692,831656,ALV_NC001408-cPa75-hybrid_cPa75,1_1,138,36
Scaffold17-831745_831920,cPa75,1,1,831868,831795,cPa75,3,175,73
Scaffold17-831996_832098,cPa75,1,1,832046,832046,cPa75,1,102,0
Scaffold17-844290_844392,cPa75,1,1,844340,844340,cPa75,1,102,0
Scaffold17-863051_863294,cPa62,1,1,863242,863101,cPa62,10,243,141
Scaffold17-870551_870653,cPa75,1,1,870613,870601,cPa75,2,102,12
Scaffold17-87618_87720,cPa62,1,1,87668,87668,cPa62,1,102,0
Scaffold17-925968_926307,cPa62,1,1,926255,926018,cPa62,13,339,237
Scaffold17-934190_934292,cPa75,1,1,934240,934211,cPa75,5,102,29
Scaffold17-935867_936016,cPa199_cPa539,0.5,2,935964,935917,cPa199_cPa539,1_1,149,47
Scaffold17-936034_936136,cPa199,1,1,936115,936084,cPa199,2,102,31
Scaffold17-950623_950725,cPa75,1,1,950673,950673,cPa75,1,102,0
Scaffold17-951311_951413,cPa75,1,1,951361,951361,cPa75,1,102,0
Scaffold17-990146_990337,cPa75,1,1,990285,990196,cPa75,2,191,89
Scaffold17-990603_990705,cPa75,1,1,990674,990653,cPa75,2,102,21
Scaffold170-10675_10777,cPa356_cPa428,0.5,2,10736,10725,cPa356_cPa428,1_1,102,11
Scaffold170-11436_11538,cPa356_cPa428,0.5,2,11533,11439,cPa356_cPa428,6_6,102,94
Scaffold170-12475_12585,cPa428,0.666666666666667,2,12548,12525,cPa356_cPa428,4_8,110,23
Scaffold170-12777_12879,cPa428,1,1,12876,12827,cPa428,2,102,49
Scaffold170-13493_13639,cPa356,0.666666666666667,2,13605,13543,cPa356_cPa428,4_2,146,62
Scaffold170-14210_14334,cPa428,1,1,14282,14260,cPa428,3,124,22
Scaffold170-22029_22131,cPa356_cPa428,0.5,2,22108,22079,cPa356_cPa428,2_2,102,29
Scaffold170-22251_22366,cPa428,0.555555555555556,2,22350,22299,cPa356_cPa428,4_5,115,51
Scaffold170-23264_23470,cPa356,0.559322033898305,2,23418,23267,cPa356_cPa428,33_26,206,151
Scaffold170-23665_23767,cPa428,1,1,23717,23715,cPa428,3,102,2
Scaffold170-24036_24138,cPa428,0.666666666666667,2,24086,24064,cPa356_cPa428,1_2,102,22
Scaffold170-24650_24850,cPa428,0.571428571428571,2,24798,24700,cPa356_cPa428,12_16,200,98
Scaffold170-29144_29246,cPa356,1,1,29194,29194,cPa356,1,102,0
Scaffold170-53780_53895,cPa356_cPa428,0.5,2,53887,53830,cPa356_cPa428,2_2,115,57
Scaffold170-54840_54942,cPa356_cPa428,0.5,2,54910,54890,cPa356_cPa428,2_2,102,20
Scaffold170-55138_55240,cPa356_cPa428,0.5,2,55188,55186,cPa356_cPa428,1_1,102,2
Scaffold170-56534_56636,cPa428,1,1,56584,56584,cPa428,1,102,0
Scaffold170-58436_58538,cPa428,1,1,58486,58450,cPa428,2,102,36
Scaffold170-59112_59214,cPa356,0.625,2,59176,59124,cPa356_cPa428,5_3,102,52
Scaffold170-59369_59477,cPa428,0.666666666666667,2,59458,59398,cPa356_cPa428,3_6,108,60
Scaffold170-59593_59695,cPa428,0.75,2,59647,59622,cPa356_cPa428,1_3,102,25
Scaffold170-60228_60330,cPa428,1,1,60278,60278,cPa428,1,102,0
Scaffold170-60378_60480,cPa356_cPa428,0.5,2,60428,60428,cPa356_cPa428,1_1,102,0
Scaffold170-61468_61578,cPa428,0.535714285714286,2,61566,61468,cPa356_cPa428,13_15,110,98
Scaffold170-63778_63880,cPa356_cPa428,0.5,2,63828,63828,cPa356_cPa428,1_1,102,0
Scaffold170-64389_64491,cPa356,1,1,64439,64439,cPa356,1,102,0
Scaffold170-66357_66459,cPa356_cPa428,0.5,2,66459,66398,cPa356_cPa428,8_8,102,61
Scaffold170-66937_67097,cPa356,0.547619047619048,2,67094,66953,cPa356_cPa428,23_19,160,141
Scaffold170-67292_67487,cPa428,0.583333333333333,2,67482,67340,cPa356_cPa428,5_7,195,142
Scaffold170-67642_67744,cPa428,0.6,2,67737,67665,cPa356_cPa428,2_3,102,72
Scaffold170-67991_68304,cPa356,0.506329113924051,2,68284,67992,cPa356_cPa428,40_39,313,292
Scaffold170-68491_68593,cPa428,0.6,2,68593,68541,cPa356_cPa428,2_3,102,52
Scaffold170-68731_68833,cPa356,0.75,2,68824,68767,cPa356_cPa428,6_2,102,57
Scaffold170-68908_69077,cPa428,0.583333333333333,2,69073,68913,cPa356_cPa428,15_21,169,160
Scaffold170-69120_69259,cPa356_cPa428,0.5,2,69246,69137,cPa356_cPa428,50_50,139,109
Scaffold170-74512_74614,cPa428,0.545454545454545,2,74612,74562,cPa356_cPa428,10_12,102,50
Scaffold170-74916_75018,cPa356,0.515151515151515,2,75011,74916,cPa356_cPa428,17_16,102,95
Scaffold170-8402_8597,cPa428,0.611111111111111,2,8545,8452,cPa356_cPa428,7_11,195,93
Scaffold170-9780_9882,cPa428,0.636363636363636,2,9870,9802,cPa356_cPa428,4_7,102,68
Scaffold170-9945_10163,cPa356_cPa428,0.5,2,10143,9995,cPa356_cPa428,14_14,218,148
Scaffold1700-14456_14609,cPa356,0.5,3,14574,14506,cPa356_cPa428_cPa510-unknown,2_1_1,153,68
Scaffold1700-16080_16182,cPa428,1,1,16130,16130,cPa428,1,102,0
Scaffold1700-2230_2332,HERV-W_repbase_HERV17_LTR17-cPa452-hybrid_HERV-W_repbase_HERV17_LTR17-cPa456-hybrid,0.5,2,2280,2280,HERV-W_repbase_HERV17_LTR17-cPa452-hybrid_HERV-W_repbase_HERV17_LTR17-cPa456-hybrid,1_1,102,0
Scaffold1700-3608_3710,cPa113-cPa363-hybrid,1,1,3658,3658,cPa113-cPa363-hybrid,1,102,0
Scaffold1700-5359_5461,cPa456-MPMVs_NC001550-hybrid,1,1,5409,5409,cPa456-MPMVs_NC001550-hybrid,1,102,0
Scaffold1700-6095_6197,cPa363-MPMVs_NC001550-hybrid,1,1,6145,6145,cPa363-MPMVs_NC001550-hybrid,1,102,0
Scaffold1701-10989_11365,cPa450,0.341796875,32,11356,10992,cPa199_cPa199-cPa227-hybrid_cPa199-cPa353-hybrid_cPa199-cPa553-hybrid_cPa223_cPa223-cPa199-hybrid_cPa223-cPa201-hybrid_cPa223-cPa227-hybrid_cPa223-cPa345-hybrid_cPa223-cPa450-hybrid_cPa223-cPa482-hybrid_cPa223-cPa553-hybrid_cPa223-HML1a_repbase_HERV-K14CI_LTR14C-hybrid_cPa223-HML4_repbase_HERVK13I_LTR13-hybrid_cPa223-unknown_cPa227_cPa227-cPa553-hybrid_cPa345_cPa345-cPa201-hybrid_cPa345-cPa227-hybrid_cPa345-cPa353-hybrid_cPa345-cPa450-hybrid_cPa345-cPa553-hybrid_cPa356-cPa227-hybrid_cPa400-cPa553-hybrid_cPa450_cPa482_cPa482-cPa201-hybrid_cPa482-cPa227-hybrid_cPa482-cPa353-hybrid_cPa482-cPa553-hybrid_cPa553,5_1_1_3_55_5_3_11_1_1_1_20_4_1_20_101_3_9_1_2_1_1_1_2_1_175_7_3_2_1_2_68,376,364
Scaffold1701-11499_11637,cPa223-HML1a_repbase_HERV-K14CI_LTR14C-hybrid,0.75,2,11585,11549,cPa199-HML1a_repbase_HERV-K14CI_LTR14C-hybrid_cPa223-HML1a_repbase_HERV-K14CI_LTR14C-hybrid,1_3,138,36
Scaffold1701-13545_13654,cPa50-unknown,0.5,4,13654,13595,cPa247-cPa223-hybrid_cPa254-cPa515-hybrid_cPa419_cPa50-unknown,1_1_1_3,109,59
Scaffold1701-13794_13896,cPa254-cPa11-hybrid_cPa254-cPa183-hybrid_cPa50-cPa223-hybrid,0.333333333333333,3,13844,13836,cPa254-cPa11-hybrid_cPa254-cPa183-hybrid_cPa50-cPa223-hybrid,1_1_1,102,8
Scaffold1701-15172_15274,cPa254_cPa47,0.5,2,15222,15182,cPa254_cPa47,1_1,102,40
Scaffold1701-16286_16388,cPa174,1,1,16340,16336,cPa174,2,102,4
Scaffold1701-2419_2589,cPa118_cPa472-cPa357-hybrid,0.133333333333333,13,2557,2419,cPa118_cPa118-unknown_cPa15_cPa15-unknown_cPa18-cPa357-hybrid_cPa18-cPa410-hybrid_cPa18-cPa443-hybrid_cPa18-cPa61-hybrid_cPa264_cPa419_cPa472-cPa264-hybrid_cPa472-cPa357-hybrid_cPa472-cPa410-hybrid,2_1_1_1_1_1_1_1_1_1_1_2_1,170,138
Scaffold1701-7894_7996,cPa391-cPa223-hybrid_cPa391-cPa392-hybrid,0.5,2,7947,7944,cPa391-cPa223-hybrid_cPa391-cPa392-hybrid,1_1,102,3
Scaffold1701-8462_8564,cPa392-cPa201-hybrid,0.636363636363636,4,8513,8487,cPa258-cPa223-hybrid_cPa356-cPa223-hybrid_cPa392-cPa201-hybrid_cPa392-HML4_repbase_HERVK13I_LTR13-hybrid,1_1_7_2,102,26
Scaffold1702-10063_10165,cPa419,1,1,10113,10113,cPa419,1,102,0
Scaffold1702-27404_27506,cPa145,1,1,27454,27454,cPa145,1,102,0
Scaffold1702-27582_27684,cPa145_cPa247-cPa413-hybrid,0.5,2,27632,27632,cPa145_cPa247-cPa413-hybrid,1_1,102,0
Scaffold1702-2886_2988,cPa75-PERV_AJ293656-hybrid,0.333333333333333,5,2939,2910,cPa75_cPa75-cPa254-hybrid_cPa75-cPa387-hybrid_cPa75-cPa402-hybrid_cPa75-PERV_AJ293656-hybrid,1_1_1_1_2,102,29
Scaffold1702-3352_3508,cPa75-cPa456-hybrid,0.666666666666667,4,3456,3402,cPa308-cPa456-hybrid_cPa402-cPa456-hybrid_cPa75-cPa446-hybrid_cPa75-cPa456-hybrid,1_1_1_6,156,54
Scaffold1702-3564_3666,cPa75-cPa456-hybrid,1,1,3614,3614,cPa75-cPa456-hybrid,1,102,0
Scaffold1702-7771_7874,HIV1_NC001802-cPa247-hybrid_HIV1_NC001802-cPa50-hybrid,0.5,2,7822,7821,HIV1_NC001802-cPa247-hybrid_HIV1_NC001802-cPa50-hybrid,1_1,103,1
Scaffold1702-8489_8596,HIV1_NC001802-cPa50-hybrid,0.714285714285714,3,8556,8539,cPa199-cPa50-hybrid_HIV1_NC001802-cPa247-hybrid_HIV1_NC001802-cPa50-hybrid,2_2_10,107,17
Scaffold1702-8892_9197,MoMLV_J02255,0.457142857142857,14,9149,8942,cPa16_cPa199-cPa247-hybrid_cPa199-cPa50-hybrid_cPa247_cPa247-cPa16-hybrid_cPa247-cPa50-hybrid_cPa247-MoMLV_J02255-hybrid_cPa247-unknown_HIV1_NC001802-cPa247-hybrid_HIV1_NC001802-cPa345-hybrid_HIV1_NC001802-cPa50-hybrid_MoMLV_J02255_MoMLV_J02255-cPa258-hybrid_MoMLV_J02255-cPa50-hybrid,1_1_7_7_2_2_3_1_1_1_18_48_2_11,305,207
Scaffold1703-16226_16328,cPa118-cPa339-hybrid,0.666666666666667,2,16276,16229,cPa118-cPa339-hybrid_cPa516-cPa339-hybrid,4_2,102,47
Scaffold1703-2100_2210,cPa391-unknown,0.789473684210526,4,2159,2150,cPa391_cPa391-cPa402-hybrid_cPa391-HFV_NC001736-hybrid_cPa391-unknown,1_2_1_15,110,9
Scaffold1703-2353_2489,cPa391-unknown,0.555555555555556,2,2451,2374,cPa391-unknown_HFV_NC001736,5_4,136,77
Scaffold1703-26303_26426,cPa145,0.5,3,26374,26353,cPa145_cPa419_cPa452-cPa145-hybrid,3_2_1,123,21
Scaffold1703-27111_27213,cPa419,1,1,27161,27161,cPa419,1,102,0
Scaffold1703-27461_27563,cPa419,1,1,27511,27511,cPa419,1,102,0
Scaffold1703-30590_30692,cPa402-cPa75-hybrid,1,1,30640,30640,cPa402-cPa75-hybrid,1,102,0
Scaffold1703-4078_4180,cPa419,0.75,2,4172,4085,cPa419_HIV1_NC001802-cPa205-hybrid,3_1,102,87
Scaffold1703-4188_4298,cPa339_cPa447,0.385964912280702,14,4290,4187,cPa142-cPa444-hybrid_cPa339_cPa339-cPa390-hybrid_cPa339-cPa444-hybrid_cPa400-cPa205-hybrid_cPa400-cPa390-hybrid_cPa419_cPa419-cPa390-hybrid_cPa447_cPa447-cPa390-hybrid_HERV-F_repbase_HERVFH19I_LTR19A-cPa419-hybrid_HERV-XA34_repbase_HERVFH21I_LTR21A-cPa205-hybrid_HIV1_NC001802-cPa390-hybrid_HIV1_NC001802-cPa402-hybrid,1_22_1_1_1_2_1_1_22_1_1_1_1_1,110,103
Scaffold1703-52006_52108,cPa356,0.923076923076923,2,52093,52015,cPa356_cPa419,12_1,102,78
Scaffold1703-54133_54235,cPa419,0.666666666666667,2,54183,54167,cPa419_cPa419-cPa339-hybrid,2_1,102,16
Scaffold1703-5627_6056,HERV-F_repbase_HERVFH19I_LTR19A,0.397260273972603,35,6022,5647,cPa16_cPa16-cPa163-hybrid_cPa16-cPa428-hybrid_cPa16-cPa75-hybrid_cPa188-cPa75-hybrid_cPa339-cPa505-hybrid_cPa339-cPa60-hybrid_cPa339-HERV-F_repbase_HERVFH19I_LTR19A-hybrid_cPa419_cPa425-cPa75-hybrid_cPa428-cPa60-hybrid_cPa505_cPa505-cPa188-hybrid_cPa505-cPa205-hybrid_cPa505-cPa339-hybrid_cPa505-cPa444-hybrid_cPa505-cPa47-hybrid_cPa505-cPa75-hybrid_cPa505-HERV-F_repbase_HERVFH19I_LTR19A-hybrid_cPa75_HERV-F_repbase_HERVFH19I_LTR19A_HERV-F_repbase_HERVFH19I_LTR19A-cPa390-hybrid_HERV-F_repbase_HERVFH19I_LTR19A-cPa444-hybrid_HERV-F_repbase_HERVFH19I_LTR19A-cPa75-hybrid_HERV-F_repbase_HERVFH19I_LTR19A-unknown_HIV1_NC001802-cPa75-hybrid_MoMLV_J02255_MoMLV_J02255-cPa188-hybrid_MoMLV_J02255-cPa205-hybrid_MoMLV_J02255-cPa390-hybrid_MoMLV_J02255-cPa425-hybrid_MoMLV_J02255-cPa444-hybrid_MoMLV_J02255-cPa60-hybrid_MoMLV_J02255-cPa75-hybrid_MoMLV_J02255-HERV-F_repbase_HERVFH19I_LTR19A-hybrid,6_1_1_1_3_1_1_4_11_1_1_5_3_3_1_1_1_2_1_1_58_2_1_1_1_2_21_1_1_1_1_4_1_1_1,429,375
Scaffold1703-6078_6233,MoMLV_J02255,0.454545454545455,9,6222,6128,cPa16_cPa219-cPa502-hybrid_cPa247_cPa419_cPa505_cPa505-cPa75-hybrid_cPa505-MoMLV_J02255-hybrid_MoMLV_J02255_MoMLV_J02255-cPa75-hybrid,3_1_1_1_7_3_1_15_1,155,94
Scaffold1703-60850_60952,cPa516,0.307692307692308,7,60929,60850,cPa118_cPa419_cPa434-cPa443-hybrid_cPa434-cPa516-hybrid_cPa443_cPa516_MDEV_AF053745-cPa516-hybrid,3_2_1_1_1_4_1,102,79
Scaffold1703-61777_61879,cPa118-cPa176-hybrid_cPa176_cPa419_MDEV_AF053745-cPa363-hybrid,0.166666666666667,8,61841,61824,cPa118-cPa176-hybrid_cPa118-cPa363-hybrid_cPa176_cPa419_cPa426-cPa465-hybrid_cPa443-cPa363-hybrid_MDEV_AF053745-cPa363-hybrid_SIV_NC001549-cPa363-hybrid,2_1_2_2_1_1_2_1,102,17
Scaffold1703-67868_67970,cPa75-cPa2-hybrid,1,1,67918,67918,cPa75-cPa2-hybrid,1,102,0
Scaffold1703-72159_72331,cPa268,0.324324324324324,16,72328,72172,cPa125_cPa125-cPa264-hybrid_cPa140_cPa15_cPa150-cPa125-hybrid_cPa260-cPa413-hybrid_cPa264_cPa268_cPa268-cPa15-hybrid_cPa268-cPa260-hybrid_cPa371-cPa15-hybrid_cPa371-cPa260-hybrid_cPa413_cPa419_cPa75_PtERV1_AC142352,5_1_2_23_1_1_1_24_1_5_1_3_2_2_1_1,172,156
Scaffold1703-75651_75753,EIAV_NC001450,1,1,75701,75701,EIAV_NC001450,1,102,0
Scaffold1703-75941_76095,EIAV_NC001450,0.777777777777778,3,76073,75973,EIAV_NC001450_EIAV_NC001450-cPa163-hybrid_EIAV_NC001450-cPa360-hybrid,7_1_1,154,100
Scaffold1703-76112_76317,EIAV_NC001450_EIAV_NC001450-cPa224-hybrid,0.375,4,76265,76140,cPa60-cPa163-hybrid_EIAV_NC001450_EIAV_NC001450-cPa224-hybrid_FrMuLV_NC001362-cPa224-hybrid,1_3_3_1,205,125
Scaffold1703-7726_7828,cPa419,0.5,3,7798,7728,cPa220_cPa419_cPa75,1_2_1,102,70
Scaffold1703-77494_77596,cPa407_cPa419,0.5,2,77556,77544,cPa407_cPa419,1_1,102,12
Scaffold1703-7917_8019,cPa419_HERV-W_repbase_HERV17_LTR17-HERV-Fb_repbase_HERVH48I_MER48-hybrid,0.5,2,7974,7967,cPa419_HERV-W_repbase_HERV17_LTR17-HERV-Fb_repbase_HERVH48I_MER48-hybrid,1_1,102,7
Scaffold1704-10931_11033,cPa174_cPa425,0.4,3,10996,10981,cPa174_cPa268-cPa264-hybrid_cPa425,2_1_2,102,15
Scaffold1704-1170_1272,cPa392,0.487179487179487,4,1272,1182,cPa392_cPa402_cPa419_cPa74,19_12_2_6,102,90
Scaffold1704-12378_12510,cPa402,0.363636363636364,8,12497,12410,cPa199-cPa392-hybrid_cPa402_cPa555-cPa74-hybrid_cPa56-cPa392-hybrid_cPa74_cPa75-cPa357-hybrid_cPa75-cPa392-hybrid_cPa75-cPa74-hybrid,1_4_1_1_1_1_1_1,132,87
Scaffold1704-13289_13391,cPa142-cPa392-hybrid_cPa205-cPa357-hybrid_cPa402-cPa74-hybrid_cPa56-cPa74-hybrid,0.25,4,13385,13292,cPa142-cPa392-hybrid_cPa205-cPa357-hybrid_cPa402-cPa74-hybrid_cPa56-cPa74-hybrid,1_1_1_1,102,93
Scaffold1704-13881_13983,cPa75-cPa357-hybrid,0.5,3,13955,13909,cPa402_cPa542_cPa75-cPa357-hybrid,1_1_2,102,46
Scaffold1704-1407_1509,cPa402,0.375,7,1506,1409,cPa15_cPa392_cPa402_cPa419_cPa447-cPa456-hybrid_cPa447-cPa482-hybrid_cPa74,4_17_30_3_1_1_24,102,97
Scaffold1704-2299_2440,cPa392,0.333333333333333,9,2428,2299,cPa339-cPa371-hybrid_cPa339-cPa434-hybrid_cPa371_cPa392_cPa402_cPa419_cPa434_cPa539-unknown_cPa74,2_1_1_17_14_2_2_1_11,141,129
Scaffold1704-2916_3018,cPa74,0.466666666666667,5,3018,2924,cPa357_cPa392_cPa402_cPa419_cPa74,1_3_9_3_14,102,94
Scaffold1704-3400_3513,cPa402_cPa74,0.37037037037037,6,3504,3419,cPa332-cPa357-hybrid_cPa357_cPa392_cPa402_cPa419_cPa74,1_2_3_10_1_10,113,85
Scaffold1704-3536_3638,cPa74,0.423076923076923,4,3628,3540,cPa392_cPa402_cPa419_cPa74,16_26_3_33,102,88
Scaffold1704-3707_3833,cPa402,0.722222222222222,3,3829,3735,cPa392_cPa402_cPa74,1_13_4,126,94
Scaffold1704-3972_4074,cPa402,0.6,5,4062,3979,cPa357_cPa392_cPa402_cPa447-cPa357-hybrid_cPa74,1_1_9_1_3,102,83
Scaffold1704-4089_4191,cPa392_cPa402,0.333333333333333,4,4183,4095,cPa392_cPa402_cPa419_cPa74,3_3_1_2,102,88
Scaffold1704-4203_4308,cPa402,0.533333333333333,4,4300,4206,cPa392_cPa402_cPa419_cPa74,3_16_1_10,105,94
Scaffold1704-4883_4985,cPa392_cPa402,0.4,3,4973,4894,cPa392_cPa402_cPa74,2_2_1,102,79
Scaffold1704-591_749,cPa402,0.380952380952381,3,720,590,cPa392_cPa402_cPa74,6_8_7,158,130
Scaffold1704-6114_6216,cPa254,0.5,3,6164,6157,cPa174_cPa254_cPa425,1_2_1,102,7
Scaffold1704-8628_8730,cPa47-unknown,1,1,8678,8678,cPa47-unknown,1,102,0
Scaffold1704-921_1023,cPa402,0.357142857142857,4,1022,921,cPa392_cPa402_cPa419_cPa74,7_10_2_9,102,101
Scaffold1704-9401_9539,cPa47,0.75,2,9487,9404,cPa404-cPa47-hybrid_cPa47,1_3,138,83
Scaffold1705-10524_10626,cPa138,0.444444444444444,6,10611,10527,cPa130-cPa395-hybrid_cPa138_cPa395_cPa410-cPa395-hybrid_cPa419_cPa419-cPa395-hybrid,1_8_2_2_4_1,102,84
Scaffold1705-14866_14968,cPa425,0.6,2,14965,14881,cPa419_cPa425,2_3,102,84
Scaffold1705-15156_15397,cPa425,0.75,4,15345,15173,cPa16-cPa260-hybrid_cPa419_cPa425_cPa526-cPa425-hybrid,1_1_9_1,241,172
Scaffold1705-15469_15587,cPa425,0.857142857142857,2,15580,15472,cPa419_cPa425,1_6,118,108
Scaffold1705-16576_17198,cPa16-unknown,0.524590163934426,9,17159,16626,cPa16-cPa419-hybrid_cPa16-cPa425-hybrid_cPa16-cPa75-hybrid_cPa16-unknown_cPa419_cPa425_cPa452-cPa419-hybrid_cPa452-cPa425-hybrid_cPa452-unknown,2_8_4_32_1_2_1_2_9,622,533
Scaffold1705-2974_3076,cPa130-cPa121-hybrid_cPa130-cPa42-hybrid_cPa130-cPa500-hybrid_cPa194-cPa413-hybrid_cPa194-HERVHcons-hybrid_cPa413_cPa450-cPa413-hybrid_cPa472-cPa413-hybrid,0.125,8,3063,3019,cPa130-cPa121-hybrid_cPa130-cPa42-hybrid_cPa130-cPa500-hybrid_cPa194-cPa413-hybrid_cPa194-HERVHcons-hybrid_cPa413_cPa450-cPa413-hybrid_cPa472-cPa413-hybrid,1_1_1_1_1_1_1_1,102,44
Scaffold1705-765_867,cPa194-cPa228-hybrid_cPa345-unknown,0.5,2,827,815,cPa194-cPa228-hybrid_cPa345-unknown,1_1,102,12
Scaffold1705-8833_9229,cPa553,0.189189189189189,19,9229,8839,cPa199_cPa273_cPa273-cPa199-hybrid_cPa273-cPa223-hybrid_cPa273-cPa444-hybrid_cPa308-cPa345-hybrid_cPa308-cPa444-hybrid_cPa345_cPa419_cPa450-cPa138-hybrid_cPa450-cPa199-hybrid_cPa450-cPa223-hybrid_cPa450-cPa447-hybrid_cPa542-cPa199-hybrid_cPa553_cPa56-cPa223-hybrid_cPa56-cPa447-hybrid_cPa587-cPa223-hybrid_cPa62-cPa199-hybrid,1_4_2_1_1_1_1_2_4_1_3_3_1_1_7_1_1_1_1,396,390
Scaffold1705-968_1070,cPa268,0.846153846153846,3,1040,994,cPa268_cPa419_cPa450-cPa228-hybrid,11_1_1,102,46
Scaffold1706-2815_2924,cPa357-cPa381-hybrid,0.294871794871795,16,2916,2857,cPa157-cPa419-hybrid_cPa339-cPa268-hybrid_cPa339-cPa308-hybrid_cPa339-cPa381-hybrid_cPa357-cPa268-hybrid_cPa357-cPa308-hybrid_cPa357-cPa381-hybrid_cPa357-cPa486-hybrid_cPa402-cPa308-hybrid_cPa402-cPa381-hybrid_cPa419_cPa419-cPa381-hybrid_cPa475_cPa475-cPa268-hybrid_cPa475-cPa381-hybrid_cPa475-cPa486-hybrid,1_1_2_1_2_21_23_7_1_1_1_1_2_3_7_4,109,59
Scaffold1706-34875_34995,cPa339-unknown,0.333333333333333,8,34991,34917,cPa308-cPa62-hybrid_cPa339-cPa270-hybrid_cPa339-cPa404-hybrid_cPa339-cPa425-hybrid_cPa339-unknown_cPa356-cPa425-hybrid_cPa419_cPa447-cPa47-hybrid,1_2_2_1_5_1_2_1,120,74
Scaffold1706-36080_36718,cPa585,0.258823529411765,96,36709,36079,cPa15-cPa358-hybrid_cPa194_cPa194-unknown_cPa251_cPa251-cPa205-hybrid_cPa251-cPa305-hybrid_cPa251-cPa345-hybrid_cPa251-cPa404-hybrid_cPa251-cPa585-hybrid_cPa270-cPa251-hybrid_cPa285_cPa285-cPa194-hybrid_cPa285-cPa251-hybrid_cPa285-cPa585-hybrid_cPa285-unknown_cPa293-cPa251-hybrid_cPa298_cPa298-cPa194-hybrid_cPa298-cPa305-hybrid_cPa298-cPa308-hybrid_cPa298-cPa424-hybrid_cPa298-cPa486-hybrid_cPa308-cPa251-hybrid_cPa308-cPa585-hybrid_cPa308-unknown_cPa327-cPa194-hybrid_cPa327-cPa251-hybrid_cPa327-cPa585-hybrid_cPa327-cPa62-hybrid_cPa327-unknown_cPa339-cPa251-hybrid_cPa339-cPa585-hybrid_cPa358_cPa358-cPa194-hybrid_cPa358-cPa251-hybrid_cPa358-cPa254-hybrid_cPa358-cPa285-hybrid_cPa358-cPa305-hybrid_cPa358-cPa308-hybrid_cPa358-cPa327-hybrid_cPa358-cPa424-hybrid_cPa358-cPa450-hybrid_cPa358-cPa47-hybrid_cPa358-cPa486-hybrid_cPa358-cPa585-hybrid_cPa358-unknown_cPa419_cPa424-cPa251-hybrid_cPa424-cPa585-hybrid_cPa424-unknown_cPa438-cPa424-hybrid_cPa447-cPa585-hybrid_cPa486-cPa194-hybrid_cPa486-cPa305-hybrid_cPa486-cPa327-hybrid_cPa486-cPa585-hybrid_cPa585_cPa585-cPa251-hybrid_cPa585-cPa308-hybrid_cPa585-cPa358-hybrid_cPa585-cPa62-hybrid_cPa585-unknown_cPa62_cPa67_cPa67-cPa167-hybrid_cPa67-cPa251-hybrid_cPa67-cPa270-hybrid_cPa67-cPa308-hybrid_cPa67-cPa358-hybrid_cPa67-cPa47-hybrid_cPa67-cPa585-hybrid_cPa67-cPa61-hybrid_cPa67-unknown_cPa71_cPa71-cPa15-hybrid_cPa71-cPa167-hybrid_cPa71-cPa174-hybrid_cPa71-cPa194-hybrid_cPa71-cPa251-hybrid_cPa71-cPa254-hybrid_cPa71-cPa270-hybrid_cPa71-cPa305-hybrid_cPa71-cPa308-hybrid_cPa71-cPa327-hybrid_cPa71-cPa358-hybrid_cPa71-cPa424-hybrid_cPa71-cPa585-hybrid_cPa71-cPa62-hybrid_cPa71-unknown_cPa75-cPa251-hybrid_cPa75-cPa305-hybrid_cPa75-cPa358-hybrid_HML1b_repbase_HERV-K14I_LTR14A-cPa251-hybrid_HML1b_repbase_HERV-K14I_LTR14A-cPa358-hybrid_HML1b_repbase_HERV-K14I_LTR14A-cPa585-hybrid_S71_repbase_HERVS71_LTR6A-cPa358-hybrid,1_2_1_40_1_1_1_1_1_1_1_4_10_12_9_2_1_1_8_5_1_1_2_1_2_1_2_1_1_1_1_6_18_2_3_1_1_11_9_4_6_1_1_2_6_2_3_1_2_1_1_1_1_2_2_1_132_3_1_1_1_5_1_15_1_9_1_1_2_1_2_1_29_2_2_1_1_2_12_1_1_8_14_6_2_10_11_2_15_2_1_1_2_1_1_1,638,630
Scaffold1706-36866_36968,cPa251,0.641666666666667,9,36952,36878,cPa251_cPa251-unknown_cPa285-cPa358-hybrid_cPa298_cPa298-cPa194-hybrid_cPa298-cPa251-hybrid_cPa358_cPa358-cPa251-hybrid_cPa358-unknown,77_1_1_5_1_1_28_3_3,102,74
Scaffold1706-39685_39922,cPa199,0.763157894736842,2,39903,39710,cPa199_cPa447,29_9,237,193
Scaffold1706-39946_40080,cPa199,0.4,7,40039,39945,cPa199_cPa419_cPa434-cPa15-hybrid_cPa434-cPa199-hybrid_cPa434-unknown_cPa447_cPa545-unknown,14_1_1_7_10_1_1,134,94
Scaffold1706-41514_41628,cPa118,0.4,4,41578,41564,cPa118_cPa118-cPa125-hybrid_cPa15_cPa15-cPa199-hybrid,2_1_1_1,114,14
Scaffold1706-62874_62976,cPa273,0.666666666666667,2,62924,62911,cPa273_cPa273-unknown,2_1,102,13
Scaffold1706-8149_8311,cPa419_cPa456,0.307692307692308,5,8288,8199,cPa106_cPa332_cPa419_cPa456_cPa62,1_3_4_4_1,162,89
Scaffold1707-20207_20309,cPa356,1,1,20270,20257,cPa356,4,102,13
Scaffold1707-21606_21758,cPa425,1,1,21711,21646,cPa425,15,152,65
Scaffold1707-21774_21882,cPa425,1,1,21830,21807,cPa425,3,108,23
Scaffold1708-15351_15658,cPa478-cPa75-hybrid,0.607142857142857,8,15631,15400,cPa419_cPa419-cPa339-hybrid_cPa478-cPa205-hybrid_cPa478-cPa224-hybrid_cPa478-cPa555-hybrid_cPa478-cPa75-hybrid_cPa478-HML8_repbase_HERVK11I_MER11A-hybrid_cPa478-unknown,2_1_1_3_2_17_1_1,307,231
Scaffold1708-35847_35981,cPa456-cPa339-hybrid,0.571428571428571,3,35956,35897,cPa452-unknown_cPa456-cPa339-hybrid_cPa456-unknown,1_4_2,134,59
Scaffold1708-36041_36143,cPa339,1,1,36096,36091,cPa339,2,102,5
Scaffold1709-25708_25810,HFV_NC001736-cPa363-hybrid,1,1,25758,25758,HFV_NC001736-cPa363-hybrid,1,102,0
Scaffold1709-25976_26078,cPa452,0.5,3,26039,26012,cPa452_cPa587-cPa363-hybrid_HFV_NC001736-cPa452-hybrid,2_1_1,102,27
Scaffold1709-26202_26304,cPa452-cPa363-hybrid_cPa456_cPa587,0.333333333333333,3,26252,26208,cPa452-cPa363-hybrid_cPa456_cPa587,1_1_1,102,44
Scaffold1709-26677_26779,cPa452-cPa47-hybrid,1,1,26727,26727,cPa452-cPa47-hybrid,1,102,0
Scaffold1709-28518_28978,cPa174,0.339901477832512,17,28977,28536,cPa174_cPa174-cPa425-hybrid_cPa254_cPa254-cPa174-hybrid_cPa254-cPa404-hybrid_cPa254-cPa425-hybrid_cPa254-cPa47-hybrid_cPa404_cPa404-unknown_cPa419-cPa47-hybrid_cPa425_cPa425-cPa174-hybrid_cPa425-cPa254-hybrid_cPa47_cPa47-cPa254-hybrid_cPa47-cPa404-hybrid_cPa47-cPa425-hybrid,69_1_16_1_1_1_1_40_1_1_52_3_1_12_1_1_1,460,441
Scaffold171-10376_10478,cPa67,1,1,10474,10382,cPa67,29,102,92
Scaffold171-11333_11536,cPa67,1,1,11534,11383,cPa67,17,203,151
Scaffold171-12018_12120,cPa419_cPa67,0.5,2,12068,12046,cPa419_cPa67,1_1,102,22
Scaffold171-12374_12476,cPa339,0.6,3,12466,12424,cPa323-cPa75-hybrid_cPa339_cPa419,1_3_1,102,42
Scaffold171-13577_14087,cPa502,0.541666666666667,15,14082,13583,cPa323-unknown_cPa339_cPa339-cPa452-hybrid_cPa339-cPa555-hybrid_cPa339-cPa67-hybrid_cPa339-unknown_cPa419_cPa502_cPa511-cPa419-hybrid_cPa511-cPa452-hybrid_cPa511-cPa67-hybrid_cPa511-cPa71-hybrid_cPa511-cPa75-hybrid_cPa511-unknown_cPa62-cPa363-hybrid,1_84_2_1_2_4_5_143_2_4_1_1_2_11_1,510,499
Scaffold171-16668_16770,cPa502,1,1,16748,16707,cPa502,4,102,41
Scaffold171-1713_1815,cPa119-cPa486-hybrid_cPa254-cPa387-hybrid,0.5,2,1794,1763,cPa119-cPa486-hybrid_cPa254-cPa387-hybrid,1_1,102,31
Scaffold171-22603_22705,cPa353,0.666666666666667,2,22696,22653,cPa339_cPa353,2_4,102,43
Scaffold171-24508_24610,cPa339,1,1,24594,24512,cPa339,3,102,82
Scaffold171-32129_32234,cPa224,0.485981308411215,9,32182,32139,cPa224_cPa224-HERV30_repbase_HERV30I_LTR30-hybrid_cPa224-unknown_cPa360_cPa360-HERV30_repbase_HERV30I_LTR30-hybrid_cPa360-unknown_cPa419_FrMuLV_NC001362-HERV30_repbase_HERV30I_LTR30-hybrid_HERV-ADP_repbase_HERVP71A_I_LTR71A-HERV30_repbase_HERV30I_LTR30-hybrid,52_1_1_36_3_6_6_1_1,105,43
Scaffold171-32331_32448,cPa391,0.282051282051282,14,32448,32372,cPa15-cPa224-hybrid_cPa224_cPa248-cPa360-hybrid_cPa360_cPa391_cPa391-cPa224-hybrid_cPa391-cPa360-hybrid_cPa391-HERV-ADP_repbase_HERVP71A_I_LTR71A-hybrid_cPa391-unknown_cPa392-cPa224-hybrid_cPa419_cPa419-cPa224-hybrid_cPa419-cPa360-hybrid_HERV-Fb_repbase_HERVH48I_MER48-cPa224-hybrid,1_9_1_7_11_1_1_1_1_1_2_1_1_1,117,76
Scaffold171-44434_44536,cPa419,1,1,44484,44484,cPa419,1,102,0
Scaffold171-50362_50565,cPa452,0.4,8,50513,50387,cPa363_cPa363-cPa113-hybrid_cPa363-cPa224-hybrid_cPa363-cPa456-hybrid_cPa363-cPa587-hybrid_cPa363-unknown_cPa452_cPa456,2_1_1_3_3_1_8_1,203,126
Scaffold171-59294_59396,cPa298,1,1,59359,59299,cPa298,11,102,60
Scaffold171-59444_59549,cPa298,0.909090909090909,2,59497,59466,cPa298_cPa298-cPa391-hybrid,10_1,105,31
Scaffold171-80051_80181,cPa67,1,1,80178,80052,cPa67,24,130,126
Scaffold171-80261_80363,cPa67,1,1,80311,80311,cPa67,1,102,0
Scaffold171-80839_80941,cPa67,1,1,80889,80841,cPa67,2,102,48
Scaffold171-80966_81068,cPa67,1,1,81040,81016,cPa67,4,102,24
Scaffold171-9111_9213,cPa67,1,1,9188,9161,cPa67,3,102,27
Scaffold171-9247_9759,cPa67,1,1,9741,9271,cPa67,111,512,470
Scaffold171-9830_9932,cPa67,1,1,9890,9880,cPa67,4,102,10
Scaffold171-9976_10165,cPa67,1,1,10151,10026,cPa67,10,189,125
Scaffold1710-16993_17095,cPa15-EqFV_NC002201-hybrid,1,1,17043,17043,cPa15-EqFV_NC002201-hybrid,1,102,0
Scaffold1710-22874_22976,cPa173,1,1,22924,22907,cPa173,2,102,17
Scaffold1710-30064_30191,cPa413,0.2421875,19,30141,30114,cPa121_cPa121-cPa14-hybrid_cPa121-cPa247-hybrid_cPa121-cPa413-hybrid_cPa121-HML8_repbase_HERVK11I_MER11A-hybrid_cPa121-SMRV_NC001514-hybrid_cPa121-unknown_cPa14_cPa413_cPa425_HML8_repbase_HERVK11I_MER11A_SMRV_NC001514_SMRV_NC001514-cPa14-hybrid_SMRV_NC001514-cPa413-hybrid_STLV2_NC001815_STLV2_NC001815-cPa14-hybrid_STLV2_NC001815-cPa247-hybrid_STLV2_NC001815-cPa413-hybrid_STLV2_NC001815-unknown,1_9_6_16_2_1_14_8_31_1_9_8_2_1_6_1_1_5_6,127,27
Scaffold1710-30270_30372,cPa121-cPa208-hybrid,1,1,30320,30320,cPa121-cPa208-hybrid,1,102,0
Scaffold1710-44125_44468,cPa285-unknown,0.583333333333333,3,44416,44175,cPa285-cPa479-hybrid_cPa285-unknown_cPa419,4_7_1,343,241
Scaffold1710-455_780,cPa353_cPa75,0.26530612244898,14,728,481,cPa224-cPa542-hybrid_cPa353_cPa353-cPa356-hybrid_cPa353-cPa387-hybrid_cPa353-cPa542-hybrid_cPa353-cPa75-hybrid_cPa353-unknown_cPa387_cPa478-cPa387-hybrid_cPa478-cPa434-hybrid_cPa478-cPa542-hybrid_cPa478-cPa75-hybrid_cPa555_cPa75,1_13_1_1_1_8_3_2_1_1_1_2_1_13,325,247
Scaffold1710-783_920,cPa478-cPa75-hybrid,0.473684210526316,6,886,829,cPa353-cPa542-hybrid_cPa478-cPa419-hybrid_cPa478-cPa434-hybrid_cPa478-cPa75-hybrid_cPa542_cPa75,1_1_2_9_1_5,137,57
Scaffold1710-7902_8004,cPa47,1,1,7952,7952,cPa47,1,102,0
Scaffold1710-8132_8341,cPa47,0.5,3,8289,8147,cPa392-unknown_cPa47_cPa47-unknown,1_2_1,209,142
Scaffold1710-8700_8873,cPa47,0.347826086956522,8,8865,8743,cPa174_cPa174-cPa425-hybrid_cPa174-unknown_cPa254_cPa392-cPa404-hybrid_cPa404_cPa425_cPa47,18_1_6_1_1_9_24_32,173,122
Scaffold1711-17213_17315,cPa75,1,1,17263,17214,cPa75,2,102,49
Scaffold1711-27515_27690,cPa357,0.666666666666667,2,27638,27565,cPa357_cPa357-unknown,2_1,175,73
Scaffold1711-27705_27807,cPa357,1,1,27755,27755,cPa357,1,102,0
Scaffold1711-33091_33193,cPa360,1,1,33141,33141,cPa360,1,102,0
Scaffold1711-33387_33489,cPa360,1,1,33437,33437,cPa360,1,102,0
Scaffold1711-33703_33805,cPa360,1,1,33753,33753,cPa360,1,102,0
Scaffold1711-34354_34456,cPa360,1,1,34404,34367,cPa360,3,102,37
Scaffold1711-34717_34869,cPa360,0.888888888888889,2,34817,34727,cPa121-cPa360-hybrid_cPa360,1_8,152,90
Scaffold1711-35743_35845,cPa456,1,1,35793,35793,cPa456,1,102,0
Scaffold1711-35878_36062,cPa224-cPa285-hybrid_cPa456,0.333333333333333,4,36055,35928,cPa224-cPa285-hybrid_cPa356-unknown_cPa456_cPa540,2_1_2_1,184,127
Scaffold1711-36418_36520,cPa540-cPa356-hybrid,1,1,36468,36468,cPa540-cPa356-hybrid,1,102,0
Scaffold1711-36847_37119,cPa224-unknown,0.454545454545455,6,37116,36847,cPa224_cPa224-cPa356-hybrid_cPa224-cPa95-hybrid_cPa224-unknown_cPa395-unknown_cPa531,1_1_2_5_1_1,272,269
Scaffold1711-66745_66952,cPa75,1,1,66900,66795,cPa75,3,207,105
Scaffold1711-8512_8614,cPa62,1,1,8562,8562,cPa62,1,102,0
Scaffold1712-112014_112116,cPa75,1,1,112064,112064,cPa75,1,102,0
Scaffold1712-112896_112998,cPa75,1,1,112946,112946,cPa75,1,102,0
Scaffold1712-116208_116441,cPa75,1,1,116389,116258,cPa75,4,233,131
Scaffold1712-12637_12739,cPa256,1,1,12687,12687,cPa256,1,102,0
Scaffold1712-166840_166942,cPa75-cPa293-hybrid,1,1,166890,166890,cPa75-cPa293-hybrid,1,102,0
Scaffold1712-175426_175528,cPa75,1,1,175476,175476,cPa75,1,102,0
Scaffold1712-189734_189836,cPa381,1,1,189784,189784,cPa381,1,102,0
Scaffold1712-195789_195921,cPa75,0.666666666666667,2,195869,195839,cPa75_cPa75-unknown,2_1,132,30
Scaffold1712-196042_196340,cPa75,0.461538461538462,4,196288,196092,cPa75_cPa75-cPa223-hybrid_cPa75-cPa224-hybrid_cPa75-unknown,6_1_1_5,298,196
Scaffold1712-210108_210214,cPa62,1,1,210162,210158,cPa62,2,106,4
Scaffold1712-213694_213796,cPa285,1,1,213744,213744,cPa285,1,102,0
Scaffold1712-219661_219772,cPa75,1,1,219720,219711,cPa75,2,111,9
Scaffold1712-219847_219949,cPa75,1,1,219897,219897,cPa75,1,102,0
Scaffold1712-220076_220711,cPa75,0.935483870967742,3,220659,220126,cPa410_cPa410-cPa75-hybrid_cPa75,1_1_29,635,533
Scaffold1712-220786_220893,cPa410_cPa75_cPa75-cPa398-hybrid,0.333333333333333,3,220841,220836,cPa410_cPa75_cPa75-cPa398-hybrid,1_1_1,107,5
Scaffold1712-221062_221164,cPa75,1,1,221112,221112,cPa75,1,102,0
Scaffold1712-224277_224379,cPa419,1,1,224327,224327,cPa419,1,102,0
Scaffold1712-251005_251121,cPa75,1,1,251069,251034,cPa75,11,116,35
Scaffold1712-251160_251311,cPa75,1,1,251259,251210,cPa75,3,151,49
Scaffold1712-251328_251430,cPa75,1,1,251378,251378,cPa75,1,102,0
Scaffold1712-251495_251689,cPa75,1,1,251637,251545,cPa75,8,194,92
Scaffold1712-251755_251857,cPa75,1,1,251824,251805,cPa75,3,102,19
Scaffold1712-251869_251971,cPa75,1,1,251919,251919,cPa75,1,102,0
Scaffold1712-252183_252303,cPa75,1,1,252251,252233,cPa75,2,120,18
Scaffold1712-252382_252720,cPa75,1,1,252668,252432,cPa75,10,338,236
Scaffold1712-262942_263044,cPa75,1,1,262992,262992,cPa75,2,102,0
Scaffold1712-263071_263331,cPa75,1,1,263279,263121,cPa75,16,260,158
Scaffold1712-263499_263835,cPa75,1,1,263783,263549,cPa75,15,336,234
Scaffold1712-263866_264066,cPa75,1,1,264014,263916,cPa75,3,200,98
Scaffold1712-264106_264347,cPa75,1,1,264295,264156,cPa75,22,241,139
Scaffold1712-264575_264677,cPa75,1,1,264625,264625,cPa75,1,102,0
Scaffold1712-271999_272101,cPa75-cPa449-hybrid,1,1,272049,272049,cPa75-cPa449-hybrid,1,102,0
Scaffold1712-274525_274627,cPa356-cPa163-hybrid_cPa356-cPa200-hybrid_cPa356-cPa583-hybrid_cPa356-unknown_cPa428-cPa200-hybrid,0.2,5,274599,274575,cPa356-cPa163-hybrid_cPa356-cPa200-hybrid_cPa356-cPa583-hybrid_cPa356-unknown_cPa428-cPa200-hybrid,1_1_1_1_1,102,24
Scaffold1712-39543_39704,cPa142-cPa208-hybrid_cPa75-cPa208-hybrid,0.5,2,39652,39593,cPa142-cPa208-hybrid_cPa75-cPa208-hybrid,1_1,161,59
Scaffold1712-53922_54024,cPa510-cPa371-hybrid,1,1,53972,53972,cPa510-cPa371-hybrid,1,102,0
Scaffold1712-59073_59175,WDSV_NC001867,1,1,59123,59123,WDSV_NC001867,1,102,0
Scaffold1712-59209_59311,WDSV_NC001867,1,1,59259,59259,WDSV_NC001867,1,102,0
Scaffold1712-63646_64124,cPa62-cPa75-hybrid,0.857142857142857,2,64072,63696,cPa62-cPa75-hybrid_WDSV_NC001867-cPa75-hybrid,6_1,478,376
Scaffold1712-64221_64323,cPa75,1,1,64271,64271,cPa75,1,102,0
Scaffold1712-64396_64522,cPa62-cPa75-hybrid,1,1,64470,64446,cPa62-cPa75-hybrid,2,126,24
Scaffold1712-64538_64640,cPa62-cPa75-hybrid,1,1,64588,64588,cPa62-cPa75-hybrid,1,102,0
Scaffold1712-64657_64925,cPa62-cPa75-hybrid,0.833333333333333,2,64873,64707,cPa62-cPa75-hybrid_cPa75,5_1,268,166
Scaffold1712-66968_67070,cPa75,1,1,67018,67018,cPa75,1,102,0
Scaffold1712-67354_67456,cPa75,1,1,67404,67404,cPa75,1,102,0
Scaffold1712-67504_67606,cPa75,1,1,67554,67554,cPa75,1,102,0
Scaffold1712-74646_74748,cPa75,1,1,74696,74696,cPa75,1,102,0
Scaffold1712-74995_75097,cPa75,1,1,75045,75045,cPa75,1,102,0
Scaffold1712-77133_77235,cPa199,1,1,77183,77183,cPa199,1,102,0
Scaffold1712-77270_77372,cPa201,1,1,77320,77320,cPa201,1,102,0
Scaffold1713-12012_12114,cPa75,1,1,12062,12062,cPa75,1,102,0
Scaffold1713-12358_12460,cPa75,1,1,12408,12408,cPa75,1,102,0
Scaffold1716-31010_31112,cPa75-cPa62-hybrid,1,1,31060,31060,cPa75-cPa62-hybrid,1,102,0
Scaffold1716-38975_39192,cPa75,1,1,39140,39025,cPa75,3,217,115
Scaffold1717-13312_13414,cPa62,1,1,13362,13362,cPa62,1,102,0
Scaffold1717-43654_43756,cPa75,1,1,43704,43674,cPa75,2,102,30
Scaffold1717-4914_5016,cPa75,1,1,4964,4964,cPa75,1,102,0
Scaffold1717-5156_5258,cPa75,1,1,5206,5206,cPa75,1,102,0
Scaffold1717-5444_5603,cPa75,1,1,5551,5494,cPa75,2,159,57
Scaffold1717-5635_5737,cPa75,1,1,5685,5685,cPa75,1,102,0
Scaffold1719-118240_118342,cPa419,1,1,118290,118290,cPa419,1,102,0
Scaffold1719-19719_19821,cPa119_cPa119-HML3_repbase_HERVK9I_MER9-hybrid,0.5,2,19793,19769,cPa119_cPa119-HML3_repbase_HERVK9I_MER9-hybrid,1_1,102,24
Scaffold1719-20747_20935,HML3_repbase_HERVK9I_MER9,1,1,20883,20751,HML3_repbase_HERVK9I_MER9,3,188,132
Scaffold1719-68561_68663,cPa118-cPa254-hybrid,1,1,68611,68611,cPa118-cPa254-hybrid,1,102,0
Scaffold1719-84671_84773,cPa111,1,1,84721,84721,cPa111,1,102,0
Scaffold1719-86556_86658,cPa75,1,1,86606,86606,cPa75,2,102,0
Scaffold1719-95961_96113,cPa285,0.8,2,96108,95993,cPa285_cPa75,4_1,152,115
Scaffold172-16156_16258,cPa472-unknown,1,1,16256,16206,cPa472-unknown,3,102,50
Scaffold172-16693_16795,cPa583-unknown,0.625,4,16788,16743,cPa224_cPa224-HERV30_repbase_HERV30I_LTR30-hybrid_cPa486-unknown_cPa583-unknown,1_1_1_5,102,45
Scaffold172-17287_17389,cPa583-unknown,0.333333333333333,5,17362,17295,cPa224_cPa224-cPa285-hybrid_cPa413_cPa486-cPa285-hybrid_cPa583-unknown,3_1_3_1_4,102,67
Scaffold172-18113_18215,cPa413,1,1,18163,18156,cPa413,2,102,7
Scaffold172-18633_18797,cPa413,0.666666666666667,2,18745,18683,cPa413_cPa419,2_1,164,62
Scaffold172-19165_19267,cPa413,0.75,2,19263,19203,cPa413_cPa413-HERV30_repbase_HERV30I_LTR30-hybrid,3_1,102,60
Scaffold172-29088_29190,cPa256-unknown,1,1,29169,29138,cPa256-unknown,3,102,31
Scaffold172-49651_49753,WDSV_NC001867,1,1,49752,49677,WDSV_NC001867,10,102,75
Scaffold172-50772_50874,WDSV_NC001867,1,1,50834,50822,WDSV_NC001867,2,102,12
Scaffold172-53921_54221,cPa199,0.894736842105263,3,54169,53940,cPa199_cPa199-unknown_cPa273-unknown,17_1_1,300,229
Scaffold172-54304_54413,cPa199,0.8,2,54389,54354,cPa199_cPa199-cPa381-hybrid,4_1,109,35
Scaffold172-5575_6471,WDSV_NC001867,0.48936170212766,7,6468,5619,cPa254-WDSV_NC001867-hybrid_cPa62_cPa62-cPa254-hybrid_cPa62-unknown_cPa62-WDSV_NC001867-hybrid_cPa75_WDSV_NC001867,1_18_1_37_13_2_69,896,849
Scaffold172-77462_77564,cPa71-cPa62-hybrid_cPa75_WDSV_NC001867,0.333333333333333,3,77552,77498,cPa71-cPa62-hybrid_cPa75_WDSV_NC001867,1_1_1,102,54
Scaffold172-79875_79977,WDSV_NC001867,1,1,79925,79925,WDSV_NC001867,1,102,0
Scaffold172-80121_80223,WDSV_NC001867,1,1,80171,80171,WDSV_NC001867,1,102,0
Scaffold1720-29700_29802,cPa75,1,1,29750,29750,cPa75,1,102,0
Scaffold1720-30433_30631,cPa75,1,1,30579,30483,cPa75,2,198,96
Scaffold1720-80114_80216,cPa456-cPa47-hybrid,1,1,80164,80164,cPa456-cPa47-hybrid,1,102,0
Scaffold1720-95407_95509,cPa379-unknown,1,1,95457,95457,cPa379-unknown,2,102,0
Scaffold1721-26982_27084,cPa540,1,1,27032,27032,cPa540,1,102,0
Scaffold1725-133480_133646,cPa75-HFV_NC001736-hybrid,0.666666666666667,2,133594,133530,cPa273_cPa75-HFV_NC001736-hybrid,1_2,166,64
Scaffold1725-134103_134205,cPa273,1,1,134153,134153,cPa273,1,102,0
Scaffold1725-169615_169717,cPa193-cPa51-hybrid_cPa232,0.5,2,169675,169665,cPa193-cPa51-hybrid_cPa232,1_1,102,10
Scaffold1725-183370_183472,cPa62,1,1,183420,183420,cPa62,1,102,0
Scaffold1725-201210_201385,cPa75,1,1,201333,201260,cPa75,3,175,73
Scaffold1725-201393_201556,cPa75,0.75,2,201504,201443,cPa75_cPa75-unknown,3_1,163,61
Scaffold1725-201586_201688,cPa293-cPa75-hybrid,1,1,201636,201636,cPa293-cPa75-hybrid,1,102,0
Scaffold1725-201790_201892,cPa75,1,1,201840,201840,cPa75,1,102,0
Scaffold1725-204196_204298,cPa75,1,1,204246,204246,cPa75,1,102,0
Scaffold1725-216131_216233,cPa75,1,1,216210,216181,cPa75,2,102,29
Scaffold1725-216527_216674,cPa75,1,1,216622,216577,cPa75,2,147,45
Scaffold1725-223585_223687,cPa285,1,1,223676,223635,cPa285,2,102,41
Scaffold1725-239152_239438,cPa75,0.888888888888889,2,239386,239202,cPa163_cPa75,1_8,286,184
Scaffold1725-239452_239554,cPa75,1,1,239542,239502,cPa75,2,102,40
Scaffold1725-239556_239658,cPa75,1,1,239619,239606,cPa75,3,102,13
Scaffold1725-256573_256675,cPa62-cPa75-hybrid,1,1,256623,256623,cPa62-cPa75-hybrid,1,102,0
Scaffold1725-257098_257204,cPa62-cPa75-hybrid,1,1,257152,257148,cPa62-cPa75-hybrid,2,106,4
Scaffold1725-257609_257802,cPa75,1,1,257750,257659,cPa75,3,193,91
Scaffold1725-257898_258000,cPa75,1,1,257948,257948,cPa75,1,102,0
Scaffold1725-268319_268421,cPa285_cPa62,0.5,2,268417,268369,cPa285_cPa62,2_2,102,48
Scaffold1725-268570_268672,cPa62,1,1,268634,268620,cPa62,2,102,14
Scaffold1725-269451_269558,cPa285,0.454545454545455,3,269522,269469,cPa285_cPa293_cPa62,5_2_4,107,53
Scaffold1725-270268_270384,cPa285,0.555555555555556,3,270332,270318,cPa285_cPa293-cPa285-hybrid_cPa62,5_1_3,116,14
Scaffold1725-323956_324058,cPa425_cPa446_cPa446-MLV_Pmv4-hybrid,0.333333333333333,3,324008,323972,cPa425_cPa446_cPa446-MLV_Pmv4-hybrid,1_1_1,102,36
Scaffold1725-381282_381384,cPa75,1,1,381377,381303,cPa75,5,102,74
Scaffold1725-381465_381567,cPa75,1,1,381553,381501,cPa75,4,102,52
Scaffold1725-381792_381894,cPa75,1,1,381842,381842,cPa75,1,102,0
Scaffold1725-381900_382248,cPa75,1,1,382196,381950,cPa75,30,348,246
Scaffold1725-382258_382815,cPa75,1,1,382763,382308,cPa75,37,557,455
Scaffold1725-382854_382956,cPa75,1,1,382908,382904,cPa75,2,102,4
Scaffold1725-386079_386189,cPa75,1,1,386137,386129,cPa75,2,110,8
Scaffold1725-386207_387023,cPa75,1,1,386971,386257,cPa75,18,816,714
Scaffold1725-392843_392986,cPa75,1,1,392934,392893,cPa75,2,143,41
Scaffold1725-393091_393193,cPa75,1,1,393141,393141,cPa75,1,102,0
Scaffold1725-399054_399252,cPa75,1,1,399200,399104,cPa75,3,198,96
Scaffold1725-401349_401451,cPa75,1,1,401399,401399,cPa75,1,102,0
Scaffold1725-401804_401906,cPa75,1,1,401854,401854,cPa75,1,102,0
Scaffold1725-409819_410067,cPa75,1,1,410054,409869,cPa75,6,248,185
Scaffold1725-410138_410371,cPa75,1,1,410327,410179,cPa75,10,233,148
Scaffold1725-411537_412142,cPa75,1,1,412090,411587,cPa75,17,605,503
Scaffold1725-417003_417274,cPa75,1,1,417222,417053,cPa75,5,271,169
Scaffold1725-417280_417382,cPa75,1,1,417330,417330,cPa75,1,102,0
Scaffold1725-417491_417596,cPa75,1,1,417544,417541,cPa75,2,105,3
Scaffold1725-418039_418141,cPa75,1,1,418089,418089,cPa75,1,102,0
Scaffold1725-419561_419663,cPa62,1,1,419659,419611,cPa62,2,102,48
Scaffold1725-419784_419887,cPa62,1,1,419835,419834,cPa62,2,103,1
Scaffold1725-424818_425006,cPa75,1,1,425004,424868,cPa75,5,188,136
Scaffold1725-425189_425291,cPa75,1,1,425239,425239,cPa75,1,102,0
Scaffold1725-425308_425410,cPa75,1,1,425358,425358,cPa75,1,102,0
Scaffold1725-439192_439302,cPa75,1,1,439250,439242,cPa75,2,110,8
Scaffold1725-439569_439754,cPa75,1,1,439702,439619,cPa75,2,185,83
Scaffold1725-44024_44126,cPa75,1,1,44074,44074,cPa75,1,102,0
Scaffold1725-44518_44620,cPa75,1,1,44568,44568,cPa75,1,102,0
Scaffold1725-44793_45326,cPa75,0.769230769230769,2,45274,44843,cPa75_cPa75-cPa62-hybrid,10_3,533,431
Scaffold1725-451159_451261,cPa75,1,1,451209,451164,cPa75,4,102,45
Scaffold1725-451684_451832,cPa75,1,1,451780,451715,cPa75,6,148,65
Scaffold1725-451856_451958,cPa75,1,1,451906,451906,cPa75,1,102,0
Scaffold1725-452005_452279,cPa75,1,1,452237,452055,cPa75,16,274,182
Scaffold1725-453516_453618,cPa75,1,1,453566,453566,cPa75,1,102,0
Scaffold1725-468040_468299,cPa75,1,1,468247,468090,cPa75,3,259,157
Scaffold1725-470355_470457,cPa75,1,1,470405,470388,cPa75,4,102,17
Scaffold1725-470579_470904,cPa75,1,1,470852,470629,cPa75,9,325,223
Scaffold1725-470928_471078,cPa75,1,1,471026,470978,cPa75,2,150,48
Scaffold1725-471107_471209,cPa75,1,1,471157,471153,cPa75,2,102,4
Scaffold1725-471347_471486,cPa75,1,1,471436,471397,cPa75,4,139,39
Scaffold1725-472813_472915,cPa285,1,1,472863,472863,cPa285,1,102,0
Scaffold1725-475910_476181,cPa75,1,1,476129,475960,cPa75,4,271,169
Scaffold1725-476557_476822,cPa75,1,1,476820,476607,cPa75,10,265,213
Scaffold1725-482281_482383,cPa75,1,1,482359,482328,cPa75,3,102,31
Scaffold1725-482962_483064,cPa75,1,1,483012,483012,cPa75,1,102,0
Scaffold1725-489686_489788,cPa75,1,1,489767,489728,cPa75,4,102,39
Scaffold1725-489808_489966,cPa75,1,1,489958,489858,cPa75,4,158,100
Scaffold1725-489982_490142,cPa75,1,1,490090,490032,cPa75,7,160,58
Scaffold1725-490218_490331,cPa75,1,1,490320,490268,cPa75,8,113,52
Scaffold1725-490452_490560,cPa75,1,1,490545,490465,cPa75,4,108,80
Scaffold1725-490581_490683,cPa75,1,1,490656,490582,cPa75,3,102,74
Scaffold1725-491817_491919,cPa75,1,1,491899,491823,cPa75,6,102,76
Scaffold1725-492183_492313,cPa75,1,1,492261,492233,cPa75,3,130,28
Scaffold1725-492645_492747,cPa75,1,1,492695,492695,cPa75,1,102,0
Scaffold1725-492772_493402,cPa75,1,1,493381,492780,cPa75,43,630,601
Scaffold1725-493937_494039,cPa75,1,1,493998,493987,cPa75,2,102,11
Scaffold1725-49419_49521,cPa75,1,1,49469,49469,cPa75,1,102,0
Scaffold1725-494647_494773,cPa75,1,1,494727,494690,cPa75,9,126,37
Scaffold1725-494951_495099,cPa75,1,1,495089,494975,cPa75,16,148,114
Scaffold1725-495215_495317,cPa75,1,1,495293,495243,cPa75,3,102,50
Scaffold1725-495431_495565,cPa75,1,1,495513,495481,cPa75,3,134,32
Scaffold1725-495635_495737,cPa75,1,1,495685,495685,cPa75,1,102,0
Scaffold1725-509453_509555,cPa75,1,1,509503,509503,cPa75,1,102,0
Scaffold1725-521223_521370,cPa75,1,1,521318,521227,cPa75,4,147,91
Scaffold1725-528407_528509,cPa75,1,1,528457,528408,cPa75,3,102,49
Scaffold1725-544388_544523,cPa425,1,1,544471,544438,cPa425,2,135,33
Scaffold1725-550162_550264,cPa75,1,1,550212,550212,cPa75,1,102,0
Scaffold1725-550826_550928,cPa75,1,1,550876,550876,cPa75,1,102,0
Scaffold1725-554163_554717,cPa75,1,1,554665,554213,cPa75,15,554,452
Scaffold1725-554763_554963,cPa75,1,1,554911,554813,cPa75,4,200,98
Scaffold1725-555977_556079,cPa62,1,1,556027,556027,cPa62,1,102,0
Scaffold1725-570514_570616,cPa62,1,1,570564,570515,cPa62,2,102,49
Scaffold1725-570929_571031,cPa62,1,1,570979,570979,cPa62,1,102,0
Scaffold1725-571217_571319,cPa62,1,1,571267,571267,cPa62,1,102,0
Scaffold1725-571416_571518,cPa62-cPa285-hybrid_cPa62-cPa75-hybrid,0.5,2,571473,571466,cPa62-cPa285-hybrid_cPa62-cPa75-hybrid,1_1,102,7
Scaffold1725-571545_571779,cPa62,0.857142857142857,2,571727,571595,cPa62_cPa62-cPa75-hybrid,6_1,234,132
Scaffold1725-572040_572236,cPa62,0.833333333333333,2,572186,572090,cPa293-cPa62-hybrid_cPa62,1_5,196,96
Scaffold1725-572324_572956,cPa75,0.541666666666667,8,572947,572343,cPa224_cPa285_cPa285-cPa62-hybrid_cPa285-cPa75-hybrid_cPa381-cPa62-hybrid_cPa62_cPa75_cPa75-cPa62-hybrid,2_9_3_1_1_3_26_3,632,604
Scaffold1725-57849_57951,cPa75,1,1,57899,57899,cPa75,1,102,0
Scaffold1725-582884_582988,cPa62,1,1,582936,582934,cPa62,5,104,2
Scaffold1725-583097_583228,cPa62,1,1,583176,583147,cPa62,2,131,29
Scaffold1725-583323_583435,cPa62,1,1,583383,583369,cPa62,4,112,14
Scaffold1725-613169_613271,cPa293-cPa75-hybrid,1,1,613219,613219,cPa293-cPa75-hybrid,1,102,0
Scaffold1725-613695_613797,cPa285-cPa75-hybrid,1,1,613745,613745,cPa285-cPa75-hybrid,1,102,0
Scaffold1725-623675_623777,cPa75,1,1,623725,623725,cPa75,1,102,0
Scaffold1725-69459_69561,cPa75,1,1,69526,69509,cPa75,2,102,17
Scaffold1725-69715_69879,cPa75,1,1,69827,69732,cPa75,4,164,95
Scaffold1725-70174_70370,cPa75,1,1,70318,70224,cPa75,2,196,94
Scaffold1725-72821_72923,cPa75,1,1,72871,72871,cPa75,1,102,0
Scaffold1725-73111_73213,cPa75,1,1,73161,73161,cPa75,1,102,0
Scaffold1726-14327_14486,cPa75,1,1,14434,14360,cPa75,4,159,74
Scaffold1726-14493_14646,cPa75,1,1,14594,14543,cPa75,8,153,51
Scaffold1726-1610_1712,cPa75,1,1,1660,1660,cPa75,1,102,0
Scaffold1726-1721_1823,cPa75,1,1,1771,1771,cPa75,1,102,0
Scaffold1726-18665_18833,cPa75,1,1,18781,18682,cPa75,13,168,99
Scaffold1726-1872_1974,cPa75,1,1,1922,1922,cPa75,1,102,0
Scaffold1726-18906_19241,cPa75,1,1,19220,18941,cPa75,33,335,279
Scaffold1726-19452_19554,cPa75,1,1,19554,19502,cPa75,12,102,52
Scaffold1726-23453_23579,cPa75,1,1,23527,23503,cPa75,2,126,24
Scaffold1726-25889_25991,cPa118_cPa15,0.5,2,25939,25939,cPa118_cPa15,1_1,102,0
Scaffold1728-107834_107936,cPa75,1,1,107884,107884,cPa75,1,102,0
Scaffold1728-107997_108099,cPa75,1,1,108047,108047,cPa75,1,102,0
Scaffold1728-115952_116142,cPa75_cPa75-unknown,0.5,2,116090,116002,cPa75_cPa75-unknown,1_1,190,88
Scaffold1728-123063_123194,cPa425,0.75,2,123142,123113,cPa425_cPa447,3_1,131,29
Scaffold1728-127564_127666,cPa425,1,1,127614,127614,cPa425,1,102,0
Scaffold1728-128609_128711,cPa75,1,1,128659,128659,cPa75,1,102,0
Scaffold1728-135575_135677,cPa75,1,1,135625,135625,cPa75,1,102,0
Scaffold1728-135893_135995,cPa75,1,1,135983,135934,cPa75,5,102,49
Scaffold1728-136142_136307,cPa75,1,1,136258,136164,cPa75,23,165,94
Scaffold1728-136725_136887,cPa75,1,1,136849,136729,cPa75,12,162,120
Scaffold1728-143445_143547,cPa75,1,1,143495,143495,cPa75,1,102,0
Scaffold1728-146324_146462,cPa75,1,1,146410,146374,cPa75,4,138,36
Scaffold1728-147479_147581,cPa75,1,1,147529,147529,cPa75,1,102,0
Scaffold1728-148270_148372,cPa75,1,1,148320,148320,cPa75,1,102,0
Scaffold1728-148474_148576,cPa75,1,1,148524,148524,cPa75,1,102,0
Scaffold1728-148600_148717,cPa75,1,1,148665,148650,cPa75,2,117,15
Scaffold1728-148760_148862,cPa75,1,1,148810,148810,cPa75,1,102,0
Scaffold1728-148890_149291,cPa75,1,1,149239,148940,cPa75,9,401,299
Scaffold1728-149330_149434,cPa75,1,1,149382,149372,cPa75,3,104,10
Scaffold1728-149448_149708,cPa75,1,1,149683,149498,cPa75,7,260,185
Scaffold1728-163103_163205,cPa42,1,1,163153,163147,cPa42,2,102,6
Scaffold1728-168346_168448,cPa62,1,1,168396,168396,cPa62,1,102,0
Scaffold1728-191905_192007,cPa75,1,1,191955,191955,cPa75,1,102,0
Scaffold1728-206995_207097,cPa111-unknown,1,1,207045,207045,cPa111-unknown,1,102,0
Scaffold1728-210351_210453,cPa75-unknown,1,1,210401,210401,cPa75-unknown,1,102,0
Scaffold1728-237213_237315,cPa379-cPa339-hybrid,1,1,237263,237263,cPa379-cPa339-hybrid,1,102,0
Scaffold1728-237495_237597,cPa379-cPa285-hybrid,1,1,237545,237545,cPa379-cPa285-hybrid,1,102,0
Scaffold1728-237903_238008,cPa379-cPa339-hybrid,0.5,3,237999,237953,cPa285_cPa379-cPa339-hybrid_cPa379-cPa75-hybrid,1_2_1,105,46
Scaffold1728-26943_27045,cPa75,1,1,26993,26993,cPa75,1,102,0
Scaffold1728-28300_28402,cPa75,1,1,28350,28350,cPa75,1,102,0
Scaffold1728-28665_28767,cPa75,1,1,28715,28715,cPa75,1,102,0
Scaffold1728-28886_28988,cPa75,1,1,28936,28936,cPa75,1,102,0
Scaffold1728-29330_29518,cPa75,1,1,29466,29380,cPa75,3,188,86
Scaffold1728-3074_3176,cPa75,1,1,3124,3124,cPa75,1,102,0
Scaffold1728-39810_39912,cPa75,1,1,39860,39860,cPa75,1,102,0
Scaffold1728-67657_67884,cPa75,1,1,67832,67707,cPa75,4,227,125
Scaffold1728-68039_68141,cPa75,1,1,68089,68089,cPa75,1,102,0
Scaffold1728-86104_86206,cPa75,1,1,86154,86154,cPa75,1,102,0
Scaffold1728-86277_86528,cPa75,1,1,86476,86327,cPa75,8,251,149
Scaffold1728-86593_86706,cPa75,1,1,86654,86643,cPa75,2,113,11
Scaffold1728-92543_92645,cPa75,1,1,92593,92593,cPa75,1,102,0
Scaffold1728-95925_96027,cPa75,1,1,95975,95975,cPa75,1,102,0
Scaffold1728-99159_99425,cPa270,0.954545454545455,2,99389,99209,cPa270_HERV30_repbase_HERV30I_LTR30,21_1,266,180
Scaffold1729-14868_15028,cPa75,1,1,14976,14918,cPa75,2,160,58
Scaffold1729-97639_97741,cPa75,1,1,97689,97689,cPa75,1,102,0
Scaffold1729-98431_98533,cPa75,1,1,98481,98481,cPa75,1,102,0
Scaffold173-1269_1371,cPa62-unknown,0.8,2,1359,1274,cPa62-cPa152-hybrid_cPa62-unknown,1_4,102,85
Scaffold173-1431_1557,cPa62-cPa75-hybrid_cPa75,0.5,2,1505,1481,cPa62-cPa75-hybrid_cPa75,1_1,126,24
Scaffold173-1631_1733,cPa75,1,1,1681,1681,cPa75,1,102,0
Scaffold173-1879_1981,cPa75,1,1,1929,1929,cPa75,1,102,0
Scaffold173-2016_2127,cPa62-cPa152-hybrid_cPa62-cPa75-hybrid,0.5,2,2075,2066,cPa62-cPa152-hybrid_cPa62-cPa75-hybrid,1_1,111,9
Scaffold173-28989_29114,cPa174_cPa404-cPa254-hybrid,0.333333333333333,4,29062,29039,cPa174_cPa254_cPa404-cPa254-hybrid_cPa404-cPa419-hybrid,2_1_2_1,125,23
Scaffold173-30568_30670,cPa452-cPa308-hybrid,1,1,30618,30618,cPa452-cPa308-hybrid,1,102,0
Scaffold173-505_631,cPa16-unknown,0.205128205128205,12,579,505,cPa16_cPa16-cPa71-hybrid_cPa16-unknown_cPa260-cPa16-hybrid_cPa379_cPa379-cPa75-hybrid_cPa379-unknown_cPa62-unknown_cPa71_cPa71-cPa450-hybrid_cPa71-unknown_cPa75,7_1_8_1_2_1_1_4_3_2_2_7,126,74
Scaffold173-70877_70979,cPa50-cPa390-hybrid,1,1,70938,70927,cPa50-cPa390-hybrid,2,102,11
Scaffold173-726_828,cPa379_cPa379-unknown_cPa62-cPa152-hybrid,0.333333333333333,3,776,748,cPa379_cPa379-unknown_cPa62-cPa152-hybrid,1_1_1,102,28
Scaffold173-76262_76364,cPa339_cPa444-cPa62-hybrid_cPa447,0.333333333333333,3,76321,76312,cPa339_cPa444-cPa62-hybrid_cPa447,1_1_1,102,9
Scaffold173-8372_8474,cPa228_cPa449,0.44,4,8432,8375,cPa228_cPa419_cPa449_cPa449-unknown,11_2_11_1,102,57
Scaffold1731-11384_11486,cPa75,1,1,11434,11434,cPa75,2,102,0
Scaffold1731-11534_11636,cPa293,1,1,11584,11584,cPa293,1,102,0
Scaffold1731-21987_22089,cPa75,1,1,22074,22037,cPa75,2,102,37
Scaffold1731-22309_22811,cPa75,1,1,22779,22344,cPa75,23,502,435
Scaffold1731-22917_23416,cPa75,1,1,23364,22967,cPa75,27,499,397
Scaffold1731-25461_25605,cPa75,1,1,25553,25511,cPa75,2,144,42
Scaffold1731-26647_26782,cPa75,1,1,26730,26697,cPa75,2,135,33
Scaffold1731-26901_27004,cPa75,1,1,26952,26951,cPa75,2,103,1
Scaffold1731-29032_29134,cPa62-cPa75-hybrid,1,1,29082,29082,cPa62-cPa75-hybrid,1,102,0
Scaffold1732-11757_11859,cPa434,1,1,11826,11807,cPa434,2,102,19
Scaffold1732-11945_12066,cPa434,1,1,12022,11989,cPa434,24,121,33
Scaffold1732-12493_12595,cPa434,0.75,2,12564,12543,cPa434_cPa542-cPa67-hybrid,3_1,102,21
Scaffold1732-13034_13136,cPa434,1,1,13131,13039,cPa434,5,102,92
Scaffold1732-7169_7279,cPa434,1,1,7227,7219,cPa434,2,110,8
Scaffold1733-1291_1393,cPa75,1,1,1365,1341,cPa75,2,102,24
Scaffold1733-1396_1825,cPa75,1,1,1805,1446,cPa75,16,429,359
Scaffold1733-15390_15492,cPa75,1,1,15482,15440,cPa75,2,102,42
Scaffold1733-15570_15672,cPa75,1,1,15620,15620,cPa75,1,102,0
Scaffold1733-15788_16311,cPa75,1,1,16259,15838,cPa75,34,523,421
Scaffold1733-16315_16611,cPa75,1,1,16559,16365,cPa75,15,296,194
Scaffold1733-16680_16790,cPa75,1,1,16738,16730,cPa75,3,110,8
Scaffold1733-1870_1972,cPa75,1,1,1964,1920,cPa75,2,102,44
Scaffold1733-19132_19252,HML3_repbase_HERVK9I_MER9,1,1,19200,19182,HML3_repbase_HERVK9I_MER9,2,120,18
Scaffold1733-19324_19493,HML3_repbase_HERVK9I_MER9,1,1,19441,19374,HML3_repbase_HERVK9I_MER9,4,169,67
Scaffold1733-2157_2406,cPa75,1,1,2354,2207,cPa75,7,249,147
Scaffold1733-26037_26139,cPa75,1,1,26087,26087,cPa75,1,102,0
Scaffold1733-26222_26324,cPa75,1,1,26275,26272,cPa75,2,102,3
Scaffold1733-26852_26954,cPa75,1,1,26902,26902,cPa75,1,102,0
Scaffold1733-2781_2883,cPa75,1,1,2831,2830,cPa75,2,102,1
Scaffold1733-28384_28486,cPa75,1,1,28480,28434,cPa75,9,102,46
Scaffold1733-28508_28835,cPa75,1,1,28783,28558,cPa75,9,327,225
Scaffold1733-28849_28983,cPa75,1,1,28931,28899,cPa75,2,134,32
Scaffold1733-28986_29088,cPa75,1,1,29036,29036,cPa75,1,102,0
Scaffold1733-45945_46047,cPa75,1,1,45995,45995,cPa75,1,102,0
Scaffold1733-47477_49087,cPa75,1,1,49074,47504,cPa75,62,1610,1570
Scaffold1733-51194_51308,cPa75,0.75,2,51256,51218,cPa308-cPa75-hybrid_cPa75,1_3,114,38
Scaffold1733-66818_66920,cPa75,1,1,66868,66868,cPa75,1,102,0
Scaffold1733-66978_67331,cPa75,0.933333333333333,2,67305,67028,cPa75_cPa75-HML3_repbase_HERVK9I_MER9-hybrid,28_2,353,277
Scaffold1733-67346_67448,cPa75,1,1,67396,67396,cPa75,1,102,0
Scaffold1733-67483_67585,cPa75,1,1,67533,67533,cPa75,1,102,0
Scaffold1733-70270_70386,cPa75,1,1,70334,70320,cPa75,2,116,14
Scaffold1733-70629_70859,cPa75,1,1,70807,70679,cPa75,3,230,128
Scaffold1733-70895_71179,cPa75,1,1,71127,70945,cPa75,8,284,182
Scaffold1733-71217_71346,cPa75,1,1,71294,71267,cPa75,5,129,27
Scaffold1733-78036_78138,cPa315_cPa75,0.5,2,78086,78069,cPa315_cPa75,1_1,102,17
Scaffold1733-80479_80581,cPa75,1,1,80529,80529,cPa75,1,102,0
Scaffold1733-80650_80752,cPa75,1,1,80700,80700,cPa75,1,102,0
Scaffold1733-80781_80883,cPa75,1,1,80831,80831,cPa75,1,102,0
Scaffold1733-92326_92428,cPa75,1,1,92376,92376,cPa75,1,102,0
Scaffold1733-92455_92671,cPa75,1,1,92619,92505,cPa75,3,216,114
Scaffold1733-93052_93154,cPa75,1,1,93102,93102,cPa75,1,102,0
Scaffold1733-93226_93353,cPa75,1,1,93302,93276,cPa75,4,127,26
Scaffold1733-950_1052,cPa75,1,1,1000,981,cPa75,5,102,19
Scaffold1734-116726_116835,cPa75,1,1,116799,116776,cPa75,5,109,23
Scaffold1734-116886_117976,cPa75,1,1,117924,116936,cPa75,61,1090,988
Scaffold1734-118000_118102,cPa75,1,1,118050,118050,cPa75,1,102,0
Scaffold1734-119432_119534,cPa75,1,1,119482,119441,cPa75,3,102,41
Scaffold1734-120067_120252,cPa75,1,1,120250,120117,cPa75,8,185,133
Scaffold1734-120402_120582,cPa75,1,1,120569,120448,cPa75,14,180,121
Scaffold1734-120869_120971,cPa75,1,1,120919,120919,cPa75,1,102,0
Scaffold1734-120993_121095,cPa75,1,1,121089,121005,cPa75,6,102,84
Scaffold1734-12707_12920,cPa75-unknown,0.953488372093023,2,12868,12757,cPa75_cPa75-unknown,2_41,213,111
Scaffold1734-12929_13054,cPa75,1,1,13002,12979,cPa75,5,125,23
Scaffold1734-146242_146344,cPa75,1,1,146298,146292,cPa75,3,102,6
Scaffold1734-147151_147297,cPa75,1,1,147245,147188,cPa75,6,146,57
Scaffold1734-147352_147683,cPa75,1,1,147676,147387,cPa75,21,331,289
Scaffold1734-147713_147815,cPa75,1,1,147782,147763,cPa75,3,102,19
Scaffold1734-147828_148067,cPa75,1,1,148063,147831,cPa75,9,239,232
Scaffold1734-148111_148213,cPa75,1,1,148161,148112,cPa75,3,102,49
Scaffold1734-155445_155547,cPa75,1,1,155495,155495,cPa75,1,102,0
Scaffold1734-160081_160183,cPa482-cPa75-hybrid,0.666666666666667,2,160180,160131,cPa482_cPa482-cPa75-hybrid,1_2,102,49
Scaffold1734-16159_16261,cPa75-unknown,1,1,16209,16209,cPa75-unknown,1,102,0
Scaffold1734-16265_16367,cPa75-unknown,1,1,16315,16315,cPa75-unknown,1,102,0
Scaffold1734-16454_16556,cPa75-unknown,1,1,16504,16504,cPa75-unknown,1,102,0
Scaffold1734-173737_173931,cPa75,1,1,173879,173787,cPa75,2,194,92
Scaffold1734-184478_184580,cPa75,1,1,184528,184528,cPa75,1,102,0
Scaffold1734-185020_185122,cPa75,1,1,185070,185070,cPa75,1,102,0
Scaffold1734-185146_185606,cPa75,1,1,185554,185196,cPa75,18,460,358
Scaffold1734-185707_185970,cPa75,1,1,185918,185757,cPa75,5,263,161
Scaffold1734-189803_189989,cPa75,1,1,189958,189853,cPa75,4,186,105
Scaffold1734-190071_190173,cPa75,1,1,190144,190090,cPa75,4,102,54
Scaffold1734-190342_190444,cPa75,1,1,190444,190350,cPa75,6,102,94
Scaffold1734-190491_190607,cPa75,1,1,190563,190493,cPa75,7,116,70
Scaffold1734-190642_190744,cPa75,1,1,190742,190641,cPa75,19,102,101
Scaffold1734-190935_191037,cPa75,1,1,191036,190972,cPa75,3,102,64
Scaffold1734-207445_207547,cPa75,1,1,207495,207495,cPa75,1,102,0
Scaffold1734-210112_210214,cPa75,1,1,210162,210162,cPa75,1,102,0
Scaffold1734-210475_210577,cPa75,1,1,210525,210525,cPa75,1,102,0
Scaffold1734-210649_210751,cPa75,1,1,210699,210670,cPa75,2,102,29
Scaffold1734-216276_216378,cPa75-cPa273-hybrid,1,1,216326,216326,cPa75-cPa273-hybrid,1,102,0
Scaffold1734-216423_216525,cPa75-cPa273-hybrid,1,1,216473,216473,cPa75-cPa273-hybrid,1,102,0
Scaffold1734-228798_228900,cPa75,1,1,228848,228848,cPa75,1,102,0
Scaffold1734-229106_229343,cPa75,1,1,229291,229156,cPa75,12,237,135
Scaffold1734-240313_240415,cPa75,1,1,240363,240336,cPa75,2,102,27
Scaffold1734-240465_240567,cPa75,1,1,240515,240515,cPa75,1,102,0
Scaffold1734-240575_240761,cPa75,1,1,240747,240625,cPa75,4,186,122
Scaffold1734-317806_318028,cPa75,1,1,317976,317856,cPa75,5,222,120
Scaffold1734-318046_318148,cPa75,1,1,318096,318096,cPa75,1,102,0
Scaffold1734-318182_318625,cPa75,1,1,318573,318232,cPa75,11,443,341
Scaffold1734-318898_319012,cPa75,1,1,318960,318948,cPa75,3,114,12
Scaffold1734-324135_324237,cPa75,1,1,324185,324185,cPa75,1,102,0
Scaffold1734-33753_33855,cPa75,1,1,33808,33757,cPa75,6,102,51
Scaffold1734-366592_366817,cPa75,1,1,366765,366642,cPa75,3,225,123
Scaffold1734-367047_367856,cPa75,1,1,367804,367097,cPa75,52,809,707
Scaffold1734-367916_368055,cPa75,1,1,368003,367966,cPa75,2,139,37
Scaffold1734-370505_370796,cPa75,1,1,370744,370555,cPa75,8,291,189
Scaffold1734-398451_398553,cPa75,1,1,398501,398501,cPa75,1,102,0
Scaffold1734-398567_398669,cPa75,1,1,398617,398617,cPa75,1,102,0
Scaffold1734-40773_40875,cPa62,1,1,40823,40823,cPa62,1,102,0
Scaffold1734-435498_435600,cPa75,1,1,435548,435548,cPa75,1,102,0
Scaffold1734-439760_439922,cPa75,1,1,439870,439810,cPa75,5,162,60
Scaffold1734-440125_440227,cPa75,1,1,440175,440140,cPa75,2,102,35
Scaffold1734-440282_440454,cPa75,0.8,2,440402,440310,cPa425-cPa75-hybrid_cPa75,1_4,172,92
Scaffold1734-440535_440727,cPa75,1,1,440724,440585,cPa75,6,192,139
Scaffold1734-459042_459144,cPa75,1,1,459092,459092,cPa75,1,102,0
Scaffold1734-499339_499537,cPa587,0.666666666666667,2,499507,499389,cPa587_cPa587-unknown,4_2,198,118
Scaffold1734-499904_500006,cPa587,1,1,499997,499954,cPa587,2,102,43
Scaffold1734-500106_500208,cPa587,1,1,500156,500156,cPa587,1,102,0
Scaffold1734-514655_514757,cPa285,1,1,514705,514705,cPa285,1,102,0
Scaffold1734-529628_529730,cPa75,1,1,529727,529664,cPa75,9,102,63
Scaffold1734-545757_545859,cPa75,1,1,545807,545807,cPa75,1,102,0
Scaffold1734-545894_545996,cPa75,1,1,545944,545938,cPa75,3,102,6
Scaffold1734-546039_546248,cPa75,1,1,546196,546089,cPa75,3,209,107
Scaffold1734-546251_546353,cPa75,1,1,546301,546301,cPa75,1,102,0
Scaffold1734-546386_546488,cPa75,1,1,546436,546388,cPa75,2,102,48
Scaffold1734-546621_546940,cPa75,1,1,546888,546671,cPa75,11,319,217
Scaffold1734-547277_547508,cPa75,1,1,547456,547327,cPa75,21,231,129
Scaffold1734-594383_594540,cPa62,1,1,594521,594433,cPa62,8,157,88
Scaffold1734-606065_606167,cPa75,1,1,606115,606115,cPa75,1,102,0
Scaffold1734-614749_614851,cPa581,1,1,614799,614799,cPa581,1,102,0
Scaffold1734-633972_634074,cPa75,1,1,634022,634022,cPa75,1,102,0
Scaffold1734-634176_634368,cPa75,1,1,634316,634226,cPa75,4,192,90
Scaffold1734-634381_634483,cPa75,1,1,634431,634431,cPa75,1,102,0
Scaffold1734-634674_634809,cPa75,1,1,634757,634724,cPa75,17,135,33
Scaffold1734-657087_657189,cPa75,1,1,657137,657137,cPa75,1,102,0
Scaffold1734-657255_657442,cPa75,1,1,657390,657305,cPa75,4,187,85
Scaffold1734-657486_657589,cPa75,1,1,657537,657529,cPa75,3,103,8
Scaffold1734-657609_657711,cPa75,1,1,657659,657659,cPa75,1,102,0
Scaffold1734-657823_658156,cPa75,1,1,658104,657873,cPa75,7,333,231
Scaffold1734-658231_658364,cPa75,1,1,658312,658281,cPa75,3,133,31
Scaffold1734-661766_661868,HERV30_repbase_HERV30I_LTR30,1,1,661816,661816,HERV30_repbase_HERV30I_LTR30,1,102,0
Scaffold1734-678514_678616,cPa293,1,1,678564,678564,cPa293,1,102,0
Scaffold1734-685658_685760,HIV2_NC001722,1,1,685708,685708,HIV2_NC001722,1,102,0
Scaffold1734-688590_688845,cPa482,0.75,2,688793,688594,cPa482_cPa482-unknown,6_2,255,199
Scaffold1734-92884_92986,cPa75-PtERV1_AC142352-hybrid,1,1,92934,92934,cPa75-PtERV1_AC142352-hybrid,1,102,0
Scaffold1735-117418_117520,cPa194,1,1,117468,117468,cPa194,1,102,0
Scaffold1735-40658_40760,cPa75,1,1,40708,40708,cPa75,1,102,0
Scaffold1735-40880_41079,cPa75,1,1,41062,40930,cPa75,10,199,132
Scaffold1735-41176_41278,cPa75,1,1,41226,41226,cPa75,1,102,0
Scaffold1735-41339_41441,cPa75,1,1,41389,41389,cPa75,1,102,0
Scaffold1735-78812_78914,cPa75,1,1,78862,78862,cPa75,1,102,0
Scaffold1736-13084_13186,cPa410,1,1,13134,13134,cPa410,1,102,0
Scaffold1738-39246_39599,cPa75,0.535714285714286,7,39578,39283,cPa293_cPa62_cPa62-cPa293-hybrid_cPa62-cPa75-hybrid_cPa75_cPa75-cPa62-hybrid_cPa75-unknown,1_3_3_4_15_1_1,353,295
Scaffold1738-39618_40165,cPa75,0.471428571428571,7,40113,39633,cPa293_cPa413_cPa62_cPa62-cPa293-hybrid_cPa62-cPa75-hybrid_cPa62-unknown_cPa75,1_2_16_8_7_3_33,547,480
Scaffold1739-10078_10180,cPa260-cPa435-hybrid,1,1,10128,10128,cPa260-cPa435-hybrid,1,102,0
Scaffold1739-10608_10710,cPa260-cPa75-hybrid,1,1,10658,10658,cPa260-cPa75-hybrid,1,102,0
Scaffold1740-10417_10684,cPa75,0.666666666666667,3,10632,10424,cPa285-cPa75-hybrid_cPa75_cPa75-unknown,2_6_1,267,208
Scaffold1740-1339_1441,cPa205,1,1,1389,1388,cPa205,2,102,1
Scaffold1740-9625_9727,cPa75,1,1,9675,9675,cPa75,1,102,0
Scaffold1741-14154_14256,cPa61-cPa75-hybrid,1,1,14204,14204,cPa61-cPa75-hybrid,1,102,0
Scaffold1741-16020_16122,cPa75,1,1,16070,16070,cPa75,1,102,0
Scaffold1741-1761_1863,cPa75,1,1,1831,1785,cPa75,4,102,46
Scaffold1741-1903_2005,cPa75,0.666666666666667,2,1955,1953,cPa75_cPa75-unknown,2_1,102,2
Scaffold1741-5927_6029,cPa75,1,1,5977,5977,cPa75,1,102,0
Scaffold1742-20999_21101,cPa75,1,1,21049,21049,cPa75,1,102,0
Scaffold1742-21129_21231,cPa75,1,1,21179,21179,cPa75,1,102,0
Scaffold1742-2631_2812,cPa75,1,1,2760,2681,cPa75,2,181,79
Scaffold1743-18267_18426,cPa75,1,1,18374,18317,cPa75,2,159,57
Scaffold1743-18530_18632,cPa75,1,1,18580,18554,cPa75,2,102,26
Scaffold1743-18824_19022,cPa75,1,1,18970,18856,cPa75,7,198,114
Scaffold1743-24188_24290,cPa75,1,1,24238,24238,cPa75,1,102,0
Scaffold1743-47848_47950,cPa75,1,1,47898,47898,cPa75,1,102,0
Scaffold1743-48138_48371,cPa75,1,1,48319,48188,cPa75,3,233,131
Scaffold1743-48469_48571,cPa75,1,1,48519,48519,cPa75,1,102,0
Scaffold1743-76856_76958,cPa75,1,1,76906,76906,cPa75,1,102,0
Scaffold1743-82899_83001,cPa75,1,1,82949,82949,cPa75,1,102,0
Scaffold1743-83248_83350,cPa75,1,1,83298,83298,cPa75,1,102,0
Scaffold1743-83689_83833,cPa75,1,1,83781,83739,cPa75,2,144,42
Scaffold1743-84084_84186,cPa75,1,1,84134,84134,cPa75,1,102,0
Scaffold1743-95791_95973,cPa75,1,1,95921,95841,cPa75,3,182,80
Scaffold1743-95991_97064,cPa75,1,1,97041,96041,cPa75,68,1073,1000
Scaffold1744-4937_5039,cPa75,1,1,4987,4987,cPa75,1,102,0
Scaffold1744-6218_6659,cPa75,1,1,6607,6244,cPa75,14,441,363
Scaffold1744-6690_6792,cPa75,1,1,6740,6740,cPa75,1,102,0
Scaffold1745-3824_3926,cPa62,1,1,3874,3874,cPa62,1,102,0
Scaffold1745-4090_4192,cPa62,1,1,4140,4115,cPa62,2,102,25
Scaffold1745-9197_9363,cPa75,0.625,6,9360,9196,cPa224-cPa293-hybrid_cPa224-unknown_cPa285_cPa285-unknown_cPa315-unknown_cPa75,1_1_2_1_1_10,166,164
Scaffold1745-9472_9574,cPa168_cPa75-unknown,0.5,2,9522,9521,cPa168_cPa75-unknown,1_1,102,1
Scaffold1746-12707_12809,cPa400-cPa75-hybrid,1,1,12757,12757,cPa400-cPa75-hybrid,1,102,0
Scaffold1746-14595_14733,cPa75,0.666666666666667,2,14681,14645,cPa285-cPa224-hybrid_cPa75,1_2,138,36
Scaffold1746-14868_15051,cPa75,0.916666666666667,2,14999,14918,cPa75_cPa75-unknown,11_1,183,81
Scaffold1748-117552_117808,cPa75,1,1,117756,117602,cPa75,5,256,154
Scaffold1748-117859_117961,cPa75,1,1,117949,117909,cPa75,2,102,40
Scaffold1748-20123_20265,cPa75,1,1,20213,20173,cPa75,2,142,40
Scaffold1748-20280_20382,cPa75,1,1,20330,20284,cPa75,4,102,46
Scaffold1748-20408_20510,cPa75,1,1,20458,20451,cPa75,2,102,7
Scaffold1748-30878_30980,cPa75,1,1,30928,30928,cPa75,1,102,0
Scaffold1748-31006_31108,cPa75,1,1,31056,31056,cPa75,1,102,0
Scaffold1748-39978_40087,cPa75,1,1,40072,40028,cPa75,3,109,44
Scaffold1748-40593_40695,cPa75,1,1,40643,40643,cPa75,1,102,0
Scaffold1748-81925_82027,cPa75,1,1,81975,81975,cPa75,1,102,0
Scaffold1748-82179_82281,cPa75,1,1,82229,82229,cPa75,1,102,0
Scaffold1748-82452_82554,cPa75,1,1,82502,82502,cPa75,1,102,0
Scaffold1748-82675_82864,cPa75_cPa75-cPa360-hybrid,0.5,2,82812,82725,cPa75_cPa75-cPa360-hybrid,1_1,189,87
Scaffold1748-82930_83032,cPa425-cPa511-hybrid,1,1,82980,82980,cPa425-cPa511-hybrid,1,102,0
Scaffold1749-17990_18137,cPa75,1,1,18085,18040,cPa75,2,147,45
Scaffold1749-18201_18303,cPa75,1,1,18251,18251,cPa75,1,102,0
Scaffold1749-20537_20639,cPa75,1,1,20587,20587,cPa75,1,102,0
Scaffold1749-20794_20924,cPa75-unknown,1,1,20872,20844,cPa75-unknown,2,130,28
Scaffold1749-20946_21141,cPa75,1,1,21089,20996,cPa75,2,195,93
Scaffold1749-31126_31326,cPa75,1,1,31274,31176,cPa75,2,200,98
Scaffold1749-31355_31463,cPa75,0.666666666666667,2,31411,31405,cPa447-cPa75-hybrid_cPa75,1_2,108,6
Scaffold1749-31562_31759,cPa75,0.8,2,31707,31612,cPa447-cPa75-hybrid_cPa75,1_4,197,95
Scaffold1749-31975_32077,cPa75,1,1,32025,32025,cPa75,1,102,0
Scaffold1749-41998_42118,cPa75,1,1,42066,42048,cPa75,2,120,18
Scaffold1749-42156_42697,cPa75,1,1,42682,42206,cPa75,33,541,476
Scaffold1749-49690_49850,cPa75,1,1,49798,49740,cPa75,2,160,58
Scaffold1749-49861_49963,cPa75,1,1,49911,49911,cPa75,1,102,0
Scaffold1749-50095_50197,cPa75,1,1,50145,50145,cPa75,1,102,0
Scaffold1749-50216_50388,cPa75,1,1,50336,50266,cPa75,3,172,70
Scaffold1749-50445_50616,cPa75,1,1,50607,50495,cPa75,4,171,112
Scaffold1749-50678_50780,cPa75,1,1,50728,50728,cPa75,1,102,0
Scaffold1749-52056_52158,cPa75,1,1,52106,52106,cPa75,1,102,0
Scaffold1749-52782_52884,cPa75,1,1,52832,52832,cPa75,1,102,0
Scaffold1749-52887_53122,cPa75,1,1,53070,52937,cPa75,8,235,133
Scaffold1749-53163_53297,cPa75,1,1,53245,53212,cPa75,7,134,33
Scaffold1749-61885_62045,cPa75,1,1,62021,61935,cPa75,6,160,86
Scaffold1749-62114_62359,cPa75,0.608695652173913,3,62307,62121,cPa75_cPa75-cPa272-hybrid_cPa75-unknown,14_1_8,245,186
Scaffold1749-62684_62786,cPa62,0.666666666666667,4,62743,62717,cPa62_cPa75-cPa109-hybrid_cPa75-cPa254-hybrid_cPa75-cPa62-hybrid,6_1_1_1,102,26
Scaffold175-22474_22576,cPa356_cPa428,0.5,2,22524,22524,cPa356_cPa428,1_1,102,0
Scaffold175-25545_25666,cPa356,0.555555555555556,2,25616,25583,cPa356_cPa428,5_4,121,33
Scaffold1750-10297_10425,cPa75,1,1,10399,10347,cPa75,5,128,52
Scaffold1750-11022_11349,cPa75,0.666666666666667,2,11335,11072,cPa356_cPa75,2_4,327,263
Scaffold1750-11673_11775,cPa75,1,1,11723,11723,cPa75,1,102,0
Scaffold1750-2659_3086,cPa182,0.377777777777778,9,3034,2701,cPa182_cPa447_cPa75_cPa75-ALVJ_Z46390-hybrid_cPa75-cPa182-hybrid_cPa75-cPa360-hybrid_cPa75-cPa447-hybrid_cPa75-cPa62-hybrid_cPa75-unknown,17_1_2_1_12_1_3_1_7,427,333
Scaffold1750-7072_7208,cPa75,1,1,7156,7122,cPa75,2,136,34
Scaffold1750-7244_7346,cPa75,1,1,7294,7294,cPa75,1,102,0
Scaffold1750-9977_10103,cPa75,1,1,10060,10027,cPa75,4,126,33
Scaffold1751-24843_24945,cPa360,1,1,24893,24893,cPa360,1,102,0
Scaffold1751-2762_3008,cPa75-cPa544-hybrid,0.444444444444444,4,3003,2773,cPa544_cPa75_cPa75-cPa544-hybrid_cPa75-unknown,1_3_4_1,246,230
Scaffold1751-3050_3152,cPa75_cPa75-unknown,0.5,2,3103,3100,cPa75_cPa75-unknown,1_1,102,3
Scaffold1751-7907_8009,cPa381-cPa360-hybrid,1,1,7957,7957,cPa381-cPa360-hybrid,1,102,0
Scaffold1751-9640_9742,cPa75,1,1,9690,9690,cPa75,1,102,0
Scaffold1752-109835_109937,cPa62,0.5,4,109885,109837,cPa119-cPa62-hybrid_cPa62_WDSV_NC001867_WDSV_NC001867-cPa62-hybrid,1_4_2_1,102,48
Scaffold1752-115874_116148,cPa434,1,1,116148,115904,cPa434,79,274,244
Scaffold1752-125597_125699,cPa62,1,1,125647,125647,cPa62,1,102,0
Scaffold1752-12676_12778,cPa75,1,1,12726,12726,cPa75,1,102,0
Scaffold1752-12786_12888,cPa75,1,1,12836,12836,cPa75,1,102,0
Scaffold1752-129225_129409,cPa285,0.358208955223881,13,129371,129225,cPa254_cPa254-cPa285-hybrid_cPa254-cPa345-hybrid_cPa254-cPa62-hybrid_cPa254-unknown_cPa272_cPa285_cPa285-cPa254-hybrid_cPa285-cPa345-hybrid_cPa285-cPa62-hybrid_cPa285-unknown_cPa345_cPa62,20_1_1_1_4_1_24_6_2_1_4_1_1,184,146
Scaffold1752-13188_13389,cPa75,1,1,13337,13238,cPa75,12,201,99
Scaffold1752-136843_136945,cPa425,0.294117647058824,9,136945,136852,cPa174_cPa174-cPa404-hybrid_cPa174-cPa47-hybrid_cPa174-unknown_cPa254_cPa404_cPa404-cPa47-hybrid_cPa425_cPa47,1_1_2_2_3_1_1_5_1,102,93
Scaffold1752-160774_160876,cPa75,1,1,160824,160810,cPa75,3,102,14
Scaffold1752-161027_161129,cPa75,1,1,161077,161077,cPa75,1,102,0
Scaffold1752-163574_163676,cPa428,0.475,4,163676,163621,cPa356_cPa356-unknown_cPa428_cPa428-unknown,5_10_19_6,102,55
Scaffold1752-163764_163943,cPa356-unknown,0.375,4,163895,163814,cPa356_cPa356-unknown_cPa428_cPa428-unknown,2_12_10_8,179,81
Scaffold1752-167292_167394,cPa75,1,1,167342,167342,cPa75,1,102,0
Scaffold1752-167447_167549,cPa75,1,1,167497,167497,cPa75,1,102,0
Scaffold1752-17044_17167,cPa75,1,1,17115,17094,cPa75,3,123,21
Scaffold1752-17298_17503,cPa75,1,1,17451,17348,cPa75,18,205,103
Scaffold1752-17556_17808,cPa75,1,1,17756,17606,cPa75,13,252,150
Scaffold1752-175706_176840,cPa75,0.981481481481482,2,176788,175756,cPa194-cPa75-hybrid_cPa75,1_53,1134,1032
Scaffold1752-176845_177072,cPa75,1,1,177020,176895,cPa75,3,227,125
Scaffold1752-177210_177312,cPa75,1,1,177305,177231,cPa75,8,102,74
Scaffold1752-17912_18061,cPa75,1,1,18009,17962,cPa75,2,149,47
Scaffold1752-182244_182346,cPa308-cPa75-hybrid,1,1,182294,182294,cPa308-cPa75-hybrid,1,102,0
Scaffold1752-183513_183615,cPa75,1,1,183563,183563,cPa75,1,102,0
Scaffold1752-183632_183734,cPa75,1,1,183682,183682,cPa75,1,102,0
Scaffold1752-185935_186383,cPa75,1,1,186350,185969,cPa75,29,448,381
Scaffold1752-188359_188533,cPa75,1,1,188481,188409,cPa75,2,174,72
Scaffold1752-188868_188986,cPa75,1,1,188937,188918,cPa75,3,118,19
Scaffold1752-189013_189348,cPa75,1,1,189296,189063,cPa75,10,335,233
Scaffold1752-189357_189634,cPa75,1,1,189582,189407,cPa75,5,277,175
Scaffold1752-189843_190169,cPa75,1,1,190117,189893,cPa75,6,326,224
Scaffold1752-19030_19132,cPa75,1,1,19080,19080,cPa75,1,102,0
Scaffold1752-194999_195168,cPa75,1,1,195116,195018,cPa75,9,169,98
Scaffold1752-195190_195292,cPa75,1,1,195240,195231,cPa75,3,102,9
Scaffold1752-195293_195395,cPa75,1,1,195345,195343,cPa75,2,102,2
Scaffold1752-195457_195870,cPa75,1,1,195837,195507,cPa75,22,413,330
Scaffold1752-195931_196405,cPa75,1,1,196383,195981,cPa75,31,474,402
Scaffold1752-196516_196618,cPa75,1,1,196577,196544,cPa75,8,102,33
Scaffold1752-196641_196829,cPa75,1,1,196798,196657,cPa75,8,188,141
Scaffold1752-198551_198706,cPa75,1,1,198654,198601,cPa75,2,155,53
Scaffold1752-198999_199101,cPa75,1,1,199049,199049,cPa75,1,102,0
Scaffold1752-23675_23777,cPa75,1,1,23725,23725,cPa75,1,102,0
Scaffold1752-34054_34156,cPa75,1,1,34104,34055,cPa75,2,102,49
Scaffold1752-34168_34520,cPa75,1,1,34473,34218,cPa75,18,352,255
Scaffold1752-37437_37539,cPa75,1,1,37516,37487,cPa75,2,102,29
Scaffold1752-37585_37791,cPa75,1,1,37739,37601,cPa75,5,206,138
Scaffold1752-37864_37966,cPa75,1,1,37914,37914,cPa75,1,102,0
Scaffold1752-38000_38102,cPa75,1,1,38059,38050,cPa75,2,102,9
Scaffold1752-3804_4024,cPa428,0.583333333333333,4,4018,3827,cPa356_cPa356-unknown_cPa428_cPa428-unknown,12_1_21_2,220,191
Scaffold1752-39142_39244,cPa75,1,1,39192,39192,cPa75,1,102,0
Scaffold1752-39687_39789,cPa285-cPa75-hybrid,1,1,39737,39737,cPa285-cPa75-hybrid,1,102,0
Scaffold1752-39811_40110,cPa75,0.666666666666667,2,40058,39861,cPa285-cPa75-hybrid_cPa75,2_4,299,197
Scaffold1752-40179_40281,cPa75_WDSV_NC001867,0.5,2,40229,40187,cPa75_WDSV_NC001867,1_1,102,42
Scaffold1752-4049_4151,cPa428,0.5,3,4104,4070,cPa356_cPa428_cPa428-unknown,2_3_1,102,34
Scaffold1752-42007_42109,cPa75,1,1,42057,42017,cPa75,5,102,40
Scaffold1752-57082_57255,cPa62_WDSV_NC001867,0.333333333333333,6,57217,57123,cPa119_cPa62_cPa62-unknown_cPa62-WDSV_NC001867-hybrid_WDSV_NC001867_WDSV_NC001867-unknown,1_9_5_2_9_1,173,94
Scaffold1752-57340_57442,WDSV_NC001867,1,1,57390,57390,WDSV_NC001867,1,102,0
Scaffold1752-57850_58021,cPa62,0.846153846153846,2,58020,57866,cPa62_WDSV_NC001867,11_2,171,154
Scaffold1752-58325_58427,cPa62,1,1,58375,58375,cPa62,1,102,0
Scaffold1752-58489_58591,cPa62,1,1,58539,58539,cPa62,1,102,0
Scaffold1752-61501_61603,cPa199,0.833333333333333,2,61579,61521,cPa199_cPa199-unknown,5_1,102,58
Scaffold1752-61760_61868,cPa199,0.916666666666667,2,61816,61761,cPa199_cPa482,11_1,108,55
Scaffold1752-7886_7988,cPa75,1,1,7936,7936,cPa75,1,102,0
Scaffold1752-8618_8720,cPa75,1,1,8668,8668,cPa75,1,102,0
Scaffold1752-8744_8846,cPa75,1,1,8794,8794,cPa75,1,102,0
Scaffold1752-9012_9114,cPa75,1,1,9062,9062,cPa75,1,102,0
Scaffold1752-90773_91097,cPa434,1,1,91045,90799,cPa434,121,324,246
Scaffold1753-11208_11310,cPa163,1,1,11258,11258,cPa163,1,102,0
Scaffold1753-113314_113508,cPa75,1,1,113456,113364,cPa75,4,194,92
Scaffold1753-113525_113627,cPa75,1,1,113575,113575,cPa75,1,102,0
Scaffold1753-113714_113890,cPa75,1,1,113838,113764,cPa75,5,176,74
Scaffold1753-119474_119608,cPa75,1,1,119556,119524,cPa75,3,134,32
Scaffold1753-128124_128226,cPa75,1,1,128174,128174,cPa75,1,102,0
Scaffold1753-134254_134356,cPa75-cPa62-hybrid,1,1,134304,134304,cPa75-cPa62-hybrid,1,102,0
Scaffold1753-134376_134478,cPa75-cPa62-hybrid,1,1,134426,134426,cPa75-cPa62-hybrid,1,102,0
Scaffold1753-136999_137101,cPa75,1,1,137049,137049,cPa75,1,102,0
Scaffold1753-137195_138000,cPa75,1,1,137948,137245,cPa75,18,805,703
Scaffold1753-13995_14097,cPa75-unknown,1,1,14045,14045,cPa75-unknown,1,102,0
Scaffold1753-140920_141115,cPa75,1,1,141066,140964,cPa75,4,195,102
Scaffold1753-143416_143627,cPa75-cPa62-hybrid,1,1,143575,143466,cPa75-cPa62-hybrid,4,211,109
Scaffold1753-143787_143911,cPa75-cPa62-hybrid,1,1,143859,143837,cPa75-cPa62-hybrid,2,124,22
Scaffold1753-144173_144363,cPa75-cPa62-hybrid,1,1,144311,144223,cPa75-cPa62-hybrid,2,190,88
Scaffold1753-149877_150056,cPa75,1,1,150004,149927,cPa75,2,179,77
Scaffold1753-150077_150208,cPa75,1,1,150156,150127,cPa75,2,131,29
Scaffold1753-150224_150326,cPa75,1,1,150274,150274,cPa75,1,102,0
Scaffold1753-150337_150467,cPa75,1,1,150415,150387,cPa75,3,130,28
Scaffold1753-150505_150719,cPa75,1,1,150667,150555,cPa75,5,214,112
Scaffold1753-150788_150890,cPa75,1,1,150838,150838,cPa75,1,102,0
Scaffold1753-151084_151208,cPa75,1,1,151156,151134,cPa75,2,124,22
Scaffold1753-160538_160640,cPa75,1,1,160599,160588,cPa75,2,102,11
Scaffold1753-160805_161318,cPa75,0.916666666666667,2,161266,160855,cPa75_cPa75-unknown,11_1,513,411
Scaffold1753-167860_167962,cPa486_cPa75-cPa381-hybrid,0.5,2,167921,167910,cPa486_cPa75-cPa381-hybrid,1_1,102,11
Scaffold1753-168057_168159,cPa75-cPa486-hybrid_cPa75-cPa62-hybrid,0.5,2,168107,168069,cPa75-cPa486-hybrid_cPa75-cPa62-hybrid,1_1,102,38
Scaffold1753-17479_17581,cPa75,1,1,17529,17529,cPa75,1,102,0
Scaffold1753-17762_17864,cPa75,1,1,17812,17812,cPa75,1,102,0
Scaffold1753-18325_18455,cPa75,1,1,18403,18375,cPa75,2,130,28
Scaffold1753-194102_194204,cPa285,1,1,194152,194152,cPa285,1,102,0
Scaffold1753-201662_201764,cPa75-unknown,1,1,201712,201712,cPa75-unknown,1,102,0
Scaffold1753-201851_201953,cPa75,1,1,201901,201901,cPa75,1,102,0
Scaffold1753-201984_202212,cPa75,1,1,202160,202034,cPa75,4,228,126
Scaffold1753-202439_202541,cPa75,1,1,202489,202489,cPa75,1,102,0
Scaffold1753-215680_215782,cPa75,1,1,215730,215730,cPa75,1,102,0
Scaffold1753-215985_216135,cPa75,1,1,216083,216022,cPa75,4,150,61
Scaffold1753-216149_216287,cPa75,1,1,216235,216199,cPa75,2,138,36
Scaffold1753-216362_216549,cPa75,1,1,216497,216412,cPa75,3,187,85
Scaffold1753-216599_216701,cPa75,1,1,216649,216649,cPa75,1,102,0
Scaffold1753-22343_22445,cPa75,1,1,22393,22393,cPa75,1,102,0
Scaffold1753-225366_225468,cPa223-cPa285-hybrid,1,1,225416,225416,cPa223-cPa285-hybrid,1,102,0
Scaffold1753-23229_23331,cPa75,1,1,23279,23279,cPa75,1,102,0
Scaffold1753-238750_238852,cPa285,1,1,238800,238800,cPa285,1,102,0
Scaffold1753-250807_250910,cPa75,1,1,250858,250857,cPa75,2,103,1
Scaffold1753-250917_251104,cPa75,1,1,251052,250967,cPa75,2,187,85
Scaffold1753-251215_251344,cPa75,1,1,251292,251265,cPa75,2,129,27
Scaffold1753-268031_268221,cPa75_cPa75-cPa224-hybrid,0.5,2,268169,268081,cPa75_cPa75-cPa224-hybrid,1_1,190,88
Scaffold1753-268261_268363,cPa285-cPa75-hybrid_cPa75,0.5,2,268312,268311,cPa285-cPa75-hybrid_cPa75,1_1,102,1
Scaffold1753-271202_271352,cPa62,1,1,271300,271252,cPa62,2,150,48
Scaffold1753-27458_27631,cPa75,1,1,27581,27508,cPa75,34,173,73
Scaffold1753-27680_27929,cPa75,1,1,27877,27717,cPa75,5,249,160
Scaffold1753-277171_277571,cPa75,1,1,277520,277221,cPa75,21,400,299
Scaffold1753-277616_277718,cPa75,1,1,277666,277666,cPa75,1,102,0
Scaffold1753-27933_28035,cPa75,1,1,28001,27983,cPa75,2,102,18
Scaffold1753-281696_281875,cPa75,1,1,281823,281746,cPa75,3,179,77
Scaffold1753-281929_282309,cPa75,1,1,282257,281979,cPa75,15,380,278
Scaffold1753-282316_282461,cPa75,1,1,282409,282366,cPa75,2,145,43
Scaffold1753-282478_282580,cPa75,1,1,282528,282528,cPa75,1,102,0
Scaffold1753-282693_282795,cPa75,1,1,282743,282743,cPa75,1,102,0
Scaffold1753-289081_289373,cPa75,1,1,289321,289131,cPa75,12,292,190
Scaffold1753-289375_289483,cPa75,1,1,289431,289425,cPa75,2,108,6
Scaffold1753-289555_289866,cPa75,1,1,289814,289605,cPa75,11,311,209
Scaffold1753-289954_290056,cPa75,1,1,290004,289956,cPa75,2,102,48
Scaffold1753-305993_306095,ALVJ_Z46390-unknown,1,1,306043,306043,ALVJ_Z46390-unknown,1,102,0
Scaffold1753-329581_329820,cPa75,0.6,2,329768,329631,cPa75_cPa75-unknown,3_2,239,137
Scaffold1753-329864_329966,cPa75-unknown,1,1,329914,329914,cPa75-unknown,1,102,0
Scaffold1753-330141_330454,cPa75,1,1,330402,330191,cPa75,9,313,211
Scaffold1753-330682_330840,cPa75,1,1,330788,330711,cPa75,8,158,77
Scaffold1753-333220_333322,cPa62-unknown,1,1,333270,333270,cPa62-unknown,1,102,0
Scaffold1753-341041_341143,cPa75,1,1,341091,341091,cPa75,1,102,0
Scaffold1753-341249_341437,WDSV_NC001867,0.533333333333333,4,341437,341299,cPa119_cPa381_WDSV_NC001867_WDSV_NC001867-cPa381-hybrid,1_5_8_1,188,138
Scaffold1753-48396_48498,cPa285,1,1,48446,48446,cPa285,1,102,0
Scaffold1753-49378_49480,cPa75,1,1,49428,49428,cPa75,1,102,0
Scaffold1753-49501_49742,cPa75,1,1,49720,49551,cPa75,8,241,169
Scaffold1753-49745_50053,cPa75,1,1,50001,49770,cPa75,12,308,231
Scaffold1753-50201_50314,cPa75,1,1,50262,50251,cPa75,4,113,11
Scaffold1753-50955_51139,cPa75,1,1,51087,51005,cPa75,3,184,82
Scaffold1753-54823_54995,cPa75,1,1,54943,54873,cPa75,2,172,70
Scaffold1753-55109_55227,cPa75,1,1,55175,55159,cPa75,2,118,16
Scaffold1753-55422_55524,cPa75,1,1,55472,55472,cPa75,1,102,0
Scaffold1753-5745_5847,cPa75,1,1,5795,5795,cPa75,3,102,0
Scaffold1753-57760_57862,cPa75,1,1,57810,57810,cPa75,1,102,0
Scaffold1753-57901_58649,cPa75,1,1,58597,57951,cPa75,54,748,646
Scaffold1753-58732_58834,cPa75,1,1,58782,58782,cPa75,1,102,0
Scaffold1753-59318_59420,cPa75,1,1,59368,59368,cPa75,1,102,0
Scaffold1753-65309_65411,cPa360-cPa75-hybrid,1,1,65359,65359,cPa360-cPa75-hybrid,1,102,0
Scaffold1753-81568_81756,cPa75,0.833333333333333,2,81705,81618,cPa526-cPa75-hybrid_cPa75,1_5,188,87
Scaffold1753-81969_82071,cPa526-cPa75-hybrid,1,1,82019,82019,cPa526-cPa75-hybrid,1,102,0
Scaffold1754-18023_18131,cPa74,0.75,2,18119,18063,cPa392_cPa74,3_9,108,56
Scaffold1754-18154_18256,cPa392,0.529411764705882,3,18249,18162,cPa392_cPa402_cPa74,9_1_7,102,87
Scaffold1754-18275_18454,cPa392,0.435897435897436,6,18430,18290,cPa392_cPa402_cPa402-cPa74-hybrid_cPa402-unknown_cPa419_cPa74,17_4_1_1_1_15,179,140
Scaffold1754-19700_19802,cPa402,1,1,19750,19750,cPa402,1,102,0
Scaffold1754-21257_21359,cPa402,1,1,21307,21307,cPa402,1,102,0
Scaffold1754-21360_21462,cPa402_cPa75-cPa402-hybrid,0.5,2,21410,21410,cPa402_cPa75-cPa402-hybrid,1_1,102,0
Scaffold1754-21506_21608,cPa402,1,1,21556,21556,cPa402,1,102,0
Scaffold1755-14971_15074,cPa74-cPa107-hybrid,0.666666666666667,2,15023,15021,cPa381-cPa107-hybrid_cPa74-cPa107-hybrid,1_2,103,2
Scaffold1755-16919_17464,cPa74,0.39873417721519,21,17416,16918,cPa199_cPa199-cPa345-hybrid_cPa199-cPa581-hybrid_cPa199-cPa62-hybrid_cPa199-HERV-XA34_repbase_HERVFH21I_LTR21A-hybrid_cPa199-HML5_repbase_HERVK22I_LTR22-hybrid_cPa199-unknown_cPa268-cPa254-hybrid_cPa268-cPa62-hybrid_cPa371-cPa107-hybrid_cPa371-cPa174-hybrid_cPa371-cPa581-hybrid_cPa392_cPa392-unknown_cPa402_cPa452-cPa345-hybrid_cPa71-cPa345-hybrid_cPa74_cPa74-cPa392-hybrid_HERV-W_repbase_HERV17_LTR17-cPa62-hybrid_HERV-W_repbase_HERV17_LTR17-HERV-XA34_repbase_HERVFH21I_LTR21A-hybrid,2_1_1_1_1_1_3_1_1_1_1_1_16_1_58_1_1_63_1_1_1,545,498
Scaffold1755-17519_18190,cPa74,0.355932203389831,12,18187,17522,cPa174_cPa199_cPa199-cPa254-hybrid_cPa199-cPa285-hybrid_cPa392_cPa402_cPa402-cPa392-hybrid_cPa419_cPa419-cPa581-hybrid_cPa47_cPa74_cPa75,1_2_1_1_71_69_1_3_1_1_84_1,671,665
Scaffold1755-18953_19055,cPa402,0.4,3,19055,18986,cPa392_cPa402_cPa74,9_12_9,102,69
Scaffold1755-19191_19293,cPa392,0.524590163934426,4,19293,19196,cPa392_cPa402_cPa419_cPa74,32_5_1_23,102,97
Scaffold1755-19435_19695,cPa392,0.450381679389313,7,19688,19434,cPa392_cPa402_cPa452_cPa539_cPa566-cPa174-hybrid_cPa581-cPa452-hybrid_cPa74,59_37_1_1_1_1_31,260,254
Scaffold1755-20504_20606,cPa392,0.523809523809524,4,20606,20525,cPa392_cPa402_cPa419_cPa74,22_9_2_9,102,81
Scaffold1755-20616_20718,cPa402,0.405405405405405,3,20717,20618,cPa392_cPa402_cPa74,11_15_11,102,99
Scaffold1755-21705_21844,cPa402,0.394736842105263,5,21840,21704,cPa163-unknown_cPa391-unknown_cPa392_cPa402_cPa74,1_1_15_30_29,139,136
Scaffold1755-22772_22874,cPa402,0.666666666666667,3,22851,22802,cPa402_cPa74_cPa75-unknown,6_2_1,102,49
Scaffold1755-23730_23832,cPa402_cPa75-unknown,0.5,2,23782,23780,cPa402_cPa75-unknown,1_1,102,2
Scaffold1755-24849_24951,cPa402_cPa74,0.5,2,24899,24899,cPa402_cPa74,1_1,102,0
Scaffold1755-25017_25119,cPa402,0.666666666666667,2,25085,25064,cPa402_cPa74,2_1,102,21
Scaffold1755-2518_2620,cPa152-cPa339-hybrid_cPa290-cPa339-hybrid_cPa339_cPa390_cPa505-cPa339-hybrid_cPa515_cPa540,0.142857142857143,7,2568,2540,cPa152-cPa339-hybrid_cPa290-cPa339-hybrid_cPa339_cPa390_cPa505-cPa339-hybrid_cPa515_cPa540,1_1_1_1_1_1_1,102,28
Scaffold1755-31246_31348,cPa75,1,1,31306,31275,cPa75,5,102,31
Scaffold1755-34033_34135,cPa75,1,1,34083,34083,cPa75,1,102,0
Scaffold1755-40267_40369,cPa363_cPa452,0.285714285714286,5,40339,40286,cPa176-cPa118-hybrid_cPa363_cPa452_cPa452-cPa363-hybrid_cPa71,1_2_2_1_1,102,53
Scaffold1755-40675_40797,cPa333,0.481481481481481,7,40745,40678,cPa15-cPa568-hybrid_cPa333_cPa333-cPa118-hybrid_cPa333-cPa50-hybrid_cPa333-cPa568-hybrid_cPa371-cPa50-hybrid_cPa568,1_13_2_5_2_3_1,122,67
Scaffold1755-42610_42712,cPa15-cPa450-hybrid,1,1,42660,42660,cPa15-cPa450-hybrid,1,102,0
Scaffold1755-43340_43442,cPa450,1,1,43390,43390,cPa450,1,102,0
Scaffold1755-43489_43610,cPa199-cPa450-hybrid,0.5,3,43569,43539,cPa15-cPa450-hybrid_cPa199_cPa199-cPa450-hybrid,1_1_2,121,30
Scaffold1755-44530_44643,cPa199,0.5,4,44602,44566,cPa199_cPa199-cPa313-hybrid_cPa199-unknown_cPa313,3_1_1_1,113,36
Scaffold1755-44744_44846,cPa199-cPa229-hybrid,1,1,44794,44794,cPa199-cPa229-hybrid,1,102,0
Scaffold1755-46522_46624,cPa188-BaEV_D10032-hybrid_cPa339-BaEV_D10032-hybrid,0.5,2,46598,46572,cPa188-BaEV_D10032-hybrid_cPa339-BaEV_D10032-hybrid,1_1,102,26
Scaffold1755-51638_51792,cPa357-cPa118-hybrid_cPa502-cPa118-hybrid_cPa62,0.333333333333333,3,51740,51688,cPa357-cPa118-hybrid_cPa502-cPa118-hybrid_cPa62,1_1_1,154,52
Scaffold1755-52583_52716,cPa15_cPa357-cPa118-hybrid_cPa357-cPa125-hybrid,0.333333333333333,3,52670,52633,cPa15_cPa357-cPa118-hybrid_cPa357-cPa125-hybrid,1_1_1,133,37
Scaffold1755-54909_55011,cPa333-cPa75-hybrid,1,1,54959,54957,cPa333-cPa75-hybrid,2,102,2
Scaffold1755-62155_62273,cPa75,0.875,2,62221,62205,cPa75_cPa75-unknown,7_1,118,16
Scaffold1755-86433_86535,cPa402,0.666666666666667,2,86483,86482,cPa402_cPa74,2_1,102,1
Scaffold1755-9292_9394,cPa345,1,1,9357,9321,cPa345,9,102,36
Scaffold1756-14192_14295,cPa425,0.5,3,14274,14242,cPa390-cPa425-hybrid_cPa425_cPa425-cPa287-hybrid,1_2_1,103,32
Scaffold1756-16814_16916,cPa390_cPa390-unknown,0.5,2,16864,16855,cPa390_cPa390-unknown,1_1,102,9
Scaffold1756-6994_7096,cPa260,0.5,3,7044,7038,cPa260_cPa327-cPa305-hybrid_cPa459,2_1_1,102,6
Scaffold1756-8947_9069,cPa260,0.387096774193548,9,9017,8993,cPa196_cPa196-cPa260-hybrid_cPa196-cPa424-hybrid_cPa196-unknown_cPa260_cPa305-unknown_cPa327_cPa327-cPa260-hybrid_cPa327-unknown,3_1_1_1_12_1_7_2_3,122,24
Scaffold1756-9172_9305,cPa260,0.75,2,9296,9200,cPa260_cPa327-unknown,3_1,133,96
Scaffold176-48289_48395,cPa363,0.657142857142857,4,48379,48337,cPa117_cPa363_cPa363-cPa117-hybrid_cPa456,17_46_2_5,106,42
Scaffold176-48497_48648,cPa363,0.8,2,48638,48547,cPa117_cPa363,1_4,151,91
Scaffold176-52120_52347,SMRV_NC001514-cPa539-hybrid,0.363636363636364,5,52295,52170,cPa419_SMRV_NC001514-cPa107-hybrid_SMRV_NC001514-cPa121-hybrid_SMRV_NC001514-cPa308-hybrid_SMRV_NC001514-cPa539-hybrid,1_3_2_1_4,227,125
Scaffold176-52559_52663,SMRV_NC001514-cPa107-hybrid_SMRV_NC001514-cPa121-hybrid,0.5,2,52611,52609,SMRV_NC001514-cPa107-hybrid_SMRV_NC001514-cPa121-hybrid,2_2,104,2
Scaffold176-54722_54824,cPa419,1,1,54796,54737,cPa419,11,102,59
Scaffold176-59000_59102,cPa452,0.461538461538462,3,59057,59041,cPa363_cPa452_cPa71,5_6_2,102,16
Scaffold176-6750_7157,cPa223,0.964285714285714,3,7129,6752,cPa223_cPa410-cPa223-hybrid_cPa419,54_1_1,407,377
Scaffold176-7191_7610,cPa223,0.973684210526316,2,7606,7241,cPa223_cPa410-cPa512-hybrid,37_1,419,365
Scaffold176-7614_7761,cPa223,0.852941176470588,8,7753,7633,cPa223_cPa392-cPa223-hybrid_cPa410-cPa223-hybrid_cPa410-cPa512-hybrid_cPa492-cPa512-hybrid_cPa511-cPa223-hybrid_cPa566-cPa223-hybrid_STLV1_NC000858-cPa223-hybrid,87_1_2_2_1_1_1_7,147,120
Scaffold176-9561_9841,STLV1_NC000858-unknown,0.967213114754098,3,9827,9607,STLV1_NC000858-cPa444-hybrid_STLV1_NC000858-HML7_repbase_HERVK11DI_MER11D-hybrid_STLV1_NC000858-unknown,1_1_59,280,220
Scaffold177-18150_18385,cPa199,0.257575757575758,12,18374,18178,cPa199_cPa227-cPa199-hybrid_cPa273-cPa199-hybrid_cPa273-unknown_cPa419_cPa450_cPa450-cPa199-hybrid_cPa450-cPa62-hybrid_cPa450-unknown_cPa553-cPa199-hybrid_cPa553-unknown_cPa62,17_1_2_4_1_16_8_1_12_2_1_1,235,196
Scaffold177-25956_26243,cPa62,0.576923076923077,7,26224,26006,cPa285_cPa308-cPa62-hybrid_cPa308-cPa74-hybrid_cPa419_cPa62_cPa62-unknown_cPa75,1_1_1_5_15_1_2,287,218
Scaffold177-36431_36840,cPa75,0.212765957446809,14,36788,36467,cPa15_cPa232-cPa75-hybrid_cPa293-cPa75-hybrid_cPa419_cPa425-cPa75-hybrid_cPa456-cPa200-hybrid_cPa482-cPa75-hybrid_cPa542-cPa232-hybrid_cPa542-unknown_cPa75_HERV-F_repbase_HERVFH19I_LTR19A-cPa75-hybrid_HERV-R_repbase_HERV3_LTR4-cPa293-hybrid_HERV-R_repbase_HERV3_LTR4-cPa75-hybrid_HERV-R_repbase_HERV3_LTR4-unknown,1_1_3_8_1_1_2_1_1_10_1_1_9_7,409,321
Scaffold177-36863_36965,cPa293_cPa419,0.5,2,36931,36913,cPa293_cPa419,1_1,102,18
Scaffold177-5566_5673,cPa419,0.777777777777778,3,5621,5607,BLV_NC001414_cPa419_HERV30_repbase_HERV30I_LTR30-unknown,1_7_1,107,14
Scaffold177-60523_60625,cPa75,0.736842105263158,5,60607,60539,cPa224_cPa285_cPa356-cPa224-hybrid_cPa419_cPa75,1_1_1_2_14,102,68
Scaffold177-60697_60799,cPa419,0.52,9,60754,60730,cPa360_cPa360-cPa138-hybrid_cPa360-cPa34-hybrid_cPa360-cPa402-hybrid_cPa419_cPa428_cPa583-cPa360-hybrid_cPa75_cPa75-cPa391-hybrid,1_2_1_1_13_1_1_4_1,102,24
Scaffold177-62234_62336,cPa75,0.523809523809524,3,62318,62238,cPa419_cPa75_cPa75-unknown,9_11_1,102,80
Scaffold177-62401_62553,cPa75,0.5,5,62548,62447,cPa308_cPa419_cPa75_cPa75-HERV-XA34_repbase_HERVFH21I_LTR21A-hybrid_cPa75-unknown,1_3_6_1_1,152,101
Scaffold177-62669_62771,cPa419_cPa75,0.4,3,62758,62668,cPa419_cPa419-cPa285-hybrid_cPa75,2_1_2,102,90
Scaffold177-63090_63192,HERV-XA34_repbase_HERVFH21I_LTR21A,0.75,2,63163,63140,HERV-XA34_repbase_HERVFH21I_LTR21A_HERV-XA34_repbase_HERVFH21I_LTR21A-cPa419-hybrid,3_1,102,23
Scaffold177-64761_64863,cPa425,0.714285714285714,2,64860,64766,cPa419_cPa425,2_5,102,94
Scaffold177-65601_66229,cPa194,0.635802469135803,11,66227,65609,cPa194_cPa356_cPa356-cPa67-hybrid_cPa419_cPa434_cPa434-cPa583-hybrid_cPa566-cPa419-hybrid_cPa566-cPa67-hybrid_cPa67_cPa67-cPa356-hybrid_HERV-I_repbase_HERVI_LTR10B,103_5_1_11_1_1_1_1_34_3_1,628,618
Scaffold177-66463_66565,cPa194,0.666666666666667,2,66513,66476,cPa194_cPa523-cPa194-hybrid,2_1,102,37
Scaffold177-66776_67013,cPa356,0.760869565217391,9,67005,66786,cPa194-cPa356-hybrid_cPa356_cPa356-cPa194-hybrid_cPa387-cPa447-hybrid_cPa419_cPa434-cPa356-hybrid_cPa447_cPa450-cPa260-hybrid_cPa566-cPa67-hybrid,1_35_1_1_4_1_1_1_1,237,219
Scaffold177-67217_67319,cPa356,0.666666666666667,5,67297,67219,cPa356_cPa387_cPa419_cPa447_WDSV_NC001867-cPa67-hybrid,10_1_1_2_1,102,78
Scaffold177-68191_68293,cPa61,0.333333333333333,9,68291,68195,cPa362_cPa410_cPa410-cPa194-hybrid_cPa419_cPa61_cPa61-cPa67-hybrid_cPa61-HERV-I_repbase_HERVI_LTR10B-hybrid_WDSV_NC001867_WDSV_NC001867-cPa566-hybrid,2_2_1_4_7_1_1_2_1,102,96
Scaffold177-68532_68634,cPa566,0.578947368421053,9,68624,68531,cPa360-cPa530-hybrid_cPa410_cPa410-cPa356-hybrid_cPa410-cPa566-hybrid_cPa434-cPa566-hybrid_cPa566_cPa61_cPa61-cPa566-hybrid_HERV-XA34_repbase_HERVFH21I_LTR21A-cPa62-hybrid,1_1_1_1_1_11_1_1_1,102,93
Scaffold177-68675_68777,cPa61,0.5,6,68775,68676,cPa345-cPa61-hybrid_cPa356-cPa264-hybrid_cPa410_cPa419_cPa434-cPa566-hybrid_cPa61,1_1_1_1_1_5,102,99
Scaffold178-16415_16535,cPa419,1,1,16494,16428,cPa419,15,120,66
Scaffold178-16630_16734,cPa419,1,1,16682,16646,cPa419,8,104,36
Scaffold178-17021_17127,cPa419,1,1,17087,17023,cPa419,5,106,64
Scaffold178-17352_17454,cPa419,1,1,17402,17392,cPa419,2,102,10
Scaffold178-17589_17722,cPa419,1,1,17692,17639,cPa419,7,133,53
Scaffold178-41364_41466,cPa419,1,1,41418,41414,cPa419,2,102,4
Scaffold178-41649_41751,cPa419,1,1,41699,41699,cPa419,1,102,0
Scaffold178-66716_66818,cPa419,1,1,66766,66766,cPa419,1,102,0
Scaffold178-66955_67057,cPa419,1,1,67047,67005,cPa419,3,102,42
Scaffold178-67163_67286,cPa419,1,1,67258,67179,cPa419,54,123,79
Scaffold178-68413_68515,cPa419,1,1,68490,68463,cPa419,6,102,27
Scaffold178-68578_68727,cPa419,1,1,68722,68615,cPa419,18,149,107
Scaffold178-923_1025,cPa419,1,1,1022,922,cPa419,32,102,100
Scaffold179-56179_56285,cPa62-cPa75-hybrid,0.454545454545455,4,56233,56220,cPa293-cPa75-hybrid_cPa62_cPa62-cPa75-hybrid_HML1b_repbase_HERV-K14I_LTR14A-cPa75-hybrid,2_3_5_1,106,13
Scaffold179-57056_57158,cPa62-cPa75-hybrid,1,1,57131,57106,cPa62-cPa75-hybrid,2,102,25
Scaffold18-1002641_1002743,cPa75,1,1,1002691,1002691,cPa75,1,102,0
Scaffold18-1007960_1008062,cPa75,1,1,1008010,1008010,cPa75,1,102,0
Scaffold18-1008112_1008224,cPa75,1,1,1008172,1008162,cPa75,2,112,10
Scaffold18-1008390_1008600,cPa75,1,1,1008548,1008411,cPa75,5,210,137
Scaffold18-1008762_1008871,cPa75,1,1,1008819,1008812,cPa75,2,109,7
Scaffold18-1009444_1009581,cPa75,1,1,1009529,1009494,cPa75,7,137,35
Scaffold18-1009697_1009799,cPa75,1,1,1009747,1009747,cPa75,1,102,0
Scaffold18-1012550_1012652,cPa75,1,1,1012600,1012600,cPa75,1,102,0
Scaffold18-1017222_1017324,cPa75,1,1,1017272,1017272,cPa75,1,102,0
Scaffold18-1017690_1017792,cPa75,1,1,1017740,1017740,cPa75,1,102,0
Scaffold18-1018012_1018114,cPa75,1,1,1018062,1018059,cPa75,2,102,3
Scaffold18-1019628_1019730,cPa75,1,1,1019678,1019678,cPa75,2,102,0
Scaffold18-1019854_1020104,cPa75,1,1,1020100,1019893,cPa75,22,250,207
Scaffold18-1030744_1030906,cPa75,1,1,1030854,1030794,cPa75,2,162,60
Scaffold18-1033343_1033873,cPa75,1,1,1033821,1033382,cPa75,20,530,439
Scaffold18-1034049_1034261,cPa75,1,1,1034209,1034099,cPa75,15,212,110
Scaffold18-1034263_1034435,cPa75,1,1,1034383,1034313,cPa75,2,172,70
Scaffold18-1034491_1034593,cPa75,1,1,1034541,1034541,cPa75,1,102,0
Scaffold18-1034622_1034724,cPa75,1,1,1034672,1034672,cPa75,1,102,0
Scaffold18-1035072_1035234,cPa75,1,1,1035182,1035122,cPa75,5,162,60
Scaffold18-1046917_1047038,cPa75,1,1,1046986,1046967,cPa75,9,121,19
Scaffold18-1047123_1047506,cPa75,1,1,1047454,1047173,cPa75,16,383,281
Scaffold18-1047574_1047838,cPa75,1,1,1047786,1047601,cPa75,27,264,185
Scaffold18-1054649_1054751,cPa75,1,1,1054738,1054682,cPa75,3,102,56
Scaffold18-1055121_1055223,cPa75,1,1,1055172,1055139,cPa75,3,102,33
Scaffold18-1055268_1055525,cPa75,1,1,1055487,1055318,cPa75,8,257,169
Scaffold18-1055533_1055895,cPa75,1,1,1055843,1055532,cPa75,37,362,311
Scaffold18-1058345_1058499,cPa75,1,1,1058447,1058395,cPa75,4,154,52
Scaffold18-1058801_1058973,cPa75,1,1,1058921,1058851,cPa75,3,172,70
Scaffold18-1058987_1059173,cPa75,1,1,1059121,1059037,cPa75,7,186,84
Scaffold18-1061231_1061333,cPa75,1,1,1061323,1061281,cPa75,4,102,42
Scaffold18-1061746_1061907,cPa75,1,1,1061855,1061796,cPa75,5,161,59
Scaffold18-1062005_1062132,cPa75,1,1,1062080,1062055,cPa75,5,127,25
Scaffold18-1063950_1064095,cPa75,1,1,1064043,1064000,cPa75,2,145,43
Scaffold18-1069797_1069899,cPa75,1,1,1069847,1069847,cPa75,1,102,0
Scaffold18-1072419_1072570,cPa75,1,1,1072518,1072469,cPa75,2,151,49
Scaffold18-1072741_1072843,cPa75,1,1,1072791,1072791,cPa75,1,102,0
Scaffold18-1073055_1073375,cPa75,1,1,1073326,1073105,cPa75,31,320,221
Scaffold18-1073495_1073895,cPa75,1,1,1073843,1073545,cPa75,8,400,298
Scaffold18-1075454_1075556,cPa75,1,1,1075504,1075504,cPa75,1,102,0
Scaffold18-1077307_1077455,cPa75,1,1,1077403,1077357,cPa75,5,148,46
Scaffold18-1077470_1077674,cPa75,1,1,1077622,1077520,cPa75,9,204,102
Scaffold18-1078175_1078283,cPa75,1,1,1078231,1078225,cPa75,2,108,6
Scaffold18-1078435_1078537,cPa75,1,1,1078485,1078485,cPa75,1,102,0
Scaffold18-1079056_1079208,cPa75,1,1,1079156,1079106,cPa75,13,152,50
Scaffold18-1079248_1079440,cPa75,1,1,1079389,1079298,cPa75,25,192,91
Scaffold18-1086974_1087088,cPa117-cPa75-hybrid_cPa117-unknown,0.5,2,1087038,1087001,cPa117-cPa75-hybrid_cPa117-unknown,3_3,114,37
Scaffold18-122487_122589,cPa75,1,1,122537,122537,cPa75,1,102,0
Scaffold18-124213_124315,cPa75,1,1,124268,124263,cPa75,2,102,5
Scaffold18-125248_125350,cPa75,1,1,125298,125250,cPa75,8,102,48
Scaffold18-130854_131037,cPa75,1,1,130985,130904,cPa75,3,183,81
Scaffold18-133470_133572,cPa75,1,1,133520,133520,cPa75,1,102,0
Scaffold18-136923_137025,cPa75,1,1,136973,136973,cPa75,1,102,0
Scaffold18-137132_137244,cPa75,1,1,137192,137182,cPa75,2,112,10
Scaffold18-14265_14367,cPa75,1,1,14315,14315,cPa75,1,102,0
Scaffold18-151263_151365,cPa75,1,1,151313,151313,cPa75,1,102,0
Scaffold18-151639_151863,cPa75,1,1,151811,151689,cPa75,7,224,122
Scaffold18-151968_152299,cPa75,1,1,152247,152018,cPa75,13,331,229
Scaffold18-156654_156756,cPa75,1,1,156704,156704,cPa75,1,102,0
Scaffold18-156878_157126,cPa75,1,1,157074,156928,cPa75,43,248,146
Scaffold18-157431_157533,cPa75,1,1,157481,157481,cPa75,1,102,0
Scaffold18-157549_157651,cPa75,1,1,157645,157599,cPa75,2,102,46
Scaffold18-161969_162071,cPa75-cPa308-hybrid,1,1,162019,162019,cPa75-cPa308-hybrid,1,102,0
Scaffold18-162195_162297,cPa75-cPa308-hybrid,1,1,162245,162245,cPa75-cPa308-hybrid,1,102,0
Scaffold18-193365_193467,cPa75,1,1,193415,193415,cPa75,1,102,0
Scaffold18-20141_20243,cPa75,1,1,20229,20191,cPa75,2,102,38
Scaffold18-20271_20442,cPa75,1,1,20390,20321,cPa75,3,171,69
Scaffold18-20924_21043,cPa75,1,1,20991,20937,cPa75,4,119,54
Scaffold18-21061_21220,cPa75,1,1,21183,21111,cPa75,6,159,72
Scaffold18-21297_21399,cPa75,1,1,21347,21328,cPa75,2,102,19
Scaffold18-21407_21509,cPa75,1,1,21457,21457,cPa75,1,102,0
Scaffold18-214164_214266,cPa75,1,1,214214,214214,cPa75,1,102,0
Scaffold18-220510_220612,cPa75,1,1,220560,220560,cPa75,1,102,0
Scaffold18-231843_231945,cPa75,1,1,231893,231893,cPa75,1,102,0
Scaffold18-232111_232213,cPa75,1,1,232161,232161,cPa75,1,102,0
Scaffold18-232575_232733,cPa75,1,1,232681,232625,cPa75,4,158,56
Scaffold18-236351_236498,cPa75,1,1,236446,236363,cPa75,6,147,83
Scaffold18-236812_237013,cPa75,1,1,236961,236862,cPa75,5,201,99
Scaffold18-237149_237302,cPa75,1,1,237250,237191,cPa75,3,153,59
Scaffold18-237351_237588,cPa75,1,1,237536,237401,cPa75,6,237,135
Scaffold18-237732_237834,cPa75,1,1,237782,237782,cPa75,1,102,0
Scaffold18-248203_248305,cPa75,1,1,248253,248253,cPa75,1,102,0
Scaffold18-248883_248985,cPa75,1,1,248933,248933,cPa75,1,102,0
Scaffold18-267893_267995,cPa75_cPa75-unknown,0.5,2,267943,267903,cPa75_cPa75-unknown,1_1,102,40
Scaffold18-271261_271363,cPa75,1,1,271311,271311,cPa75,1,102,0
Scaffold18-275270_275372,cPa75,1,1,275320,275320,cPa75,1,102,0
Scaffold18-275623_275725,cPa75,1,1,275673,275673,cPa75,1,102,0
Scaffold18-275851_276018,cPa75,1,1,275966,275901,cPa75,5,167,65
Scaffold18-278117_278219,cPa75,1,1,278192,278118,cPa75,10,102,74
Scaffold18-278274_278505,cPa75,1,1,278482,278324,cPa75,8,231,158
Scaffold18-278514_278726,cPa75,1,1,278674,278552,cPa75,9,212,122
Scaffold18-283008_283110,cPa75,1,1,283058,283047,cPa75,2,102,11
Scaffold18-283234_283402,cPa75,1,1,283350,283284,cPa75,3,168,66
Scaffold18-283691_283899,cPa75,1,1,283847,283741,cPa75,8,208,106
Scaffold18-283910_284012,cPa75,1,1,283960,283960,cPa75,1,102,0
Scaffold18-284281_284406,cPa75,1,1,284354,284331,cPa75,2,125,23
Scaffold18-288193_288309,cPa75,1,1,288257,288227,cPa75,4,116,30
Scaffold18-288315_288468,cPa75,0.8,2,288416,288340,cPa75_cPa75-unknown,4_1,153,76
Scaffold18-289629_289731,cPa75,1,1,289711,289679,cPa75,3,102,32
Scaffold18-289892_289994,cPa75,1,1,289942,289920,cPa75,3,102,22
Scaffold18-290011_290113,cPa75,1,1,290079,290040,cPa75,6,102,39
Scaffold18-290166_290268,cPa75,1,1,290216,290216,cPa75,1,102,0
Scaffold18-290565_290667,cPa75,1,1,290619,290578,cPa75,4,102,41
Scaffold18-295487_295589,cPa75,1,1,295537,295537,cPa75,1,102,0
Scaffold18-297373_297475,cPa75,1,1,297423,297423,cPa75,1,102,0
Scaffold18-340681_340783,cPa272,1,1,340731,340731,cPa272,1,102,0
Scaffold18-352813_352915,cPa400,1,1,352863,352863,cPa400,1,102,0
Scaffold18-361285_361387,cPa75,1,1,361335,361335,cPa75,1,102,0
Scaffold18-361559_361661,cPa75,1,1,361609,361609,cPa75,1,102,0
Scaffold18-367330_367499,cPa75,1,1,367447,367380,cPa75,3,169,67
Scaffold18-367543_367739,cPa75,1,1,367687,367593,cPa75,2,196,94
Scaffold18-367896_367998,cPa75,1,1,367946,367946,cPa75,1,102,0
Scaffold18-368130_368327,cPa75,1,1,368275,368180,cPa75,2,197,95
Scaffold18-369391_369493,cPa75,1,1,369441,369441,cPa75,1,102,0
Scaffold18-369899_370001,cPa75,1,1,369949,369949,cPa75,1,102,0
Scaffold18-370795_370897,cPa247,1,1,370845,370845,cPa247,1,102,0
Scaffold18-378560_378834,cPa75,1,1,378784,378610,cPa75,11,274,174
Scaffold18-378895_379080,cPa75,1,1,379028,378945,cPa75,2,185,83
Scaffold18-379184_379286,cPa75,1,1,379234,379234,cPa75,1,102,0
Scaffold18-379360_379462,cPa75,1,1,379452,379410,cPa75,3,102,42
Scaffold18-379605_379707,cPa75,1,1,379671,379655,cPa75,2,102,16
Scaffold18-379947_380049,cPa75,1,1,380012,379997,cPa75,2,102,15
Scaffold18-380103_380205,cPa75,1,1,380153,380120,cPa75,4,102,33
Scaffold18-380498_380600,cPa75,1,1,380548,380548,cPa75,1,102,0
Scaffold18-399521_399702,cPa395,0.9,2,399666,399571,cPa395_cPa395-unknown,9_1,181,95
Scaffold18-424912_425014,cPa75,1,1,424962,424962,cPa75,1,102,0
Scaffold18-425179_425325,cPa75,1,1,425273,425229,cPa75,2,146,44
Scaffold18-43499_43601,cPa75,1,1,43549,43549,cPa75,1,102,0
Scaffold18-43738_43840,cPa75,1,1,43788,43788,cPa75,1,102,0
Scaffold18-44412_44514,cPa75,1,1,44462,44462,cPa75,1,102,0
Scaffold18-445440_445551,cPa75,1,1,445499,445484,cPa75,5,111,15
Scaffold18-446217_446319,cPa75,1,1,446267,446216,cPa75,2,102,51
Scaffold18-447243_447345,cPa75,1,1,447293,447293,cPa75,1,102,0
Scaffold18-456807_456909,cPa75,1,1,456857,456857,cPa75,1,102,0
Scaffold18-457495_457597,cPa308-cPa75-hybrid,1,1,457545,457545,cPa308-cPa75-hybrid,1,102,0
Scaffold18-457693_457795,cPa75,1,1,457743,457743,cPa75,1,102,0
Scaffold18-457935_458037,cPa75,1,1,457985,457985,cPa75,2,102,0
Scaffold18-458071_458173,cPa75,1,1,458121,458121,cPa75,1,102,0
Scaffold18-463378_463529,cPa75,1,1,463477,463381,cPa75,3,151,96
Scaffold18-463680_463790,cPa75,1,1,463738,463730,cPa75,3,110,8
Scaffold18-463802_463913,cPa75,1,1,463861,463852,cPa75,3,111,9
Scaffold18-464061_464267,cPa75,1,1,464215,464111,cPa75,7,206,104
Scaffold18-476468_476570,cPa75,1,1,476550,476481,cPa75,5,102,69
Scaffold18-476889_476991,cPa75,1,1,476963,476939,cPa75,5,102,24
Scaffold18-477743_477984,cPa75,1,1,477967,477775,cPa75,6,241,192
Scaffold18-478008_479019,cPa75,1,1,478978,478058,cPa75,50,1011,920
Scaffold18-479198_479300,cPa75,1,1,479290,479248,cPa75,3,102,42
Scaffold18-481461_481664,cPa75,1,1,481612,481511,cPa75,2,203,101
Scaffold18-481685_481787,cPa75,1,1,481735,481735,cPa75,1,102,0
Scaffold18-496056_496158,cPa75,1,1,496106,496106,cPa75,1,102,0
Scaffold18-496160_496262,cPa75,1,1,496210,496210,cPa75,1,102,0
Scaffold18-496313_496415,cPa75,1,1,496363,496363,cPa75,1,102,0
Scaffold18-498013_498115,cPa75,1,1,498063,498063,cPa75,1,102,0
Scaffold18-505528_505674,cPa75,1,1,505622,505578,cPa75,2,146,44
Scaffold18-520158_520260,cPa356,1,1,520208,520208,cPa356,1,102,0
Scaffold18-520468_520653,cPa356,0.5,3,520639,520490,cPa356_cPa428_cPa428-cPa356-hybrid,10_9_1,185,149
Scaffold18-520886_520988,cPa356,0.666666666666667,2,520936,520930,cPa356_cPa428,2_1,102,6
Scaffold18-521076_521178,cPa356_cPa428,0.5,2,521126,521120,cPa356_cPa428,1_1,102,6
Scaffold18-544178_544355,cPa75,1,1,544303,544228,cPa75,4,177,75
Scaffold18-544648_544886,cPa75,1,1,544834,544698,cPa75,18,238,136
Scaffold18-544899_545510,cPa75,1,1,545458,544949,cPa75,33,611,509
Scaffold18-549075_549196,cPa75,1,1,549144,549125,cPa75,8,121,19
Scaffold18-549302_549404,cPa75,1,1,549381,549319,cPa75,9,102,62
Scaffold18-549517_549619,cPa75,1,1,549579,549567,cPa75,3,102,12
Scaffold18-554641_554743,cPa75,1,1,554691,554691,cPa75,1,102,0
Scaffold18-554828_554999,cPa75,1,1,554947,554878,cPa75,3,171,69
Scaffold18-564058_564160,cPa75,1,1,564108,564108,cPa75,1,102,0
Scaffold18-564292_565241,cPa75,1,1,565189,564342,cPa75,34,949,847
Scaffold18-572337_572439,cPa75,1,1,572387,572387,cPa75,1,102,0
Scaffold18-572599_572801,cPa75,0.818181818181818,2,572749,572649,cPa75_cPa75-unknown,9_2,202,100
Scaffold18-576176_576278,cPa75,1,1,576226,576226,cPa75,1,102,0
Scaffold18-576426_576528,cPa75,1,1,576476,576476,cPa75,1,102,0
Scaffold18-581427_581848,cPa75,1,1,581796,581477,cPa75,14,421,319
Scaffold18-581850_582120,cPa75,1,1,582068,581897,cPa75,15,270,171
Scaffold18-603547_603649,cPa447,1,1,603597,603597,cPa447,1,102,0
Scaffold18-605554_605656,cPa75,1,1,605637,605604,cPa75,2,102,33
Scaffold18-605846_605948,cPa75,1,1,605896,605896,cPa75,1,102,0
Scaffold18-606032_606134,cPa75,1,1,606082,606082,cPa75,1,102,0
Scaffold18-607316_607418,cPa293,1,1,607366,607366,cPa293,1,102,0
Scaffold18-626367_626469,cPa75-cPa360-hybrid,1,1,626417,626417,cPa75-cPa360-hybrid,1,102,0
Scaffold18-626907_627017,cPa75-cPa360-hybrid,1,1,626965,626957,cPa75-cPa360-hybrid,2,110,8
Scaffold18-631223_631389,cPa75,1,1,631337,631273,cPa75,5,166,64
Scaffold18-631531_631633,cPa75,1,1,631581,631581,cPa75,1,102,0
Scaffold18-631677_631865,cPa75,1,1,631813,631727,cPa75,4,188,86
Scaffold18-631871_631993,cPa75,1,1,631953,631921,cPa75,3,122,32
Scaffold18-632085_632304,cPa75,1,1,632278,632095,cPa75,9,219,183
Scaffold18-632402_632725,cPa75,1,1,632673,632452,cPa75,7,323,221
Scaffold18-634927_635029,cPa572,1,1,634977,634977,cPa572,1,102,0
Scaffold18-640822_640924,cPa75-unknown,1,1,640872,640872,cPa75-unknown,1,102,0
Scaffold18-671640_672261,cPa75,1,1,672209,671690,cPa75,30,621,519
Scaffold18-672283_672385,cPa75,1,1,672333,672333,cPa75,1,102,0
Scaffold18-672399_672501,cPa75,1,1,672471,672418,cPa75,4,102,53
Scaffold18-672638_672746,cPa75,1,1,672744,672663,cPa75,10,108,81
Scaffold18-673268_673370,cPa75,1,1,673318,673300,cPa75,4,102,18
Scaffold18-673399_673501,cPa75,1,1,673498,673400,cPa75,8,102,98
Scaffold18-684597_684868,cPa75,1,1,684816,684647,cPa75,8,271,169
Scaffold18-684921_685479,cPa75,1,1,685442,684971,cPa75,20,558,471
Scaffold18-690247_690349,cPa75,1,1,690297,690297,cPa75,1,102,0
Scaffold18-690991_691104,cPa75,1,1,691052,691041,cPa75,5,113,11
Scaffold18-691322_691424,cPa75,1,1,691372,691333,cPa75,2,102,39
Scaffold18-694492_694594,cPa75,1,1,694542,694542,cPa75,1,102,0
Scaffold18-694729_694831,cPa75,1,1,694779,694779,cPa75,1,102,0
Scaffold18-694912_695053,cPa75,1,1,695001,694962,cPa75,4,141,39
Scaffold18-695139_695346,cPa75,1,1,695294,695189,cPa75,4,207,105
Scaffold18-695408_695647,cPa75,1,1,695595,695458,cPa75,4,239,137
Scaffold18-697554_697676,cPa75,1,1,697624,697604,cPa75,5,122,20
Scaffold18-697773_698218,cPa75,1,1,698166,697823,cPa75,13,445,343
Scaffold18-698281_698383,cPa75,1,1,698331,698331,cPa75,1,102,0
Scaffold18-699137_699239,cPa75,1,1,699187,699155,cPa75,6,102,32
Scaffold18-699483_699788,cPa75,1,1,699736,699521,cPa75,10,305,215
Scaffold18-699826_700031,cPa75,1,1,699979,699865,cPa75,14,205,114
Scaffold18-700050_700152,cPa75,1,1,700100,700085,cPa75,2,102,15
Scaffold18-700191_700293,cPa75,1,1,700247,700241,cPa75,2,102,6
Scaffold18-700314_700416,cPa75,1,1,700376,700364,cPa75,3,102,12
Scaffold18-701008_701110,cPa75,1,1,701084,701058,cPa75,3,102,26
Scaffold18-702558_702660,cPa75,1,1,702608,702608,cPa75,1,102,0
Scaffold18-702933_703039,cPa75,1,1,702987,702982,cPa75,4,106,5
Scaffold18-703098_703247,cPa75,1,1,703243,703148,cPa75,4,149,95
Scaffold18-703973_704075,cPa75,1,1,704023,704023,cPa75,1,102,0
Scaffold18-704159_704261,cPa75,1,1,704209,704209,cPa75,1,102,0
Scaffold18-707159_707261,cPa75,1,1,707209,707209,cPa75,1,102,0
Scaffold18-710576_710678,cPa75,1,1,710626,710626,cPa75,1,102,0
Scaffold18-711011_711113,cPa75,1,1,711061,711061,cPa75,1,102,0
Scaffold18-711131_711233,cPa75,1,1,711181,711181,cPa75,1,102,0
Scaffold18-711240_711342,cPa75,1,1,711290,711290,cPa75,1,102,0
Scaffold18-712949_713051,cPa75,1,1,712999,712999,cPa75,1,102,0
Scaffold18-713162_713264,cPa75,1,1,713212,713212,cPa75,1,102,0
Scaffold18-713360_713462,cPa447_cPa75_cPa75-CAEV_NC001463-hybrid,0.333333333333333,3,713410,713403,cPa447_cPa75_cPa75-CAEV_NC001463-hybrid,1_1_1,102,7
Scaffold18-713658_713760,cPa75,1,1,713708,713708,cPa75,1,102,0
Scaffold18-713972_714098,cPa75,1,1,714046,714022,cPa75,2,126,24
Scaffold18-714172_714274,cPa75,1,1,714222,714222,cPa75,1,102,0
Scaffold18-736396_736502,cPa75,1,1,736474,736446,cPa75,4,106,28
Scaffold18-754787_754999,cPa75,1,1,754947,754837,cPa75,5,212,110
Scaffold18-755085_755192,cPa75,1,1,755140,755092,cPa75,4,107,48
Scaffold18-785005_785107,cPa75,1,1,785055,785055,cPa75,1,102,0
Scaffold18-785395_785512,cPa75,1,1,785460,785445,cPa75,2,117,15
Scaffold18-786053_786155,cPa75,1,1,786103,786103,cPa75,1,102,0
Scaffold18-796285_796456,cPa75,1,1,796442,796335,cPa75,5,171,107
Scaffold18-796472_796574,cPa75,1,1,796522,796480,cPa75,2,102,42
Scaffold18-799345_799500,cPa75,1,1,799448,799395,cPa75,6,155,53
Scaffold18-799537_799850,cPa75,1,1,799798,799587,cPa75,8,313,211
Scaffold18-799851_800195,cPa75,1,1,800143,799901,cPa75,20,344,242
Scaffold18-806175_806277,cPa75,1,1,806225,806225,cPa75,1,102,0
Scaffold18-82873_82975,cPa75,1,1,82923,82923,cPa75,1,102,0
Scaffold18-829690_829792,cPa75,1,1,829740,829740,cPa75,1,102,0
Scaffold18-83046_83148,cPa75,1,1,83096,83096,cPa75,1,102,0
Scaffold18-830519_830684,cPa75,1,1,830632,830569,cPa75,3,165,63
Scaffold18-830959_831167,cPa75,1,1,831115,830989,cPa75,6,208,126
Scaffold18-831201_831303,cPa75,1,1,831251,831251,cPa75,1,102,0
Scaffold18-83405_83507,cPa75,1,1,83455,83455,cPa75,1,102,0
Scaffold18-834785_834887,cPa75,1,1,834835,834835,cPa75,1,102,0
Scaffold18-83687_83808,cPa62-cPa75-hybrid_cPa75,0.5,2,83756,83737,cPa62-cPa75-hybrid_cPa75,1_1,121,19
Scaffold18-846352_846454,cPa75,1,1,846402,846402,cPa75,1,102,0
Scaffold18-846631_846733,cPa75,1,1,846681,846681,cPa75,1,102,0
Scaffold18-846821_847077,cPa75,1,1,847025,846871,cPa75,9,256,154
Scaffold18-847084_847308,cPa75,1,1,847256,847134,cPa75,11,224,122
Scaffold18-847349_847727,cPa75,1,1,847696,847399,cPa75,25,378,297
Scaffold18-853174_853276,cPa75-unknown,1,1,853224,853224,cPa75-unknown,1,102,0
Scaffold18-857801_857925,cPa75,1,1,857873,857851,cPa75,4,124,22
Scaffold18-857990_858116,cPa75,1,1,858065,858040,cPa75,19,126,25
Scaffold18-858203_858401,cPa75,1,1,858392,858236,cPa75,20,198,156
Scaffold18-860510_860612,cPa75,1,1,860560,860560,cPa75,1,102,0
Scaffold18-860652_860754,cPa75,1,1,860702,860702,cPa75,1,102,0
Scaffold18-871389_871651,cPa75,1,1,871625,871439,cPa75,4,262,186
Scaffold18-871742_871889,cPa75,1,1,871837,871779,cPa75,4,147,58
Scaffold18-871916_872018,cPa75,1,1,871966,871966,cPa75,1,102,0
Scaffold18-87837_88067,cPa75,1,1,88015,87887,cPa75,5,230,128
Scaffold18-88165_88267,cPa75,1,1,88215,88215,cPa75,1,102,0
Scaffold18-88465_88567,cPa75,1,1,88515,88515,cPa75,1,102,0
Scaffold18-887089_887191,cPa75,1,1,887181,887099,cPa75,7,102,82
Scaffold18-887878_888073,cPa75,1,1,888021,887928,cPa75,5,195,93
Scaffold18-888162_888264,cPa75,1,1,888264,888187,cPa75,4,102,77
Scaffold18-888334_888436,cPa75,1,1,888384,888384,cPa75,1,102,0
Scaffold18-910668_910979,cPa75,1,1,910927,910718,cPa75,5,311,209
Scaffold18-941635_941737,HML3_repbase_HERVK9I_MER9,1,1,941705,941685,HML3_repbase_HERVK9I_MER9,2,102,20
Scaffold18-946286_946388,cPa75,1,1,946336,946336,cPa75,1,102,0
Scaffold18-946424_946526,cPa75,1,1,946474,946474,cPa75,1,102,0
Scaffold18-946837_946939,cPa75,1,1,946887,946887,cPa75,1,102,0
Scaffold18-948036_948138,cPa75,1,1,948136,948038,cPa75,4,102,98
Scaffold18-956299_956401,cPa555,1,1,956349,956349,cPa555,1,102,0
Scaffold18-969908_970010,cPa75,1,1,969958,969958,cPa75,1,102,0
Scaffold18-970036_970439,cPa75,1,1,970428,970086,cPa75,44,403,342
Scaffold18-970466_970623,cPa75,1,1,970583,970516,cPa75,4,157,67
Scaffold18-970624_970784,cPa75,1,1,970741,970650,cPa75,11,160,91
Scaffold18-993056_993186,cPa75,1,1,993139,993091,cPa75,7,130,48
Scaffold18-993376_993502,cPa75,1,1,993450,993426,cPa75,3,126,24
Scaffold18-993727_993832,cPa75,1,1,993815,993775,cPa75,10,105,40
Scaffold18-993880_993982,cPa75,1,1,993930,993930,cPa75,1,102,0
Scaffold18-998955_999057,cPa75,1,1,999005,999005,cPa75,1,102,0
Scaffold180-2195_2297,cPa419,1,1,2245,2245,cPa419,1,102,0
Scaffold180-28204_28306,cPa419,1,1,28254,28254,cPa419,1,102,0
Scaffold180-37482_37584,cPa419,1,1,37532,37532,cPa419,1,102,0
Scaffold181-34084_34186,cPa62,1,1,34134,34134,cPa62,1,102,0
Scaffold182-39908_40025,cPa419,1,1,39973,39927,cPa419,9,117,46
Scaffold182-41059_41161,cPa419,1,1,41109,41098,cPa419,5,102,11
Scaffold182-50391_50502,cPa419,1,1,50466,50441,cPa419,5,111,25
Scaffold182-50525_50627,cPa419,1,1,50575,50534,cPa419,14,102,41
Scaffold182-52969_53071,cPa419,1,1,53062,53019,cPa419,17,102,43
Scaffold182-53109_53211,cPa419,1,1,53179,53155,cPa419,3,102,24
Scaffold182-53228_53330,cPa419,1,1,53278,53278,cPa419,1,102,0
Scaffold182-53658_53760,cPa419,1,1,53742,53682,cPa419,20,102,60
Scaffold182-54007_54109,cPa419,1,1,54057,54044,cPa419,2,102,13
Scaffold182-54531_54835,cPa419,1,1,54829,54535,cPa419,59,304,294
Scaffold182-56755_56857,cPa419,1,1,56805,56783,cPa419,2,102,22
Scaffold182-57458_57714,cPa419,1,1,57702,57494,cPa419,52,256,208
Scaffold182-57883_57985,cPa419,1,1,57976,57893,cPa419,38,102,83
Scaffold182-58062_58164,cPa419,1,1,58112,58074,cPa419,3,102,38
Scaffold182-58182_58284,cPa419,1,1,58232,58232,cPa419,1,102,0
Scaffold182-6521_6623,cPa419,1,1,6579,6571,cPa419,2,102,8
Scaffold182-67610_67788,cPa419,1,1,67787,67613,cPa419,7,178,174
Scaffold182-67791_67974,cPa419,1,1,67943,67796,cPa419,14,183,147
Scaffold182-71045_71147,cPa419,1,1,71147,71064,cPa419,3,102,83
Scaffold182-7124_7302,cPa419,1,1,7273,7174,cPa419,10,178,99
Scaffold182-71338_71442,cPa419,1,1,71406,71356,cPa419,5,104,50
Scaffold182-71734_71836,cPa419,1,1,71825,71760,cPa419,8,102,65
Scaffold182-71980_72152,cPa419,1,1,72124,71983,cPa419,14,172,141
Scaffold182-72339_72480,cPa419,1,1,72456,72381,cPa419,10,141,75
Scaffold182-7413_7576,cPa419,1,1,7544,7437,cPa419,35,163,107
Scaffold182-7650_7784,cPa419,1,1,7783,7691,cPa419,26,134,92
Scaffold183-10379_10481,cPa428,0.512455516014235,3,10451,10378,cPa356_cPa419-unknown_cPa428,136_1_144,102,73
Scaffold183-10509_10611,cPa356,0.555555555555556,2,10584,10521,cPa356_cPa428,15_12,102,63
Scaffold183-12396_12532,cPa428,0.553571428571429,2,12493,12430,cPa356_cPa428,25_31,136,63
Scaffold183-12613_12844,cPa428,0.526315789473684,2,12830,12617,cPa356_cPa428,54_60,231,213
Scaffold183-12940_13042,cPa356_cPa428,0.4,3,12990,12953,cPa356_cPa356-unknown_cPa428,2_1_2,102,37
Scaffold183-19858_19960,cPa428,1,1,19908,19908,cPa428,1,102,0
Scaffold183-34695_34797,cPa356_cPa428,0.5,2,34756,34745,cPa356_cPa428,1_1,102,11
Scaffold183-7551_7709,cPa356,0.541666666666667,2,7657,7601,cPa356_cPa428,52_44,158,56
Scaffold183-7714_7952,cPa356,0.620689655172414,2,7931,7722,cPa356_cPa428,18_11,238,209
Scaffold183-8347_8449,cPa428,1,1,8397,8397,cPa428,1,102,0
Scaffold183-8504_8655,cPa428,0.6,2,8604,8554,cPa356_cPa428,2_3,151,50
Scaffold183-8791_8893,cPa428,0.511627906976744,2,8868,8801,cPa356_cPa428,21_22,102,67
Scaffold183-9253_9387,cPa428,0.571428571428571,2,9383,9303,cPa356_cPa428,30_40,134,80
Scaffold184-50957_51059,cPa419,1,1,51012,50964,cPa419,13,102,48
Scaffold184-52079_52275,cPa419,0.967741935483871,2,52255,52129,cPa419_cPa478-cPa298-hybrid,30_1,196,126
Scaffold184-52352_52454,cPa419,1,1,52402,52362,cPa419,2,102,40
Scaffold185-17546_17657,cPa419,1,1,17605,17596,cPa419,2,111,9
Scaffold19-133294_133409,cPa199_cPa205,0.333333333333333,6,133409,133305,cPa199_cPa205_cPa205-unknown_cPa228-cPa152-hybrid_cPa61_cPa61-cPa205-hybrid,8_8_1_1_5_1,115,104
Scaffold19-143405_143664,FrMuLV_NC001362,0.294642857142857,24,143655,143405,cPa118-cPa315-hybrid_cPa308-cPa75-hybrid_cPa332-cPa404-hybrid_cPa332-cPa61-hybrid_cPa419_cPa425_cPa456-cPa183-hybrid_cPa456-cPa425-hybrid_cPa47_cPa47-cPa183-hybrid_cPa47-cPa425-hybrid_cPa552-cPa183-hybrid_cPa552-cPa529-hybrid_cPa75_FrMuLV_NC001362_FrMuLV_NC001362-cPa15-hybrid_FrMuLV_NC001362-cPa183-hybrid_FrMuLV_NC001362-cPa315-hybrid_FrMuLV_NC001362-cPa404-hybrid_FrMuLV_NC001362-cPa425-hybrid_FrMuLV_NC001362-cPa47-hybrid_FrMuLV_NC001362-cPa61-hybrid_FrMuLV_NC001362-cPa75-hybrid_FrMuLV_NC001362-unknown,1_1_1_1_1_1_3_1_10_1_1_3_1_3_33_1_13_1_1_2_1_2_8_21,259,250
Scaffold19-143737_143839,FrMuLV_NC001362,0.428571428571429,9,143818,143742,cPa332-cPa404-hybrid_cPa456-cPa75-hybrid_cPa47_cPa47-cPa183-hybrid_cPa552-cPa183-hybrid_cPa552-cPa75-hybrid_FrMuLV_NC001362_FrMuLV_NC001362-cPa75-hybrid_FrMuLV_NC001362-unknown,1_2_2_1_1_1_9_2_2,102,76
Scaffold19-145562_145664,cPa163_cPa332-cPa224-hybrid_cPa47-cPa224-hybrid,0.333333333333333,3,145642,145590,cPa163_cPa332-cPa224-hybrid_cPa47-cPa224-hybrid,1_1_1,102,52
Scaffold19-165683_165785,cPa15,0.666666666666667,3,165738,165720,cPa118_cPa15_cPa443,1_4_1,102,18
Scaffold19-170018_170120,cPa75,0.642857142857143,3,170070,170018,cPa201-cPa75-hybrid_cPa447-cPa75-hybrid_cPa75,2_3_9,102,52
Scaffold19-172490_172592,cPa447,0.444444444444444,6,172589,172494,cPa363-cPa75-hybrid_cPa390-cPa452-hybrid_cPa447_cPa452_cPa74-cPa199-hybrid_cPa74-unknown,1_1_4_1_1_1,102,95
Scaffold19-172665_172767,cPa447,0.571428571428571,7,172743,172676,cPa199_cPa363-cPa75-hybrid_cPa390-cPa199-hybrid_cPa447_cPa449-cPa75-hybrid_cPa74-cPa449-hybrid_cPa74-cPa75-hybrid,1_1_1_8_1_1_1,102,67
Scaffold19-173766_173868,cPa447,1,1,173816,173783,cPa447,2,102,33
Scaffold19-174333_174435,cPa447,0.75,2,174383,174347,cPa447_cPa449,3_1,102,36
Scaffold19-175245_175347,cPa447,0.8,3,175333,175244,cPa174_cPa254-cPa15-hybrid_cPa447,2_1_12,102,89
Scaffold19-175445_175558,cPa447,1,1,175557,175461,cPa447,14,113,96
Scaffold19-175603_175810,cPa447,0.970588235294118,2,175809,175641,cPa419_cPa447,1_33,207,168
Scaffold19-176987_177119,cPa447,0.9,3,177071,176990,cPa357_cPa419_cPa447,1_1_18,132,81
Scaffold19-177173_177275,cPa447,1,1,177223,177223,cPa447,1,102,0
Scaffold19-189082_189184,cPa47,1,1,189132,189132,cPa47,1,102,0
Scaffold19-190882_190984,cPa174,1,1,190932,190932,cPa174,1,102,0
Scaffold19-191676_191778,cPa174,0.666666666666667,2,191726,191705,cPa174_cPa47,2_1,102,21
Scaffold19-191894_192031,cPa174-cPa254-hybrid_cPa47,0.214285714285714,8,192005,191894,cPa174_cPa174-cPa254-hybrid_cPa174-cPa425-hybrid_cPa174-cPa47-hybrid_cPa404-cPa254-hybrid_cPa425_cPa425-cPa254-hybrid_cPa47,2_3_1_1_1_2_1_3,137,111
Scaffold19-192131_192331,cPa174_cPa404-cPa254-hybrid_cPa47,0.333333333333333,3,192279,192181,cPa174_cPa404-cPa254-hybrid_cPa47,1_1_1,200,98
Scaffold19-192682_192919,cPa174_cPa174-cPa254-hybrid,0.210526315789474,10,192875,192732,cPa174_cPa174-cPa254-hybrid_cPa174-cPa425-hybrid_cPa174-cPa47-hybrid_cPa404-cPa174-hybrid_cPa404-cPa254-hybrid_cPa425_cPa425-cPa174-hybrid_cPa425-cPa254-hybrid_cPa47,8_8_1_2_1_4_5_1_1_7,237,143
Scaffold19-23413_23515,cPa21_cPa452,0.5,2,23466,23463,cPa21_cPa452,1_1,102,3
Scaffold19-242680_242782,cPa174,1,1,242730,242730,cPa174,1,102,0
Scaffold19-266713_266821,cPa553,0.25,14,266769,266763,cPa227_cPa227-cPa199-hybrid_cPa227-cPa542-hybrid_cPa273_cPa345_cPa345-unknown_cPa450_cPa482-cPa227-hybrid_cPa482-cPa273-hybrid_cPa482-cPa345-hybrid_cPa482-cPa450-hybrid_cPa482-cPa542-hybrid_cPa482-unknown_cPa553,5_2_2_9_5_2_14_3_2_1_1_12_5_21,108,6
Scaffold19-266909_267333,cPa553,0.228443449048152,48,267295,266959,cPa199_cPa199-cPa542-hybrid_cPa199-unknown_cPa223-cPa542-hybrid_cPa227_cPa227-cPa199-hybrid_cPa227-cPa273-hybrid_cPa227-cPa345-hybrid_cPa227-cPa542-hybrid_cPa227-unknown_cPa273_cPa273-cPa199-hybrid_cPa273-cPa227-hybrid_cPa273-cPa332-hybrid_cPa273-cPa450-hybrid_cPa273-cPa542-hybrid_cPa273-unknown_cPa345_cPa345-cPa199-hybrid_cPa345-cPa227-hybrid_cPa345-cPa273-hybrid_cPa345-cPa450-hybrid_cPa345-cPa542-hybrid_cPa345-unknown_cPa450_cPa450-cPa227-hybrid_cPa450-cPa273-hybrid_cPa450-cPa345-hybrid_cPa450-cPa542-hybrid_cPa450-unknown_cPa482_cPa482-cPa199-hybrid_cPa482-cPa227-hybrid_cPa482-cPa273-hybrid_cPa482-cPa450-hybrid_cPa482-cPa542-hybrid_cPa482-cPa553-hybrid_cPa482-unknown_cPa542_cPa553_cPa553-cPa450-hybrid_cPa553-cPa542-hybrid_cPa553-unknown_cPa75_cPa75-cPa199-hybrid_cPa75-cPa273-hybrid_cPa75-cPa345-hybrid_cPa75-cPa542-hybrid,14_8_1_1_63_1_5_3_28_3_123_1_1_1_1_7_1_127_1_3_4_2_9_4_148_4_3_1_7_4_10_2_2_12_4_33_1_18_11_204_1_1_1_7_2_1_1_3,424,336
Scaffold19-271683_271908,cPa529-cPa459-hybrid,0.362903225806452,22,271859,271716,cPa353-cPa196-hybrid_cPa363-cPa379-hybrid_cPa381-cPa305-hybrid_cPa529_cPa529-cPa121-hybrid_cPa529-cPa196-hybrid_cPa529-cPa305-hybrid_cPa529-cPa424-hybrid_cPa529-cPa459-hybrid_JSRV_DQ838494-cPa121-hybrid_JSRV_DQ838494-cPa196-hybrid_JSRV_DQ838494-cPa305-hybrid_JSRV_DQ838494-cPa425-hybrid_JSRV_DQ838494-cPa459-hybrid_S71_repbase_HERVS71_LTR6A-cPa121-hybrid_S71_repbase_HERVS71_LTR6A-cPa196-hybrid_S71_repbase_HERVS71_LTR6A-cPa305-hybrid_S71_repbase_HERVS71_LTR6A-cPa424-hybrid_S71_repbase_HERVS71_LTR6A-cPa425-hybrid_S71_repbase_HERVS71_LTR6A-cPa452-hybrid_S71_repbase_HERVS71_LTR6A-cPa459-hybrid_S71_repbase_HERVS71_LTR6A-unknown,1_1_1_1_1_7_8_2_45_1_2_2_1_3_1_3_10_1_1_1_30_1,225,143
Scaffold19-272005_272203,cPa529-cPa459-hybrid,0.384615384615385,9,272151,272051,cPa529-cPa229-hybrid_cPa529-cPa305-hybrid_cPa529-cPa424-hybrid_cPa529-cPa459-hybrid_cPa529-unknown_JSRV_DQ838494-cPa305-hybrid_JSRV_DQ838494-cPa459-hybrid_S71_repbase_HERVS71_LTR6A-cPa305-hybrid_S71_repbase_HERVS71_LTR6A-cPa459-hybrid,1_4_1_10_1_1_1_3_4,198,100
Scaffold19-300253_300355,cPa447,0.36986301369863,14,300335,300282,cPa223-cPa15-hybrid_cPa323-cPa117-hybrid_cPa323-cPa118-hybrid_cPa323-cPa15-hybrid_cPa323-cPa199-hybrid_cPa323-cPa229-hybrid_cPa323-cPa313-hybrid_cPa323-cPa444-hybrid_cPa323-cPa452-hybrid_cPa447_cPa449_cPa50-ALVE_FJ793550-hybrid_cPa50-cPa452-hybrid_cPa527-cPa452-hybrid,2_1_4_4_3_3_1_4_2_27_19_1_1_1,102,53
Scaffold19-300366_300468,cPa447,0.454545454545455,4,300462,300392,cPa323-cPa15-hybrid_cPa323-cPa199-hybrid_cPa447_cPa449,1_1_5_4,102,70
Scaffold19-300641_300743,cPa449,0.428571428571429,5,300691,300650,cPa323-cPa118-hybrid_cPa323-cPa15-hybrid_cPa323-cPa313-hybrid_cPa447_cPa449,1_1_1_1_3,102,41
Scaffold19-300789_300937,cPa447,0.4,4,300885,300833,cPa323-cPa199-hybrid_cPa447_cPa449_cPa449-cPa118-hybrid,1_2_1_1,148,52
Scaffold19-301670_301898,cPa313,0.251533742331288,23,301895,301674,cPa223_cPa229_cPa229-cPa363-hybrid_cPa264-cPa327-hybrid_cPa313_cPa313-cPa456-hybrid_cPa323-cPa223-hybrid_cPa323-cPa444-hybrid_cPa339_cPa339-cPa223-hybrid_cPa339-cPa444-hybrid_cPa390-cPa223-hybrid_cPa390-cPa424-hybrid_cPa390-cPa444-hybrid_cPa404-cPa15-hybrid_cPa447_cPa447-cPa223-hybrid_cPa449_cPa50-cPa339-hybrid_cPa527-cPa444-hybrid_cPa568-cPa223-hybrid_cPa568-cPa444-hybrid_cPa62-cPa118-hybrid,29_25_1_1_41_1_2_6_7_1_2_1_1_1_1_7_1_30_1_1_1_1_1,228,221
Scaffold19-302206_302308,cPa223,0.390243902439024,4,302298,302206,cPa223_cPa229_cPa313_cPa449,32_9_11_30,102,92
Scaffold19-302330_302584,cPa449,0.340909090909091,10,302584,302334,cPa223_cPa228_cPa228-cPa313-hybrid_cPa228-cPa459-hybrid_cPa229_cPa313_cPa313-unknown_cPa443-cPa118-hybrid_cPa443-cPa363-hybrid_cPa449,9_3_1_2_6_5_1_1_1_15,254,250
Scaffold19-304284_304386,cPa223,0.186567164179104,15,304386,304287,cPa199_cPa223_cPa228-cPa199-hybrid_cPa228-cPa456-hybrid_cPa228-cPa542-hybrid_cPa229_cPa313_cPa332_cPa345-cPa15-hybrid_cPa443-cPa199-hybrid_cPa443-cPa450-hybrid_cPa449_cPa450-cPa199-hybrid_cPa456_cPa553,3_25_2_3_1_20_21_23_1_3_1_23_1_6_1,102,99
Scaffold19-306110_306446,cPa449,0.20353982300885,41,306409,306112,cPa16-cPa583-hybrid_cPa176-cPa174-hybrid_cPa176-cPa199-hybrid_cPa176-cPa229-hybrid_cPa176-cPa254-hybrid_cPa176-cPa323-hybrid_cPa176-cPa392-hybrid_cPa176-cPa395-hybrid_cPa176-cPa449-hybrid_cPa176-cPa456-hybrid_cPa176-cPa47-hybrid_cPa183-cPa174-hybrid_cPa183-cPa392-hybrid_cPa183-cPa456-hybrid_cPa223_cPa229_cPa313_cPa332_cPa358_cPa358-cPa174-hybrid_cPa424-cPa229-hybrid_cPa424-cPa254-hybrid_cPa424-cPa47-hybrid_cPa449_cPa450-cPa583-hybrid_cPa452_cPa452-cPa174-hybrid_cPa452-cPa199-hybrid_cPa452-cPa223-hybrid_cPa452-cPa229-hybrid_cPa452-cPa254-hybrid_cPa452-cPa323-hybrid_cPa452-cPa392-hybrid_cPa452-cPa395-hybrid_cPa452-cPa404-hybrid_cPa452-cPa456-hybrid_cPa456-cPa583-hybrid_cPa583_cPa75-cPa254-hybrid_cPa75-cPa392-hybrid_cPa75-cPa47-hybrid,1_3_5_1_3_1_3_1_1_1_2_1_1_1_1_13_21_4_1_1_1_1_2_23_1_1_1_1_1_1_2_1_1_1_1_2_1_1_2_1_1,336,297
Scaffold19-307579_307714,cPa449,0.464285714285714,8,307708,307611,cPa176-cPa229-hybrid_cPa176-cPa357-hybrid_cPa176-cPa395-hybrid_cPa176-cPa449-hybrid_cPa199-cPa583-hybrid_cPa229_cPa313_cPa449,1_1_1_1_1_5_5_13,135,97
Scaffold19-307729_307837,cPa449,0.36734693877551,5,307822,307735,cPa176-cPa229-hybrid_cPa229_cPa313_cPa449_cPa75-cPa229-hybrid,3_10_17_18_1,108,87
Scaffold19-308502_308626,cPa449,0.409090909090909,6,308622,308506,cPa229_cPa229-cPa227-hybrid_cPa229-cPa449-hybrid_cPa313_cPa449_cPa449-cPa323-hybrid,7_1_1_16_18_1,124,116
Scaffold19-311887_312076,cPa227,0.211111111111111,12,312076,311887,cPa164_cPa168_cPa227_cPa273_cPa357_cPa357-cPa273-hybrid_cPa450_cPa450-cPa583-hybrid_cPa469_cPa469-cPa475-hybrid_cPa475_cPa583,2_12_19_1_6_1_8_1_15_1_8_16,189,189
Scaffold19-312111_312484,cPa227,0.219512195121951,20,312478,312111,cPa163-cPa475-hybrid_cPa164_cPa164-cPa273-hybrid_cPa168_cPa168-cPa357-hybrid_cPa227_cPa227-cPa168-hybrid_cPa227-cPa273-hybrid_cPa227-cPa357-hybrid_cPa273_cPa357_cPa357-cPa273-hybrid_cPa357-cPa583-hybrid_cPa450_cPa450-cPa168-hybrid_cPa450-cPa583-hybrid_cPa469_cPa475_cPa583_cPa583-cPa357-hybrid,1_4_1_37_1_54_1_1_1_3_29_1_1_13_1_1_31_17_47_1,373,367
Scaffold19-313005_313107,cPa227,0.4,6,313105,313038,cPa168_cPa227_cPa357_cPa450_cPa469_cPa542-cPa450-hybrid,2_6_4_1_1_1,102,67
Scaffold19-313160_313262,cPa227,0.4,6,313261,313190,cPa168_cPa227_cPa273_cPa357_cPa469_cPa583,2_8_1_3_4_2,102,71
Scaffold19-313285_313387,cPa227_cPa357_cPa583,0.333333333333333,3,313345,313301,cPa227_cPa357_cPa583,1_1_1,102,44
Scaffold19-314299_314401,cPa227,0.588235294117647,5,314352,314311,cPa168_cPa227_cPa357_cPa450_cPa469,3_10_2_1_1,102,41
Scaffold19-314458_314560,cPa227,0.5,4,314557,314472,cPa168_cPa227_cPa357_cPa583,1_6_4_1,102,85
Scaffold19-314789_314897,cPa227,0.476190476190476,7,314849,314808,cPa168_cPa227_cPa357_cPa450_cPa469_cPa475_cPa583,3_10_1_1_3_1_2,108,41
Scaffold19-315534_315646,cPa227,0.232558139534884,10,315645,315534,cPa168_cPa168-cPa227-hybrid_cPa227_cPa357_cPa357-cPa138-hybrid_cPa357-cPa469-hybrid_cPa450_cPa469_cPa475_cPa583,18_1_20_13_1_1_3_11_4_14,112,111
Scaffold19-315897_315999,cPa227,0.212389380530973,11,315996,315900,cPa168_cPa227_cPa227-cPa168-hybrid_cPa357_cPa450_cPa450-cPa469-hybrid_cPa469_cPa475_cPa475-cPa450-hybrid_cPa475-cPa469-hybrid_cPa583,23_24_1_14_7_1_20_4_1_1_17,102,96
Scaffold19-316534_316636,cPa168_cPa227_cPa357,0.222222222222222,6,316622,316534,cPa168_cPa227_cPa273-cPa469-hybrid_cPa357_cPa469_cPa475,2_2_1_2_1_1,102,88
Scaffold19-317848_318273,cPa450,0.166666666666667,23,318268,317851,cPa168_cPa168-cPa357-hybrid_cPa227_cPa227-cPa168-hybrid_cPa227-cPa475-hybrid_cPa273_cPa273-cPa357-hybrid_cPa273-cPa475-hybrid_cPa273-cPa62-hybrid_cPa273-cPa75-hybrid_cPa273-unknown_cPa357_cPa357-cPa168-hybrid_cPa357-cPa475-hybrid_cPa450_cPa450-cPa168-hybrid_cPa450-cPa357-hybrid_cPa450-cPa469-hybrid_cPa469_cPa475_cPa475-cPa168-hybrid_cPa583_cPa583-cPa75-hybrid,11_1_15_1_1_1_2_1_2_1_3_15_1_1_17_1_1_1_2_12_1_10_1,425,417
Scaffold19-318275_318424,cPa450,0.333333333333333,14,318415,318277,cPa168_cPa227_cPa227-cPa357-hybrid_cPa227-cPa475-hybrid_cPa227-cPa75-hybrid_cPa273_cPa273-cPa450-hybrid_cPa273-cPa75-hybrid_cPa273-unknown_cPa357_cPa450_cPa469_cPa475_cPa583,6_7_1_1_1_2_1_1_2_2_14_1_2_1,149,138
Scaffold19-327391_327503,cPa15,0.382978723404255,13,327501,327404,cPa118_cPa119_cPa125_cPa125-cPa118-hybrid_cPa125-cPa140-hybrid_cPa125-cPa223-hybrid_cPa125-cPa268-hybrid_cPa140_cPa15_cPa15-unknown_cPa268-cPa140-hybrid_cPa345-cPa223-hybrid_cPa419,8_1_7_3_1_2_1_1_18_2_1_1_1,112,97
Scaffold19-329749_329851,cPa228-unknown,0.571428571428571,4,329814,329749,cPa119-cPa47-hybrid_cPa228-cPa15-hybrid_cPa228-unknown_cPa443,1_1_4_1,102,65
Scaffold19-329896_330037,cPa47,0.185185185185185,16,330036,329899,cPa119-cPa425-hybrid_cPa125-cPa254-hybrid_cPa125-cPa425-hybrid_cPa140_cPa15_cPa15-cPa404-hybrid_cPa174_cPa228-cPa125-hybrid_cPa228-cPa15-hybrid_cPa254_cPa254-cPa404-hybrid_cPa264_cPa268_cPa404_cPa425_cPa47,1_3_1_1_1_1_1_1_2_1_1_1_1_4_2_5,141,137
Scaffold19-330361_330463,cPa15-cPa404-hybrid_cPa15-cPa47-hybrid_cPa174_cPa228-cPa118-hybrid_cPa228-cPa47-hybrid_cPa425_cPa47,0.142857142857143,7,330458,330411,cPa15-cPa404-hybrid_cPa15-cPa47-hybrid_cPa174_cPa228-cPa118-hybrid_cPa228-cPa47-hybrid_cPa425_cPa47,1_1_1_1_1_1_1,102,47
Scaffold19-330641_330777,cPa47,0.2,9,330729,330684,cPa15_cPa228-cPa174-hybrid_cPa228-cPa404-hybrid_cPa228-cPa425-hybrid_cPa228-cPa47-hybrid_cPa264-cPa125-hybrid_cPa404-cPa254-hybrid_cPa425_cPa47,1_1_1_1_1_1_1_1_2,136,45
Scaffold19-331956_332105,cPa47,0.444444444444444,9,332073,331957,cPa125-cPa425-hybrid_cPa174_cPa174-cPa404-hybrid_cPa404_cPa425_cPa47_cPa47-cPa15-hybrid_cPa47-cPa425-hybrid_cPa47-unknown,1_1_1_2_1_8_1_2_1,149,116
Scaffold19-332155_332257,cPa47-cPa425-hybrid,1,1,332205,332205,cPa47-cPa425-hybrid,1,102,0
Scaffold19-332912_333014,cPa425,1,1,332962,332962,cPa425,1,102,0
Scaffold19-335965_336123,cPa333,0.578947368421053,7,336087,335985,cPa168-cPa50-hybrid_cPa323_cPa333_cPa371_cPa50_cPa568_cPa568-unknown,1_1_44_1_22_6_1,158,102
Scaffold19-336242_336347,cPa333,0.504273504273504,7,336327,336280,cPa323_cPa333_cPa333-unknown_cPa50_cPa50-cPa568-hybrid_cPa568_cPa568-cPa333-hybrid,3_59_1_35_1_17_1,105,47
Scaffold19-337758_337860,cPa568-cPa75-hybrid,1,1,337810,337808,cPa568-cPa75-hybrid,2,102,2
Scaffold19-339756_339858,cPa264,1,1,339806,339806,cPa264,1,102,0
Scaffold19-339877_339979,cPa447,0.21875,9,339973,339884,cPa140-cPa356-hybrid_cPa140-cPa447-hybrid_cPa140-HIV2_NC001722-hybrid_cPa264_cPa264-cPa447-hybrid_cPa356-cPa447-hybrid_cPa410_cPa447_cPa566,1_5_1_5_2_5_4_7_2,102,89
Scaffold19-340038_340210,cPa410,0.333333333333333,23,340201,340046,cPa140-cPa264-hybrid_cPa140-cPa447-hybrid_cPa15-unknown_cPa264_cPa264-cPa410-hybrid_cPa264-cPa443-hybrid_cPa264-cPa447-hybrid_cPa264-cPa566-hybrid_cPa264-unknown_cPa356-cPa447-hybrid_cPa356-HIV2_NC001722-hybrid_cPa387-cPa95-hybrid_cPa387-HIV2_NC001722-hybrid_cPa410_cPa410-cPa264-hybrid_cPa410-cPa447-hybrid_cPa419_cPa447_cPa447-HIV2_NC001722-hybrid_cPa523-HIV2_NC001722-hybrid_cPa546-cPa447-hybrid_cPa566_PERVA_AY099323-cPa264-hybrid,3_1_1_18_1_1_4_2_1_5_2_1_2_33_1_2_1_13_1_1_1_3_1,172,155
Scaffold19-340552_340654,cPa356,0.333333333333333,5,340634,340555,cPa140-cPa447-hybrid_cPa356_cPa356-unknown_cPa447_cPa566-cPa356-hybrid,1_2_1_1_1,102,79
Scaffold19-350046_350203,cPa425,0.823529411764706,4,350159,350055,cPa419_cPa419-cPa371-hybrid_cPa425_cPa425-cPa194-hybrid,1_1_14_1,157,104
Scaffold19-350292_350519,cPa425,1,1,350504,350342,cPa425,10,227,162
Scaffold19-350589_350789,cPa425,0.690265486725664,16,350783,350598,cPa290-SnRV_NC001724-hybrid_cPa356_cPa356-cPa223-hybrid_cPa356-SnRV_NC001724-hybrid_cPa419_cPa425_cPa425-cPa194-hybrid_cPa425-cPa223-hybrid_cPa425-cPa583-hybrid_cPa425-cPa67-hybrid_cPa425-SnRV_NC001724-hybrid_cPa434-cPa356-hybrid_cPa434-cPa583-hybrid_cPa434-PERVE_NC003059-hybrid_cPa434-SnRV_NC001724-hybrid_cPa434-unknown,1_1_1_1_1_78_8_1_3_2_1_1_6_1_5_2,200,185
Scaffold19-350792_350894,cPa425,0.428571428571429,13,350886,350791,cPa194-cPa425-hybrid_cPa356_cPa419_cPa425_cPa425-cPa194-hybrid_cPa425-cPa67-hybrid_cPa434-cPa425-hybrid_cPa434-cPa583-hybrid_cPa434-cPa75-hybrid_cPa434-SnRV_NC001724-hybrid_cPa434-unknown_cPa510-cPa67-hybrid_HERVHcons-cPa194-hybrid,1_1_1_12_1_1_1_2_1_2_3_1_1,102,95
Scaffold19-350907_351036,cPa434-cPa583-hybrid,0.304347826086957,9,350984,350943,cPa356_cPa356-cPa194-hybrid_cPa356-cPa583-hybrid_cPa425-cPa194-hybrid_cPa425-cPa583-hybrid_cPa425-SnRV_NC001724-hybrid_cPa434-cPa194-hybrid_cPa434-cPa583-hybrid_cPa434-SnRV_NC001724-hybrid,1_2_1_3_1_1_4_7_3,129,41
Scaffold19-351081_351535,cPa434-cPa583-hybrid,0.325,13,351483,351131,cPa194_cPa356_cPa356-cPa194-hybrid_cPa419-cPa194-hybrid_cPa425-cPa194-hybrid_cPa425-cPa583-hybrid_cPa425-cPa67-hybrid_cPa425-SnRV_NC001724-hybrid_cPa434-cPa194-hybrid_cPa434-cPa583-hybrid_cPa434-cPa67-hybrid_cPa434-SnRV_NC001724-hybrid_cPa583,1_1_1_1_7_2_1_1_2_13_3_6_1,454,352
Scaffold19-351604_351739,cPa67,0.391304347826087,7,351737,351604,cPa194_cPa387-cPa583-hybrid_cPa387-SnRV_NC001724-hybrid_cPa425-cPa583-hybrid_cPa434-cPa583-hybrid_cPa447-cPa583-hybrid_cPa67,7_1_1_2_2_1_9,135,133
Scaffold19-354079_354181,cPa425-cPa356-hybrid_cPa447-cPa434-hybrid,0.5,2,354129,354127,cPa425-cPa356-hybrid_cPa447-cPa434-hybrid,1_1,102,2
Scaffold19-354205_354307,cPa425-cPa434-hybrid,1,1,354255,354255,cPa425-cPa434-hybrid,1,102,0
Scaffold19-354343_354445,cPa425-cPa434-hybrid,1,1,354393,354393,cPa425-cPa434-hybrid,1,102,0
Scaffold19-359360_359543,SnRV_NC001724-cPa15-hybrid,0.333333333333333,7,359543,359383,cPa575_MoMLV_J02255-cPa118-hybrid_MoMLV_J02255-cPa15-hybrid_MoMLV_J02255-HERV-W_repbase_HERV17_LTR17-hybrid_SnRV_NC001724-cPa15-hybrid_SnRV_NC001724-HERV-F_repbase_HERVFH19I_LTR19A-hybrid_SnRV_NC001724-HERV-W_repbase_HERV17_LTR17-hybrid,2_1_2_1_4_1_1,183,160
Scaffold19-360845_360947,SnRV_NC001724-cPa15-hybrid,0.375,8,360947,360875,cPa358-cPa140-hybrid_cPa358-cPa15-hybrid_cPa456_cPa587-cPa456-hybrid_SnRV_NC001724_SnRV_NC001724-cPa125-hybrid_SnRV_NC001724-cPa140-hybrid_SnRV_NC001724-cPa15-hybrid,1_1_2_1_1_1_3_6,102,72
Scaffold19-366532_366864,cPa205,0.483333333333333,4,366848,366547,cPa106-PERVE_NC003059-hybrid_cPa205_cPa419_cPa61,1_29_3_27,332,301
Scaffold19-366961_367109,cPa205,1,1,367071,366964,cPa205,6,148,107
Scaffold19-369542_369644,cPa75,0.555555555555556,3,369640,369592,cPa168-cPa402-hybrid_cPa75_cPa75-cPa450-hybrid,1_5_3,102,48
Scaffold19-370298_370400,cPa450,0.375,6,370387,370310,cPa199_cPa199-cPa402-hybrid_cPa199-unknown_cPa362-cPa450-hybrid_cPa450_cPa542-HIV2_NC001722-hybrid,1_1_1_1_3_1,102,77
Scaffold19-377604_377737,cPa379,0.777777777777778,2,377690,377654,cPa379_cPa446,7_2,133,36
Scaffold19-379401_379512,cPa71,0.28125,10,379501,379414,cPa16_cPa176_cPa363_cPa379_cPa446_cPa446-cPa363-hybrid_cPa446-cPa71-hybrid_cPa446-unknown_cPa452_cPa71,5_4_2_1_3_1_1_2_4_9,111,87
Scaffold19-379545_379647,cPa176,0.411764705882353,7,379641,379544,cPa16_cPa176_cPa176-cPa446-hybrid_cPa363_cPa379_cPa452_cPa71,3_7_1_2_1_1_2,102,97
Scaffold19-379657_379854,cPa176,0.271739130434783,14,379853,379656,cPa16_cPa16-cPa446-hybrid_cPa176_cPa176-unknown_cPa363_cPa371-unknown_cPa379_cPa379-unknown_cPa446_cPa446-cPa315-hybrid_cPa446-cPa363-hybrid_cPa452_cPa452-cPa315-hybrid_cPa71,13_1_25_1_16_1_2_1_7_1_1_6_1_16,197,197
Scaffold19-379926_380081,cPa176,0.236842105263158,19,380079,379926,cPa16_cPa16-cPa363-hybrid_cPa176_cPa176-cPa315-hybrid_cPa176-cPa363-hybrid_cPa176-cPa452-hybrid_cPa176-unknown_cPa363_cPa371-cPa446-hybrid_cPa371-unknown_cPa379_cPa419_cPa446_cPa446-cPa16-hybrid_cPa446-cPa363-hybrid_cPa452_cPa452-cPa363-hybrid_cPa452-unknown_cPa71,7_1_36_1_1_1_1_28_1_3_8_2_6_1_1_20_1_1_32,155,153
Scaffold19-380268_380370,cPa176,0.416666666666667,4,380355,380269,cPa176_cPa363_cPa452_cPa71,5_4_1_2,102,86
Scaffold19-380570_380672,cPa363,0.333333333333333,6,380668,380584,cPa16_cPa16-cPa176-hybrid_cPa176_cPa363_cPa452_cPa71,1_1_2_6_3_5,102,84
Scaffold19-381244_381346,cPa379-cPa315-hybrid_cPa71,0.285714285714286,5,381335,381253,cPa176_cPa315_cPa379-cPa315-hybrid_cPa452-unknown_cPa71,1_1_2_1_2,102,82
Scaffold19-382012_382455,cPa16,0.205357142857143,26,382406,382022,cPa16_cPa16-cPa315-hybrid_cPa16-cPa452-hybrid_cPa176_cPa176-cPa315-hybrid_cPa339_cPa339-cPa315-hybrid_cPa339-cPa71-hybrid_cPa339-unknown_cPa357_cPa357-cPa16-hybrid_cPa357-cPa315-hybrid_cPa357-cPa363-hybrid_cPa357-cPa446-hybrid_cPa357-cPa452-hybrid_cPa357-unknown_cPa363_cPa379-cPa446-hybrid_cPa419_cPa446_cPa452_cPa452-cPa71-hybrid_cPa71_cPa71-cPa315-hybrid_cPa71-cPa446-hybrid_cPa75-cPa452-hybrid,23_3_1_15_1_2_1_1_1_5_1_2_3_4_1_5_7_1_2_14_7_1_7_2_1_1,443,384
Scaffold19-382509_382616,cPa176,0.247619047619048,22,382612,382522,cPa16_cPa16-cPa363-hybrid_cPa16-cPa446-hybrid_cPa16-cPa452-hybrid_cPa176_cPa176-cPa16-hybrid_cPa176-cPa363-hybrid_cPa176-cPa446-hybrid_cPa339-cPa363-hybrid_cPa357-cPa16-hybrid_cPa357-cPa363-hybrid_cPa357-cPa379-hybrid_cPa357-cPa446-hybrid_cPa357-cPa452-hybrid_cPa357-cPa71-hybrid_cPa357-unknown_cPa363_cPa379-cPa363-hybrid_cPa419_cPa446_cPa452_cPa71,15_3_2_1_26_1_1_1_1_2_6_1_8_3_1_4_12_1_1_6_7_2,107,90
Scaffold19-382621_382832,cPa446,0.3,7,382807,382627,cPa16_cPa176_cPa176-cPa446-hybrid_cPa363_cPa379_cPa446_cPa452,3_2_2_7_1_9_6,211,180
Scaffold19-384041_384143,cPa452-cPa223-hybrid_cPa452-cPa323-hybrid,0.5,2,384118,384091,cPa452-cPa223-hybrid_cPa452-cPa323-hybrid,1_1,102,27
Scaffold19-386123_386225,cPa47,0.8,2,386180,386155,cPa449-cPa174-hybrid_cPa47,1_4,102,25
Scaffold19-386327_386435,cPa47,0.625,4,386429,386377,cPa174_cPa254_cPa425_cPa47,1_1_1_5,108,52
Scaffold19-387093_387195,cPa47,0.777777777777778,3,387184,387143,cPa174_cPa404_cPa47,1_1_7,102,41
Scaffold19-387553_387666,cPa47,0.374193548387097,27,387663,387577,cPa118-cPa174-hybrid_cPa118-cPa254-hybrid_cPa118-cPa425-hybrid_cPa125_cPa125-cPa174-hybrid_cPa125-cPa254-hybrid_cPa125-cPa404-hybrid_cPa140_cPa140-cPa174-hybrid_cPa140-cPa404-hybrid_cPa15_cPa15-cPa174-hybrid_cPa174_cPa174-cPa404-hybrid_cPa248-cPa404-hybrid_cPa254_cPa268_cPa268-cPa404-hybrid_cPa404_cPa425_cPa425-cPa174-hybrid_cPa425-cPa404-hybrid_cPa443-cPa425-hybrid_cPa443-cPa47-hybrid_cPa47_cPa74-cPa254-hybrid_cPa74-cPa404-hybrid,1_1_1_5_1_1_2_2_1_1_4_1_23_2_1_19_3_1_13_7_1_1_1_1_58_2_1,113,86
Scaffold19-388628_388911,cPa402-cPa223-hybrid,0.348484848484849,29,388859,388627,cPa118_cPa118-cPa223-hybrid_cPa119-cPa113-hybrid_cPa119-cPa223-hybrid_cPa125_cPa125-cPa223-hybrid_cPa140-Cer1_U15406-hybrid_cPa140-cPa223-hybrid_cPa15-cPa223-hybrid_cPa174_cPa174-cPa118-hybrid_cPa174-cPa140-hybrid_cPa174-cPa223-hybrid_cPa248-cPa223-hybrid_cPa254_cPa264-cPa223-hybrid_cPa268-cPa223-hybrid_cPa402-cPa174-hybrid_cPa402-cPa223-hybrid_cPa404_cPa404-cPa443-hybrid_cPa425_cPa425-cPa223-hybrid_cPa443-cPa113-hybrid_cPa443-cPa118-hybrid_cPa443-cPa223-hybrid_cPa443-cPa392-hybrid_cPa516-cPa223-hybrid_cPa74-cPa223-hybrid,4_10_1_2_1_13_1_7_12_4_1_1_3_2_2_2_4_3_46_1_1_1_2_1_1_1_1_1_3,283,232
Scaffold19-389160_389566,cPa402-cPa223-hybrid,0.438461538461538,28,389514,389203,cPa118-cPa223-hybrid_cPa119-cPa223-hybrid_cPa125-cPa113-hybrid_cPa125-cPa223-hybrid_cPa125-cPa392-hybrid_cPa140-cPa223-hybrid_cPa15_cPa15-cPa223-hybrid_cPa15-cPa392-hybrid_cPa174_cPa174-cPa223-hybrid_cPa248-Cer1_U15406-hybrid_cPa248-cPa223-hybrid_cPa264-cPa223-hybrid_cPa268-cPa223-hybrid_cPa315_cPa315-cPa268-hybrid_cPa402-Cer1_U15406-hybrid_cPa402-cPa113-hybrid_cPa402-cPa174-hybrid_cPa402-cPa223-hybrid_cPa402-cPa425-hybrid_cPa404_cPa425_cPa425-cPa443-hybrid_cPa443-cPa223-hybrid_cPa516-cPa223-hybrid_cPa74-cPa223-hybrid,8_3_2_9_1_1_1_7_1_8_1_1_1_1_7_1_1_2_6_1_57_1_2_3_1_1_1_1,406,311
Scaffold19-392495_392597,cPa47,1,1,392545,392545,cPa47,1,102,0
Scaffold19-393326_393437,cPa118_cPa119_cPa125,0.333333333333333,3,393385,393376,cPa118_cPa119_cPa125,1_1_1,111,9
Scaffold19-394285_394387,cPa174,0.375,5,394380,394335,cPa174_cPa264_cPa404_cPa443_cPa47,3_1_1_1_2,102,45
Scaffold19-394559_394678,cPa118-cPa264-hybrid_cPa119_cPa125_cPa174_cPa174-cPa119-hybrid_cPa174-cPa125-hybrid_cPa174-cPa228-hybrid_cPa174-cPa443-hybrid_cPa404_cPa443,0.1,10,394634,394590,cPa118-cPa264-hybrid_cPa119_cPa125_cPa174_cPa174-cPa119-hybrid_cPa174-cPa125-hybrid_cPa174-cPa228-hybrid_cPa174-cPa443-hybrid_cPa404_cPa443,1_1_1_1_1_1_1_1_1_1,119,44
Scaffold19-394793_394895,cPa174,0.272727272727273,11,394887,394808,cPa118-cPa119-hybrid_cPa125_cPa140-cPa228-hybrid_cPa15-cPa174-hybrid_cPa174_cPa174-cPa425-hybrid_cPa194-cPa119-hybrid_cPa425_cPa425-cPa228-hybrid_cPa443_cPa47,1_1_1_1_6_1_1_4_1_1_4,102,79
Scaffold19-409529_409631,cPa395-unknown_cPa447_cPa447-cPa199-hybrid_cPa452-cPa357-hybrid,0.25,4,409615,409552,cPa395-unknown_cPa447_cPa447-cPa199-hybrid_cPa452-cPa357-hybrid,1_1_1_1,102,63
Scaffold19-412088_412190,cPa449,0.567567567567568,11,412188,412087,cPa194-cPa447-hybrid_cPa254-cPa447-hybrid_cPa308-cPa113-hybrid_cPa308-cPa447-hybrid_cPa419_cPa447_cPa449_cPa527-PRIMA41_repbase_PRIMA41_MER41A-hybrid_cPa583-cPa452-hybrid_MLV_Xmv43-cPa447-hybrid_MLV_Xmv43-PRIMA41_repbase_PRIMA41_MER41A-hybrid,1_1_2_1_1_6_21_1_1_1_1,102,101
Scaffold19-414466_414582,cPa357-cPa75-hybrid,0.818181818181818,2,414582,414485,cPa357-cPa75-hybrid_cPa75,9_2,116,97
Scaffold19-435272_435374,cPa425,1,1,435337,435293,cPa425,53,102,44
Scaffold19-441271_441373,cPa15,0.666666666666667,4,441368,441309,cPa118_cPa140_cPa15_cPa248,1_1_10_3,102,59
Scaffold19-444516_444618,cPa47,0.666666666666667,2,444588,444521,cPa174_cPa47,1_2,102,67
Scaffold19-444757_444865,cPa15_cPa254-cPa118-hybrid,0.125,15,444862,444780,cPa118_cPa118-unknown_cPa15_cPa174-cPa15-hybrid_cPa174-unknown_cPa254-cPa118-hybrid_cPa254-cPa264-hybrid_cPa254-unknown_cPa394-cPa118-hybrid_cPa394-cPa47-hybrid_cPa404-cPa118-hybrid_cPa404-cPa264-hybrid_cPa404-cPa371-hybrid_cPa443_cPa47,2_1_3_1_1_3_1_2_1_1_1_2_1_2_2,108,82
Scaffold19-444888_445188,cPa15,0.206896551724138,47,445185,444887,cPa118_cPa125_cPa140_cPa15_cPa15-cPa118-hybrid_cPa15-cPa174-hybrid_cPa15-cPa371-hybrid_cPa15-unknown_cPa174_cPa174-cPa140-hybrid_cPa174-cPa264-hybrid_cPa174-cPa371-hybrid_cPa248-cPa15-hybrid_cPa254-cPa118-hybrid_cPa254-cPa140-hybrid_cPa254-cPa174-hybrid_cPa254-cPa248-hybrid_cPa254-cPa264-hybrid_cPa254-cPa371-hybrid_cPa254-unknown_cPa264_cPa315-cPa140-hybrid_cPa315-cPa15-hybrid_cPa394-cPa118-hybrid_cPa394-cPa125-hybrid_cPa394-cPa140-hybrid_cPa394-cPa15-hybrid_cPa394-cPa174-hybrid_cPa394-cPa443-hybrid_cPa404_cPa404-cPa118-hybrid_cPa404-cPa140-hybrid_cPa404-cPa371-hybrid_cPa404-unknown_cPa425-cPa264-hybrid_cPa425-cPa371-hybrid_cPa434-cPa118-hybrid_cPa434-cPa264-hybrid_cPa443_cPa443-cPa15-hybrid_cPa443-cPa371-hybrid_cPa47_cPa47-cPa15-hybrid_cPa47-cPa371-hybrid_cPa47-cPa443-hybrid_cPa47-unknown_cPa551-cPa174-hybrid,10_3_1_30_1_1_1_1_6_1_1_1_1_1_1_2_2_1_5_5_1_1_1_4_2_1_5_3_3_2_1_1_1_4_1_1_1_2_15_1_1_13_1_1_1_1_1,300,298
Scaffold19-446022_446132,cPa15,0.333333333333333,6,446119,446021,cPa15_cPa248_cPa248-cPa443-hybrid_cPa254-cPa371-hybrid_cPa419_cPa443,3_1_1_1_1_2,110,98
Scaffold19-449630_449735,cPa199_cPa308-cPa199-hybrid_cPa75_cPa75-cPa199-hybrid,0.25,4,449685,449680,cPa199_cPa308-cPa199-hybrid_cPa75_cPa75-cPa199-hybrid,1_1_1_1,105,5
Scaffold19-453280_453395,BaEV_D10032-cPa157-hybrid_cPa188-cPa157-hybrid_cPa323-cPa157-hybrid_cPa419,0.25,4,453343,453325,BaEV_D10032-cPa157-hybrid_cPa188-cPa157-hybrid_cPa323-cPa157-hybrid_cPa419,1_1_1_1,115,18
Scaffold19-453543_453645,BaEV_D10032-HERV-F_repbase_HERVFH19I_LTR19A-hybrid_cPa188-HERV-F_repbase_HERVFH19I_LTR19A-hybrid_cPa323-HERV-F_repbase_HERVFH19I_LTR19A-hybrid_HERV-E_repbase_HERVE_LTR2-cPa157-hybrid_HERV-E_repbase_HERVE_LTR2-cPa223-hybrid,0.2,5,453593,453593,BaEV_D10032-HERV-F_repbase_HERVFH19I_LTR19A-hybrid_cPa188-HERV-F_repbase_HERVFH19I_LTR19A-hybrid_cPa323-HERV-F_repbase_HERVFH19I_LTR19A-hybrid_HERV-E_repbase_HERVE_LTR2-cPa157-hybrid_HERV-E_repbase_HERVE_LTR2-cPa223-hybrid,1_1_1_1_1,102,0
Scaffold19-457649_457751,cPa456,1,1,457716,457699,cPa456,3,102,17
Scaffold19-458692_458794,cPa456,1,1,458764,458742,cPa456,2,102,22
Scaffold19-459868_459970,cPa456,1,1,459950,459918,cPa456,2,102,32
Scaffold19-460843_460945,cPa456,1,1,460893,460893,cPa456,1,102,0
Scaffold19-464231_464333,cPa223_cPa313,0.227272727272727,7,464319,464231,cPa223_cPa229_cPa313_cPa332_cPa449_cPa449-cPa223-hybrid_cPa456,5_2_5_2_4_1_3,102,88
Scaffold19-464391_464493,cPa456,0.375,6,464474,464418,cPa223_cPa229_cPa313_cPa332_cPa449_cPa456,1_1_1_1_1_3,102,56
Scaffold19-464520_464687,cPa456,0.337662337662338,11,464682,464551,cPa223_cPa229_cPa313_cPa313-cPa449-hybrid_cPa332_cPa363-cPa223-hybrid_cPa363-cPa229-hybrid_cPa363-cPa313-hybrid_cPa449_cPa449-cPa229-hybrid_cPa456,1_1_7_1_19_1_1_1_18_1_26,167,131
Scaffold19-467133_467324,cPa332,0.55,3,467324,467147,cPa332_cPa449_cPa456,22_1_17,191,177
Scaffold19-468194_468308,cPa332,0.657894736842105,4,468306,468205,cPa205_cPa332_cPa449_cPa456,1_25_1_11,114,101
Scaffold19-468903_469005,cPa332,0.666666666666667,2,468953,468952,cPa332_cPa456,2_1,102,1
Scaffold19-478656_478762,cPa199,0.892857142857143,3,478710,478670,cPa199_cPa402_cPa402-cPa74-hybrid,25_2_1,106,40
Scaffold19-481056_481235,cPa510,0.35,8,481183,481055,cPa395-cPa15-hybrid_cPa472-cPa15-hybrid_cPa510_cPa510-cPa15-hybrid_cPa510-cPa200-hybrid_cPa544_cPa544-cPa15-hybrid_cPa544-cPa200-hybrid,2_1_7_2_1_2_4_1,179,128
Scaffold19-481283_481385,cPa200,0.5,3,481333,481283,cPa200_cPa510_cPa544,2_1_1,102,50
Scaffold19-485621_485844,cPa15,0.425925925925926,10,485792,485639,cPa118_cPa118-cPa140-hybrid_cPa15_cPa15-cPa248-hybrid_cPa248_cPa248-cPa443-hybrid_cPa268_cPa357-cPa118-hybrid_cPa443_cPa443-cPa268-hybrid,3_1_23_1_12_1_1_1_10_1,223,153
Scaffold19-485899_486166,cPa15,0.48936170212766,7,486114,485942,cPa118_cPa140_cPa15_cPa15-cPa268-hybrid_cPa248_cPa357-cPa268-hybrid_cPa443,1_1_23_1_8_1_12,267,172
Scaffold19-486209_486332,cPa15,0.333333333333333,5,486280,486256,cPa107-cPa15-hybrid_cPa15_cPa248_cPa357-cPa268-hybrid_cPa443,1_2_1_1_1,123,24
Scaffold19-486376_486647,cPa15,0.72,4,486595,486395,cPa118-cPa248-hybrid_cPa15_cPa248_cPa443,1_18_4_2,271,200
Scaffold19-487215_487325,cPa308-cPa227-hybrid,0.5,5,487278,487258,cPa15_cPa15-cPa118-hybrid_cPa268-cPa357-hybrid_cPa308-cPa227-hybrid_cPa308-unknown,1_1_1_4_1,110,20
Scaffold19-487604_487713,cPa15-cPa357-hybrid_cPa308-cPa227-hybrid_cPa308-cPa357-hybrid,0.333333333333333,3,487661,487654,cPa15-cPa357-hybrid_cPa308-cPa227-hybrid_cPa308-cPa357-hybrid,1_1_1,109,7
Scaffold19-487784_488044,cPa118_cPa15,0.258064516129032,26,488004,487821,cPa118_cPa118-cPa15-hybrid_cPa118-cPa168-hybrid_cPa118-cPa227-hybrid_cPa118-cPa258-hybrid_cPa118-cPa583-hybrid_cPa140-cPa118-hybrid_cPa140-cPa168-hybrid_cPa140-cPa227-hybrid_cPa140-cPa258-hybrid_cPa15_cPa15-cPa168-hybrid_cPa15-cPa227-hybrid_cPa248_cPa248-cPa168-hybrid_cPa248-cPa227-hybrid_cPa264-cPa168-hybrid_cPa268-cPa357-hybrid_cPa308-cPa168-hybrid_cPa392-cPa15-hybrid_cPa392-cPa273-hybrid_cPa392-cPa357-hybrid_cPa392-cPa475-hybrid_cPa404-cPa118-hybrid_cPa404-cPa227-hybrid_cPa443,16_1_1_1_1_1_1_1_1_1_16_2_2_4_2_1_1_1_1_1_1_1_1_1_1_1,260,183
Scaffold19-490772_491058,cPa254-cPa419-hybrid_cPa356-cPa419-hybrid,0.4,3,491006,490822,cPa254-cPa419-hybrid_cPa356-cPa419-hybrid_cPa434-HML1a_repbase_HERV-K14CI_LTR14C-hybrid,2_2_1,286,184
Scaffold19-493657_493900,cPa357,0.626865671641791,19,493900,493656,cPa107_cPa107-cPa174-hybrid_cPa107-cPa510-hybrid_cPa107-unknown_cPa15-cPa582-hybrid_cPa168-cPa174-hybrid_cPa168-cPa200-hybrid_cPa168-cPa357-hybrid_cPa200_cPa227-cPa174-hybrid_cPa357_cPa357-cPa510-hybrid_cPa410-cPa510-hybrid_cPa419_cPa510_cPa510-cPa174-hybrid_cPa512-cPa582-hybrid_cPa544_cPa544-cPa410-hybrid,4_2_1_1_1_1_1_1_25_2_126_1_1_1_28_1_1_2_1,243,244
Scaffold19-493915_494017,cPa357,0.65546218487395,17,493974,493914,cPa107-cPa200-hybrid_cPa107-cPa357-hybrid_cPa168-cPa200-hybrid_cPa168-cPa510-hybrid_cPa168-cPa582-hybrid_cPa200_cPa200-cPa227-hybrid_cPa227-cPa174-hybrid_cPa227-cPa357-hybrid_cPa357_cPa510_cPa512-cPa174-hybrid_cPa512-cPa582-hybrid_cPa544_cPa544-cPa200-hybrid_cPa583-cPa510-hybrid_cPa61,4_1_1_1_2_12_1_1_1_78_10_2_1_1_1_1_1,102,60
Scaffold19-495243_495396,cPa357,0.321167883211679,16,495354,495286,cPa15-cPa450-hybrid_cPa168_cPa168-cPa582-hybrid_cPa168-cPa583-hybrid_cPa168-cPa585-hybrid_cPa168-unknown_cPa227_cPa227-cPa200-hybrid_cPa227-cPa585-hybrid_cPa273_cPa357_cPa512-cPa107-hybrid_cPa512-cPa227-hybrid_cPa512-cPa450-hybrid_cPa583_cPa75-cPa510-hybrid,1_35_1_1_1_2_13_1_1_30_44_1_2_1_1_2,153,68
Scaffold19-495412_495686,cPa273,0.292631578947368,37,495682,495411,cPa15-cPa450-hybrid_cPa168_cPa168-cPa227-hybrid_cPa168-cPa273-hybrid_cPa168-cPa357-hybrid_cPa168-cPa450-hybrid_cPa168-cPa530-hybrid_cPa168-cPa583-hybrid_cPa168-cPa585-hybrid_cPa168-unknown_cPa224-cPa450-hybrid_cPa227_cPa227-cPa273-hybrid_cPa227-cPa357-hybrid_cPa227-cPa450-hybrid_cPa227-cPa530-hybrid_cPa227-cPa585-hybrid_cPa273_cPa273-cPa357-hybrid_cPa273-cPa450-hybrid_cPa273-cPa530-hybrid_cPa273-unknown_cPa357_cPa419_cPa450_cPa512-cPa273-hybrid_cPa512-cPa530-hybrid_cPa512-cPa585-hybrid_cPa583_cPa583-cPa227-hybrid_cPa583-cPa450-hybrid_cPa583-cPa585-hybrid_cPa585_cPa75_cPa75-cPa200-hybrid_cPa75-cPa357-hybrid_cPa75-cPa510-hybrid,1_117_3_7_2_3_1_2_3_15_1_35_1_3_4_2_1_139_1_1_2_2_100_1_7_1_4_2_4_1_1_1_2_1_1_1_2,274,271
Scaffold19-511981_512094,cPa163,0.6,3,512081,512030,cPa163_cPa163-unknown_HIV1_NC001802-unknown,3_1_1,113,51
Scaffold19-546503_546617,cPa75,1,1,546565,546553,cPa75,3,114,12
Scaffold19-546702_546804,cPa75,1,1,546752,546752,cPa75,1,102,0
Scaffold19-547274_547376,cPa75,1,1,547324,547324,cPa75,1,102,0
Scaffold19-565713_565815,cPa75,0.8,2,565771,565746,cPa75_cPa75-unknown,4_1,102,25
Scaffold19-71770_71872,cPa47,0.75,2,71858,71783,cPa404_cPa47,1_3,102,75
Scaffold19-72912_73014,cPa47,0.727272727272727,3,72984,72912,cPa15_cPa174_cPa47,1_2_8,102,72
Scaffold19-73318_73420,cPa425-unknown,0.275,9,73414,73317,cPa174_cPa174-cPa47-hybrid_cPa254_cPa404-cPa174-hybrid_cPa425_cPa425-cPa174-hybrid_cPa425-unknown_cPa47_cPa47-cPa125-hybrid,8_1_2_1_7_3_11_6_1,102,97
Scaffold19-73689_73791,cPa47,0.416666666666667,6,73791,73689,cPa174_cPa174-unknown_cPa254_cPa425_cPa425-unknown_cPa47,5_1_1_6_1_10,102,102
Scaffold19-73803_73990,cPa174,0.30952380952381,12,73959,73803,cPa174_cPa174-cPa47-hybrid_cPa254_cPa404_cPa404-cPa371-hybrid_cPa404-cPa47-hybrid_cPa419-cPa174-hybrid_cPa425_cPa425-cPa174-hybrid_cPa425-cPa47-hybrid_cPa425-unknown_cPa47,13_2_1_2_1_2_1_9_1_1_2_7,187,156
Scaffold19-73997_74168,cPa425_cPa47,0.28,7,74132,74028,cPa174_cPa254_cPa404_cPa425_cPa425-cPa47-hybrid_cPa425-unknown_cPa47,5_3_1_7_1_1_7,171,104
Scaffold19-77444_77546,cPa345,1,1,77494,77494,cPa345,1,102,0
Scaffold19-90433_90535,cPa75,1,1,90483,90440,cPa75,2,102,43
Scaffold19-90594_90711,cPa75,1,1,90664,90618,cPa75,21,117,46
Scaffold19-90930_91126,cPa75,1,1,91074,90980,cPa75,11,196,94
Scaffold190-13694_13822,cPa356_cPa428,0.5,2,13771,13740,cPa356_cPa428,6_6,128,31
Scaffold190-15053_15155,cPa356,1,1,15103,15103,cPa356,1,102,0
Scaffold190-30082_30184,cPa356_cPa428,0.5,2,30152,30132,cPa356_cPa428,1_1,102,20
Scaffold190-30270_30372,cPa356,1,1,30320,30320,cPa356,1,102,0
Scaffold190-30618_30720,cPa356_cPa428,0.5,2,30668,30668,cPa356_cPa428,1_1,102,0
Scaffold190-42540_42644,cPa356,0.5,3,42615,42551,cPa356_cPa356-cPa428-hybrid_cPa428,5_1_4,104,64
Scaffold190-45230_45398,cPa428,0.666666666666667,2,45378,45280,cPa356_cPa428,3_6,168,98
Scaffold190-51407_51509,cPa356_cPa428,0.5,2,51457,51457,cPa356_cPa428,1_1,102,0
Scaffold190-56067_56169,cPa428,1,1,56117,56117,cPa428,1,102,0
Scaffold190-58785_58887,cPa428,1,1,58835,58835,cPa428,1,102,0
Scaffold191-28822_28930,cPa419,1,1,28878,28872,cPa419,2,108,6
Scaffold191-29269_29433,cPa419,1,1,29381,29319,cPa419,4,164,62
Scaffold191-29571_29673,cPa419,1,1,29625,29620,cPa419,3,102,5
Scaffold191-65075_65293,cPa419,1,1,65241,65125,cPa419,5,218,116
Scaffold192-13310_13412,cPa505,0.577777777777778,24,13412,13311,cPa109_cPa109-ENTV_NC004994-hybrid_cPa109-MoMLV_J02255-hybrid_cPa152_cPa163-MoMLV_J02255-hybrid_cPa168_cPa168-cPa549-hybrid_cPa174-MoMLV_J02255-hybrid_cPa402-cPa469-hybrid_cPa402-MoMLV_J02255-hybrid_cPa419_cPa425_cPa425-cPa293-hybrid_cPa425-cPa581-hybrid_cPa449-cPa425-hybrid_cPa469_cPa505_cPa74-cPa469-hybrid_cPa75_EqFV_NC002201_EqFV_NC002201-cPa469-hybrid_HTLV1_NC001436_MoMLV_J02255_SMRV_NC001514-cPa293-hybrid,7_1_3_1_1_2_1_1_2_3_3_9_1_1_1_4_78_2_4_1_1_3_4_1,102,101
Scaffold192-13471_13573,cPa505,0.381294964028777,35,13573,13470,cPa109_cPa109-cPa549-hybrid_cPa109-cPa581-hybrid_cPa109-EqFV_NC002201-hybrid_cPa168-HTLV1_NC001436-hybrid_cPa293-cPa581-hybrid_cPa392-MoMLV_J02255-hybrid_cPa392-unknown_cPa402-cPa75-hybrid_cPa419_cPa419-cPa75-hybrid_cPa419-HTLV2_M10060-hybrid_cPa425_cPa425-cPa152-hybrid_cPa425-cPa75-hybrid_cPa425-unknown_cPa469_cPa469-MoMLV_J02255-hybrid_cPa505_cPa505-unknown_cPa531-MoMLV_J02255-hybrid_cPa581_cPa583-cPa469-hybrid_cPa583-cPa581-hybrid_cPa583-HTLV1_NC001436-hybrid_cPa583-MoMLV_J02255-hybrid_cPa75_cPa75-cPa469-hybrid_EqFV_NC002201_EqFV_NC002201-cPa469-hybrid_EqFV_NC002201-cPa581-hybrid_HTLV1_NC001436_HTLV1_NC001436-cPa549-hybrid_MoMLV_J02255_SMRV_NC001514-unknown,6_2_1_1_1_1_1_1_1_2_1_1_26_1_2_2_6_1_53_1_2_3_1_1_1_1_7_1_2_1_1_3_1_2_1,102,103
Scaffold192-14217_14578,cPa505,0.424460431654676,29,14578,14218,cPa109_cPa109-cPa293-hybrid_cPa109-cPa75-hybrid_cPa109-HTLV2_M10060-hybrid_cPa109-unknown_cPa118-unknown_cPa168_cPa174-HTLV2_M10060-hybrid_cPa293-unknown_cPa402-cPa469-hybrid_cPa419_cPa419-unknown_cPa425_cPa434_cPa469-unknown_cPa505_cPa505-unknown_cPa581-cPa152-hybrid_cPa583_cPa583-cPa581-hybrid_cPa74-cPa469-hybrid_cPa74-cPa531-hybrid_cPa74-HTLV1_NC001436-hybrid_cPa74-MoMLV_J02255-hybrid_cPa75_HTLV1_NC001436_HTLV1_NC001436-cPa531-hybrid_HTLV1_NC001436-unknown_SMRV_NC001514,85_2_1_2_14_1_1_1_2_1_3_1_15_1_1_118_1_1_1_1_1_1_1_1_14_3_1_2_1,361,360
Scaffold192-15624_15726,cPa75,0.444444444444444,6,15712,15670,cPa142-unknown_cPa174-HML1b_repbase_HERV-K14I_LTR14A-hybrid_cPa402_cPa425_cPa449_cPa75,1_1_1_1_1_4,102,42
Scaffold192-15890_15997,cPa402-unknown,0.583333333333333,6,15945,15891,cPa402-cPa500-hybrid_cPa402-unknown_cPa419-unknown_cPa449-REV_NC006934-hybrid_cPa459-cPa75-hybrid_cPa74-unknown,1_7_1_1_1_1,107,54
Scaffold192-16085_16195,cPa402-unknown,0.75,2,16143,16135,cPa402-unknown_ENTV_NC004994-cPa15-hybrid,3_1,110,8
Scaffold192-17847_17949,cPa308_cPa459,0.5,2,17897,17897,cPa308_cPa459,1_1,102,0
Scaffold192-17985_18087,cPa433-unknown,1,1,18035,18035,cPa433-unknown,1,102,0
Scaffold192-19996_20098,cPa145,0.277777777777778,6,20092,20033,cPa145_cPa145-HERV-XA34_repbase_HERVFH21I_LTR21A-hybrid_cPa358-HERV-XA34_repbase_HERVFH21I_LTR21A-hybrid_cPa409-HERV-XA34_repbase_HERVFH21I_LTR21A-hybrid_HERV-XA34_repbase_HERVFH21I_LTR21A_HML6_repbase_HERVK3I_LTR3,5_1_4_1_3_4,102,59
Scaffold192-25062_25164,cPa15,0.666666666666667,2,25147,25112,cPa118-cPa15-hybrid_cPa15,1_2,102,35
Scaffold192-26074_26423,cPa391,0.714285714285714,13,26408,26124,cPa106-cPa298-hybrid_cPa118-cPa298-hybrid_cPa199_cPa199-cPa298-hybrid_cPa356_cPa356-cPa500-hybrid_cPa391_cPa391-cPa15-hybrid_cPa391-cPa199-hybrid_cPa391-cPa298-hybrid_cPa391-cPa413-hybrid_cPa419_cPa419-cPa449-hybrid,1_1_3_1_1_1_50_1_1_2_2_5_1,349,284
Scaffold192-26498_26657,cPa391,0.588235294117647,15,26606,26548,cPa106-cPa413-hybrid_cPa109-cPa298-hybrid_cPa118-cPa298-hybrid_cPa199-cPa298-hybrid_cPa199-cPa413-hybrid_cPa298_cPa356-cPa298-hybrid_cPa391_cPa391-cPa298-hybrid_cPa391-cPa413-hybrid_cPa391-cPa449-hybrid_cPa391-unknown_cPa419_cPa449-cPa419-hybrid_cPa75,2_1_1_4_2_1_1_70_13_18_1_1_2_1_1,159,58
Scaffold192-26665_26767,cPa391_cPa419-cPa298-hybrid,0.5,2,26715,26688,cPa391_cPa419-cPa298-hybrid,1_1,102,27
Scaffold192-27616_27718,cPa419_cPa449-cPa413-hybrid,0.5,2,27705,27666,cPa419_cPa449-cPa413-hybrid,1_1,102,39
Scaffold192-28678_28780,cPa199,0.266666666666667,16,28773,28680,cPa199_cPa199-cPa512-hybrid_cPa227_cPa227-cPa199-hybrid_cPa227-cPa345-hybrid_cPa227-cPa482-hybrid_cPa227-cPa512-hybrid_cPa339-cPa227-hybrid_cPa419_cPa450_cPa450-cPa199-hybrid_cPa450-cPa223-hybrid_cPa450-cPa227-hybrid_cPa450-cPa345-hybrid_cPa450-cPa419-hybrid_HERV-W_repbase_HERV17_LTR17-cPa323-hybrid,8_1_2_1_1_1_1_1_6_2_1_1_1_1_1_1,102,93
Scaffold192-28816_29011,cPa450-cPa413-hybrid,0.212121212121212,20,29007,28819,cPa199_cPa199-cPa298-hybrid_cPa199-cPa413-hybrid_cPa227-cPa298-hybrid_cPa227-cPa413-hybrid_cPa339-cPa413-hybrid_cPa345_cPa419_cPa419-cPa223-hybrid_cPa419-cPa551-hybrid_cPa449-cPa402-hybrid_cPa450-cPa109-hybrid_cPa450-cPa298-hybrid_cPa450-cPa402-hybrid_cPa450-cPa413-hybrid_cPa450-cPa551-hybrid_cPa456-cPa413-hybrid_cPa553_cPa75_cPa75-cPa298-hybrid,8_4_2_4_7_1_2_9_1_1_1_1_3_1_14_1_1_3_1_1,195,188
Scaffold192-30371_30473,cPa419,0.384615384615385,7,30460,30379,cPa419_HERV-ADP_repbase_HERVP71A_I_LTR71A-cPa551-hybrid_HERV-W_repbase_HERV17_LTR17-cPa199-hybrid_HERV-W_repbase_HERV17_LTR17-cPa345-hybrid_HERV-W_repbase_HERV17_LTR17-cPa413-hybrid_HERV-W_repbase_HERV17_LTR17-cPa500-hybrid_HERV-W_repbase_HERV17_LTR17-cPa551-hybrid,5_1_1_1_1_2_2,102,81
Scaffold192-31008_31110,cPa512,0.666666666666667,2,31058,31046,cPa419_cPa512,1_2,102,12
Scaffold192-31531_31638,HERV-W_repbase_HERV17_LTR17,0.764705882352941,3,31596,31581,cPa419_cPa512-HERV-W_repbase_HERV17_LTR17-hybrid_HERV-W_repbase_HERV17_LTR17,3_1_13,107,15
Scaffold192-32320_32435,CAEV_NC001463-HERV-W_repbase_HERV17_LTR17-hybrid_cPa118-HERV-W_repbase_HERV17_LTR17-hybrid_cPa205-HERV-W_repbase_HERV17_LTR17-hybrid_cPa419_HERV-W_repbase_HERV17_LTR17_HML5_repbase_HERVK22I_LTR22-HERV-W_repbase_HERV17_LTR17-hybrid,0.133333333333333,9,32431,32343,CAEV_NC001463-HERV-W_repbase_HERV17_LTR17-hybrid_cPa118-HERV-W_repbase_HERV17_LTR17-hybrid_cPa205-HERV-W_repbase_HERV17_LTR17-hybrid_cPa34_cPa419_HERV-W_repbase_HERV17_LTR17_HERV-W_repbase_HERV17_LTR17-cPa194-hybrid_HML5_repbase_HERVK22I_LTR22-HERV-W_repbase_HERV17_LTR17-hybrid_HML7_repbase_HERVK11DI_MER11D-HERV-W_repbase_HERV17_LTR17-hybrid,2_2_2_1_2_2_1_2_1,115,88
Scaffold192-33012_33197,cPa205,0.4,6,33190,33014,CAEV_NC001463-cPa15-hybrid_CAEV_NC001463-cPa75-hybrid_cPa205_cPa205-cPa257-hybrid_cPa419_HML7_repbase_HERVK11DI_MER11D-cPa257-hybrid,2_1_4_1_1_1,185,176
Scaffold192-33268_33370,cPa419,1,1,33318,33318,cPa419,1,102,0
Scaffold192-33564_33666,cPa205_cPa419,0.5,2,33645,33614,cPa205_cPa419,1_1,102,31
Scaffold192-33787_33889,cPa205,1,1,33888,33837,cPa205,2,102,51
Scaffold192-34272_34525,cPa15,0.434782608695652,6,34514,34306,cPa118_cPa118-cPa15-hybrid_cPa15_cPa419_cPa425_HML5_repbase_HERVK22I_LTR22-cPa15-hybrid,7_2_10_2_1_1,253,208
Scaffold192-34768_34870,cPa15,0.6,3,34850,34784,cPa118-cPa15-hybrid_cPa15_cPa425-unknown,1_3_1,102,66
Scaffold192-45808_45910,cPa500-cPa381-hybrid,1,1,45858,45858,cPa500-cPa381-hybrid,1,102,0
Scaffold192-5019_5275,cPa425,0.384615384615385,6,5223,5066,cPa173-cPa75-hybrid_cPa419_cPa425_cPa425-cPa75-hybrid_cPa425-unknown_cPa75,1_1_5_1_2_3,256,157
Scaffold192-52578_52680,HERV-XA34_repbase_HERVFH21I_LTR21A-cPa174-hybrid,1,1,52628,52628,HERV-XA34_repbase_HERVFH21I_LTR21A-cPa174-hybrid,1,102,0
Scaffold192-54236_54338,HERV-F_repbase_HERVFH19I_LTR19A-unknown,0.714285714285714,3,54286,54235,HERV-F_repbase_HERVFH19I_LTR19A-cPa109-hybrid_HERV-F_repbase_HERVFH19I_LTR19A-cPa174-hybrid_HERV-F_repbase_HERVFH19I_LTR19A-unknown,1_1_5,102,51
Scaffold192-57133_57235,cPa118-unknown_cPa419,0.5,2,57183,57166,cPa118-unknown_cPa419,1_1,102,17
Scaffold192-57647_57749,cPa419,0.5,3,57744,57665,cPa121-unknown_cPa419_cPa419-cPa199-hybrid,1_2_1,102,79
Scaffold192-57954_58056,cPa121-cPa75-hybrid_cPa419,0.5,2,58004,57976,cPa121-cPa75-hybrid_cPa419,1_1,102,28
Scaffold192-8662_8764,cPa419_cPa452_cPa456-unknown,0.333333333333333,3,8737,8709,cPa419_cPa452_cPa456-unknown,1_1_1,102,28
Scaffold192-990_1178,cPa419,0.333333333333333,7,1149,991,cPa15_cPa323-FIV_NC001482-hybrid_cPa363_cPa419_cPa450-cPa254-hybrid_cPa452_cPa568-cPa16-hybrid,1_1_1_3_1_1_1,188,158
Scaffold193-15944_16046,cPa419,1,1,15994,15982,cPa419,2,102,12
Scaffold193-17776_17878,cPa419,1,1,17826,17826,cPa419,1,102,0
Scaffold193-6006_6108,cPa419,1,1,6089,6016,cPa419,4,102,73
Scaffold193-6696_6835,cPa419,1,1,6802,6719,cPa419,13,139,83
Scaffold193-6964_7105,cPa419,1,1,7053,6991,cPa419,3,141,62
Scaffold193-7155_7355,cPa419,1,1,7351,7205,cPa419,4,200,146
Scaffold193-7357_7459,cPa419,1,1,7407,7407,cPa419,1,102,0
Scaffold194-13752_13880,cPa363,0.666666666666667,2,13877,13781,cPa363_cPa456,4_2,128,96
Scaffold194-13907_14208,cPa456,0.386934673366834,10,14192,13925,cPa363_cPa452_cPa452-cPa587-hybrid_cPa456_cPa587_MLV_Xmv43_SMRV_NC001514-cPa363-hybrid_SMRV_NC001514-cPa452-hybrid_SMRV_NC001514-cPa456-hybrid_SMRV_NC001514-cPa587-hybrid,39_43_1_77_14_1_5_2_4_13,301,267
Scaffold194-27194_27397,cPa223,0.789473684210526,7,27345,27244,cPa140-cPa121-hybrid_cPa140-cPa14-hybrid_cPa15-cPa121-hybrid_cPa223_cPa268-cPa121-hybrid_cPa268-cPa14-hybrid_cPa425,4_2_1_60_5_1_3,203,101
Scaffold194-28314_28494,cPa15,0.5125,16,28442,28363,cPa118_cPa118-unknown_cPa140_cPa140-cPa118-hybrid_cPa140-cPa15-hybrid_cPa140-cPa223-hybrid_cPa140-cPa248-hybrid_cPa140-cPa75-hybrid_cPa15_cPa15-cPa248-hybrid_cPa15-unknown_cPa268_cPa268-cPa118-hybrid_cPa268-cPa15-hybrid_cPa268-cPa248-hybrid_cPa443,12_1_1_3_2_3_4_1_41_1_1_3_1_3_1_2,180,79
Scaffold194-37337_37596,cPa67,0.253333333333333,30,37591,37387,cPa254_cPa285_cPa305_cPa305-cPa285-hybrid_cPa305-cPa67-hybrid_cPa308_cPa308-cPa285-hybrid_cPa308-cPa486-hybrid_cPa308-cPa62-hybrid_cPa308-cPa67-hybrid_cPa308-cPa71-hybrid_cPa327_cPa327-cPa254-hybrid_cPa327-cPa424-hybrid_cPa327-cPa486-hybrid_cPa356_cPa419_cPa424_cPa424-cPa270-hybrid_cPa424-cPa285-hybrid_cPa424-cPa308-hybrid_cPa424-cPa486-hybrid_cPa424-cPa67-hybrid_cPa424-cPa71-hybrid_cPa539-cPa285-hybrid_cPa539-cPa308-hybrid_cPa539-cPa75-hybrid_cPa62_cPa67_cPa75,2_5_2_2_1_5_1_1_1_1_2_3_1_1_1_1_10_2_1_1_2_1_1_2_1_1_1_2_19_1,259,204
Scaffold194-37677_37790,cPa419,0.351351351351351,21,37789,37693,cPa118-cPa67-hybrid_cPa308_cPa327_cPa356_cPa419_cPa419-cPa327-hybrid_cPa447-cPa285-hybrid_cPa447-cPa327-hybrid_cPa56-cPa308-hybrid_cPa56-cPa67-hybrid_cPa585-cPa67-hybrid_cPa585-cPa71-hybrid_cPa67_cPa71_cPa75_cPa75-cPa67-hybrid_HFV_NC001736-cPa308-hybrid_HFV_NC001736-cPa67-hybrid_PERVE_NC003059-cPa308-hybrid_PERVE_NC003059-cPa424-hybrid_PERVE_NC003059-cPa67-hybrid,1_1_1_1_13_1_1_1_1_1_1_1_3_2_1_1_1_1_2_1_1,113,96
Scaffold194-40064_40568,cPa199,0.574468085106383,15,40537,40073,cPa199_cPa199-cPa15-hybrid_cPa199-unknown_cPa419_cPa428_cPa434_cPa434-cPa15-hybrid_cPa434-cPa248-hybrid_cPa434-cPa305-hybrid_cPa434-cPa308-hybrid_cPa434-cPa371-hybrid_cPa434-cPa425-hybrid_cPa434-unknown_cPa447_cPa447-cPa308-hybrid,81_1_1_17_1_20_2_1_1_6_1_1_3_3_2,504,464
Scaffold194-41518_41620,cPa391,1,1,41568,41568,cPa391,1,102,0
Scaffold195-36160_36262,cPa428,1,1,36210,36210,cPa428,1,102,0
Scaffold195-36833_36935,cPa428,0.666666666666667,2,36930,36883,cPa356_cPa428,1_2,102,47
Scaffold195-37440_37542,cPa356_cPa428,0.5,2,37540,37490,cPa356_cPa428,4_4,102,50
Scaffold195-55632_55825,cPa356_cPa428,0.5,2,55806,55631,cPa356_cPa428,7_7,193,175
Scaffold195-56009_56111,cPa356,0.545454545454545,2,56091,56036,cPa356_cPa428,6_5,102,55
Scaffold195-60630_60732,cPa428,1,1,60680,60680,cPa428,1,102,0
Scaffold195-62357_62459,cPa356,0.6,2,62409,62369,cPa356_cPa428,3_2,102,40
Scaffold196-57214_57387,cPa356,0.555555555555556,2,57339,57228,cPa356_cPa428,10_8,173,111
Scaffold196-57403_57507,cPa428,0.525,3,57507,57410,cPa356_cPa419_cPa428,37_1_42,104,97
Scaffold196-57543_57645,cPa356,0.545454545454545,2,57641,57553,cPa356_cPa428,18_15,102,88
Scaffold196-58216_58443,cPa356,0.55,2,58443,58218,cPa356_cPa428,55_45,227,225
Scaffold196-59987_60089,cPa356_cPa428,0.5,2,60059,59990,cPa356_cPa428,4_4,102,69
Scaffold197-12582_12733,cPa223-cPa486-hybrid,0.253012048192771,12,12725,12581,cPa223_cPa223-cPa268-hybrid_cPa223-cPa293-hybrid_cPa223-cPa308-hybrid_cPa223-cPa339-hybrid_cPa223-cPa353-hybrid_cPa223-cPa381-hybrid_cPa223-cPa486-hybrid_cPa223-cPa502-hybrid_cPa223-PtERV1_AC142352-hybrid_cPa419_cPa544-cPa268-hybrid,2_5_1_15_9_8_3_21_2_6_10_1,151,144
Scaffold197-13358_13460,cPa419,1,1,13408,13408,cPa419,1,102,0
Scaffold197-18369_18793,cPa223,0.821011673151751,14,18793,18410,cPa199-cPa56-hybrid_cPa223_cPa223-cPa177-hybrid_cPa223-cPa273-hybrid_cPa223-cPa419-hybrid_cPa223-cPa542-hybrid_cPa223-cPa56-hybrid_cPa223-unknown_cPa273_cPa419_cPa428_cPa450-cPa273-hybrid_cPa450-cPa56-hybrid_STLV2_NC001815-cPa56-hybrid,1_211_1_5_1_2_18_4_1_9_1_1_1_1,424,383
Scaffold197-19741_19874,cPa223-cPa273-hybrid,0.666666666666667,4,19861,19740,cPa223-cPa273-hybrid_cPa273_cPa419_HTLV1_NC001436,10_1_3_1,133,121
Scaffold197-26126_26228,cPa419,0.8,2,26197,26135,cPa419_HERVFc2_repbase-cPa450-hybrid,4_1,102,62
Scaffold197-32978_33092,cPa446,0.224299065420561,28,33040,33026,cPa176_cPa176-cPa363-hybrid_cPa183-cPa16-hybrid_cPa183-cPa176-hybrid_cPa183-cPa363-hybrid_cPa183-cPa391-hybrid_cPa183-cPa428-hybrid_cPa183-cPa62-hybrid_cPa200-cPa163-hybrid_cPa223-cPa16-hybrid_cPa223-cPa176-hybrid_cPa223-cPa363-hybrid_cPa308_cPa327_cPa327-cPa363-hybrid_cPa356_cPa363_cPa379_cPa379-cPa363-hybrid_cPa391-cPa450-hybrid_cPa419_cPa419-cPa363-hybrid_cPa424_cPa424-cPa16-hybrid_cPa424-cPa363-hybrid_cPa428_cPa446_cPa452,4_2_9_2_11_1_1_1_3_5_1_7_1_15_3_1_4_29_1_1_20_1_16_9_5_1_48_12,114,14
Scaffold197-33291_33713,cPa452,0.187755102040816,29,33705,33340,cPa176_cPa176-cPa16-hybrid_cPa176-cPa327-hybrid_cPa176-cPa363-hybrid_cPa176-cPa585-hybrid_cPa183-cPa16-hybrid_cPa183-cPa176-hybrid_cPa183-cPa363-hybrid_cPa183-cPa585-hybrid_cPa223-cPa16-hybrid_cPa223-cPa363-hybrid_cPa223-cPa379-hybrid_cPa223-cPa585-hybrid_cPa327_cPa327-cPa363-hybrid_cPa34-cPa363-hybrid_cPa363_cPa379_cPa379-cPa363-hybrid_cPa419_cPa419-cPa16-hybrid_cPa424_cPa424-cPa16-hybrid_cPa424-cPa363-hybrid_cPa428_cPa446_cPa452_cPa62-cPa16-hybrid_cPa71-cPa16-hybrid,51_11_1_12_1_67_4_72_1_4_6_1_1_80_1_2_12_109_1_6_1_73_2_2_1_73_138_1_1,422,365
Scaffold197-35036_35612,cPa308,0.283737024221453,38,35608,35039,cPa268_cPa268-cPa16-hybrid_cPa293_cPa308_cPa313-cPa117-hybrid_cPa313-cPa16-hybrid_cPa313-cPa363-hybrid_cPa313-cPa381-hybrid_cPa313-MMTV_NC001503-hybrid_cPa339_cPa339-cPa16-hybrid_cPa34-cPa16-hybrid_cPa34-MMTV_NC001503-hybrid_cPa345-MMTV_NC001503-hybrid_cPa353_cPa356-cPa16-hybrid_cPa357-cPa254-hybrid_cPa357-cPa486-hybrid_cPa357-MMTV_NC001503-hybrid_cPa381_cPa381-cPa16-hybrid_cPa381-cPa363-hybrid_cPa381-cPa452-hybrid_cPa381-MMTV_NC001503-hybrid_cPa391_cPa391-MMTV_NC001503-hybrid_cPa419_cPa419-cPa268-hybrid_cPa428_cPa428-cPa353-hybrid_cPa486_cPa587-cPa381-hybrid_cPa587-MMTV_NC001503-hybrid_cPa75-cPa363-hybrid_cPa75-MMTV_NC001503-hybrid_MMTV_NC001503_MMTV_NC001503-cPa16-hybrid_MMTV_NC001503-cPa363-hybrid,1_1_1_164_1_7_6_1_1_2_1_3_1_1_5_1_1_2_1_138_3_2_1_1_4_1_31_1_1_1_163_2_2_1_1_19_4_1,576,569
Scaffold197-37473_37787,cPa363,0.200488997555012,52,37787,37475,cPa229-cPa117-hybrid_cPa308_cPa308-cPa117-hybrid_cPa313-cPa117-hybrid_cPa313-cPa452-hybrid_cPa313-cPa50-hybrid_cPa313-SIV_NC001870-hybrid_cPa339_cPa339-cPa117-hybrid_cPa345-cPa117-hybrid_cPa345-cPa452-hybrid_cPa353-cPa117-hybrid_cPa356_cPa357_cPa357-cPa117-hybrid_cPa357-cPa268-hybrid_cPa357-cPa363-hybrid_cPa357-cPa381-hybrid_cPa357-cPa419-hybrid_cPa357-cPa452-hybrid_cPa357-cPa50-hybrid_cPa357-cPa74-hybrid_cPa357-cPa75-hybrid_cPa357-MMTV_NC001503-hybrid_cPa363_cPa381-cPa117-hybrid_cPa381-cPa452-hybrid_cPa419_cPa428-cPa117-hybrid_cPa428-cPa50-hybrid_cPa452_cPa452-cPa117-hybrid_cPa456_cPa572-cPa117-hybrid_cPa587-cPa117-hybrid_cPa587-cPa254-hybrid_cPa587-cPa268-hybrid_cPa587-cPa345-hybrid_cPa587-cPa353-hybrid_cPa587-cPa357-hybrid_cPa587-cPa363-hybrid_cPa587-cPa381-hybrid_cPa587-cPa452-hybrid_cPa587-cPa486-hybrid_cPa587-cPa50-hybrid_cPa587-cPa75-hybrid_cPa587-MMTV_NC001503-hybrid_cPa75_cPa75-cPa117-hybrid_SIV_NC001549-cPa75-hybrid_SIV_NC001870_SIV_NC001870-cPa50-hybrid,3_2_4_17_4_3_1_1_1_4_2_1_2_40_60_1_2_3_1_4_2_1_1_3_82_1_1_12_1_1_6_1_50_1_29_2_1_1_1_1_2_5_7_1_2_2_8_11_8_1_7_1,314,312
Scaffold197-38088_38190,cPa456,0.198412698412698,36,38190,38087,cPa229-cPa117-hybrid_cPa268_cPa268-cPa117-hybrid_cPa308_cPa308-cPa117-hybrid_cPa308-cPa452-hybrid_cPa308-cPa50-hybrid_cPa313-cPa117-hybrid_cPa313-cPa419-hybrid_cPa313-cPa452-hybrid_cPa339-cPa117-hybrid_cPa339-cPa452-hybrid_cPa345-cPa452-hybrid_cPa353_cPa353-cPa117-hybrid_cPa353-cPa75-hybrid_cPa356_cPa357-cPa117-hybrid_cPa357-cPa268-hybrid_cPa357-cPa452-hybrid_cPa363_cPa381_cPa419_cPa419-cPa452-hybrid_cPa428_cPa452_cPa456_cPa486_cPa486-cPa452-hybrid_cPa582-cPa117-hybrid_cPa587-cPa117-hybrid_cPa587-cPa268-hybrid_cPa587-cPa452-hybrid_cPa75_cPa75-cPa452-hybrid_PRIMA41_repbase_PRIMA41_MER41A,2_6_1_21_1_2_1_7_1_2_1_1_1_5_2_1_1_4_3_33_9_22_14_1_1_2_50_40_1_1_1_1_7_2_3_1,102,103
Scaffold197-38289_38558,cPa308,0.26027397260274,24,38558,38309,cPa229-cPa268-hybrid_cPa268_cPa308_cPa308-cPa117-hybrid_cPa308-cPa268-hybrid_cPa313-cPa117-hybrid_cPa313-cPa164-hybrid_cPa313-cPa268-hybrid_cPa313-cPa308-hybrid_cPa313-cPa452-hybrid_cPa313-cPa475-hybrid_cPa313-cPa50-hybrid_cPa313-cPa572-hybrid_cPa339-cPa268-hybrid_cPa353_cPa356_cPa381_cPa381-cPa75-hybrid_cPa419_cPa428_cPa486_cPa572-cPa117-hybrid_cPa572-cPa308-hybrid_cPa75,1_36_76_1_1_4_1_7_5_2_1_1_3_1_16_1_72_1_14_1_43_2_1_1,269,249
Scaffold197-43069_43255,cPa308-cPa75-hybrid,0.307692307692308,8,43203,43109,cPa268-cPa419-hybrid_cPa268-cPa75-hybrid_cPa308-cPa419-hybrid_cPa308-cPa62-hybrid_cPa308-cPa75-hybrid_cPa353-cPa75-hybrid_cPa381-cPa75-hybrid_cPa62,1_3_7_4_8_1_1_1,186,94
Scaffold197-43330_43509,cPa308-cPa75-hybrid,0.6,3,43457,43380,cPa268-cPa75-hybrid_cPa308-cPa75-hybrid_cPa75,1_3_1,179,77
Scaffold197-43789_44050,cPa308-cPa62-hybrid,0.166666666666667,24,43998,43839,cPa117-cPa419-hybrid_cPa183-cPa419-hybrid_cPa268-cPa285-hybrid_cPa268-cPa333-hybrid_cPa268-cPa356-hybrid_cPa268-cPa419-hybrid_cPa268-cPa450-hybrid_cPa268-cPa62-hybrid_cPa268-cPa75-hybrid_cPa308_cPa308-cPa176-hybrid_cPa308-cPa200-hybrid_cPa308-cPa224-hybrid_cPa308-cPa356-hybrid_cPa308-cPa402-hybrid_cPa308-cPa419-hybrid_cPa308-cPa62-hybrid_cPa308-cPa75-hybrid_cPa353-cPa333-hybrid_cPa353-cPa419-hybrid_cPa353-cPa75-hybrid_cPa381_cPa62_cPa75,1_1_1_1_1_10_1_3_3_3_3_5_1_4_1_11_13_7_1_1_1_2_1_2,261,159
Scaffold197-44688_44999,cPa308-cPa62-hybrid,0.373134328358209,16,44996,44719,cPa183-cPa200-hybrid_cPa183-cPa450-hybrid_cPa183-cPa62-hybrid_cPa183-cPa75-hybrid_cPa183-unknown_cPa223-cPa176-hybrid_cPa223-cPa200-hybrid_cPa223-cPa62-hybrid_cPa223-unknown_cPa268-cPa62-hybrid_cPa308-cPa450-hybrid_cPa308-cPa62-hybrid_cPa363-cPa62-hybrid_cPa379-cPa200-hybrid_cPa379-cPa62-hybrid_cPa452-cPa62-hybrid,2_1_3_1_3_1_2_6_6_12_1_25_1_1_1_1,311,277
Scaffold197-45831_45933,cPa183-cPa106-hybrid_cPa223-cPa106-hybrid_cPa452-cPa106-hybrid_cPa62_cPa62-cPa106-hybrid,0.2,5,45901,45880,cPa183-cPa106-hybrid_cPa223-cPa106-hybrid_cPa452-cPa106-hybrid_cPa62_cPa62-cPa106-hybrid,1_1_1_1_1,102,21
Scaffold197-45969_46071,cPa62-cPa413-hybrid,1,1,46019,46019,cPa62-cPa413-hybrid,1,102,0
Scaffold197-46273_46390,cPa199,0.816901408450704,6,46390,46281,cPa199_cPa232-cPa106-hybrid_cPa419_cPa419-cPa62-hybrid_cPa456-cPa106-hybrid_cPa62,58_1_8_1_1_2,117,109
Scaffold197-47353_47455,cPa345_cPa419_cPa553,0.214285714285714,8,47455,47355,cPa199_cPa273_cPa345_cPa371-cPa333-hybrid_cPa419_cPa428-cPa553-hybrid_cPa450-cPa553-hybrid_cPa553,1_1_3_1_3_1_1_3,102,100
Scaffold197-48679_48870,cPa419,0.279411764705882,28,48828,48687,cPa109_cPa109-cPa223-hybrid_cPa109-cPa381-hybrid_cPa254_cPa345-cPa256-hybrid_cPa356_cPa371-SnRV_NC001724-hybrid_cPa419_cPa419-HERV-F_repbase_HERVFH19I_LTR19A-hybrid_cPa426-cPa452-hybrid_cPa426-HERV-E_repbase_HERVE_LTR2-hybrid_cPa428_cPa450-cPa75-hybrid_cPa450-unknown_cPa67_cPa75_HERV-E_repbase_HERVE_LTR2-cPa67-hybrid_HML4_repbase_HERVK13I_LTR13_HML4_repbase_HERVK13I_LTR13-cPa199-hybrid_HML4_repbase_HERVK13I_LTR13-cPa232-hybrid_HML4_repbase_HERVK13I_LTR13-cPa333-hybrid_HML4_repbase_HERVK13I_LTR13-cPa381-hybrid_HML4_repbase_HERVK13I_LTR13-cPa419-hybrid_HML4_repbase_HERVK13I_LTR13-cPa516-hybrid_HML4_repbase_HERVK13I_LTR13-cPa62-hybrid_HML4_repbase_HERVK13I_LTR13-HERV-E_repbase_HERVE_LTR2-hybrid_HML4_repbase_HERVK13I_LTR13-unknown_MPMVs_NC001550-cPa232-hybrid,4_1_1_1_1_3_1_19_1_1_1_3_1_1_2_2_1_7_1_2_2_6_1_1_1_1_1_1,191,141
Scaffold197-49061_49272,cPa67,0.206349206349206,21,49269,49096,cPa109_cPa109-cPa199-hybrid_cPa109-cPa381-hybrid_cPa109-cPa67-hybrid_cPa152_cPa387-cPa381-hybrid_cPa391_cPa419_cPa426-cPa256-hybrid_cPa482-cPa381-hybrid_cPa482-SnRV_NC001724-hybrid_cPa516-cPa109-hybrid_cPa67_cPa67-cPa381-hybrid_cPa75_HML4_repbase_HERVK13I_LTR13-cPa109-hybrid_HML4_repbase_HERVK13I_LTR13-cPa199-hybrid_HML4_repbase_HERVK13I_LTR13-cPa381-hybrid_HML4_repbase_HERVK13I_LTR13-cPa67-hybrid_HML4_repbase_HERVK13I_LTR13-cPa75-hybrid_MPMVs_NC001550,4_1_6_2_1_6_1_4_1_2_1_1_13_2_1_1_1_8_1_2_4,211,173
Scaffold197-49403_49789,cPa419,0.5,13,49787,49453,cPa109-Xen1_AJ506107-hybrid_cPa419_cPa419-Xen1_AJ506107-hybrid_cPa426-cPa256-hybrid_cPa428_cPa450-Xen1_AJ506107-hybrid_cPa482-cPa381-hybrid_cPa67-Xen1_AJ506107-hybrid_cPa75_HML4_repbase_HERVK13I_LTR13-cPa419-hybrid_HML4_repbase_HERVK13I_LTR13-cPa75-hybrid_HML4_repbase_HERVK13I_LTR13-HERV-F_repbase_HERVFH19I_LTR19A-hybrid_Xen1_AJ506107-cPa381-hybrid,1_14_1_1_1_1_2_1_1_1_1_1_2,386,334
Scaffold197-50459_50683,cPa419,0.225,30,50679,50484,cPa118-cPa75-hybrid_cPa125-cPa75-hybrid_cPa140-cPa410-hybrid_cPa15-cPa199-hybrid_cPa15-cPa75-hybrid_cPa248-cPa293-hybrid_cPa248-cPa542-hybrid_cPa248-cPa75-hybrid_cPa260_cPa260-cPa293-hybrid_cPa260-cPa419-hybrid_cPa264-cPa75-hybrid_cPa356_cPa410_cPa410-cPa516-hybrid_cPa419_cPa428_cPa482-cPa199-hybrid_cPa482-cPa293-hybrid_cPa482-cPa75-hybrid_cPa482-unknown_cPa516_cPa542_cPa566-Xen1_AJ506107-hybrid_cPa61-cPa199-hybrid_cPa61-cPa75-hybrid_cPa75_VISNA_S55323_Xen1_AJ506107-cPa410-hybrid_Xen1_AJ506107-unknown,5_2_1_2_1_1_1_3_2_1_1_2_4_6_1_18_3_1_1_3_1_6_1_1_1_2_5_1_2_1,224,195
Scaffold197-52786_53033,cPa118-cPa62-hybrid,0.625,4,52981,52836,cPa118-cPa62-hybrid_cPa118-unknown_cPa15-cPa62-hybrid_cPa61-unknown,5_1_1_1,247,145
Scaffold197-53114_53620,cPa118-cPa62-hybrid,0.476190476190476,11,53568,53137,cPa118-cPa356-hybrid_cPa118-cPa510-hybrid_cPa118-cPa62-hybrid_cPa118-cPa75-hybrid_cPa140-cPa62-hybrid_cPa248-cPa62-hybrid_cPa264-cPa62-hybrid_cPa419_cPa443-cPa62-hybrid_cPa516-cPa62-hybrid_cPa62,2_3_20_1_1_1_2_1_4_1_6,506,431
Scaffold197-53740_53982,cPa62,0.902777777777778,5,53981,53744,cPa118-cPa510-hybrid_cPa118-cPa62-hybrid_cPa285-cPa254-hybrid_cPa419_cPa62,1_4_1_1_65,242,237
Scaffold197-54039_54530,cPa118-cPa510-hybrid,0.186440677966102,17,54526,54039,cPa118-cPa391-hybrid_cPa118-cPa395-hybrid_cPa118-cPa419-hybrid_cPa118-cPa510-hybrid_cPa118-cPa75-hybrid_cPa125-cPa510-hybrid_cPa140-cPa391-hybrid_cPa140-cPa510-hybrid_cPa196_cPa248-cPa510-hybrid_cPa254_cPa254-unknown_cPa419_cPa433_cPa62_cPa75_HERV30_repbase_HERV30I_LTR30-cPa510-hybrid,2_1_1_11_1_2_1_2_1_1_9_4_10_1_10_1_1,491,487
Scaffold197-57108_57308,cPa199,0.214285714285714,18,57308,57109,cPa150_cPa199_cPa223_cPa223-unknown_cPa227_cPa255-cPa553-hybrid_cPa273_cPa273-cPa542-hybrid_cPa273-unknown_cPa302_cPa345_cPa419_cPa450_cPa450-cPa188-hybrid_cPa482_cPa482-cPa450-hybrid_cPa542_cPa553,2_9_1_1_2_1_5_1_1_1_6_5_2_1_1_1_1_1,200,199
Scaffold197-58672_58774,cPa308,0.228915662650602,23,58774,58680,cPa188-cPa268-hybrid_cPa223-cPa381-hybrid_cPa223-cPa419-hybrid_cPa223-cPa486-hybrid_cPa227-cPa486-hybrid_cPa264-cPa223-hybrid_cPa264-cPa419-hybrid_cPa268_cPa273-cPa486-hybrid_cPa308_cPa308-cPa248-hybrid_cPa308-cPa381-hybrid_cPa345-cPa486-hybrid_cPa353_cPa353-cPa248-hybrid_cPa353-cPa486-hybrid_cPa381_cPa419_cPa434-cPa188-hybrid_cPa444-cPa268-hybrid_cPa486_cPa516-cPa345-hybrid_cPa75,1_2_1_1_1_1_1_3_1_19_1_1_1_2_4_1_18_10_1_1_10_1_1,102,94
Scaffold197-59420_59877,cPa118,0.176891615541922,49,59870,59432,cPa118_cPa118-cPa443-hybrid_cPa125_cPa125-cPa248-hybrid_cPa125-cPa308-hybrid_cPa125-cPa419-hybrid_cPa125-cPa486-hybrid_cPa15_cPa15-cPa248-hybrid_cPa15-cPa486-hybrid_cPa248_cPa248-cPa125-hybrid_cPa248-cPa381-hybrid_cPa254-cPa248-hybrid_cPa264_cPa264-cPa15-hybrid_cPa264-cPa248-hybrid_cPa264-cPa345-hybrid_cPa268_cPa268-cPa125-hybrid_cPa308_cPa308-cPa248-hybrid_cPa339-cPa248-hybrid_cPa353_cPa353-cPa248-hybrid_cPa381_cPa419_cPa428_cPa434_cPa434-cPa248-hybrid_cPa434-cPa419-hybrid_cPa434-cPa443-hybrid_cPa443_cPa443-cPa125-hybrid_cPa443-cPa248-hybrid_cPa443-cPa353-hybrid_cPa443-cPa381-hybrid_cPa486_cPa516_cPa516-cPa248-hybrid_cPa516-cPa308-hybrid_cPa516-cPa443-hybrid_cPa516-cPa486-hybrid_cPa516-unknown_cPa61_cPa61-cPa381-hybrid_cPa61-cPa425-hybrid_cPa95-cPa125-hybrid_WDSV_NC001867-cPa248-hybrid,173_1_60_14_1_1_1_98_2_4_33_1_1_1_155_1_8_1_6_1_49_1_2_7_5_46_18_1_8_1_1_1_154_3_1_1_1_29_67_6_1_1_2_2_3_1_1_1_1,457,438
Scaffold197-60586_60714,cPa419,0.230769230769231,12,60704,60596,cPa308_cPa353_cPa353-cPa248-hybrid_cPa381_cPa419_cPa419-cPa248-hybrid_cPa425-cPa308-hybrid_cPa425-cPa486-hybrid_cPa486_cPa75_cPa75-cPa248-hybrid_cPa95-cPa248-hybrid,11_11_4_10_15_1_1_1_8_1_1_1,128,108
Scaffold198-10298_10435,cPa419,1,1,10420,10348,cPa419,7,137,72
Scaffold198-14364_14504,cPa419,1,1,14457,14414,cPa419,4,140,43
Scaffold198-56387_56489,cPa419,1,1,56437,56437,cPa419,1,102,0
Scaffold198-56691_56867,cPa419,1,1,56815,56704,cPa419,4,176,111
Scaffold198-7012_7114,cPa419,1,1,7062,7062,cPa419,1,102,0
Scaffold199-13909_14011,cPa419,1,1,13962,13909,cPa419,16,102,53
Scaffold199-14219_14329,cPa419,1,1,14310,14229,cPa419,22,110,81
Scaffold199-14509_14696,cPa419,1,1,14650,14513,cPa419,15,187,137
Scaffold199-14715_14821,cPa419,1,1,14781,14764,cPa419,4,106,17
Scaffold199-19099_19201,cPa419,1,1,19149,19149,cPa419,1,102,0
Scaffold199-40181_40283,cPa419,1,1,40231,40231,cPa419,1,102,0
Scaffold199-40764_40873,cPa419,1,1,40822,40814,cPa419,9,109,8
Scaffold199-41084_41186,cPa419,1,1,41134,41096,cPa419,3,102,38
Scaffold199-46998_47100,cPa419,1,1,47079,47048,cPa419,2,102,31
Scaffold199-57820_57922,cPa419,1,1,57918,57848,cPa419,13,102,70
Scaffold199-58213_58405,cPa419,1,1,58391,58235,cPa419,24,192,156
Scaffold199-58492_58683,cPa419,1,1,58652,58500,cPa419,40,191,152
Scaffold199-58720_58864,cPa419,1,1,58842,58763,cPa419,47,144,79
Scaffold199-58872_58974,cPa419,1,1,58973,58881,cPa419,8,102,92
Scaffold199-59083_59190,cPa419,1,1,59158,59114,cPa419,10,107,44
Scaffold199-59238_59343,cPa419,1,1,59291,59288,cPa419,3,105,3
Scaffold199-59376_59484,cPa419,1,1,59432,59385,cPa419,27,108,47
Scaffold199-59554_59677,cPa419,1,1,59661,59560,cPa419,9,123,101
Scaffold199-59934_60112,cPa419,1,1,60060,59939,cPa419,11,178,121
Scaffold200-10406_10516,cPa47,0.266666666666667,15,10503,10405,cPa174_cPa174-cPa254-hybrid_cPa174-unknown_cPa315_cPa315-cPa254-hybrid_cPa315-cPa419-hybrid_cPa315-cPa425-hybrid_cPa315-cPa47-hybrid_cPa315-unknown_cPa404_cPa404-cPa254-hybrid_cPa404-unknown_cPa425_cPa425-cPa254-hybrid_cPa47,2_2_2_2_7_1_2_1_14_1_1_1_7_1_16,110,98
Scaffold200-10520_10744,cPa47,0.483870967741935,10,10744,10537,cPa125-cPa47-hybrid_cPa174-cPa425-hybrid_cPa315-cPa248-hybrid_cPa315-cPa404-hybrid_cPa315-cPa425-hybrid_cPa315-cPa47-hybrid_cPa315-unknown_cPa425_cPa425-cPa419-hybrid_cPa47,1_1_1_1_3_1_4_3_1_15,224,207
Scaffold200-11276_11380,cPa425,1,1,11328,11326,cPa425,2,104,2
Scaffold200-11537_11671,cPa425_cPa47,0.5,2,11619,11555,cPa425_cPa47,2_2,134,64
Scaffold200-12272_12374,cPa315-cPa425-hybrid_cPa425_cPa47,0.333333333333333,3,12329,12307,cPa315-cPa425-hybrid_cPa425_cPa47,1_1_1,102,22
Scaffold200-12379_12481,cPa425,0.666666666666667,3,12446,12395,cPa224-cPa425-hybrid_cPa425_cPa47,1_4_1,102,51
Scaffold200-12504_12606,cPa174_cPa425_cPa47_cPa47-unknown,0.25,4,12581,12540,cPa174_cPa425_cPa47_cPa47-unknown,1_1_1_1,102,41
Scaffold200-14018_14168,cPa163-cPa315-hybrid_cPa224-unknown_cPa425,0.333333333333333,3,14116,14068,cPa163-cPa315-hybrid_cPa224-unknown_cPa425,1_1_1,150,48
Scaffold200-14357_14459,cPa425,0.625,3,14413,14361,cPa174_cPa254-cPa47-hybrid_cPa425,2_1_5,102,52
Scaffold200-15324_15426,cPa174-cPa254-hybrid,1,1,15374,15374,cPa174-cPa254-hybrid,1,102,0
Scaffold200-15632_15734,cPa254_cPa425,0.5,2,15682,15682,cPa254_cPa425,1_1,102,0
Scaffold200-16035_16181,cPa425,0.5,5,16130,16044,cPa254_cPa254-cPa425-hybrid_cPa404_cPa425_cPa47,1_1_1_4_1,146,86
Scaffold200-16275_16409,cPa425,1,1,16357,16325,cPa425,3,134,32
Scaffold200-21917_22019,cPa387,0.454545454545455,4,22015,21946,cPa339-unknown_cPa356-unknown_cPa387_HERV-Fb_repbase_HERVH48I_MER48-unknown,1_1_5_4,102,69
Scaffold200-22204_22330,HERV-Fb_repbase_HERVH48I_MER48-cPa472-hybrid,1,1,22278,22254,HERV-Fb_repbase_HERVH48I_MER48-cPa472-hybrid,3,126,24
Scaffold200-22369_22471,HERV-Fb_repbase_HERVH48I_MER48-cPa472-hybrid,0.666666666666667,2,22419,22384,HERV-Fb_repbase_HERVH48I_MER48-cPa472-hybrid_HERV-Fb_repbase_HERVH48I_MER48-unknown,2_1,102,35
Scaffold200-22984_23230,HERV-Fb_repbase_HERVH48I_MER48-cPa472-hybrid,0.8,3,23178,22999,cPa356-cPa472-hybrid_cPa419_HERV-Fb_repbase_HERVH48I_MER48-cPa472-hybrid,1_2_12,246,179
Scaffold200-24326_24431,cPa18-cPa51-hybrid,1,1,24379,24376,cPa18-cPa51-hybrid,2,105,3
Scaffold200-25236_25338,cPa18-cPa51-hybrid_cPa298-cPa51-hybrid,0.5,2,25315,25286,cPa18-cPa51-hybrid_cPa298-cPa51-hybrid,1_1,102,29
Scaffold200-27171_27302,cPa298-cPa391-hybrid,0.75,2,27250,27221,cPa298-cPa391-hybrid_cPa391,3_1,131,29
Scaffold203-1913_2015,cPa285,1,1,1963,1963,cPa285,1,102,0
Scaffold204-12463_12565,cPa75-cPa241-hybrid,1,1,12513,12513,cPa75-cPa241-hybrid,1,102,0
Scaffold204-12763_12896,cPa413-cPa241-hybrid,0.388888888888889,6,12875,12785,cPa333-cPa241-hybrid_cPa333-cPa515-hybrid_cPa413-cPa241-hybrid_cPa413-cPa531-hybrid_cPa413-unknown_cPa75-cPa241-hybrid,2_1_7_1_2_5,133,90
Scaffold204-18550_18949,cPa356,0.363636363636364,9,18897,18586,cPa173_cPa173-cPa308-hybrid_cPa173-cPa356-hybrid_cPa177_cPa177-cPa356-hybrid_cPa177-cPa391-hybrid_cPa177-unknown_cPa356_cPa419,5_1_1_4_3_2_1_12_4,399,311
Scaffold204-22962_23142,cPa199,0.333333333333333,7,23093,22970,cPa199_cPa228_cPa390_cPa413_cPa413-cPa339-hybrid_cPa413-unknown_cPa62,4_1_1_2_1_2_1,180,123
Scaffold204-23157_23274,cPa413,0.782312925170068,9,23222,23167,cPa199_cPa199-cPa228-hybrid_cPa413_cPa413-cPa339-hybrid_cPa413-cPa486-hybrid_cPa413-unknown_cPa419_cPa486_cPa62-cPa339-hybrid,8_1_115_2_1_17_1_1_1,117,55
Scaffold204-30016_30118,cPa62,1,1,30115,30023,cPa62,10,102,92
Scaffold204-30522_30624,cPa62,1,1,30572,30572,cPa62,1,102,0
Scaffold204-30696_30798,cPa62,1,1,30756,30729,cPa62,7,102,27
Scaffold204-34804_34906,cPa419,1,1,34854,34804,cPa419,3,102,50
Scaffold204-46451_46553,cPa390_cPa587,0.210526315789474,9,46550,46471,cPa270_cPa381_cPa381-unknown_cPa390_cPa398_cPa419_cPa486_cPa587_cPa62,1_3_1_4_1_2_2_4_1,102,79
Scaffold204-47709_47829,cPa381_cPa587,0.296296296296296,7,47814,47721,cPa381_cPa390_cPa398_cPa410_cPa419_cPa486_cPa587,8_4_1_1_1_4_8,120,93
Scaffold204-54514_54777,cPa492,0.864864864864865,5,54725,54542,cPa339_cPa402-cPa492-hybrid_cPa447-cPa492-hybrid_cPa492_HML1a_repbase_HERV-K14CI_LTR14C,2_1_1_32_1,263,183
Scaffold204-54779_54962,cPa492,0.72,11,54962,54812,cPa339_cPa353-cPa492-hybrid_cPa419_cPa425-cPa492-hybrid_cPa425-unknown_cPa439-cPa492-hybrid_cPa447-HML1a_repbase_HERV-K14CI_LTR14C-hybrid_cPa492_cPa492-unknown_cPa81-HML1a_repbase_HERV-K14CI_LTR14C-hybrid_HML1a_repbase_HERV-K14CI_LTR14C,3_1_2_1_1_1_1_36_2_1_1,183,150
Scaffold204-56280_56382,cPa339,1,1,56359,56282,cPa339,5,102,77
Scaffold204-57293_57456,cPa339,0.64,3,57452,57299,cPa339_cPa353_cPa419,32_17_1,163,153
Scaffold204-57541_57780,cPa339,0.718954248366013,5,57769,57554,cPa339_cPa353_cPa353-unknown_cPa419_rRVRV_JQ303225-cPa353-hybrid,110_29_1_12_1,239,215
Scaffold204-58178_58280,cPa339,0.693877551020408,3,58267,58194,cPa339_cPa353_cPa419,34_13_2,102,73
Scaffold205-43069_43171,cPa75,1,1,43119,43070,cPa75,3,102,49
Scaffold205-43490_43592,cPa75,1,1,43551,43540,cPa75,2,102,11
Scaffold205-43719_44342,cPa75,1,1,44290,43769,cPa75,20,623,521
Scaffold205-44495_44650,cPa75,1,1,44598,44545,cPa75,3,155,53
Scaffold206-54800_54902,cPa356,1,1,54853,54850,cPa356,3,102,3
Scaffold206-54998_55100,cPa356,1,1,55048,55048,cPa356,1,102,0
Scaffold207-26919_27021,cPa419,1,1,26969,26967,cPa419,2,102,2
Scaffold208-1200_1302,cPa75,1,1,1250,1221,cPa75,2,102,29
Scaffold208-15809_15927,cPa75,1,1,15875,15859,cPa75,2,118,16
Scaffold208-16004_16461,cPa75,1,1,16409,16054,cPa75,36,457,355
Scaffold208-1701_1910,cPa75,0.923076923076923,2,1858,1718,cPa75_cPa75-unknown,12_1,209,140
Scaffold208-18854_18956,cPa285-cPa62-hybrid,1,1,18904,18904,cPa285-cPa62-hybrid,1,102,0
Scaffold208-1927_2029,cPa75,1,1,1977,1977,cPa75,1,102,0
Scaffold208-2087_2199,cPa75,1,1,2161,2110,cPa75,7,112,51
Scaffold208-2403_2553,cPa75,1,1,2514,2453,cPa75,4,150,61
Scaffold208-3239_3396,cPa75,1,1,3344,3289,cPa75,4,157,55
Scaffold208-3568_3671,cPa121-cPa75-hybrid_cPa75,0.5,2,3619,3618,cPa121-cPa75-hybrid_cPa75,1_1,103,1
Scaffold208-3743_3845,cPa121-cPa75-hybrid,0.666666666666667,2,3793,3774,cPa121-cPa75-hybrid_cPa75,2_1,102,19
Scaffold209-11119_11221,cPa486,1,1,11180,11135,cPa486,3,102,45
Scaffold209-44911_45015,cPa75,1,1,44963,44961,cPa75,3,104,2
Scaffold209-45018_45120,cPa75,1,1,45068,45020,cPa75,3,102,48
Scaffold210-29513_29615,cPa428,1,1,29563,29563,cPa428,1,102,0
Scaffold210-29784_29886,cPa428,1,1,29834,29834,cPa428,1,102,0
Scaffold210-30737_30908,cPa356,1,1,30879,30742,cPa356,5,171,137
Scaffold210-47529_47650,cPa356,0.53125,2,47629,47542,cPa356_cPa428,17_15,121,87
Scaffold210-47970_48072,cPa356,0.666666666666667,2,48020,48011,cPa356_cPa428,2_1,102,9
Scaffold211-16594_16696,cPa356_cPa428,0.5,2,16644,16643,cPa356_cPa428,1_1,102,1
Scaffold211-17354_17456,cPa428,1,1,17404,17404,cPa428,1,102,0
Scaffold211-51927_52029,cPa356,1,1,51977,51977,cPa356,1,102,0
Scaffold211-55118_55220,cPa428,0.6,2,55186,55168,cPa356_cPa428,2_3,102,18
Scaffold212-19807_19909,cPa273-cPa62-hybrid,1,1,19857,19857,cPa273-cPa62-hybrid,1,102,0
Scaffold212-19959_20061,cPa199-cPa62-hybrid_cPa273-cPa62-hybrid,0.5,2,20009,19987,cPa199-cPa62-hybrid_cPa273-cPa62-hybrid,1_1,102,22
Scaffold212-20408_20510,cPa199-cPa62-hybrid_cPa199-WDSV_NC001867-hybrid,0.5,2,20462,20458,cPa199-cPa62-hybrid_cPa199-WDSV_NC001867-hybrid,1_1,102,4
Scaffold212-2398_2505,cPa75-cPa260-hybrid_cPa75-cPa360-hybrid,0.5,2,2453,2448,cPa75-cPa260-hybrid_cPa75-cPa360-hybrid,1_1,107,5
Scaffold212-24334_24501,WDSV_NC001867,1,1,24449,24384,WDSV_NC001867,4,167,65
Scaffold212-24636_24738,WDSV_NC001867,1,1,24686,24686,WDSV_NC001867,1,102,0
Scaffold212-6511_6644,cPa387-cPa56-hybrid,0.6,2,6592,6558,cPa387_cPa387-cPa56-hybrid,2_3,133,34
Scaffold212-7207_7321,cPa387-cPa56-hybrid_cPa56,0.5,2,7269,7257,cPa387-cPa56-hybrid_cPa56,2_2,114,12
Scaffold213-1635_1737,cPa356,0.636363636363636,2,1729,1685,cPa356_cPa428,7_4,102,44
Scaffold214-13268_13555,cPa113,0.564102564102564,8,13534,13275,cPa113_cPa113-cPa62-hybrid_cPa113-cPa75-hybrid_cPa113-unknown_cPa254_cPa419_cPa492-cPa75-hybrid_cPa75,22_1_3_1_2_6_1_3,287,259
Scaffold214-15920_16134,cPa62,0.688172043010753,14,16127,15970,cPa138-cPa118-hybrid_cPa138-cPa15-hybrid_cPa254_cPa254-cPa492-hybrid_cPa419_cPa42-cPa15-hybrid_cPa42-cPa62-hybrid_cPa425-cPa62-hybrid_cPa492_cPa492-cPa62-hybrid_cPa572-cPa15-hybrid_cPa572-cPa62-hybrid_cPa62_cPa75,1_5_2_1_9_2_1_1_2_1_1_2_64_1,214,157
Scaffold214-17474_17640,cPa62,0.678571428571429,10,17599,17477,cPa138-cPa62-hybrid_cPa199-cPa356-hybrid_cPa199-WDSV_NC001867-hybrid_cPa254_cPa419_cPa42-cPa15-hybrid_cPa42-cPa410-hybrid_cPa42-cPa62-hybrid_cPa572-cPa62-hybrid_cPa62,2_1_1_1_8_1_1_1_2_38,166,122
Scaffold214-18453_18655,cPa131-cPa339-hybrid,0.104166666666667,29,18639,18455,cPa131-cPa339-hybrid_cPa131-cPa390-hybrid_cPa131-cPa447-hybrid_cPa138-cPa216-hybrid_cPa138-cPa339-hybrid_cPa138-cPa381-hybrid_cPa138-cPa447-hybrid_cPa194_cPa194-cPa75-hybrid_cPa246-cPa339-hybrid_cPa254-cPa75-hybrid_cPa305-cPa194-hybrid_cPa308-cPa339-hybrid_cPa381_cPa419_cPa42-cPa339-hybrid_cPa42-cPa381-hybrid_cPa42-cPa419-hybrid_cPa438-cPa339-hybrid_cPa478-cPa447-hybrid_cPa486-cPa390-hybrid_cPa572-cPa216-hybrid_cPa572-cPa339-hybrid_cPa572-cPa381-hybrid_cPa62_cPa62-cPa339-hybrid_cPa67_HERVFc2_repbase-cPa75-hybrid_Xen1_AJ506107-cPa339-hybrid,5_1_1_1_1_2_1_1_1_1_1_1_1_4_4_2_3_1_1_1_1_1_1_1_4_1_1_3_1,202,184
Scaffold214-19133_19483,cPa67,0.178571428571429,47,19468,19136,cPa131-cPa216-hybrid_cPa131-cPa339-hybrid_cPa131-cPa518-hybrid_cPa131-cPa523-hybrid_cPa131-cPa549-hybrid_cPa138-cPa194-hybrid_cPa138-cPa356-hybrid_cPa16-cPa194-hybrid_cPa194_cPa194-cPa67-hybrid_cPa199-SnRV_NC001724-hybrid_cPa216_cPa285_cPa363-cPa194-hybrid_cPa395-cPa381-hybrid_cPa395-cPa419-hybrid_cPa419_cPa42-cPa194-hybrid_cPa438-cPa216-hybrid_cPa452-cPa194-hybrid_cPa452-cPa285-hybrid_cPa452-cPa381-hybrid_cPa472-cPa381-hybrid_cPa479-cPa216-hybrid_cPa479-cPa339-hybrid_cPa486-SnRV_NC001724-hybrid_cPa572-cPa381-hybrid_cPa572-cPa67-hybrid_cPa62_cPa67_cPa71-cPa194-hybrid_cPa75_HERV-E_repbase_HERVE_LTR2-cPa518-hybrid_HERVFc2_repbase_HERVFc2_repbase-cPa125-hybrid_HERVFc2_repbase-cPa194-hybrid_HERVFc2_repbase-cPa216-hybrid_HERVFc2_repbase-cPa285-hybrid_HERVFc2_repbase-cPa339-hybrid_HERVFc2_repbase-cPa381-hybrid_HERVFc2_repbase-cPa518-hybrid_HERVFc2_repbase-cPa62-hybrid_HERVFc2_repbase-cPa67-hybrid_HERVFc2_repbase-cPa75-hybrid_HERVFc2_repbase-SnRV_NC001724-hybrid_HERVFc2_repbase-unknown_Xen1_AJ506107-cPa339-hybrid,4_4_3_1_1_3_1_1_30_2_1_6_2_11_2_1_21_1_2_3_1_1_4_1_2_1_4_2_3_35_3_1_1_1_1_1_2_1_4_14_1_2_2_2_1_4_1,350,332
Scaffold214-19523_19648,cPa194,0.213592233009709,33,19646,19534,cPa194_cPa194-cPa381-hybrid_cPa199-SnRV_NC001724-hybrid_cPa285-cPa194-hybrid_cPa285-cPa67-hybrid_cPa356_cPa363-cPa194-hybrid_cPa363-cPa67-hybrid_cPa395-cPa194-hybrid_cPa395-cPa381-hybrid_cPa395-cPa67-hybrid_cPa419_cPa428_cPa428-SnRV_NC001724-hybrid_cPa452-cPa194-hybrid_cPa472-cPa194-hybrid_cPa472-cPa381-hybrid_cPa472-cPa67-hybrid_cPa527-cPa67-hybrid_cPa552-cPa194-hybrid_cPa572-cPa381-hybrid_cPa572-cPa67-hybrid_cPa575-cPa67-hybrid_cPa62-cPa381-hybrid_cPa62-cPa67-hybrid_cPa67_cPa71-cPa194-hybrid_HERV-E_repbase_HERVE_LTR2-SnRV_NC001724-hybrid_HERVFc2_repbase_HERVFc2_repbase-cPa194-hybrid_HERVFc2_repbase-cPa339-hybrid_HERVFc2_repbase-cPa381-hybrid_HERVFc2_repbase-cPa67-hybrid,22_1_2_2_1_1_2_1_3_1_12_5_1_1_2_1_2_1_1_1_1_1_3_1_2_21_2_1_2_2_1_1_2,125,112
Scaffold214-21155_21436,cPa62,0.537313432835821,16,21416,21157,cPa157-HML4_repbase_HERVK13I_LTR13-hybrid_cPa285_cPa285-cPa419-hybrid_cPa293_cPa339_cPa356_cPa395-cPa285-hybrid_cPa419_cPa472-cPa285-hybrid_cPa472-cPa62-hybrid_cPa572-cPa285-hybrid_cPa62_cPa62-unknown_HERVFc2_repbase_HERVFc2_repbase-cPa62-hybrid_Xen1_AJ506107-cPa61-hybrid,1_2_1_1_1_1_3_14_1_1_1_36_1_1_1_1,281,259
Scaffold214-21936_22038,cPa419,0.75,3,21994,21939,cPa254-cPa62-hybrid_cPa419_cPa511-cPa402-hybrid,1_6_1,102,55
Scaffold214-22144_22330,cPa419,0.260869565217391,17,22329,22161,cPa168-cPa402-hybrid_cPa216_cPa419_cPa419-cPa293-hybrid_cPa419-cPa523-hybrid_cPa419-cPa545-hybrid_cPa419-HML4_repbase_HERVK13I_LTR13-hybrid_cPa438-cPa526-hybrid_cPa450-cPa293-hybrid_cPa450-cPa402-hybrid_cPa450-cPa583-hybrid_cPa463_cPa527-cPa293-hybrid_cPa529-HML4_repbase_HERVK13I_LTR13-hybrid_cPa552-cPa293-hybrid_cPa75-cPa463-hybrid_HERV-E_repbase_HERVE_LTR2-cPa293-hybrid,2_1_6_1_1_1_1_1_1_1_1_1_1_1_1_1_1,186,168
Scaffold214-24443_24813,cPa450,0.515151515151515,10,24771,24493,cPa168_cPa168-cPa469-hybrid_cPa168-unknown_cPa227_cPa273_cPa273-cPa168-hybrid_cPa357_cPa450_cPa450-cPa168-hybrid_cPa450-unknown,17_1_1_2_3_1_1_34_1_5,370,278
Scaffold214-26261_26363,cPa227,1,1,26311,26311,cPa227,1,102,0
Scaffold214-27144_27276,cPa227,0.666666666666667,3,27264,27194,cPa168_cPa227_cPa273,1_6_2,132,70
Scaffold214-28171_28273,cPa273,0.45,7,28273,28170,cPa164_cPa168_cPa227_cPa273_cPa357_cPa475_cPa583,1_2_4_9_1_1_2,102,103
Scaffold214-28762_28874,cPa273,0.5,5,28831,28768,cPa168_cPa227_cPa273_cPa357_cPa357-cPa227-hybrid,1_1_4_1_1,112,63
Scaffold214-31875_31980,cPa168,0.294117647058824,9,31966,31887,cPa164-cPa227-hybrid_cPa168_cPa273_cPa450_cPa450-cPa75-hybrid_cPa475_cPa529_cPa583_cPa95,1_5_1_1_1_1_3_3_1,105,79
Scaffold214-32020_32222,cPa529,0.375,17,32212,32038,cPa14-cPa583-hybrid_cPa14-cPa75-hybrid_cPa164-cPa469-hybrid_cPa168_cPa168-cPa75-hybrid_cPa273_cPa450_cPa450-cPa529-hybrid_cPa450-cPa583-hybrid_cPa475_cPa529_cPa545_cPa583_cPa95-cPa227-hybrid_cPa95-cPa469-hybrid_cPa95-cPa529-hybrid_cPa95-cPa583-hybrid,1_1_1_5_1_1_2_2_2_1_18_2_4_1_1_3_2,202,174
Scaffold214-32950_33178,cPa357,0.6,2,33126,32950,cPa168_cPa357,2_3,228,176
Scaffold214-33381_33483,cPa357,1,1,33431,33431,cPa357,1,102,0
Scaffold214-34028_34130,cPa357,1,1,34078,34078,cPa357,1,102,0
Scaffold214-35351_35759,cPa357,0.651162790697674,13,35757,35381,cPa168_cPa168-cPa357-hybrid_cPa168-cPa539-hybrid_cPa227_cPa227-cPa121-hybrid_cPa227-cPa360-hybrid_cPa227-cPa539-hybrid_cPa357_cPa357-cPa539-hybrid_cPa357-unknown_cPa583-cPa539-hybrid_cPa75-cPa539-hybrid_PyERV_AF500296-cPa360-hybrid,1_1_1_2_1_1_1_28_2_2_1_1_1,408,376
Scaffold214-44918_45084,cPa450,0.461139896373057,26,45033,44931,cPa199_cPa223_cPa227_cPa227-cPa199-hybrid_cPa227-cPa223-hybrid_cPa273-cPa199-hybrid_cPa273-cPa223-hybrid_cPa273-unknown_cPa419_cPa450_cPa450-cPa199-hybrid_cPa450-cPa223-hybrid_cPa450-cPa345-hybrid_cPa450-cPa482-hybrid_cPa450-unknown_cPa542-cPa199-hybrid_cPa543-cPa199-hybrid_cPa543-cPa223-hybrid_cPa543-cPa345-hybrid_cPa553_cPa553-cPa199-hybrid_cPa553-cPa200-hybrid_cPa553-cPa223-hybrid_cPa553-cPa482-hybrid_cPa553-cPa51-hybrid_cPa553-unknown,6_1_1_2_1_21_3_1_2_89_19_6_1_1_5_4_2_1_1_5_14_1_2_1_1_2,166,102
Scaffold214-45117_45235,cPa356-cPa199-hybrid,0.428571428571429,4,45216,45167,cPa356-cPa199-hybrid_cPa356-cPa553-hybrid_cPa395-cPa199-hybrid_cPa62-cPa345-hybrid,3_1_2_1,118,49
Scaffold214-48377_48597,cPa356,0.567567567567568,19,48591,48387,cPa14-cPa241-hybrid_cPa14-cPa356-hybrid_cPa14-cPa530-hybrid_cPa14-unknown_cPa18-cPa241-hybrid_cPa18-cPa290-hybrid_cPa18-cPa395-hybrid_cPa18-cPa515-hybrid_cPa18-cPa529-hybrid_cPa18-cPa530-hybrid_cPa18-unknown_cPa356_cPa395-cPa241-hybrid_cPa395-cPa530-hybrid_cPa4_cPa4-cPa241-hybrid_cPa4-cPa395-hybrid_cPa4-cPa530-hybrid_cPa434-cPa241-hybrid,1_1_1_1_4_1_1_1_1_6_2_42_2_3_2_1_1_2_1,220,204
Scaffold214-48668_48791,cPa356,0.618421052631579,19,48741,48680,cPa18-cPa241-hybrid_cPa18-cPa290-hybrid_cPa18-cPa356-hybrid_cPa18-cPa515-hybrid_cPa18-cPa530-hybrid_cPa356_cPa356-cPa419-hybrid_cPa395_cPa395-cPa241-hybrid_cPa395-cPa356-hybrid_cPa395-cPa530-hybrid_cPa395-cPa540-hybrid_cPa4-cPa241-hybrid_cPa4-cPa510-hybrid_cPa4-cPa530-hybrid_cPa472-unknown_cPa541-cPa515-hybrid_cPa541-cPa530-hybrid_cPa575,2_1_1_3_2_47_1_1_2_4_1_1_3_1_1_1_1_2_1,123,61
Scaffold214-49189_49444,cPa356,0.148936170212766,34,49444,49239,cPa11_cPa127_cPa127-cPa540-hybrid_cPa14-cPa241-hybrid_cPa14-cPa530-hybrid_cPa18-cPa11-hybrid_cPa18-cPa127-hybrid_cPa18-cPa190-hybrid_cPa18-cPa241-hybrid_cPa18-cPa290-hybrid_cPa18-cPa515-hybrid_cPa18-cPa530-hybrid_cPa241_cPa290_cPa290-cPa241-hybrid_cPa356_cPa356-cPa127-hybrid_cPa356-cPa241-hybrid_cPa356-cPa515-hybrid_cPa395-cPa241-hybrid_cPa395-cPa290-hybrid_cPa395-cPa515-hybrid_cPa395-cPa530-hybrid_cPa4-cPa241-hybrid_cPa4-cPa290-hybrid_cPa4-cPa515-hybrid_cPa4-cPa530-hybrid_cPa515_cPa530_cPa531-cPa575-hybrid_cPa540_cPa541-cPa241-hybrid_cPa541-cPa515-hybrid_cPa541-cPa540-hybrid,1_12_1_1_1_1_1_1_2_1_3_7_4_2_1_14_1_1_1_3_1_3_2_2_1_1_2_6_1_1_10_3_1_1,255,205
Scaffold214-50145_50247,cPa540,0.22,16,50232,50144,cPa11-cPa356-hybrid_cPa11-cPa530-hybrid_cPa127_cPa127-cPa290-hybrid_cPa127-cPa356-hybrid_cPa18-cPa356-hybrid_cPa241_cPa290_cPa290-cPa540-hybrid_cPa290-unknown_cPa356_cPa419_cPa515_cPa530_cPa531_cPa540,1_1_8_1_1_1_8_1_1_2_1_1_8_3_1_11,102,88
Scaffold214-50343_50445,cPa127,0.333333333333333,6,50438,50343,cPa11-cPa290-hybrid_cPa127_cPa127-unknown_cPa241_cPa356_cPa540,1_3_1_1_1_2,102,95
Scaffold214-50477_50898,cPa127,0.305555555555556,10,50890,50526,cPa11_cPa11-unknown_cPa127_cPa241_cPa241-unknown_cPa356-cPa290-hybrid_cPa515_cPa530_cPa531-cPa290-hybrid_cPa540,2_3_11_2_1_1_5_4_1_6,421,364
Scaffold214-53874_53976,cPa127,0.3125,9,53960,53886,cPa11_cPa11-cPa515-hybrid_cPa127_cPa127-cPa515-hybrid_cPa515_cPa530_cPa531_cPa540_cPa552,1_1_5_1_1_2_1_3_1,102,74
Scaffold214-54494_54618,cPa515,0.217391304347826,11,54598,54494,cPa11_cPa127_cPa241_cPa356-cPa531-hybrid_cPa515_cPa515-cPa356-hybrid_cPa530_cPa531_cPa531-cPa515-hybrid_cPa540_cPa552,2_4_3_1_5_1_3_1_1_1_1,124,104
Scaffold215-23452_23554,cPa356,0.666666666666667,2,23527,23501,cPa356_cPa428,2_1,102,26
Scaffold215-34817_34919,cPa356,1,1,34867,34867,cPa356,1,102,0
Scaffold215-40276_40378,cPa428,0.583333333333333,2,40357,40283,cPa356_cPa428,5_7,102,74
Scaffold215-7891_7993,cPa428,0.48780487804878,4,7989,7906,cPa356_cPa356-cPa428-hybrid_cPa419_cPa428,19_1_1_20,102,83
Scaffold219-15714_15847,cPa428,0.673076923076923,3,15804,15764,cPa356_cPa356-unknown_cPa428,16_1_35,133,40
Scaffold219-19925_20027,cPa356_cPa428,0.5,2,19975,19975,cPa356_cPa428,1_1,102,0
Scaffold219-20749_20852,cPa356,0.666666666666667,2,20800,20758,cPa356_cPa428,2_1,103,42
Scaffold219-21328_21430,cPa356_cPa428,0.5,2,21378,21343,cPa356_cPa428,2_2,102,35
Scaffold219-24102_24204,cPa428,0.666666666666667,2,24168,24152,cPa356_cPa428,1_2,102,16
Scaffold219-24426_24528,cPa356_cPa428,0.5,2,24482,24476,cPa356_cPa428,1_1,102,6
Scaffold219-24626_24728,cPa428,1,1,24676,24676,cPa428,2,102,0
Scaffold219-25033_25157,cPa428,0.571428571428571,2,25125,25082,cPa356_cPa428,6_8,124,43
Scaffold219-32209_32345,cPa428,0.777777777777778,2,32302,32256,cPa356_cPa428,2_7,136,46
Scaffold219-36687_36822,cPa428,0.631578947368421,2,36777,36713,cPa356_cPa428,7_12,135,64
Scaffold219-38580_38682,cPa428,1,1,38630,38630,cPa428,1,102,0
Scaffold219-46407_46509,cPa356,0.75,2,46460,46456,cPa356_cPa428,3_1,102,4
Scaffold220-10313_10415,cPa419,0.666666666666667,5,10407,10322,cPa400_cPa419_cPa428-cPa163-hybrid_cPa75_HTLV2_M10060-cPa75-hybrid,1_8_1_1_1,102,85
Scaffold220-10990_11092,cPa400,0.625,4,11088,10998,cPa400_cPa419_cPa74_cPa74-cPa163-hybrid,5_1_1_1,102,90
Scaffold220-11299_11401,cPa400,0.9,2,11395,11319,cPa400_cPa75,9_1,102,76
Scaffold220-12163_12312,cPa400,0.619047619047619,4,12293,12210,cPa400_cPa419_cPa75_MLV_Pmv4,13_6_1_1,149,83
Scaffold220-14079_14181,cPa400,0.666666666666667,3,14139,14080,cPa400_cPa419_cPa456-cPa447-hybrid,4_1_1,102,59
Scaffold220-14268_14699,cPa400,0.943396226415094,6,14653,14267,cPa400_cPa402_cPa419_cPa456-unknown_cPa75-cPa447-hybrid_cPa75-unknown,150_1_5_1_1_1,431,386
Scaffold220-20211_20490,cPa400,0.954545454545455,2,20486,20223,cPa400_cPa419,21_1,279,263
Scaffold220-20574_20722,cPa400,0.857142857142857,2,20670,20611,cPa400_cPa419,6_1,148,59
Scaffold220-21297_21399,cPa400,1,1,21395,21333,cPa400,13,102,62
Scaffold220-21477_21701,cPa400,1,1,21649,21523,cPa400,23,224,126
Scaffold220-21767_21897,cPa400,0.857142857142857,2,21872,21810,cPa117-cPa219-hybrid_cPa400,1_6,130,62
Scaffold220-21963_22112,cPa400,1,1,22101,21962,cPa400,18,149,139
Scaffold220-22131_22385,cPa400,0.980769230769231,2,22366,22130,cPa308_cPa400,1_51,254,236
Scaffold220-22483_22596,cPa400,0.849056603773585,8,22593,22483,cPa257-cPa18-hybrid_cPa257-cPa219-hybrid_cPa257-cPa541-hybrid_cPa285-cPa541-hybrid_cPa400_cPa419_cPa546-cPa219-hybrid_cPa60-cPa541-hybrid,1_1_2_1_45_1_1_1,113,110
Scaffold220-23815_23917,cPa400,0.923076923076923,3,23890,23818,cPa257-cPa541-hybrid_cPa400_cPa546-cPa541-hybrid,1_24_1,102,72
Scaffold220-24847_25014,cPa400,0.384615384615385,10,24962,24893,cPa257-cPa428-hybrid_cPa257-cPa75-hybrid_cPa257-unknown_cPa285-cPa75-hybrid_cPa400_cPa400-unknown_cPa409-cPa62-hybrid_cPa546-cPa75-hybrid_cPa61-cPa75-hybrid_cPa75,1_4_3_3_10_1_1_1_1_1,167,69
Scaffold220-25022_25198,cPa257-cPa75-hybrid,0.6,4,25156,25072,cPa257-cPa75-hybrid_cPa257-unknown_cPa546-cPa75-hybrid_cPa60-cPa75-hybrid,6_2_1_1,176,84
Scaffold220-25235_25337,cPa257-cPa75-hybrid,1,1,25285,25285,cPa257-cPa75-hybrid,1,102,0
Scaffold220-25535_25637,cPa257-HERV-E_repbase_HERVE_LTR2-hybrid,1,1,25585,25585,cPa257-HERV-E_repbase_HERVE_LTR2-hybrid,1,102,0
Scaffold220-25789_25891,cPa75,1,1,25839,25839,cPa75,1,102,0
Scaffold220-25995_26184,cPa257-cPa75-hybrid_cPa285-cPa75-hybrid_cPa546-cPa75-hybrid,0.333333333333333,3,26132,26045,cPa257-cPa75-hybrid_cPa285-cPa75-hybrid_cPa546-cPa75-hybrid,1_1_1,189,87
Scaffold220-30586_30688,cPa419,1,1,30636,30636,cPa419,1,102,0
Scaffold220-30729_30876,cPa402,0.294117647058824,10,30876,30769,cPa193_cPa193-cPa402-hybrid_cPa193-cPa75-hybrid_cPa402_cPa402-cPa339-hybrid_cPa402-cPa75-hybrid_cPa419_cPa518_cPa518-cPa339-hybrid_cPa518-cPa75-hybrid,1_1_3_5_1_1_1_2_1_1,147,107
Scaffold220-30930_31032,cPa193_cPa402-cPa75-hybrid_cPa518-cPa75-hybrid,0.333333333333333,3,30980,30960,cPa193_cPa402-cPa75-hybrid_cPa518-cPa75-hybrid,1_1_1,102,20
Scaffold220-31060_31162,cPa518,0.5,4,31155,31071,cPa193-cPa75-hybrid_cPa402_cPa518_cPa518-cPa62-hybrid,1_1_3_1,102,84
Scaffold220-32248_32395,cPa75,0.212121212121212,17,32395,32285,ALVJ_Z46390-cPa339-hybrid_ALVJ_Z46390-cPa75-hybrid_cPa16-cPa75-hybrid_cPa183-cPa542-hybrid_cPa183-cPa75-hybrid_cPa193-cPa75-hybrid_cPa339_cPa363-cPa75-hybrid_cPa379-cPa75-hybrid_cPa402-cPa502-hybrid_cPa402-cPa75-hybrid_cPa419_cPa446-cPa2-hybrid_cPa446-cPa75-hybrid_cPa71-cPa402-hybrid_cPa75_HERVHcons-cPa75-hybrid,1_1_1_1_5_2_1_1_2_2_1_1_1_4_1_7_1,147,110
Scaffold220-32429_32531,cPa502,0.666666666666667,2,32495,32479,cPa502_cPa75,2_1,102,16
Scaffold220-33912_34045,cPa183,0.321428571428571,13,33993,33913,cPa16_cPa183_cPa363-cPa183-hybrid_cPa379_cPa379-cPa163-hybrid_cPa379-cPa75-hybrid_cPa419_cPa446_cPa446-cPa163-hybrid_cPa446-cPa183-hybrid_cPa446-cPa502-hybrid_cPa446-cPa75-hybrid_cPa452,1_9_1_2_1_1_1_3_2_2_1_2_2,133,80
Scaffold220-34057_34302,cPa452,0.25,7,34250,34078,cPa183_cPa379_cPa379-cPa163-hybrid_cPa419_cPa446_cPa452_EIAV_NC001450,1_2_2_2_1_3_1,245,172
Scaffold220-39177_39279,cPa117-cPa413-hybrid_cPa419_cPa456-cPa150-hybrid_cPa456-cPa413-hybrid_cPa502,0.2,5,39229,39218,cPa117-cPa413-hybrid_cPa419_cPa456-cPa150-hybrid_cPa456-cPa413-hybrid_cPa502,1_1_1_1_1,102,11
Scaffold220-39299_39401,cPa363,0.4,4,39378,39349,cPa363_cPa363-unknown_cPa456_cPa456-unknown,2_1_1_1,102,29
Scaffold220-4537_4639,cPa75,0.818181818181818,3,4608,4544,cPa363-cPa2-hybrid_cPa419_cPa75,1_1_9,102,64
Scaffold220-47574_47676,cPa555-cPa527-hybrid,0.5,3,47645,47594,cPa419_cPa555-cPa357-hybrid_cPa555-cPa527-hybrid,1_1_2,102,51
Scaffold220-49594_50242,cPa357-cPa363-hybrid_cPa357-cPa452-hybrid,0.0925925925925926,27,50190,49644,cPa118-cPa452-hybrid_cPa15-cPa176-hybrid_cPa15-cPa183-hybrid_cPa15-cPa363-hybrid_cPa15-cPa446-hybrid_cPa15-cPa71-hybrid_cPa157-cPa363-hybrid_cPa227-cPa327-hybrid_cPa227-cPa363-hybrid_cPa227-cPa452-hybrid_cPa227-cPa71-hybrid_cPa357-cPa363-hybrid_cPa357-cPa452-hybrid_cPa410-cPa363-hybrid_cPa410-cPa452-hybrid_cPa410-cPa71-hybrid_cPa443-cPa363-hybrid_cPa443-cPa452-hybrid_cPa443-cPa71-hybrid_cPa443-ENTV_NC004994-hybrid_cPa521-cPa183-hybrid_cPa521-cPa452-hybrid_cPa583-cPa363-hybrid_cPa583-cPa452-hybrid_cPa61-cPa363-hybrid_cPa61-cPa452-hybrid_cPa61-unknown,1_2_2_4_1_1_1_1_1_3_1_5_5_2_4_1_3_3_1_1_1_1_2_2_1_3_1,648,546
Scaffold220-50278_50545,cPa357-cPa363-hybrid,0.0909090909090909,33,50493,50328,ALVJ_Z46390-cPa176-hybrid_cPa118-cPa327-hybrid_cPa118-cPa363-hybrid_cPa118-cPa71-hybrid_cPa15-cPa176-hybrid_cPa15-cPa183-hybrid_cPa15-cPa327-hybrid_cPa15-cPa363-hybrid_cPa15-cPa71-hybrid_cPa227-cPa183-hybrid_cPa227-cPa363-hybrid_cPa227-cPa452-hybrid_cPa227-cPa71-hybrid_cPa227-ENTV_NC004994-hybrid_cPa264-cPa183-hybrid_cPa357-cPa176-hybrid_cPa357-cPa183-hybrid_cPa357-cPa363-hybrid_cPa357-cPa446-hybrid_cPa357-cPa452-hybrid_cPa363_cPa410-cPa176-hybrid_cPa410-cPa327-hybrid_cPa410-cPa363-hybrid_cPa419_cPa419-cPa71-hybrid_cPa443-cPa363-hybrid_cPa583-cPa183-hybrid_cPa583-cPa363-hybrid_cPa61-cPa363-hybrid_cPa61-cPa452-hybrid_cPa61-cPa71-hybrid_cPa71,1_1_1_1_3_2_1_2_1_1_3_1_1_1_1_1_1_4_1_1_1_1_1_1_1_1_2_1_2_1_1_1_1,267,165
Scaffold220-51473_51575,cPa419,0.75,2,51523,51512,cPa363_cPa419,1_3,102,11
Scaffold220-5295_5397,cPa456_cPa502,0.25,6,5389,5341,cPa363_cPa452_cPa456_cPa502_cPa587_cPa587-cPa199-hybrid,1_1_2_2_1_1,102,48
Scaffold220-6541_6643,cPa502,0.65,3,6639,6555,cPa339-cPa587-hybrid_cPa456_cPa502,1_6_13,102,84
Scaffold220-8213_8315,cPa502-cPa107-hybrid_cPa502-cPa227-hybrid,0.5,2,8263,8213,cPa502-cPa107-hybrid_cPa502-cPa227-hybrid,1_1,102,50
Scaffold220-8391_8538,cPa419_cPa502-unknown,0.5,2,8486,8431,cPa419_cPa502-unknown,2_2,147,55
Scaffold220-9056_9242,cPa502-cPa75-hybrid,0.179487179487179,15,9212,9080,cPa227-cPa145-hybrid_cPa227-cPa163-hybrid_cPa227-cPa75-hybrid_cPa273-cPa145-hybrid_cPa273-cPa163-hybrid_cPa273-cPa419-hybrid_cPa273-cPa75-hybrid_cPa339-cPa419-hybrid_cPa419_cPa502-cPa145-hybrid_cPa502-cPa75-hybrid_cPa75_HTLV2_M10060_HTLV2_M10060-cPa75-hybrid_HTLV2_M10060-unknown,1_1_3_2_1_1_6_1_5_1_7_1_5_3_1,186,132
Scaffold220-9399_9517,cPa227-cPa75-hybrid_cPa419_HTLV2_M10060-cPa75-hybrid,0.333333333333333,3,9465,9449,cPa227-cPa75-hybrid_cPa419_HTLV2_M10060-cPa75-hybrid,1_1_1,118,16
Scaffold220-9541_9735,HTLV2_M10060-cPa75-hybrid,0.5,3,9688,9591,cPa419_HTLV2_M10060-cPa419-hybrid_HTLV2_M10060-cPa75-hybrid,1_1_2,194,97
Scaffold220-9915_10087,cPa419,0.384615384615385,7,10087,9940,cPa227-cPa74-hybrid_cPa419_cPa502-cPa75-hybrid_cPa585-cPa75-hybrid_cPa75_HTLV2_M10060-cPa145-hybrid_MDEV_AF053745-cPa75-hybrid,1_5_1_2_2_1_1,172,147
Scaffold221-31812_31914,cPa356_cPa428,0.5,2,31869,31824,cPa356_cPa428,5_5,102,45
Scaffold221-32143_32334,cPa428,0.508474576271186,3,32333,32178,cPa356_cPa356-unknown_cPa428,28_1_30,191,155
Scaffold223-1096_1298,cPa75,0.29126213592233,33,1297,1095,cPa107-cPa15-hybrid_cPa107-cPa183-hybrid_cPa107-cPa223-hybrid_cPa107-cPa327-hybrid_cPa107-cPa363-hybrid_cPa107-cPa452-hybrid_cPa127-cPa363-hybrid_cPa183-cPa443-hybrid_cPa183-cPa510-hybrid_cPa183-cPa511-hybrid_cPa183-MDEV_AF053745-hybrid_cPa199-cPa118-hybrid_cPa199-cPa15-hybrid_cPa199-cPa176-hybrid_cPa199-cPa183-hybrid_cPa199-cPa223-hybrid_cPa199-cPa327-hybrid_cPa199-cPa363-hybrid_cPa199-cPa452-hybrid_cPa285_cPa285-cPa363-hybrid_cPa360-cPa285-hybrid_cPa392_cPa419_cPa428_cPa443_cPa443-MDEV_AF053745-hybrid_cPa447-cPa327-hybrid_cPa530-cPa15-hybrid_cPa530-cPa363-hybrid_cPa75_FeLV_NC001940-cPa327-hybrid_FeLV_NC001940-cPa363-hybrid,1_2_1_2_11_1_1_1_1_1_2_1_2_1_2_2_5_13_1_1_1_1_1_7_1_2_1_1_1_2_30_1_2,202,202
Scaffold223-2785_2887,FeLV_NC001940-cPa360-hybrid,0.1875,21,2861,2798,cPa157-cPa34-hybrid_cPa157-cPa510-hybrid_cPa157-cPa75-hybrid_cPa356-cPa447-hybrid_cPa419_cPa526-cPa447-hybrid_cPa62-cPa510-hybrid_cPa75_FeLV_NC001940-cPa260-hybrid_FeLV_NC001940-cPa34-hybrid_FeLV_NC001940-cPa360-hybrid_FeLV_NC001940-cPa392-hybrid_FeLV_NC001940-cPa419-hybrid_FeLV_NC001940-cPa51-hybrid_FeLV_NC001940-cPa510-hybrid_FeLV_NC001940-cPa56-hybrid_FeLV_NC001940-cPa75-hybrid_FeLV_NC001940-HML3_repbase_HERVK9I_MER9-hybrid_FeLV_NC001940-MDEV_AF053745-hybrid_S71_repbase_HERVS71_LTR6A_S71_repbase_HERVS71_LTR6A-MDEV_AF053745-hybrid,2_1_1_1_1_1_1_1_1_1_6_1_1_1_1_1_3_1_4_1_1,102,63
Scaffold223-2917_3021,cPa419,0.217391304347826,16,3020,2934,cPa200_cPa285-cPa379-hybrid_cPa356_cPa356-cPa447-hybrid_cPa419_cPa447_cPa526_cPa526-cPa293-hybrid_cPa526-unknown_cPa75_FeLV_NC001940_FeLV_NC001940-cPa199-hybrid_FeLV_NC001940-cPa200-hybrid_FeLV_NC001940-cPa380-hybrid_FeLV_NC001940-unknown_S71_repbase_HERVS71_LTR6A,1_1_1_1_5_1_2_1_1_2_1_1_1_1_1_2,104,86
Scaffold223-29480_29582,cPa425,1,1,29530,29530,cPa425,1,102,0
Scaffold223-31542_31676,cPa323,0.5,4,31624,31591,cPa323_cPa62-cPa323-hybrid_cPa75-cPa248-hybrid_S71_repbase_HERVS71_LTR6A,3_1_1_1,134,33
Scaffold223-31692_31861,cPa323_cPa75,0.5,2,31809,31742,cPa323_cPa75,1_1,169,67
Scaffold223-33275_33539,cPa356,0.336206896551724,21,33487,33294,cPa356_cPa356-cPa323-hybrid_cPa356-cPa425-hybrid_cPa356-cPa447-hybrid_cPa356-cPa523-hybrid_cPa434_cPa434-cPa323-hybrid_cPa434-cPa356-hybrid_cPa434-cPa387-hybrid_cPa434-cPa523-hybrid_cPa434-unknown_cPa523_cPa523-cPa356-hybrid_cPa523-cPa387-hybrid_cPa523-cPa425-hybrid_cPa523-cPa434-hybrid_cPa523-cPa447-hybrid_cPa523-cPa542-hybrid_cPa523-HERV-Fb_repbase_HERVH48I_MER48-hybrid_cPa523-unknown_HERV-Fb_repbase_HERVH48I_MER48-cPa542-hybrid,39_1_1_1_1_16_1_1_2_1_2_31_4_2_2_1_2_1_1_5_1,264,193
Scaffold223-40286_40927,cPa75,0.953488372093023,3,40904,40300,cPa419_cPa62_cPa75,1_1_41,641,604
Scaffold223-40961_41063,cPa75,1,1,41023,41011,cPa75,2,102,12
Scaffold223-41458_41659,cPa381-HTLV2_M10060-hybrid,0.25,7,41607,41508,cPa293-cPa62-hybrid_cPa293-HTLV2_M10060-hybrid_cPa360-unknown_cPa381-HTLV2_M10060-hybrid_cPa419_cPa62_cPa75,1_1_1_2_1_1_1,201,99
Scaffold223-4219_4622,cPa356,0.584415584415584,18,4570,4228,cPa285-cPa194-hybrid_cPa285-cPa387-hybrid_cPa293-cPa194-hybrid_cPa293-cPa434-hybrid_cPa293-cPa67-hybrid_cPa293-cPa75-hybrid_cPa293-unknown_cPa308-cPa194-hybrid_cPa356_cPa356-cPa194-hybrid_cPa356-unknown_cPa387_cPa387-cPa194-hybrid_cPa419-cPa194-hybrid_cPa428_cPa447_cPa447-cPa194-hybrid_cPa447-cPa434-hybrid,1_1_23_2_3_1_3_1_135_10_1_1_1_1_1_37_7_2,403,342
Scaffold223-42301_42438,cPa138,0.5,3,42386,42309,cPa138_cPa419_cPa575-cPa138-hybrid,3_2_1,137,77
Scaffold223-42442_42765,cPa138,0.705882352941177,4,42721,42472,cPa138_cPa138-cPa121-hybrid_cPa138-cPa402-hybrid_cPa419,12_3_1_1,323,249
Scaffold223-43424_43526,cPa425,0.8,2,43494,43474,cPa138-cPa356-hybrid_cPa425,1_4,102,20
Scaffold223-44755_44913,cPa425,0.882352941176471,3,44877,44770,cPa419_cPa425_cPa75,1_15_1,158,107
Scaffold223-45309_45439,cPa425,0.9,2,45387,45327,cPa419_cPa425,1_9,130,60
Scaffold223-45498_45600,cPa425,1,1,45548,45548,cPa425,1,102,0
Scaffold223-45671_45961,cPa425,0.962264150943396,2,45930,45713,cPa425_cPa425-unknown,51_2,290,217
Scaffold223-46650_46938,cPa434-cPa478-hybrid,0.142857142857143,15,46886,46655,cPa138-cPa478-hybrid_cPa419_cPa425_cPa434-cPa425-hybrid_cPa434-cPa478-hybrid_cPa434-MDEV_AF053745-hybrid_cPa434-MSEV_CT990572-hybrid_cPa434-REV_NC006934-hybrid_cPa434-unknown_cPa478_cPa523-cPa478-hybrid_cPa582_cPa75_cPa75-MSEV_CT990572-hybrid_MDEV_AF053745,1_1_1_1_3_2_1_1_2_1_1_2_1_1_2,288,231
Scaffold223-47252_47484,MSEV_CT990572,0.377358490566038,11,47432,47290,cPa125-cPa478-hybrid_cPa419_cPa425-cPa478-hybrid_cPa434-cPa478-hybrid_cPa434-unknown_cPa478_cPa479-cPa478-hybrid_cPa479-MDEV_AF053745-hybrid_cPa75-unknown_MDEV_AF053745_MSEV_CT990572,1_2_1_1_2_11_1_1_1_12_20,232,142
Scaffold223-49146_49248,cPa125-cPa447-hybrid_cPa419_cPa425,0.333333333333333,3,49247,49196,cPa125-cPa447-hybrid_cPa419_cPa425,1_1_1,102,51
Scaffold223-49673_49875,cPa118_cPa15,0.2,11,49823,49678,cPa118_cPa125-cPa118-hybrid_cPa125-cPa15-hybrid_cPa15_cPa15-MSEV_CT990572-hybrid_cPa248-cPa118-hybrid_cPa248-MDEV_AF053745-hybrid_cPa268-cPa118-hybrid_cPa419_cPa425_cPa425-unknown,3_1_1_3_1_1_1_1_1_1_1,202,145
Scaffold223-5075_5191,cPa293-cPa194-hybrid,0.666666666666667,2,5139,5090,cPa293-cPa194-hybrid_cPa356-cPa194-hybrid,2_1,116,49
Scaffold223-5252_5735,cPa67,0.574545454545455,16,5720,5302,cPa194_cPa200-cPa194-hybrid_cPa200-cPa434-hybrid_cPa293-cPa194-hybrid_cPa356-cPa194-hybrid_cPa425-cPa194-hybrid_cPa425-cPa434-hybrid_cPa425-cPa67-hybrid_cPa434_cPa447-cPa194-hybrid_cPa479-cPa194-hybrid_cPa67_cPa67-cPa194-hybrid_cPa75-cPa194-hybrid_cPa75-cPa434-hybrid_cPa75-cPa67-hybrid,84_4_2_2_8_4_1_1_2_2_1_158_3_1_1_1,483,418
Scaffold223-6437_6872,cPa425,0.582089552238806,11,6820,6440,cPa200-cPa194-hybrid_cPa200-cPa425-hybrid_cPa200-cPa434-hybrid_cPa200-cPa75-hybrid_cPa200-HIV2_NC001722-hybrid_cPa425_cPa425-cPa194-hybrid_cPa425-cPa75-hybrid_cPa425-HIV2_NC001722-hybrid_cPa75_HERV-XA34_repbase_HERVFH21I_LTR21A-cPa75-hybrid,1_3_2_2_1_39_7_4_2_5_1,435,380
Scaffold223-6987_7089,cPa425,1,1,7037,7037,cPa425,1,102,0
Scaffold223-7392_7547,cPa425,0.8,2,7495,7412,cPa308-cPa75-hybrid_cPa425,1_4,155,83
Scaffold224-27979_28088,cPa339,0.333333333333333,6,28085,28008,cPa174_cPa254_cPa339_cPa419_cPa425_cPa47-unknown,1_1_3_2_1_1,109,77
Scaffold224-2914_3016,cPa251,0.75,2,2984,2963,cPa251_cPa358,3_1,102,21
Scaffold224-3374_3780,cPa251,0.459016393442623,4,3751,3424,cPa251_cPa358_cPa358-unknown_cPa583,28_11_2_20,406,327
Scaffold224-39384_39486,cPa419,0.8,2,39484,39423,cPa419_PERVC_HM159246-cPa419-hybrid,4_1,102,61
Scaffold224-42596_42727,cPa333,0.2,20,42675,42621,cPa176-cPa333-hybrid_cPa176-cPa50-hybrid_cPa190-cPa174-hybrid_cPa190-cPa50-hybrid_cPa254_cPa255-cPa333-hybrid_cPa255-cPa50-hybrid_cPa333_cPa419_cPa479-cPa333-hybrid_cPa479-cPa50-hybrid_cPa482-cPa174-hybrid_cPa482-cPa254-hybrid_cPa482-cPa333-hybrid_cPa482-cPa50-hybrid_cPa482-cPa523-hybrid_cPa50_cPa75_cPa75-cPa333-hybrid_HERV-ADP_repbase_HERVP71A_I_LTR71A-cPa174-hybrid,1_1_1_1_1_3_5_20_15_1_4_5_8_4_3_2_17_6_1_1,131,54
Scaffold224-42795_42935,cPa333,0.557692307692308,3,42884,42845,cPa333_cPa419_cPa50,116_3_89,140,39
Scaffold224-42988_43101,cPa419,0.444444444444444,4,43052,43038,cPa190-cPa174-hybrid_cPa419_cPa428_cPa482-cPa174-hybrid,1_4_1_3,113,14
Scaffold224-43736_43838,cPa419,0.75,3,43837,43777,cPa174_cPa419_cPa47,1_6_1,102,60
Scaffold224-5340_5442,cPa251,0.75,3,5433,5370,cPa251_cPa358_cPa500-cPa251-hybrid,6_1_1,102,63
Scaffold224-5532_5634,cPa251,1,1,5582,5577,cPa251,2,102,5
Scaffold224-5782_5936,cPa251,0.555555555555556,4,5885,5832,cPa251_cPa251-cPa456-hybrid_cPa358_HFV_NC001736-cPa358-hybrid,5_1_2_1,154,53
Scaffold224-598_700,cPa251,1,1,648,648,cPa251,1,102,0
Scaffold224-5992_6094,cPa251,0.875,2,6083,5998,cPa251_cPa358,7_1,102,85
Scaffold226-12353_12536,cPa419,0.375,8,12507,12382,Cer1_U15406-cPa208-hybrid_cPa419_cPa500_cPa500-cPa208-hybrid_HML1b_repbase_HERV-K14I_LTR14A_HML1b_repbase_HERV-K14I_LTR14A-cPa208-hybrid_HML1b_repbase_HERV-K14I_LTR14A-cPa50-hybrid_Xen1_AJ506107-cPa208-hybrid,1_6_1_1_2_2_1_2,183,125
Scaffold226-17297_17408,cPa549-unknown,0.571428571428571,2,17356,17300,cPa419_cPa549-unknown,3_4,111,56
Scaffold226-19485_19587,cPa465-MER52A_repbase_MER52AI_MER52A-hybrid,0.666666666666667,3,19573,19533,cPa419_cPa465-MER52A_repbase_MER52AI_MER52A-hybrid_cPa56-MER52A_repbase_MER52AI_MER52A-hybrid,1_4_1,102,40
Scaffold226-26008_26110,cPa419,1,1,26097,26024,cPa419,10,102,73
Scaffold226-26751_26853,cPa419,0.857142857142857,2,26844,26767,cPa315_cPa419,1_6,102,77
Scaffold226-32916_33018,cPa419,0.5,3,32997,32944,cPa356_cPa391_cPa419,1_2_3,102,53
Scaffold226-34885_34987,cPa419,0.555555555555556,3,34973,34926,cPa419_HIV1_NC001802_HIV1_NC001802-unknown,5_3_1,102,47
Scaffold226-35103_35227,HIV1_NC001802,0.666666666666667,4,35223,35102,cPa419_cPa419-HIV1_NC001802-hybrid_HIV1_NC001802_HIV1_NC001802-unknown,9_1_24_2,124,121
Scaffold226-39812_39919,cPa419,0.4,7,39916,39837,cPa118-cPa333-hybrid_cPa177-cPa208-hybrid_cPa177-cPa333-hybrid_cPa177-cPa555-hybrid_cPa419_cPa539-cPa475-hybrid_cPa75,1_1_1_1_4_1_1,107,79
Scaffold226-40943_41045,cPa333,1,1,40993,40993,cPa333,1,102,0
Scaffold227-14096_14198,cPa75-unknown,1,1,14153,14142,cPa75-unknown,3,102,11
Scaffold227-15866_15968,cPa254,0.4,4,15960,15904,cPa174-cPa443-hybrid_cPa254_cPa404_cPa47,1_2_1_1,102,56
Scaffold227-32105_32207,cPa516-cPa75-hybrid,1,1,32155,32155,cPa516-cPa75-hybrid,1,102,0
Scaffold227-32893_33046,cPa224-cPa75-hybrid,0.333333333333333,6,33029,32912,cPa216-cPa75-hybrid_cPa224-cPa75-hybrid_cPa387_cPa402-cPa75-hybrid_cPa404-cPa75-hybrid_cPa419,1_3_1_2_1_1,153,117
Scaffold227-33724_33826,cPa75,0.315789473684211,8,33811,33723,cPa224-cPa75-hybrid_cPa308-cPa75-hybrid_cPa395-cPa75-hybrid_cPa402-cPa419-hybrid_cPa402-cPa75-hybrid_cPa419_cPa62-cPa75-hybrid_cPa75,5_1_1_1_3_1_1_6,102,88
Scaffold227-40472_40614,cPa264-unknown,0.5,4,40602,40491,cPa264-HERV-ADP_repbase_HERVP71A_I_LTR71A-hybrid_cPa264-unknown_cPa75-cPa356-hybrid_cPa75-GaLV_M26927-hybrid,1_4_2_1,142,111
Scaffold227-41885_42120,cPa75-cPa168-hybrid,0.347826086956522,5,42068,41935,cPa168_cPa264-cPa168-hybrid_cPa75-cPa168-hybrid_cPa75-HERV-ADP_repbase_HERVP71A_I_LTR71A-hybrid_cPa75-unknown,6_6_8_2_1,235,133
Scaffold227-5088_5220,cPa413,0.964285714285714,2,5212,5109,cPa413_cPa413-unknown,27_1,132,103
Scaffold227-5332_5434,cPa413,1,1,5395,5344,cPa413,5,102,51
Scaffold228-10259_10469,cPa323,0.555555555555556,5,10453,10262,cPa158_cPa158-cPa323-hybrid_cPa323_cPa75-cPa118-hybrid_cPa75-cPa323-hybrid,4_2_15_1_5,210,191
Scaffold228-12985_13088,cPa315,0.693877551020408,9,13041,13022,cPa118-cPa315-hybrid_cPa285-cPa75-hybrid_cPa315_cPa419_cPa426-cPa75-hybrid_cPa62_cPa62-cPa308-hybrid_cPa62-cPa75-hybrid_cPa75,1_1_34_6_1_2_1_1_2,103,19
Scaffold228-13430_13715,cPa315,0.455445544554455,31,13693,13460,cPa15-cPa308-hybrid_cPa205-cPa315-hybrid_cPa205-cPa75-hybrid_cPa224_cPa224-cPa529-hybrid_cPa224-cPa75-hybrid_cPa285_cPa285-cPa205-hybrid_cPa285-cPa224-hybrid_cPa285-cPa248-hybrid_cPa285-cPa308-hybrid_cPa285-cPa447-hybrid_cPa285-cPa529-hybrid_cPa285-cPa587-hybrid_cPa285-cPa62-hybrid_cPa285-cPa75-hybrid_cPa285-unknown_cPa308_cPa308-cPa529-hybrid_cPa315_cPa327-cPa75-hybrid_cPa353-cPa308-hybrid_cPa353-cPa315-hybrid_cPa353-cPa62-hybrid_cPa353-cPa75-hybrid_cPa353-HML4_repbase_HERVK13I_LTR13-hybrid_cPa419_cPa62_cPa62-cPa529-hybrid_cPa62-cPa75-hybrid_cPa75,1_1_1_2_2_1_10_1_2_1_3_1_22_1_6_12_3_30_4_184_1_1_2_3_4_1_8_22_3_1_70,285,233
Scaffold228-13744_13855,cPa315_cPa419,0.333333333333333,4,13846,13748,cPa268-cPa315-hybrid_cPa315_cPa419_cPa75,1_2_2_1,111,98
Scaffold228-1548_1650,cPa449_cPa452,0.5,2,1598,1549,cPa449_cPa452,1_1,102,49
Scaffold228-15514_15758,cPa390,0.305,46,15743,15515,cPa15-cPa447-hybrid_cPa174-cPa390-hybrid_cPa174-cPa447-hybrid_cPa174-cPa62-hybrid_cPa205_cPa205-cPa308-hybrid_cPa205-cPa447-hybrid_cPa254-cPa447-hybrid_cPa260-cPa339-hybrid_cPa285-cPa529-hybrid_cPa315-cPa447-hybrid_cPa339_cPa339-cPa315-hybrid_cPa353_cPa353-cPa205-hybrid_cPa353-cPa223-hybrid_cPa353-cPa260-hybrid_cPa353-cPa308-hybrid_cPa353-cPa315-hybrid_cPa353-cPa339-hybrid_cPa353-cPa357-hybrid_cPa353-cPa390-hybrid_cPa353-cPa419-hybrid_cPa353-cPa447-hybrid_cPa353-cPa449-hybrid_cPa353-cPa469-hybrid_cPa353-cPa529-hybrid_cPa353-cPa62-hybrid_cPa353-cPa75-hybrid_cPa357-cPa390-hybrid_cPa357-cPa447-hybrid_cPa390_cPa390-cPa447-hybrid_cPa390-cPa75-hybrid_cPa404-cPa447-hybrid_cPa419_cPa443-cPa390-hybrid_cPa447_cPa449_cPa469_cPa47-cPa447-hybrid_cPa47-cPa62-hybrid_cPa62_cPa62-cPa529-hybrid_HTLV2_M10060-cPa390-hybrid_JSRV_DQ838494-cPa390-hybrid,1_1_3_1_5_1_2_2_1_1_1_1_1_13_7_1_1_3_2_1_1_5_1_1_1_1_3_1_4_1_1_61_1_1_1_9_1_17_20_10_3_2_2_1_1_1,244,228
Scaffold228-17215_17437,cPa223,0.569444444444444,16,17437,17216,cPa125-cPa194-hybrid_cPa15-cPa194-hybrid_cPa15-cPa223-hybrid_cPa174_cPa194_cPa223_cPa315_cPa402-cPa194-hybrid_cPa402-cPa223-hybrid_cPa404-cPa118-hybrid_cPa404-cPa194-hybrid_cPa419_cPa425-cPa447-hybrid_cPa426-cPa194-hybrid_cPa443-cPa223-hybrid_JSRV_DQ838494-cPa194-hybrid,1_4_2_4_2_41_2_2_3_1_2_3_1_1_2_1,222,221
Scaffold228-18883_19128,cPa174,0.133891213389121,61,19123,18882,cPa118_cPa118-cPa125-hybrid_cPa118-cPa174-hybrid_cPa118-cPa404-hybrid_cPa119_cPa119-cPa404-hybrid_cPa125_cPa125-cPa118-hybrid_cPa125-cPa140-hybrid_cPa125-cPa15-hybrid_cPa125-cPa174-hybrid_cPa125-cPa315-hybrid_cPa125-cPa404-hybrid_cPa125-cPa47-hybrid_cPa125-unknown_cPa140_cPa140-cPa248-hybrid_cPa140-cPa425-hybrid_cPa15_cPa15-cPa118-hybrid_cPa15-cPa140-hybrid_cPa15-cPa174-hybrid_cPa15-cPa248-hybrid_cPa15-cPa404-hybrid_cPa15-cPa425-hybrid_cPa15-cPa47-hybrid_cPa15-unknown_cPa174_cPa174-cPa118-hybrid_cPa174-cPa15-hybrid_cPa174-cPa47-hybrid_cPa248_cPa248-cPa140-hybrid_cPa248-cPa404-hybrid_cPa254_cPa268_cPa268-cPa118-hybrid_cPa268-cPa140-hybrid_cPa268-cPa404-hybrid_cPa268-unknown_cPa402_cPa402-cPa140-hybrid_cPa402-cPa15-hybrid_cPa402-cPa223-hybrid_cPa402-cPa248-hybrid_cPa402-cPa254-hybrid_cPa402-cPa315-hybrid_cPa402-cPa404-hybrid_cPa402-cPa425-hybrid_cPa402-cPa47-hybrid_cPa402-unknown_cPa404_cPa404-cPa15-hybrid_cPa419_cPa425_cPa425-cPa315-hybrid_cPa443_cPa443-cPa118-hybrid_cPa443-cPa404-hybrid_cPa47_cPa516-cPa140-hybrid,6_1_1_1_2_1_22_2_1_1_1_1_3_1_1_3_1_1_20_1_1_2_1_3_1_1_1_32_1_1_1_5_1_3_1_4_3_1_2_1_3_2_1_1_1_2_1_4_2_1_1_31_1_1_12_1_11_1_1_22_2,245,241
Scaffold228-19212_19392,cPa47,0.225,21,19381,19218,cPa118_cPa125_cPa125-cPa194-hybrid_cPa125-cPa315-hybrid_cPa140-cPa118-hybrid_cPa15_cPa15-cPa118-hybrid_cPa15-cPa194-hybrid_cPa15-cPa404-hybrid_cPa174_cPa174-cPa425-hybrid_cPa248-cPa118-hybrid_cPa248-cPa404-hybrid_cPa248-cPa425-hybrid_cPa404_cPa425_cPa443_cPa443-cPa118-hybrid_cPa443-cPa315-hybrid_cPa443-cPa404-hybrid_cPa47,2_1_1_1_1_3_1_1_1_4_1_2_1_1_5_1_1_1_1_1_9,180,163
Scaffold228-19903_20005,cPa174_cPa404_cPa425_cPa47,0.25,4,19987,19936,cPa174_cPa404_cPa425_cPa47,1_1_1_1,102,51
Scaffold228-20211_20387,cPa47,0.264150943396226,16,20338,20218,cPa118-cPa404-hybrid_cPa125_cPa125-cPa47-hybrid_cPa140_cPa140-cPa174-hybrid_cPa140-cPa404-hybrid_cPa15_cPa15-cPa404-hybrid_cPa174_cPa268_cPa402-cPa404-hybrid_cPa404_cPa404-cPa125-hybrid_cPa404-cPa140-hybrid_cPa425_cPa47,1_4_1_3_1_1_5_1_22_2_1_26_1_1_8_28,176,120
Scaffold228-20460_20601,cPa47,0.441860465116279,5,20581,20476,cPa174_cPa404_cPa425_cPa47_cPa47-cPa404-hybrid,14_5_4_19_1,141,105
Scaffold228-20915_21017,cPa425,1,1,20965,20927,cPa425,2,102,38
Scaffold228-21630_21824,cPa47,0.333333333333333,5,21817,21680,cPa174_cPa174-unknown_cPa404_cPa425_cPa47,1_1_1_1_2,194,137
Scaffold228-25495_25597,cPa16,0.272727272727273,7,25571,25543,cPa16_cPa16-cPa446-hybrid_cPa176_cPa363_cPa446_cPa452_cPa71,3_1_2_1_1_2_1,102,28
Scaffold228-25633_25881,cPa176,0.290322580645161,9,25876,25639,cPa16_cPa176_cPa357-cPa446-hybrid_cPa357-cPa71-hybrid_cPa357-unknown_cPa363_cPa446-cPa452-hybrid_cPa452_cPa71,5_9_1_1_1_6_1_6_1,248,237
Scaffold228-26934_27171,cPa176,0.212121212121212,14,27170,26935,cPa16_cPa16-cPa363-hybrid_cPa176_cPa176-unknown_cPa339-cPa363-hybrid_cPa363_cPa379_cPa395-cPa363-hybrid_cPa446_cPa446-cPa16-hybrid_cPa452_cPa452-cPa16-hybrid_cPa71_cPa71-cPa363-hybrid,12_1_14_2_1_5_1_1_3_1_10_1_13_1,237,235
Scaffold228-27173_27363,cPa16,0.3125,9,27358,27172,cPa16_cPa176_cPa363_cPa379_cPa419_cPa446_cPa446-cPa363-hybrid_cPa452_cPa71,10_5_4_2_1_2_1_4_3,190,186
Scaffold228-27913_28017,cPa446,0.25,8,28007,27914,cPa16_cPa176_cPa176-unknown_cPa446_cPa452_cPa452-cPa16-hybrid_cPa71_cPa71-cPa363-hybrid,1_2_1_3_1_1_2_1,104,93
Scaffold228-28172_28274,cPa176_cPa176-unknown_cPa71,0.333333333333333,3,28222,28189,cPa176_cPa176-unknown_cPa71,1_1_1,102,33
Scaffold228-37431_37604,cPa199_cPa402,0.214285714285714,8,37572,37450,cPa199_cPa199-cPa402-hybrid_cPa199-cPa450-hybrid_cPa199-unknown_cPa402_cPa402-cPa450-hybrid_cPa450_cPa542-cPa450-hybrid,3_1_1_1_3_2_2_1,173,122
Scaffold228-37707_37867,cPa402,0.45,9,37867,37718,cPa199-cPa450-hybrid_cPa199-cPa75-hybrid_cPa199-unknown_cPa285-HIV2_NC001722-hybrid_cPa362-HIV2_NC001722-hybrid_cPa402_cPa450_cPa542-cPa450-hybrid_cPa542-HIV2_NC001722-hybrid,2_1_2_1_1_9_2_1_1,160,149
Scaffold228-38891_39179,cPa402-cPa456-hybrid,0.30188679245283,17,39127,38916,cPa168-cPa456-hybrid_cPa199-cPa456-hybrid_cPa285-cPa456-hybrid_cPa402_cPa402-cPa16-hybrid_cPa402-cPa163-hybrid_cPa402-cPa205-hybrid_cPa402-cPa450-hybrid_cPa402-cPa456-hybrid_cPa402-cPa575-hybrid_cPa402-cPa587-hybrid_cPa402-HERV-F_repbase_HERVFH19I_LTR19A-hybrid_cPa402-HIV2_NC001722-hybrid_cPa402-unknown_cPa450-cPa339-hybrid_HERV-F_repbase_HERVFH19I_LTR19A_HML8_repbase_HERVK11I_MER11A-cPa450-hybrid,1_2_2_9_1_1_2_4_16_1_1_3_2_3_1_2_2,288,211
Scaffold228-39218_39460,HML8_repbase_HERVK11I_MER11A-cPa456-hybrid,0.333333333333333,7,39408,39268,cPa402-cPa456-hybrid_cPa402-cPa575-hybrid_cPa419_cPa75-cPa510-hybrid_HML8_repbase_HERVK11I_MER11A_HML8_repbase_HERVK11I_MER11A-cPa339-hybrid_HML8_repbase_HERVK11I_MER11A-cPa456-hybrid,1_1_3_1_1_1_4,242,140
Scaffold228-43746_43848,cPa419_WDSV_NC001867,0.5,2,43835,43796,cPa419_WDSV_NC001867,1_1,102,39
Scaffold228-43853_43991,cPa410_cPa419,0.2,8,43959,43865,cPa15_cPa264-cPa290-hybrid_cPa308-cPa410-hybrid_cPa410_cPa410-cPa434-hybrid_cPa410-HERV-W_repbase_HERV17_LTR17-hybrid_cPa419_EIAV_NC001450-cPa447-hybrid,1_1_1_2_1_1_2_1,138,94
Scaffold228-44861_45603,cPa356,0.385074626865672,38,45591,44867,cPa255-cPa254-hybrid_cPa264-cPa434-hybrid_cPa308-WDSV_NC001867-hybrid_cPa356_cPa356-cPa15-hybrid_cPa356-cPa308-hybrid_cPa356-cPa410-hybrid_cPa356-cPa434-hybrid_cPa356-cPa61-hybrid_cPa356-cPa75-hybrid_cPa356-unknown_cPa356-WDSV_NC001867-hybrid_cPa381-cPa61-hybrid_cPa381-WDSV_NC001867-hybrid_cPa387-cPa260-hybrid_cPa387-cPa308-hybrid_cPa387-cPa356-hybrid_cPa387-cPa434-hybrid_cPa387-unknown_cPa387-WDSV_NC001867-hybrid_cPa410-cPa308-hybrid_cPa410-cPa434-hybrid_cPa419_cPa434_cPa447_cPa447-cPa15-hybrid_cPa447-cPa308-hybrid_cPa447-cPa434-hybrid_cPa447-PERVA_AY099323-hybrid_cPa447-unknown_cPa447-WDSV_NC001867-hybrid_cPa486_cPa523-cPa308-hybrid_cPa566-cPa434-hybrid_cPa583-cPa264-hybrid_cPa583-cPa566-hybrid_cPa583-cPa62-hybrid_cPa583-WDSV_NC001867-hybrid,1_8_2_129_1_27_1_19_1_1_1_2_1_10_1_6_1_8_2_4_1_4_3_12_24_1_24_18_1_1_3_1_1_1_1_1_1_11,742,724
Scaffold228-45629_45827,cPa356,0.818181818181818,7,45788,45655,cPa356_cPa356-cPa308-hybrid_cPa356-cPa434-hybrid_cPa387-cPa308-hybrid_cPa387-cPa434-hybrid_cPa447-cPa308-hybrid_cPa447-cPa434-hybrid,36_2_1_1_1_2_1,198,133
Scaffold228-46754_46856,cPa356,0.407407407407407,8,46816,46762,cPa308-cPa419-hybrid_cPa356_cPa425-cPa308-hybrid_cPa425-cPa353-hybrid_cPa425-cPa356-hybrid_cPa425-cPa434-hybrid_cPa583_cPa583-cPa356-hybrid,1_11_1_1_2_8_1_2,102,54
Scaffold228-47037_47194,cPa356,0.28,18,47186,47062,cPa255_cPa255-cPa67-hybrid_cPa268-cPa356-hybrid_cPa356_cPa381-cPa194-hybrid_cPa381-cPa356-hybrid_cPa381-cPa419-hybrid_cPa381-cPa75-hybrid_cPa419_cPa425_cPa425-cPa308-hybrid_cPa425-cPa353-hybrid_cPa425-cPa434-hybrid_cPa510-cPa75-hybrid_cPa583_cPa583-cPa356-hybrid_cPa583-cPa67-hybrid_cPa583-cPa75-hybrid,1_1_1_35_2_5_1_5_1_4_11_1_27_1_6_8_6_9,157,124
Scaffold228-619_721,cPa50-cPa529-hybrid,0.24390243902439,11,715,639,cPa16-cPa223-hybrid_cPa323-cPa529-hybrid_cPa323-S71_repbase_HERVS71_LTR6A-hybrid_cPa363-cPa529-hybrid_cPa363-S71_repbase_HERVS71_LTR6A-hybrid_cPa390-cPa449-hybrid_cPa447-cPa529-hybrid_cPa449-cPa529-hybrid_cPa452-cPa529-hybrid_cPa452-S71_repbase_HERVS71_LTR6A-hybrid_cPa50-cPa529-hybrid,1_6_2_7_2_1_2_1_8_1_10,102,76
Scaffold229-26487_26589,cPa428,0.571428571428571,2,26579,26488,cPa356_cPa428,3_4,102,91
Scaffold229-26714_26822,cPa356_cPa428,0.5,2,26770,26762,cPa356_cPa428,3_3,108,8
Scaffold229-26915_27017,cPa356,0.666666666666667,2,26978,26965,cPa356_cPa428,2_1,102,13
Scaffold229-27417_27519,cPa356_cPa428,0.5,2,27469,27452,cPa356_cPa428,2_2,102,17
Scaffold229-3173_3275,cPa356,0.555555555555556,2,3234,3198,cPa356_cPa428,5_4,102,36
Scaffold229-33894_33996,cPa428,0.75,2,33944,33909,cPa356_cPa428,1_3,102,35
Scaffold229-34105_34208,cPa356_cPa428,0.5,2,34156,34133,cPa356_cPa428,2_2,103,23
Scaffold229-4214_4316,cPa428,1,1,4264,4264,cPa428,1,102,0
Scaffold229-4538_4656,cPa428,0.555555555555556,2,4616,4587,cPa356_cPa428,4_5,118,29
Scaffold229-46114_46337,cPa356_cPa428,0.5,2,46292,46122,cPa356_cPa428,48_48,223,170
Scaffold229-46349_46485,cPa356,0.544303797468354,2,46476,46390,cPa356_cPa428,43_36,136,86
Scaffold229-46501_46669,cPa356,0.521739130434783,2,46639,46521,cPa356_cPa428,24_22,168,118
Scaffold229-46746_46848,cPa428,0.53125,2,46847,46745,cPa356_cPa428,15_17,102,102
Scaffold233-18509_18611,cPa15_cPa419,0.5,2,18559,18552,cPa15_cPa419,1_1,102,7
Scaffold233-20518_20620,cPa419,1,1,20570,20568,cPa419,2,102,2
Scaffold233-21410_21678,cPa360,0.945652173913043,3,21677,21409,cPa142-cPa118-hybrid_cPa360_cPa360-unknown,1_87_4,268,268
Scaffold233-21952_22068,cPa360-cPa75-hybrid,1,1,22016,22002,cPa360-cPa75-hybrid,2,116,14
Scaffold233-23483_23594,cPa285-cPa75-hybrid_cPa75,0.333333333333333,4,23543,23533,cPa285_cPa285-cPa75-hybrid_cPa360-cPa75-hybrid_cPa75,1_2_1_2,111,10
Scaffold233-25904_26006,cPa419,0.5,4,25960,25914,cPa419_cPa505_cPa505-cPa164-hybrid_SIV_NC001870-unknown,3_1_1_1,102,46
Scaffold233-26058_26686,cPa505,0.289156626506024,26,26655,26108,BFV_NC001831-cPa419-hybrid_BFV_NC001831-cPa505-hybrid_BFV_NC001831-cPa71-hybrid_BFV_NC001831-EqFV_NC002201-hybrid_cPa285_cPa413-cPa71-hybrid_cPa419_cPa505_cPa505-cPa174-hybrid_cPa505-cPa71-hybrid_cPa505-EqFV_NC002201-hybrid_cPa505-MSEV_CT990572-hybrid_cPa505-unknown_cPa62_cPa71_cPa71-cPa400-hybrid_EqFV_NC002201_GaLV_M26927-cPa71-hybrid_MSEV_CT990572-cPa400-hybrid_SIV_NC001870-BFV_NC001831-hybrid_SIV_NC001870-cPa164-hybrid_SIV_NC001870-cPa419-hybrid_SIV_NC001870-cPa71-hybrid_SIV_NC001870-EqFV_NC002201-hybrid_SIV_NC001870-MSEV_CT990572-hybrid_SIV_NC001870-unknown,1_1_2_1_1_1_18_24_1_1_1_1_1_3_9_1_3_1_1_1_1_1_3_1_1_3,628,547
Scaffold233-30790_30892,cPa419,0.785714285714286,3,30877,30829,cPa419_cPa419-unknown_cPa75,11_2_1,102,48
Scaffold233-31300_31402,cPa419,1,1,31389,31338,cPa419,6,102,51
Scaffold233-36625_36774,cPa419,0.461538461538462,12,36741,36626,cPa360_cPa360-cPa546-hybrid_cPa419_cPa542-cPa546-hybrid_cPa542-cPa566-hybrid_cPa542-cPa75-hybrid_cPa546_cPa546-cPa566-hybrid_cPa566-cPa542-hybrid_cPa566-SFV_U04327-hybrid_cPa62_cPa75,1_1_12_1_1_2_1_1_1_1_1_3,149,115
Scaffold233-36847_36949,cPa566,0.5,8,36949,36865,cPa15_cPa410_cPa419_cPa419-cPa15-hybrid_cPa425-cPa15-hybrid_cPa566_cPa61_cPa75,1_3_5_1_1_13_1_1,102,84
Scaffold233-38052_38154,cPa419,0.666666666666667,3,38102,38056,cPa419_cPa428_cPa566-cPa425-hybrid,4_1_1,102,46
Scaffold233-39761_39863,cPa107,0.571428571428571,4,39839,39808,cPa107_cPa119-cPa107-hybrid_cPa163_cPa419,4_1_1_1,102,31
Scaffold233-7772_7981,cPa75-cPa327-hybrid_cPa75-unknown,0.25,6,7929,7822,cPa50-S71_repbase_HERVS71_LTR6A-hybrid_cPa60-unknown_cPa75_cPa75-cPa327-hybrid_cPa75-S71_repbase_HERVS71_LTR6A-hybrid_cPa75-unknown,1_1_1_2_1_2,209,107
Scaffold234-46448_46550,cPa428,1,1,46498,46498,cPa428,1,102,0
Scaffold235-1561_1663,cPa356,0.666666666666667,2,1611,1560,cPa356_cPa428,2_1,102,51
Scaffold235-2020_2122,cPa356,0.666666666666667,2,2077,2019,cPa356_cPa428,10_5,102,58
Scaffold235-2395_2497,cPa428,1,1,2445,2445,cPa428,1,102,0
Scaffold235-3216_3318,cPa428,0.555555555555556,2,3316,3223,cPa356_cPa428,4_5,102,93
Scaffold235-3353_3550,cPa356_cPa428,0.5,2,3517,3388,cPa356_cPa428,3_3,197,129
Scaffold235-4025_4127,cPa356,0.75,2,4080,4033,cPa356_cPa428,6_2,102,47
Scaffold237-10601_10743,HML3_repbase_HERVK9I_MER9,1,1,10691,10651,HML3_repbase_HERVK9I_MER9,5,142,40
Scaffold237-11293_11601,HML3_repbase_HERVK9I_MER9,1,1,11549,11343,HML3_repbase_HERVK9I_MER9,6,308,206
Scaffold237-25624_25726,cPa381,1,1,25674,25674,cPa381,1,102,0
Scaffold237-25740_25842,cPa381_cPa381-cPa400-hybrid_FIV_NC001482,0.333333333333333,3,25792,25754,cPa381_cPa381-cPa400-hybrid_FIV_NC001482,1_1_1,102,38
Scaffold237-26997_27099,cPa75,1,1,27047,27047,cPa75,1,102,0
Scaffold237-30834_30936,HML1a_repbase_HERV-K14CI_LTR14C,1,1,30884,30884,HML1a_repbase_HERV-K14CI_LTR14C,1,102,0
Scaffold237-36484_36586,cPa196-unknown_cPa381,0.5,2,36550,36534,cPa196-unknown_cPa381,1_1,102,16
Scaffold237-36675_36777,cPa475_cPa583,0.5,2,36725,36680,cPa475_cPa583,1_1,102,45
Scaffold237-41383_41485,MPMVs_NC001550-cPa75-hybrid,1,1,41433,41433,MPMVs_NC001550-cPa75-hybrid,1,102,0
Scaffold237-41931_42033,cPa512-cPa392-hybrid,1,1,41981,41981,cPa512-cPa392-hybrid,1,102,0
Scaffold237-42232_42334,cPa449-cPa75-hybrid,1,1,42282,42282,cPa449-cPa75-hybrid,1,102,0
Scaffold237-4375_4579,cPa75-unknown,0.636363636363636,5,4543,4382,CAEV_NC001463-unknown_cPa224-unknown_cPa527-cPa75-hybrid_cPa75_cPa75-unknown,1_1_1_1_7,204,161
Scaffold237-4711_4813,cPa75-unknown,1,1,4761,4761,cPa75-unknown,1,102,0
Scaffold237-5609_5742,cPa224-cPa75-hybrid_cPa75,0.5,2,5690,5659,cPa224-cPa75-hybrid_cPa75,1_1,133,31
Scaffold237-7687_7789,cPa273,1,1,7737,7737,cPa273,1,102,0
Scaffold238-29982_30084,cPa428,0.666666666666667,2,30032,29996,cPa356_cPa428,1_2,102,36
Scaffold238-41916_42030,cPa356,0.714285714285714,2,41996,41966,cPa356_cPa428,5_2,114,30
Scaffold238-42137_42239,cPa356,0.533333333333333,2,42188,42139,cPa356_cPa428,8_7,102,49
Scaffold238-42964_43090,cPa356,0.510869565217391,2,43082,42976,cPa356_cPa428,94_90,126,106
Scaffold238-44083_44185,cPa428,0.547619047619048,2,44175,44111,cPa356_cPa428,19_23,102,64
Scaffold238-44395_44497,cPa356,0.513513513513513,2,44497,44395,cPa356_cPa428,57_54,102,102
Scaffold238-44802_44904,cPa428,0.666666666666667,2,44892,44846,cPa356_cPa428,2_4,102,46
Scaffold239-10975_11077,cPa428,1,1,11025,11015,cPa428,3,102,10
Scaffold239-11245_11347,cPa356_cPa428,0.5,2,11295,11266,cPa356_cPa428,1_1,102,29
Scaffold239-11390_11558,cPa356_cPa428,0.5,2,11539,11440,cPa356_cPa428,2_2,168,99
Scaffold239-11635_11831,cPa428,0.7,2,11779,11685,cPa356_cPa428,3_7,196,94
Scaffold239-12471_12573,cPa356,1,1,12521,12521,cPa356,1,102,0
Scaffold239-14050_14152,cPa428,0.666666666666667,2,14100,14091,cPa356_cPa428,1_2,102,9
Scaffold239-14418_14520,cPa428,1,1,14468,14468,cPa428,1,102,0
Scaffold239-14930_15032,cPa356,1,1,14980,14980,cPa356,1,102,0
Scaffold239-15827_15929,cPa428,1,1,15877,15877,cPa428,1,102,0
Scaffold239-17432_17585,cPa428,0.627906976744186,2,17578,17467,cPa356_cPa428,16_27,153,111
Scaffold239-17831_17969,cPa428,0.75,2,17917,17855,cPa356_cPa428,3_9,138,62
Scaffold239-18081_18183,cPa428,0.727272727272727,2,18134,18099,cPa356_cPa428,3_8,102,35
Scaffold239-18973_19075,cPa428,1,1,19023,19023,cPa428,1,102,0
Scaffold239-19140_19242,cPa428,0.75,2,19240,19190,cPa356_cPa428,1_3,102,50
Scaffold239-26732_26860,cPa428,0.666666666666667,2,26808,26782,cPa356_cPa428,1_2,128,26
Scaffold239-28914_29016,cPa428,0.615384615384615,2,28994,28932,cPa356_cPa428,5_8,102,62
Scaffold239-29089_29191,cPa428,0.6,2,29186,29139,cPa356_cPa428,2_3,102,47
Scaffold239-29290_29392,cPa428,1,1,29340,29340,cPa428,1,102,0
Scaffold239-29609_29711,cPa428_cPa428-cPa356-hybrid,0.5,2,29703,29659,cPa428_cPa428-cPa356-hybrid,1_1,102,44
Scaffold239-29815_29917,cPa428,0.666666666666667,2,29865,29815,cPa356_cPa428,2_4,102,50
Scaffold239-31475_31663,cPa428,0.75,2,31611,31525,cPa356_cPa428,2_6,188,86
Scaffold239-31763_31865,cPa428,1,1,31813,31802,cPa428,2,102,11
Scaffold239-32035_32137,cPa428,0.666666666666667,2,32085,32039,cPa356_cPa428,1_2,102,46
Scaffold239-32566_32668,cPa356,1,1,32616,32616,cPa356,1,102,0
Scaffold239-33309_33433,cPa428,0.6,2,33432,33335,cPa356_cPa428,10_15,124,97
Scaffold239-33561_33696,cPa428,0.6,2,33644,33581,cPa356_cPa428,6_9,135,63
Scaffold239-34487_34713,cPa428,0.866666666666667,2,34661,34537,cPa356_cPa428,2_13,226,124
Scaffold239-35548_35650,cPa428,1,1,35598,35574,cPa428,2,102,24
Scaffold239-35782_35983,cPa428,0.533333333333333,2,35970,35832,cPa356_cPa428,7_8,201,138
Scaffold239-36174_36345,cPa428,0.75,2,36310,36224,cPa356_cPa428,1_3,171,86
Scaffold239-4139_4241,cPa356_cPa428,0.5,2,4197,4189,cPa356_cPa428,1_1,102,8
Scaffold240-20442_20544,cPa428,0.666666666666667,2,20492,20444,cPa356_cPa428,1_2,102,48
Scaffold240-24231_24333,cPa356_cPa428,0.5,2,24288,24281,cPa356_cPa428,1_1,102,7
Scaffold240-26812_27129,cPa356,0.5,3,27077,26816,cPa356_cPa356-cPa428-hybrid_cPa428,14_1_13,317,261
Scaffold240-27424_27526,cPa428,0.8,2,27492,27451,cPa356_cPa428,1_4,102,41
Scaffold240-27624_27726,cPa428,0.714285714285714,2,27679,27625,cPa356_cPa428,2_5,102,54
Scaffold240-27962_28064,cPa356,1,1,28064,28012,cPa356,2,102,52
Scaffold240-28311_28413,cPa356,0.666666666666667,2,28400,28324,cPa356_cPa428,2_1,102,76
Scaffold240-28569_28671,cPa356,0.555555555555556,2,28657,28609,cPa356_cPa428,5_4,102,48
Scaffold240-28763_28865,cPa356_cPa428,0.5,2,28813,28773,cPa356_cPa428,2_2,102,40
Scaffold240-28876_28978,cPa428,0.666666666666667,2,28955,28912,cPa356_cPa428,2_4,102,43
Scaffold240-29056_29158,cPa428,0.545454545454545,2,29155,29057,cPa356_cPa428,5_6,102,98
Scaffold240-29306_29408,cPa356,0.8,2,29359,29316,cPa356_cPa428,4_1,102,43
Scaffold240-29424_29553,cPa428,0.666666666666667,2,29503,29457,cPa356_cPa428,9_18,129,46
Scaffold240-29672_29774,cPa428,0.682926829268293,2,29751,29673,cPa356_cPa428,13_28,102,78
Scaffold240-29916_30018,cPa356_cPa428,0.5,2,30014,29932,cPa356_cPa428,8_8,102,82
Scaffold240-30027_30191,cPa428,0.666666666666667,2,30139,30034,cPa356_cPa428,1_2,164,105
Scaffold241-1194_1296,cPa544,1,1,1244,1244,cPa544,1,102,0
Scaffold241-43027_43184,BLV_NC001414-cPa75-hybrid_cPa75,0.5,2,43132,43077,BLV_NC001414-cPa75-hybrid_cPa75,1_1,157,55
Scaffold241-949_1051,HERV-XA34_repbase_HERVFH21I_LTR21A,1,1,999,999,HERV-XA34_repbase_HERVFH21I_LTR21A,1,102,0
Scaffold242-42077_42179,cPa356,0.666666666666667,2,42178,42127,cPa356_cPa428,4_2,102,51
Scaffold242-43053_43211,cPa356,0.518072289156627,2,43160,43066,cPa356_cPa428,43_40,158,94
Scaffold244-18869_18971,cPa419,1,1,18919,18919,cPa419,1,102,0
Scaffold245-31922_32024,cPa75,1,1,31972,31972,cPa75,1,102,0
Scaffold245-32400_32512,cPa75,1,1,32460,32450,cPa75,2,112,10
Scaffold245-32816_32918,cPa75,1,1,32866,32866,cPa75,1,102,0
Scaffold245-36388_36490,cPa425,1,1,36487,36438,cPa425,2,102,49
Scaffold245-36574_36843,cPa425,0.818181818181818,3,36813,36609,cPa425_cPa47_cPa47-unknown,9_1_1,269,204
Scaffold245-39459_39561,cPa75,1,1,39539,39509,cPa75,5,102,30
Scaffold246-10814_10923,cPa413_cPa419_PyERV_AF500296,0.333333333333333,3,10871,10864,cPa413_cPa419_PyERV_AF500296,1_1_1,109,7
Scaffold246-14079_14205,cPa74-cPa447-hybrid,0.297297297297297,10,14197,14111,cPa163_cPa583-cPa447-hybrid_cPa74_cPa74-cPa163-hybrid_cPa74-cPa438-hybrid_cPa74-cPa447-hybrid_cPa74-HTLV2_M10060-hybrid_Xen1_AJ506107-cPa163-hybrid_Xen1_AJ506107-cPa438-hybrid_Xen1_AJ506107-cPa447-hybrid,1_1_4_7_2_11_8_1_1_1,126,86
Scaffold246-1550_1655,FrMuLV_NC001362-cPa193-hybrid,0.4,4,1611,1568,cPa419_cPa75-HML3_repbase_HERVK9I_MER9-hybrid_FrMuLV_NC001362-cPa193-hybrid_HIV1_NC001802-cPa193-hybrid,1_1_2_1,105,43
Scaffold246-1700_1802,cPa419,1,1,1750,1750,cPa419,1,102,0
Scaffold246-17560_17662,cPa526,1,1,17610,17610,cPa526,1,102,0
Scaffold246-17675_17808,cPa526,1,1,17756,17725,cPa526,3,133,31
Scaffold246-21368_21544,cPa255_cPa356-cPa216-hybrid,0.5,2,21492,21418,cPa255_cPa356-cPa216-hybrid,1_1,176,74
Scaffold246-21613_21719,cPa356-cPa75-hybrid,0.375,6,21670,21663,cPa150-cPa75-hybrid_cPa224-cPa138-hybrid_cPa356-cPa75-hybrid_cPa419_cPa447-cPa14-hybrid_cPa75,1_1_3_1_1_1,106,7
Scaffold246-21795_21897,cPa75,0.4,10,21891,21840,cPa125-cPa138-hybrid_cPa125-cPa14-hybrid_cPa125-cPa216-hybrid_cPa125-cPa75-hybrid_cPa125-unknown_cPa14_cPa308-cPa75-hybrid_cPa34-cPa138-hybrid_cPa529-cPa75-hybrid_cPa75,1_1_1_6_1_1_1_1_2_10,102,51
Scaffold246-22444_22546,cPa125-cPa138-hybrid_cPa219-cPa223-hybrid_cPa224-cPa138-hybrid,0.333333333333333,3,22503,22491,cPa125-cPa138-hybrid_cPa219-cPa223-hybrid_cPa224-cPa138-hybrid,1_1_1,102,12
Scaffold246-23940_24133,cPa75,0.388888888888889,9,24133,23954,cPa125-cPa529-hybrid_cPa224-cPa223-hybrid_cPa529_cPa529-CAEV_NC001463-hybrid_cPa529-cPa219-hybrid_cPa529-cPa258-hybrid_cPa529-cPa75-hybrid_cPa529-unknown_cPa75,1_5_3_1_1_2_8_1_14,193,179
Scaffold246-24222_24324,cPa529-cPa75-hybrid,0.333333333333333,5,24316,24261,cPa363-cPa419-hybrid_cPa419_cPa529-CAEV_NC001463-hybrid_cPa529-cPa219-hybrid_cPa529-cPa75-hybrid,1_1_1_1_2,102,55
Scaffold246-25498_25624,cPa224,0.278260869565217,15,25572,25548,cPa183-cPa61-hybrid_cPa224_cPa224-cPa177-hybrid_cPa224-cPa228-hybrid_cPa224-cPa285-hybrid_cPa224-cPa419-hybrid_cPa224-cPa61-hybrid_cPa224-unknown_cPa323-cPa285-hybrid_cPa419_cPa61_cPa61-cPa177-hybrid_cPa61-cPa285-hybrid_cPa61-unknown_cPa75,1_32_22_1_5_1_4_11_1_3_23_5_1_1_4,126,24
Scaffold246-25650_26023,cPa61,0.272727272727273,11,26011,25700,cPa224_cPa224-cPa177-hybrid_cPa224-cPa285-hybrid_cPa224-cPa61-hybrid_cPa224-unknown_cPa419_cPa61_cPa61-cPa177-hybrid_cPa61-unknown_cPa75_cPa75-cPa219-hybrid,4_5_1_2_2_6_9_1_1_1_1,373,311
Scaffold246-31052_31154,cPa438-cPa228-hybrid,0.4,4,31102,31052,cPa419_cPa438-cPa228-hybrid_cPa500-cPa228-hybrid_cPa75,1_2_1_1,102,50
Scaffold246-31236_31338,cPa419_cPa438-cPa228-hybrid,0.5,2,31292,31286,cPa419_cPa438-cPa228-hybrid,1_1,102,6
Scaffold246-31924_32209,cPa75-cPa228-hybrid,0.271186440677966,23,32209,31974,cPa323-cPa449-hybrid_cPa371-cPa228-hybrid_cPa371-cPa449-hybrid_cPa371-cPa62-hybrid_cPa419_cPa419-cPa228-hybrid_cPa419-cPa323-hybrid_cPa419-cPa449-hybrid_cPa433_cPa433-cPa228-hybrid_cPa433-cPa449-hybrid_cPa433-cPa62-hybrid_cPa438-cPa228-hybrid_cPa459-cPa228-hybrid_cPa459-cPa449-hybrid_cPa50_cPa500-cPa228-hybrid_cPa75_cPa75-cPa228-hybrid_cPa75-cPa449-hybrid_cPa75-cPa500-hybrid_cPa75-HML5_repbase_HERVK22I_LTR22-hybrid_cPa75-unknown,3_4_6_1_3_1_1_2_1_5_12_2_11_8_6_1_1_11_32_4_1_1_1,285,235
Scaffold246-3307_3409,Xen1_AJ506107,1,1,3357,3357,Xen1_AJ506107,1,102,0
Scaffold246-33936_34601,cPa371,0.658031088082902,20,34573,33941,cPa323-cPa260-hybrid_cPa371_cPa371-cPa305-hybrid_cPa371-cPa327-hybrid_cPa419_cPa428_cPa433-cPa228-hybrid_cPa433-cPa305-hybrid_cPa433-cPa327-hybrid_cPa433-cPa434-hybrid_cPa433-cPa449-hybrid_cPa433-SIV_NC001549-hybrid_cPa459_cPa459-cPa196-hybrid_cPa459-cPa228-hybrid_cPa459-cPa449-hybrid_cPa459-SIV_NC001549-hybrid_cPa459-unknown_cPa47-SIV_NC001549-hybrid_cPa568-cPa327-hybrid,1_127_1_1_6_3_4_1_2_3_2_5_13_1_10_2_7_2_1_1,665,632
Scaffold246-34611_34848,cPa371,0.8125,3,34800,34661,cPa371_cPa419_cPa459,13_1_2,237,139
Scaffold246-34864_34966,cPa371,0.642857142857143,5,34946,34874,cPa371_cPa433-cPa196-hybrid_cPa433-cPa434-hybrid_cPa434_cPa459,9_1_1_2_1,102,72
Scaffold246-35153_35255,cPa371,0.448275862068966,7,35250,35177,cPa371_cPa419_cPa428_cPa428-cPa196-hybrid_cPa433-cPa434-hybrid_cPa434_cPa459-cPa434-hybrid,13_2_1_1_1_10_1,102,73
Scaffold246-36176_36278,cPa434,1,1,36226,36226,cPa434,1,102,0
Scaffold246-7887_8071,cPa482,0.75,3,8019,7937,cPa273-cPa555-hybrid_cPa345-cPa555-hybrid_cPa482,1_1_6,184,82
Scaffold246-8514_8770,cPa482,0.73,18,8718,8564,cPa15_cPa199-cPa188-hybrid_cPa199-cPa482-hybrid_cPa199-cPa516-hybrid_cPa199-STLV2_NC001815-hybrid_cPa227-cPa264-hybrid_cPa273-cPa15-hybrid_cPa273-cPa188-hybrid_cPa273-cPa482-hybrid_cPa345-STLV2_NC001815-hybrid_cPa419_cPa450-cPa188-hybrid_cPa450-cPa482-hybrid_cPa450-cPa516-hybrid_cPa450-PyERV_AF500296-hybrid_cPa482_cPa482-cPa555-hybrid_cPa482-STLV2_NC001815-hybrid,1_3_2_1_1_1_1_1_1_1_3_4_1_2_2_73_1_1,256,154
Scaffold246-8840_9091,cPa585-cPa482-hybrid,0.25,11,9039,8890,cPa15_cPa15-cPa264-hybrid_cPa199-cPa482-hybrid_cPa482_cPa546-cPa516-hybrid_cPa585-cPa482-hybrid_cPa585-cPa530-hybrid_cPa585-cPa555-hybrid_cPa585-PyERV_AF500296-hybrid_cPa585-STLV2_NC001815-hybrid_cPa75,3_1_1_2_1_5_1_1_1_3_1,251,149
Scaffold249-11937_12116,HERV-Fb_repbase_HERVH48I_MER48,0.6,3,12069,11984,cPa356_cPa356-unknown_HERV-Fb_repbase_HERVH48I_MER48,5_1_9,179,85
Scaffold249-12162_12387,HERV-Fb_repbase_HERVH48I_MER48,0.416666666666667,5,12381,12212,cPa254-HERV-Fb_repbase_HERVH48I_MER48-hybrid_cPa356_cPa356-HERV-Fb_repbase_HERVH48I_MER48-hybrid_cPa356-unknown_HERV-Fb_repbase_HERVH48I_MER48,1_9_10_1_15,225,169
Scaffold249-13640_13756,cPa75-HERV-Fb_repbase_HERVH48I_MER48-hybrid,0.428571428571429,7,13736,13689,cPa356-cPa290-hybrid_cPa492_cPa75_cPa75-cPa290-hybrid_cPa75-cPa527-hybrid_cPa75-HERV-Fb_repbase_HERVH48I_MER48-hybrid_cPa75-unknown,1_2_1_1_1_12_10,116,47
Scaffold249-17946_18048,cPa107,1,1,17996,17996,cPa107,1,102,0
Scaffold249-21392_21494,cPa130-cPa475-hybrid,1,1,21466,21442,cPa130-cPa475-hybrid,7,102,24
Scaffold249-22753_22956,cPa391,0.58273381294964,7,22904,22785,cPa130-cPa298-hybrid_cPa130-cPa512-hybrid_cPa130-unknown_cPa199-cPa298-hybrid_cPa298_cPa391_cPa434-cPa475-hybrid,32_1_3_1_20_81_1,203,119
Scaffold249-27972_28116,cPa260,0.82,2,28065,28015,cPa260_cPa260-unknown,41_9,144,50
Scaffold249-6918_7020,cPa345,1,1,6968,6968,cPa345,1,102,0
Scaffold249-7115_7217,cPa345,1,1,7165,7165,cPa345,1,102,0
Scaffold250-20217_20319,HERV-XA34_repbase_HERVFH21I_LTR21A,1,1,20267,20267,HERV-XA34_repbase_HERVFH21I_LTR21A,1,102,0
Scaffold250-24259_24642,cPa273,0.529411764705882,7,24590,24309,cPa119-cPa357-hybrid_cPa273_cPa273-cPa75-hybrid_cPa357_cPa357-cPa273-hybrid_cPa357-cPa285-hybrid_cPa357-cPa75-hybrid,1_9_1_2_1_2_1,383,281
Scaffold250-37405_37507,cPa16-unknown,1,1,37455,37455,cPa16-unknown,1,102,0
Scaffold250-5835_5937,cPa62,1,1,5885,5885,cPa62,1,102,0
Scaffold250-5943_6150,cPa62,1,1,6098,5993,cPa62,3,207,105
Scaffold251-26993_27095,cPa428,0.645161290322581,2,27083,27039,cPa356_cPa428,11_20,102,44
Scaffold251-27152_27474,cPa428,0.589473684210526,2,27448,27192,cPa356_cPa428,39_56,322,256
Scaffold251-27495_27597,cPa356_cPa428,0.5,2,27594,27545,cPa356_cPa428,3_3,102,49
Scaffold251-27800_27998,cPa356_cPa428,0.5,2,27996,27850,cPa356_cPa428,24_24,198,146
Scaffold251-28031_28173,cPa428,0.526315789473684,2,28153,28030,cPa356_cPa428,27_30,142,123
Scaffold251-28761_28863,cPa428,0.535714285714286,2,28862,28800,cPa356_cPa428,13_15,102,62
Scaffold251-29083_29185,cPa356,1,1,29133,29133,cPa356,1,102,0
Scaffold252-10159_10268,cPa419_cPa75_cPa75-unknown_HERV30_repbase_HERV30I_LTR30,0.25,4,10225,10174,cPa419_cPa75_cPa75-unknown_HERV30_repbase_HERV30I_LTR30,1_1_1_1,109,51
Scaffold252-13200_13348,cPa438-cPa339-hybrid,0.666666666666667,2,13296,13239,cPa438-cPa339-hybrid_cPa544-cPa353-hybrid,2_1,148,57
Scaffold252-6175_6660,cPa356,0.504643962848297,2,6634,6174,cPa356_cPa428,163_160,485,460
Scaffold252-6661_6763,cPa428,0.571428571428571,2,6740,6690,cPa356_cPa428,6_8,102,50
Scaffold252-9871_10029,cPa75_cPa75-unknown,0.5,2,9979,9921,cPa75_cPa75-unknown,3_3,158,58
Scaffold253-33936_34038,cPa428,1,1,33986,33986,cPa428,1,102,0
Scaffold254-11021_11123,cPa428,0.6,2,11076,11040,cPa356_cPa428,2_3,102,36
Scaffold254-12310_12412,cPa356,1,1,12360,12360,cPa356,1,102,0
Scaffold254-30172_30274,cPa356,0.529411764705882,2,30222,30219,cPa356_cPa428,9_8,102,3
Scaffold254-30287_30402,cPa428,0.545454545454545,3,30365,30337,cPa356_cPa356-unknown_cPa428,4_1_6,115,28
Scaffold254-30464_30566,cPa356,0.666666666666667,2,30514,30513,cPa356_cPa428,2_1,102,1
Scaffold254-38435_38537,cPa356,0.8,2,38529,38457,cPa356_cPa428,4_1,102,72
Scaffold254-9570_9672,cPa428,1,1,9620,9620,cPa428,1,102,0
Scaffold256-4012_4114,cPa419,1,1,4062,4062,cPa419,1,102,0
Scaffold257-20833_21077,cPa345,1,1,21077,20840,cPa345,48,244,237
Scaffold257-25165_25287,cPa356,0.666666666666667,2,25235,25215,cPa356_cPa428,2_1,122,20
Scaffold257-25404_25577,cPa428,0.666666666666667,2,25567,25445,cPa356_cPa428,3_6,173,122
Scaffold257-25675_25807,cPa428,0.583333333333333,2,25759,25725,cPa356_cPa428,15_21,132,34
Scaffold257-25867_25969,cPa428,0.538461538461538,2,25965,25869,cPa356_cPa428,6_7,102,96
Scaffold257-26057_26203,cPa356,0.530434782608696,3,26198,26057,cPa356_cPa419_cPa428,61_1_53,146,141
Scaffold257-27104_27317,cPa428,0.527472527472527,2,27265,27123,cPa356_cPa428,43_48,213,142
Scaffold257-27332_27511,cPa428,0.516556291390728,2,27502,27333,cPa356_cPa428,73_78,179,169
Scaffold257-27610_27712,cPa356,0.666666666666667,2,27696,27622,cPa356_cPa428,8_4,102,74
Scaffold257-3450_3587,cPa428,0.545454545454545,2,3535,3493,cPa356_cPa428,5_6,137,42
Scaffold257-5758_5860,cPa428,0.7,2,5853,5758,cPa356_cPa428,12_28,102,95
Scaffold257-6185_6287,cPa428,0.596774193548387,2,6284,6208,cPa356_cPa428,25_37,102,76
Scaffold257-6484_6586,cPa356_cPa428,0.5,2,6581,6534,cPa356_cPa428,2_2,102,47
Scaffold257-6596_6785,cPa356_cPa428,0.496503496503497,3,6742,6598,cPa356_cPa356-unknown_cPa428,71_1_71,189,144
Scaffold260-23233_23335,cPa425-cPa356-hybrid_cPa425-cPa447-hybrid,0.5,2,23333,23232,cPa425-cPa356-hybrid_cPa425-cPa447-hybrid,2_2,102,101
Scaffold260-23551_23653,cPa356,1,1,23601,23601,cPa356,1,102,0
Scaffold260-25512_25662,cPa223,0.730769230769231,5,25659,25517,cPa223_cPa419_cPa428_cPa62_EqFV_NC002201,19_1_1_4_1,150,142
Scaffold260-25718_25893,cPa223,0.783783783783784,8,25889,25727,BFV_NC001831-cPa582-hybrid_cPa223_cPa315_cPa419_cPa425_cPa531-cPa62-hybrid_cPa541-cPa62-hybrid_cPa62,1_58_2_5_1_1_1_5,175,162
Scaffold260-25914_26033,cPa223,0.757575757575758,5,26008,25913,cPa208-cPa62-hybrid_cPa223_cPa260-cPa62-hybrid_cPa419_cPa62,1_25_1_3_3,119,95
Scaffold260-26059_26274,cPa223,0.417721518987342,17,26274,26063,cPa118-EqFV_NC002201-hybrid_cPa208-cPa223-hybrid_cPa223_cPa241-EqFV_NC002201-hybrid_cPa260-cPa315-hybrid_cPa260-cPa392-hybrid_cPa260-cPa425-hybrid_cPa260-cPa62-hybrid_cPa260-EqFV_NC002201-hybrid_cPa260-FeFV_NC001871-hybrid_cPa339-cPa428-hybrid_cPa392_cPa419_cPa419-EqFV_NC002201-hybrid_cPa62_EqFV_NC002201_FeLV_NC001940-EqFV_NC002201-hybrid,1_1_33_1_1_1_5_1_16_2_1_1_9_1_2_2_1,215,211
Scaffold260-27901_28170,cPa260,0.368421052631579,12,28167,27904,cPa260_cPa260-cPa407-hybrid_cPa260-cPa425-hybrid_cPa260-cPa518-hybrid_cPa260-HML1b_repbase_HERV-K14I_LTR14A-hybrid_cPa260-unknown_cPa356_cPa419_cPa434-unknown_cPa47_cPa47-cPa391-hybrid_cPa47-cPa425-hybrid,14_3_1_1_2_4_1_6_1_3_1_1,269,263
Scaffold260-28177_28671,cPa260-cPa518-hybrid,0.175824175824176,27,28670,28203,cPa138-cPa518-hybrid_cPa138-HML1b_repbase_HERV-K14I_LTR14A-hybrid_cPa183-cPa117-hybrid_cPa183-cPa518-hybrid_cPa183-HML1b_repbase_HERV-K14I_LTR14A-hybrid_cPa208-cPa518-hybrid_cPa223-cPa518-hybrid_cPa241-cPa407-hybrid_cPa241-cPa518-hybrid_cPa241-HML1b_repbase_HERV-K14I_LTR14A-hybrid_cPa260-cPa117-hybrid_cPa260-cPa407-hybrid_cPa260-cPa419-hybrid_cPa260-cPa518-hybrid_cPa260-HML1b_repbase_HERV-K14I_LTR14A-hybrid_cPa260-unknown_cPa327-cPa518-hybrid_cPa356_cPa392-cPa518-hybrid_cPa392-HML1b_repbase_HERV-K14I_LTR14A-hybrid_cPa419_cPa428_cPa434-unknown_cPa446-cPa518-hybrid_cPa446-HML1b_repbase_HERV-K14I_LTR14A-hybrid_cPa75_HML1a_repbase_HERV-K14CI_LTR14C-EqFV_NC002201-hybrid,1_2_1_8_1_4_1_1_2_1_1_10_1_16_2_6_1_1_3_4_14_1_1_3_3_1_1,494,467
Scaffold260-30663_30765,cPa183,0.217391304347826,17,30763,30664,cPa183_cPa183-cPa109-hybrid_cPa223_cPa327-cPa183-hybrid_cPa391_cPa392-cPa109-hybrid_cPa410-cPa419-hybrid_cPa419_cPa424_cPa424-cPa254-hybrid_cPa424-cPa339-hybrid_cPa446_cPa446-cPa109-hybrid_cPa446-cPa183-hybrid_cPa446-cPa223-hybrid_cPa446-cPa407-hybrid_cPa446-unknown,10_1_4_1_2_1_1_6_4_1_1_7_2_1_2_1_1,102,99
Scaffold260-30805_30989,cPa424,0.202380952380952,30,30978,30808,cPa138-cPa419-hybrid_cPa15-cPa174-hybrid_cPa15-cPa339-hybrid_cPa15-cPa419-hybrid_cPa183_cPa183-cPa106-hybrid_cPa183-cPa109-hybrid_cPa183-cPa419-hybrid_cPa183-cPa518-hybrid_cPa183-unknown_cPa223-cPa183-hybrid_cPa327_cPa327-cPa254-hybrid_cPa327-cPa428-hybrid_cPa327-cPa446-hybrid_cPa327-HML4_repbase_HERVK13I_LTR13-hybrid_cPa392_cPa392-cPa109-hybrid_cPa419_cPa424_cPa424-cPa183-hybrid_cPa424-cPa419-hybrid_cPa424-unknown_cPa446_cPa446-cPa109-hybrid_cPa446-cPa407-hybrid_cPa446-cPa518-hybrid_cPa446-HML4_repbase_HERVK13I_LTR13-hybrid_cPa446-unknown_cPa452-cPa446-hybrid,1_1_1_1_2_1_1_1_1_4_1_4_1_1_1_1_1_1_15_17_1_1_5_12_1_1_3_1_1_1,184,170
Scaffold260-33433_33535,cPa413-cPa75-hybrid,1,1,33483,33483,cPa413-cPa75-hybrid,1,102,0
Scaffold260-37943_38045,cPa308,0.56,10,38045,37943,cPa183-cPa353-hybrid_cPa308_cPa308-unknown_cPa419_cPa428_cPa450_cPa75-cPa402-hybrid_MLV_Xmv43_MLV_Xmv43-cPa323-hybrid_PtERV1_AC142352-MLV_Xmv43-hybrid,1_28_1_9_1_1_1_6_1_1,102,102
Scaffold260-40153_40255,cPa419,0.272727272727273,8,40244,40153,cPa419_cPa443_cPa51-unknown_HML3_repbase_HERVK9I_MER9-cPa583-hybrid_MDEV_AF053745-cPa223-hybrid_MDEV_AF053745-cPa447-hybrid_MDEV_AF053745-cPa583-hybrid_MDEV_AF053745-unknown,3_1_1_1_1_1_1_2,102,91
Scaffold260-4297_4399,cPa15,1,1,4347,4347,cPa15,1,102,0
Scaffold261-36861_37121,cPa428,0.6,2,37083,36910,cPa356_cPa428,4_6,260,173
Scaffold261-8100_8207,cPa356_cPa428,0.5,2,8155,8150,cPa356_cPa428,5_5,107,5
Scaffold263-12158_12260,cPa523-cPa201-hybrid,1,1,12208,12208,cPa523-cPa201-hybrid,1,102,0
Scaffold263-12762_12867,cPa201,0.333333333333333,6,12857,12771,cPa109_cPa109-cPa553-hybrid_cPa152_cPa201_cPa419_cPa505,2_1_1_3_1_1,105,86
Scaffold263-1461_1749,cPa425,0.497872340425532,16,1697,1481,cPa174_cPa174-cPa339-hybrid_cPa254_cPa254-cPa339-hybrid_cPa254-cPa512-hybrid_cPa404_cPa404-cPa425-hybrid_cPa425_cPa425-cPa254-hybrid_cPa425-cPa47-hybrid_cPa47_cPa47-cPa447-hybrid_cPa47-cPa62-hybrid_cPa512_cPa512-cPa447-hybrid_SIV_NC001870-cPa339-hybrid,15_1_22_4_1_3_1_117_1_1_62_1_1_3_1_1,288,216
Scaffold263-1883_2100,cPa425-cPa339-hybrid,0.230769230769231,17,2100,1933,cPa174-cPa339-hybrid_cPa174-cPa447-hybrid_cPa254-cPa390-hybrid_cPa254-cPa447-hybrid_cPa254-cPa62-hybrid_cPa404-cPa339-hybrid_cPa404-cPa447-hybrid_cPa404-cPa62-hybrid_cPa419_cPa425_cPa425-cPa339-hybrid_cPa425-cPa447-hybrid_cPa47-cPa447-hybrid_cPa512_cPa512-cPa339-hybrid_cPa512-cPa447-hybrid_cPa512-cPa62-hybrid,1_1_1_1_1_1_2_1_4_1_6_1_1_1_1_1_1,217,167
Scaffold263-19014_19293,cPa482,0.498591549295775,18,19292,19020,ALVJ_Z46390-cPa456-hybrid_cPa109-cPa402-hybrid_cPa109-cPa456-hybrid_cPa109-cPa505-hybrid_cPa109-unknown_cPa152_cPa152-cPa456-hybrid_cPa152-cPa505-hybrid_cPa201_cPa201-cPa456-hybrid_cPa201-unknown_cPa205-cPa456-hybrid_cPa419_cPa482_cPa505_cPa505-cPa482-hybrid_cPa505-unknown_rRVRV_JQ303225-cPa456-hybrid,1_1_30_2_5_1_23_1_1_7_10_8_1_177_83_1_2_1,279,272
Scaffold263-19874_19976,cPa482,0.888888888888889,2,19962,19897,cPa419_cPa482,1_8,102,65
Scaffold263-20258_20360,cPa482,1,1,20308,20308,cPa482,1,102,0
Scaffold263-20415_20517,cPa482,1,1,20465,20465,cPa482,1,102,0
Scaffold263-20617_20719,cPa482,1,1,20667,20667,cPa482,1,102,0
Scaffold263-20823_21205,cPa482,0.686666666666667,18,21203,20833,ALVJ_Z46390-cPa390-hybrid_cPa109-cPa512-hybrid_cPa152-cPa390-hybrid_cPa152-cPa512-hybrid_cPa196-cPa512-hybrid_cPa201-cPa390-hybrid_cPa201-cPa512-hybrid_cPa201-MMTV_NC001503-hybrid_cPa205-cPa390-hybrid_cPa205-cPa512-hybrid_cPa356-cPa512-hybrid_cPa419_cPa419-cPa512-hybrid_cPa482_cPa482-cPa512-hybrid_cPa505-cPa512-hybrid_cPa512_cPa75-cPa512-hybrid,1_4_2_13_1_2_2_1_5_5_1_4_2_206_1_2_46_2,382,370
Scaffold263-5889_5991,cPa419,0.4,4,5988,5929,cPa196-cPa118-hybrid_cPa196-unknown_cPa419_cPa61,1_1_2_1,102,59
Scaffold263-6105_6391,cPa459,0.192307692307692,27,6377,6104,cPa196_cPa196-cPa308-hybrid_cPa196-cPa424-hybrid_cPa196-cPa459-hybrid_cPa260-cPa459-hybrid_cPa305-cPa308-hybrid_cPa305-cPa424-hybrid_cPa308_cPa308-cPa127-hybrid_cPa308-cPa15-hybrid_cPa308-cPa424-hybrid_cPa308-unknown_cPa327_cPa327-cPa308-hybrid_cPa327-cPa424-hybrid_cPa327-cPa459-hybrid_cPa327-unknown_cPa392_cPa419_cPa419-cPa459-hybrid_cPa424_cPa433_cPa433-cPa260-hybrid_cPa433-cPa424-hybrid_cPa433-unknown_cPa459_cPa75,1_2_4_4_1_1_2_4_1_1_1_1_13_1_7_2_1_1_10_2_5_13_1_2_2_20_1,286,273
Scaffold263-6451_6553,cPa419,0.277777777777778,10,6513,6455,cPa163-cPa459-hybrid_cPa196-cPa424-hybrid_cPa196-cPa459-hybrid_cPa196-unknown_cPa327-cPa419-hybrid_cPa419_cPa424_cPa433_cPa433-cPa118-hybrid_cPa459,2_5_2_1_2_10_1_4_1_8,102,58
Scaffold263-9381_9483,cPa360,0.75,3,9483,9420,cPa360_cPa395-cPa360-hybrid_cPa419,9_1_2,102,63
Scaffold263-9500_9606,cPa360_cPa419,0.4,3,9598,9502,cPa224_cPa360_cPa419,1_2_2,106,96
Scaffold263-9612_9765,cPa360,0.615384615384615,5,9715,9636,cPa360_cPa360-cPa419-hybrid_cPa419_cPa510-cPa360-hybrid_cPa523-cPa360-hybrid,16_1_7_1_1,153,79
Scaffold265-17870_17972,cPa419,1,1,17920,17920,cPa419,1,102,0
Scaffold265-18037_18140,cPa419,1,1,18088,18087,cPa419,2,103,1
Scaffold266-33852_33954,cPa419,1,1,33902,33884,cPa419,4,102,18
Scaffold266-34187_34289,cPa419,1,1,34237,34231,cPa419,2,102,6
Scaffold266-34509_34611,cPa419,1,1,34562,34519,cPa419,18,102,43
Scaffold266-34696_34798,cPa419,1,1,34796,34701,cPa419,25,102,95
Scaffold266-35440_36097,cPa419,1,1,36088,35490,cPa419,146,657,598
Scaffold266-36900_37002,cPa419,1,1,36984,36916,cPa419,9,102,68
Scaffold266-37646_37808,cPa419,1,1,37803,37651,cPa419,103,162,152
Scaffold266-37888_37998,cPa419,1,1,37990,37889,cPa419,62,110,101
Scaffold266-3988_4254,cPa419,1,1,4254,4027,cPa419,59,266,227
Scaffold266-6787_6889,cPa419,1,1,6837,6837,cPa419,1,102,0
Scaffold267-22905_23007,cPa419,1,1,22961,22940,cPa419,3,102,21
Scaffold267-23230_23332,cPa419,1,1,23280,23280,cPa419,1,102,0
Scaffold267-31357_31467,cPa419,1,1,31415,31407,cPa419,2,110,8
Scaffold267-32752_32854,cPa419,1,1,32818,32802,cPa419,2,102,16
Scaffold268-11032_11134,cPa75,1,1,11082,11082,cPa75,1,102,0
Scaffold270-23237_23390,cPa356,0.636363636363636,2,23382,23238,cPa356_cPa428,14_8,153,144
Scaffold270-23758_23860,cPa356,0.673076923076923,2,23847,23757,cPa356_cPa428,35_17,102,90
Scaffold270-24119_24221,cPa356,0.5625,2,24218,24154,cPa356_cPa428,9_7,102,64
Scaffold270-24349_24587,cPa356,0.568421052631579,2,24535,24365,cPa356_cPa428,54_41,238,170
Scaffold270-24601_25023,cPa356,0.537878787878788,2,25016,24629,cPa356_cPa428,71_61,422,387
Scaffold270-25110_25212,cPa428,0.552631578947368,2,25199,25124,cPa356_cPa428,17_21,102,75
Scaffold270-25469_25571,cPa356_cPa428,0.5,2,25556,25472,cPa356_cPa428,4_4,102,84
Scaffold270-25800_26086,cPa356_cPa428,0.5,2,26034,25827,cPa356_cPa428,6_6,286,207
Scaffold270-26098_26200,cPa356,0.68,2,26188,26133,cPa356_cPa428,17_8,102,55
Scaffold270-26563_26665,cPa356_cPa428,0.5,2,26641,26613,cPa356_cPa428,2_2,102,28
Scaffold270-26896_26998,cPa356,0.666666666666667,2,26946,26941,cPa356_cPa428,2_1,102,5
Scaffold270-27809_27977,cPa356,0.642857142857143,2,27934,27848,cPa356_cPa428,9_5,168,86
Scaffold270-28048_28273,cPa356,0.515625,2,28237,28057,cPa356_cPa428,66_62,225,180
Scaffold270-28576_28687,cPa356,0.534883720930233,2,28670,28577,cPa356_cPa428,23_20,111,93
Scaffold271-7176_7278,cPa356,1,1,7226,7226,cPa356,1,102,0
Scaffold271-7517_7619,cPa428,1,1,7567,7567,cPa428,1,102,0
Scaffold271-7719_7821,cPa428,1,1,7769,7769,cPa428,1,102,0
Scaffold272-14011_14116,cPa356,0.588235294117647,2,14078,14032,cPa356_cPa428,10_7,105,46
Scaffold272-14969_15071,cPa356_cPa428,0.5,2,15019,15019,cPa356_cPa428,1_1,102,0
Scaffold272-7129_7307,cPa356_cPa428,0.5,2,7255,7179,cPa356_cPa428,1_1,178,76
Scaffold272-7740_7944,cPa356_cPa428,0.5,2,7892,7790,cPa356_cPa428,1_1,204,102
Scaffold274-4643_4745,cPa356,0.524590163934426,2,4717,4645,cPa356_cPa428,32_29,102,72
Scaffold275-2259_2361,cPa419,1,1,2352,2291,cPa419,8,102,61
Scaffold275-33335_33437,cPa419,1,1,33418,33349,cPa419,8,102,69
Scaffold275-34307_34457,cPa419,1,1,34457,34343,cPa419,37,150,114
Scaffold275-34568_34670,cPa419,1,1,34651,34578,cPa419,8,102,73
Scaffold275-34909_35053,cPa419,1,1,35050,34933,cPa419,17,144,117
Scaffold275-35096_35270,cPa419,1,1,35265,35095,cPa419,21,174,170
Scaffold275-35422_35524,cPa419,1,1,35511,35423,cPa419,42,102,88
Scaffold275-35575_35690,cPa419,1,1,35666,35594,cPa419,4,115,72
Scaffold275-37625_37748,cPa313_cPa449,0.4,3,37716,37675,cPa313_cPa419_cPa449,2_1_2,123,41
Scaffold275-700_802,cPa419,1,1,798,707,cPa419,21,102,91
Scaffold275-8523_8625,cPa419,1,1,8623,8569,cPa419,27,102,54
Scaffold275-8639_8741,cPa419,1,1,8689,8689,cPa419,1,102,0
Scaffold276-18323_18639,cPa456,0.458333333333333,13,18617,18327,cPa117-cPa363-hybrid_cPa117-cPa456-hybrid_cPa117-cPa587-hybrid_cPa117-unknown_cPa363_cPa363-cPa456-hybrid_cPa419_cPa428_cPa452-cPa363-hybrid_cPa452-cPa456-hybrid_cPa452-cPa587-hybrid_cPa452-unknown_cPa456,6_2_5_14_24_1_2_1_1_1_2_6_55,316,290
Scaffold276-21176_21278,cPa413,1,1,21255,21176,cPa413,6,102,79
Scaffold276-21347_21601,cPa413,0.953271028037383,2,21580,21347,cPa413_cPa419,102_5,254,233
Scaffold276-24085_24224,cPa15,0.550724637681159,7,24213,24088,cPa118_cPa15_cPa248_cPa248-cPa118-hybrid_cPa248-unknown_cPa443_cPa443-unknown,19_38_1_3_1_6_1,139,125
Scaffold276-25197_25300,cPa15,0.576923076923077,9,25248,25199,cPa118_cPa15_cPa248-cPa118-hybrid_cPa248-cPa443-hybrid_cPa268-cPa443-hybrid_cPa356_cPa419_cPa428_cPa443,17_60_4_3_3_2_1_2_12,103,49
Scaffold276-25482_25598,cPa15,0.441176470588235,13,25572,25505,cPa118_cPa118-cPa15-hybrid_cPa118-cPa443-hybrid_cPa15_cPa248-cPa118-hybrid_cPa248-cPa15-hybrid_cPa248-cPa443-hybrid_cPa268-cPa118-hybrid_cPa268-cPa15-hybrid_cPa268-cPa516-hybrid_cPa419_cPa443_cPa443-cPa118-hybrid,77_1_4_150_11_5_12_5_1_1_1_71_1,116,67
Scaffold276-32534_32721,cPa419,1,1,32720,32559,cPa419,18,187,161
Scaffold276-32741_33080,cPa419,1,1,33041,32755,cPa419,116,339,286
Scaffold276-33144_33246,cPa419,1,1,33232,33184,cPa419,3,102,48
Scaffold276-33265_33646,cPa419,1,1,33639,33280,cPa419,76,381,359
Scaffold276-33660_33959,cPa419,1,1,33907,33663,cPa419,35,299,244
Scaffold276-5206_5439,cPa419,0.837209302325581,8,5387,5205,cPa229-cPa109-hybrid_cPa379-cPa109-hybrid_cPa379-cPa425-hybrid_cPa419_cPa478_cPa478-cPa109-hybrid_cPa478-cPa387-hybrid_PERV_AJ293656-cPa387-hybrid,1_1_1_72_7_1_1_2,233,182
Scaffold276-9196_9302,cPa323-cPa568-hybrid,0.634259259259259,13,9300,9244,cPa323_cPa323-cPa14-hybrid_cPa323-cPa254-hybrid_cPa323-cPa419-hybrid_cPa323-cPa50-hybrid_cPa323-cPa568-hybrid_cPa323-unknown_cPa333_cPa333-cPa419-hybrid_cPa333-cPa568-hybrid_cPa371-cPa50-hybrid_cPa371-cPa568-hybrid_cPa419,31_1_1_1_4_137_6_10_1_7_1_15_1,106,56
Scaffold278-14649_14751,cPa356,1,1,14699,14699,cPa356,1,102,0
Scaffold278-22865_22967,cPa428,1,1,22915,22915,cPa428,1,102,0
Scaffold278-23131_23233,cPa428,1,1,23181,23181,cPa428,1,102,0
Scaffold278-31207_31309,cPa428,1,1,31257,31257,cPa428,1,102,0
Scaffold278-31957_32080,cPa356_cPa428,0.428571428571429,3,32042,31972,cPa356_cPa428_cPa428-unknown,6_6_2,123,70
Scaffold278-32249_32421,cPa356,0.555555555555556,3,32417,32281,cPa356_cPa356-cPa428-hybrid_cPa428,5_1_3,172,136
Scaffold278-32425_32626,cPa428,0.608695652173913,2,32576,32475,cPa356_cPa428,9_14,201,101
Scaffold278-33690_33792,cPa428,0.666666666666667,2,33772,33740,cPa356_cPa428,1_2,102,32
Scaffold279-12291_12413,cPa505-unknown,0.521739130434783,3,12361,12300,cPa109_cPa109-unknown_cPa505-unknown,1_10_12,122,61
Scaffold279-3174_3276,cPa16-cPa426-hybrid,1,1,3224,3224,cPa16-cPa426-hybrid,1,102,0
Scaffold280-24115_24217,cPa67,1,1,24165,24115,cPa67,12,102,50
Scaffold280-24500_24676,cPa67,1,1,24648,24521,cPa67,15,176,127
Scaffold280-24774_25365,cPa67,0.845132743362832,11,25352,24824,cPa118-cPa410-hybrid_cPa118-cPa587-hybrid_cPa248-cPa587-hybrid_cPa264-cPa587-hybrid_cPa443-cPa410-hybrid_cPa443-cPa587-hybrid_cPa526-cPa118-hybrid_cPa526-cPa182-hybrid_cPa526-cPa410-hybrid_cPa526-cPa587-hybrid_cPa67,2_8_3_2_4_5_1_1_3_6_191,591,528
Scaffold280-26292_26394,cPa118,0.545454545454545,5,26342,26330,cPa118_cPa248_cPa443_cPa443-cPa264-hybrid_cPa443-unknown,6_2_1_1_1,102,12
Scaffold280-35635_36236,cPa434,0.640692640692641,15,36232,35672,cPa356-GaLV_M26927-hybrid_cPa356-HML2_Pheonix-hybrid_cPa434_cPa434-GaLV_M26927-hybrid_cPa566_cPa60-cPa15-hybrid_cPa60-cPa34-hybrid_cPa60-cPa443-hybrid_cPa60-cPa566-hybrid_cPa60-cPa75-hybrid_cPa60-EqFV_NC002201-hybrid_cPa60-GaLV_M26927-hybrid_cPa60-unknown_S71_repbase_HERVS71_LTR6A-unknown_Xen1_AJ506107-cPa15-hybrid,21_1_148_1_15_1_1_4_3_3_1_13_17_1_1,601,560
Scaffold280-36498_36600,cPa434,0.565217391304348,4,36599,36516,cPa356-GaLV_M26927-hybrid_cPa356-PtERV1_AC142352-hybrid_cPa434_cPa566,6_2_13_2,102,83
Scaffold281-13203_13305,cPa428,1,1,13253,13253,cPa428,1,102,0
Scaffold281-13668_13770,cPa428,0.75,2,13764,13686,cPa356_cPa428,1_3,102,78
Scaffold281-17831_17933,cPa428,0.538461538461538,2,17932,17876,cPa356_cPa428,6_7,102,56
Scaffold281-19296_19413,cPa356_cPa428,0.5,2,19372,19331,cPa356_cPa428,3_3,117,41
Scaffold281-20157_20322,cPa356,0.516129032258065,2,20286,20198,cPa356_cPa428,16_15,165,88
Scaffold281-20823_20934,cPa356,0.538461538461538,2,20925,20873,cPa356_cPa428,7_6,111,52
Scaffold281-36083_36185,cPa356,0.6,2,36146,36112,cPa356_cPa428,3_2,102,34
Scaffold281-37105_37207,cPa356_cPa428,0.5,2,37206,37104,cPa356_cPa428,42_42,102,102
Scaffold282-29036_29192,cPa428,0.833333333333333,2,29140,29086,cPa356_cPa428,1_5,156,54
Scaffold282-30300_30402,cPa428,1,1,30350,30350,cPa428,1,102,0
Scaffold282-30828_30938,cPa428,0.6,2,30886,30878,cPa356_cPa428,2_3,110,8
Scaffold282-34088_34196,cPa428,0.666666666666667,2,34144,34138,cPa356_cPa428,2_4,108,6
Scaffold282-35090_35192,cPa356,1,1,35140,35140,cPa356,1,102,0
Scaffold282-35641_35743,cPa428,1,1,35691,35691,cPa428,1,102,0
Scaffold285-12240_12414,cPa356,0.516666666666667,3,12402,12241,cPa356_cPa428_cPa428-unknown,31_28_1,174,161
Scaffold285-18241_18343,cPa428,0.666666666666667,2,18321,18291,cPa356_cPa428,2_4,102,30
Scaffold285-18503_18605,cPa428,0.666666666666667,2,18602,18550,cPa356_cPa428,4_8,102,52
Scaffold285-18951_19093,cPa428,0.545454545454545,2,19075,18966,cPa356_cPa428,5_6,142,109
Scaffold285-20138_20240,cPa356,1,1,20189,20188,cPa356,2,102,1
Scaffold285-20531_20633,cPa428,0.666666666666667,2,20581,20539,cPa356_cPa428,1_2,102,42
Scaffold285-32506_32679,cPa428,0.625,2,32627,32552,cPa356_cPa428,6_10,173,75
Scaffold285-32684_32793,cPa356,0.571428571428571,2,32741,32734,cPa356_cPa428,4_3,109,7
Scaffold285-32939_33082,cPa428,0.833333333333333,2,33032,32989,cPa356_cPa428,1_5,143,43
Scaffold285-33378_33480,cPa356,0.833333333333333,2,33456,33396,cPa356_cPa428,5_1,102,60
Scaffold286-2424_2526,cPa356_cPa428,0.5,2,2495,2474,cPa356_cPa428,2_2,102,21
Scaffold286-2923_3040,cPa428,0.529411764705882,2,3018,2973,cPa356_cPa428,8_9,117,45
Scaffold286-4191_4293,cPa356,1,1,4248,4241,cPa356,2,102,7
Scaffold286-7002_7104,cPa428,1,1,7052,7052,cPa428,1,102,0
Scaffold286-8621_8723,cPa356,1,1,8671,8670,cPa356,2,102,1
Scaffold288-11797_11899,cPa356,1,1,11847,11800,cPa356,2,102,47
Scaffold288-11912_12108,cPa428,0.722222222222222,2,12104,11962,cPa356_cPa428,5_13,196,142
Scaffold288-12340_12442,cPa356,0.833333333333333,2,12437,12383,cPa356_cPa428,5_1,102,54
Scaffold288-12630_12732,cPa428,0.636363636363636,2,12681,12630,cPa356_cPa428,16_28,102,51
Scaffold288-12793_12895,cPa428,0.625,2,12847,12797,cPa356_cPa428,3_5,102,50
Scaffold288-13623_13761,cPa356_cPa428,0.444444444444444,3,13737,13673,cPa356_cPa356-unknown_cPa428,8_2_8,138,64
Scaffold288-13875_13985,cPa356_cPa428,0.5,2,13934,13912,cPa356_cPa428,4_4,110,22
Scaffold288-27378_27480,cPa356,1,1,27428,27428,cPa356,1,102,0
Scaffold288-28657_28759,cPa428,1,1,28722,28707,cPa428,2,102,15
Scaffold288-34216_34318,cPa428,0.666666666666667,2,34266,34218,cPa356_cPa428,1_2,102,48
Scaffold288-34703_34805,cPa356,1,1,34753,34753,cPa356,1,102,0
Scaffold288-34809_35026,cPa356,0.5625,2,34977,34859,cPa356_cPa428,9_7,217,118
Scaffold29-12238_12370,cPa546,0.941176470588235,2,12318,12288,cPa546_cPa546-cPa51-hybrid,16_1,132,30
Scaffold29-12420_12522,cPa546,1,1,12478,12470,cPa546,2,102,8
Scaffold29-9617_9719,cPa452,1,1,9667,9667,cPa452,1,102,0
Scaffold290-13198_13387,cPa428,0.875,2,13347,13237,cPa356_cPa428,1_7,189,110
Scaffold290-13761_13897,cPa428,0.666666666666667,2,13845,13811,cPa356_cPa428,1_2,136,34
Scaffold290-16118_16220,cPa428,1,1,16168,16168,cPa428,1,102,0
Scaffold290-26345_26451,cPa356_cPa428,0.5,2,26447,26389,cPa356_cPa428,4_4,106,58
Scaffold290-26808_26910,cPa428,0.6,2,26869,26807,cPa356_cPa428,2_3,102,62
Scaffold290-28855_28957,cPa428,1,1,28906,28905,cPa428,2,102,1
Scaffold290-29005_29110,cPa356,0.666666666666667,2,29058,29053,cPa356_cPa428,2_1,105,5
Scaffold290-29650_29752,cPa428,1,1,29700,29700,cPa428,1,102,0
Scaffold291-12194_12481,cPa61,0.5,7,12455,12244,cPa205_cPa205-cPa293-hybrid_cPa419_cPa428-cPa205-hybrid_cPa61_cPa61-ENTV_NC004994-hybrid_ENTV_NC004994,4_1_2_1_10_1_1,287,211
Scaffold291-17028_17258,cPa452,0.197115384615385,47,17206,17045,cPa16_cPa16-cPa176-hybrid_cPa16-cPa183-hybrid_cPa16-cPa339-hybrid_cPa16-cPa363-hybrid_cPa16-cPa390-hybrid_cPa16-cPa447-hybrid_cPa174_cPa174-cPa16-hybrid_cPa174-cPa176-hybrid_cPa174-cPa183-hybrid_cPa174-cPa339-hybrid_cPa174-cPa363-hybrid_cPa174-cPa381-hybrid_cPa174-cPa447-hybrid_cPa176_cPa254_cPa254-cPa174-hybrid_cPa254-cPa176-hybrid_cPa254-cPa183-hybrid_cPa254-cPa339-hybrid_cPa254-cPa363-hybrid_cPa254-cPa381-hybrid_cPa254-cPa392-hybrid_cPa254-cPa447-hybrid_cPa339_cPa339-cPa381-hybrid_cPa353-cPa363-hybrid_cPa353-cPa381-hybrid_cPa363_cPa390_cPa390-cPa183-hybrid_cPa390-cPa363-hybrid_cPa390-cPa447-hybrid_cPa392_cPa419_cPa425_cPa444_cPa444-cPa339-hybrid_cPa444-cPa363-hybrid_cPa447_cPa452_cPa452-cPa183-hybrid_cPa452-cPa339-hybrid_cPa452-cPa363-hybrid_cPa452-cPa447-hybrid_cPa71,8_3_2_1_3_1_3_9_1_1_1_1_3_1_2_7_5_1_4_2_2_5_1_1_3_36_1_1_1_11_16_2_1_1_1_3_1_1_1_1_3_41_1_1_3_3_7,230,161
Scaffold291-17362_17707,cPa452,0.183505154639175,77,17692,17398,cPa16_cPa16-cPa174-hybrid_cPa16-cPa176-hybrid_cPa16-cPa183-hybrid_cPa16-cPa196-hybrid_cPa16-cPa327-hybrid_cPa16-cPa339-hybrid_cPa16-cPa363-hybrid_cPa16-cPa381-hybrid_cPa16-cPa390-hybrid_cPa16-cPa392-hybrid_cPa16-cPa424-hybrid_cPa16-cPa425-hybrid_cPa16-cPa447-hybrid_cPa16-cPa62-hybrid_cPa16-unknown_cPa174_cPa174-cPa176-hybrid_cPa174-cPa183-hybrid_cPa174-cPa254-hybrid_cPa174-cPa327-hybrid_cPa174-cPa339-hybrid_cPa174-cPa363-hybrid_cPa174-cPa381-hybrid_cPa174-cPa392-hybrid_cPa174-cPa424-hybrid_cPa174-cPa447-hybrid_cPa176_cPa176-cPa327-hybrid_cPa176-cPa424-hybrid_cPa254_cPa254-cPa174-hybrid_cPa254-cPa176-hybrid_cPa254-cPa183-hybrid_cPa254-cPa339-hybrid_cPa254-cPa363-hybrid_cPa254-cPa381-hybrid_cPa254-cPa390-hybrid_cPa254-cPa404-hybrid_cPa254-cPa424-hybrid_cPa254-cPa447-hybrid_cPa339_cPa339-cPa183-hybrid_cPa353_cPa353-cPa16-hybrid_cPa353-cPa183-hybrid_cPa353-cPa327-hybrid_cPa353-cPa363-hybrid_cPa353-cPa62-hybrid_cPa363_cPa390_cPa390-cPa176-hybrid_cPa390-cPa183-hybrid_cPa390-cPa339-hybrid_cPa390-cPa363-hybrid_cPa390-cPa392-hybrid_cPa419_cPa425_cPa444_cPa444-cPa176-hybrid_cPa444-cPa183-hybrid_cPa444-cPa196-hybrid_cPa444-cPa339-hybrid_cPa444-cPa381-hybrid_cPa444-cPa390-hybrid_cPa444-cPa424-hybrid_cPa444-cPa447-hybrid_cPa447_cPa452_cPa452-cPa381-hybrid_cPa452-cPa424-hybrid_cPa452-cPa447-hybrid_cPa47_cPa71_cPa71-cPa176-hybrid_cPa71-cPa183-hybrid_cPa71-cPa447-hybrid,67_2_17_3_2_3_8_28_3_1_1_3_2_16_1_1_47_11_6_1_1_1_3_1_1_1_6_50_1_1_19_3_12_7_4_14_3_2_2_1_1_146_1_1_1_2_1_2_1_134_80_1_1_2_1_1_2_13_1_1_5_1_2_2_1_1_1_5_178_1_1_1_1_16_2_2_1,345,294
Scaffold291-1850_1952,cPa419,0.8,2,1906,1900,cPa333-cPa51-hybrid_cPa419,1_4,102,6
Scaffold291-18661_18763,cPa381,0.909090909090909,2,18761,18663,cPa353-cPa254-hybrid_cPa381,1_10,102,98
Scaffold291-19374_19476,cPa486,0.421052631578947,8,19460,19388,cPa339_cPa339-cPa15-hybrid_cPa353_cPa353-cPa381-hybrid_cPa398-cPa447-hybrid_cPa410_cPa486_FeLV_NC001940-cPa410-hybrid,3_1_2_1_1_2_8_1,102,72
Scaffold291-19488_19661,cPa486,0.51219512195122,9,19659,19509,cPa254-cPa410-hybrid_cPa270-cPa381-hybrid_cPa270-cPa410-hybrid_cPa381_cPa410_cPa410-cPa447-hybrid_cPa419_cPa47-cPa410-hybrid_cPa486,1_1_1_4_10_1_1_1_21,173,150
Scaffold291-21003_21321,cPa486,0.454545454545455,19,21317,21002,cPa270_cPa270-cPa381-hybrid_cPa270-cPa398-hybrid_cPa270-cPa410-hybrid_cPa270-unknown_cPa381_cPa381-unknown_cPa390_cPa390-cPa381-hybrid_cPa390-cPa398-hybrid_cPa398_cPa398-cPa381-hybrid_cPa398-unknown_cPa410_cPa419_cPa486_cPa486-unknown_cPa587-cPa410-hybrid_cPa62-cPa398-hybrid,43_2_2_2_5_52_1_3_2_2_40_1_2_23_3_160_7_1_1,318,315
Scaffold291-22125_22227,cPa486,0.277777777777778,8,22223,22163,cPa270_cPa381_cPa398_cPa410_cPa419_cPa486_cPa587_cPa62-unknown,2_2_9_1_4_10_5_3,102,60
Scaffold291-23244_23646,cPa410,0.345268542199488,26,23645,23257,cPa270_cPa270-cPa410-hybrid_cPa381_cPa381-cPa398-hybrid_cPa381-cPa410-hybrid_cPa390_cPa390-cPa398-hybrid_cPa390-cPa456-hybrid_cPa390-cPa587-hybrid_cPa398_cPa398-cPa456-hybrid_cPa398-cPa587-hybrid_cPa398-unknown_cPa410_cPa410-cPa398-hybrid_cPa410-unknown_cPa419_cPa486_cPa553-cPa456-hybrid_cPa587_cPa587-cPa381-hybrid_cPa587-cPa456-hybrid_cPa62_cPa62-cPa398-hybrid_cPa62-cPa410-hybrid_cPa62-cPa587-hybrid,3_1_19_2_2_4_6_2_9_62_1_2_2_135_2_2_23_29_1_68_1_1_8_1_2_3,402,388
Scaffold291-23793_23995,cPa410,0.186046511627907,12,23957,23823,cPa270_cPa381_cPa390_cPa398_cPa398-cPa270-hybrid_cPa410_cPa413_cPa419_cPa486_cPa587_cPa62_cPa62-cPa270-hybrid,1_1_7_6_1_8_3_4_4_6_1_1,202,134
Scaffold291-24018_24203,cPa410,0.442857142857143,13,24195,24044,cPa270_cPa381_cPa390_cPa398_cPa410_cPa410-cPa398-hybrid_cPa413_cPa413-unknown_cPa419_cPa486_cPa587_cPa62_cPa62-cPa398-hybrid,1_2_2_5_31_1_5_1_4_5_8_4_1,185,151
Scaffold291-24559_24661,cPa410,0.257142857142857,20,24645,24559,cPa270_cPa381_cPa390_cPa390-cPa270-hybrid_cPa398_cPa398-cPa270-hybrid_cPa410_cPa410-cPa390-hybrid_cPa419_cPa486_cPa553-cPa390-hybrid_cPa587_cPa62_cPa62-cPa270-hybrid_cPa62-cPa381-hybrid_cPa62-cPa390-hybrid_cPa62-cPa398-hybrid_cPa62-cPa410-hybrid_cPa62-cPa419-hybrid_cPa62-cPa587-hybrid,4_25_34_1_4_1_45_3_10_11_1_3_22_4_1_1_2_1_1_1,102,86
Scaffold291-24823_25440,cPa390,0.206896551724138,33,25440,24833,cPa270_cPa270-cPa381-hybrid_cPa270-cPa410-hybrid_cPa270-cPa456-hybrid_cPa270-cPa486-hybrid_cPa381_cPa381-cPa419-hybrid_cPa381-cPa486-hybrid_cPa390_cPa390-cPa270-hybrid_cPa390-cPa398-hybrid_cPa398-cPa270-hybrid_cPa398-cPa381-hybrid_cPa398-cPa390-hybrid_cPa410_cPa410-cPa381-hybrid_cPa410-unknown_cPa413_cPa413-cPa270-hybrid_cPa419_cPa486_cPa486-cPa270-hybrid_cPa486-cPa381-hybrid_cPa587-cPa270-hybrid_cPa587-cPa486-hybrid_cPa62_cPa62-cPa270-hybrid_cPa62-cPa381-hybrid_cPa62-cPa390-hybrid_cPa62-cPa398-hybrid_cPa62-cPa410-hybrid_cPa62-cPa419-hybrid_cPa62-cPa587-hybrid,71_1_1_1_1_111_1_1_120_2_1_1_2_1_88_3_1_1_1_46_38_1_1_1_1_60_9_2_5_2_2_1_2,617,607
Scaffold291-25584_25686,cPa390,0.307692307692308,18,25680,25583,cPa270_cPa270-cPa390-hybrid_cPa270-cPa486-hybrid_cPa270-unknown_cPa381_cPa390_cPa390-cPa270-hybrid_cPa390-cPa381-hybrid_cPa410_cPa486_cPa486-cPa270-hybrid_cPa486-unknown_cPa62_cPa62-cPa270-hybrid_cPa62-cPa390-hybrid_cPa62-cPa410-hybrid_cPa62-cPa419-hybrid_cPa62-unknown,17_1_1_1_2_28_1_1_3_7_1_1_17_3_4_1_1_1,102,97
Scaffold291-26662_26764,cPa486_cPa62,0.333333333333333,5,26746,26677,cPa268_cPa486_cPa486-cPa268-hybrid_cPa62_cPa62-cPa381-hybrid,1_3_1_3_1,102,69
Scaffold291-26931_27033,cPa381,0.5,4,27018,26959,cPa268_cPa268-cPa449-hybrid_cPa381_cPa486,1_1_5_3,102,59
Scaffold291-27349_27451,cPa268_cPa308_cPa353,0.222222222222222,6,27440,27379,cPa268_cPa308_cPa308-cPa381-hybrid_cPa353_cPa381_cPa486,2_2_1_2_1_1,102,61
Scaffold291-28651_28753,cPa419_HML4_repbase_HERVK13I_LTR13-unknown,0.5,2,28739,28701,cPa419_HML4_repbase_HERVK13I_LTR13-unknown,1_1,102,38
Scaffold291-5002_5417,cPa394-cPa353-hybrid,0.5,7,5365,5001,cPa174-cPa20-hybrid_cPa394_cPa394-cPa353-hybrid_cPa394-rRVRV_JQ303225-hybrid_cPa394-unknown_cPa419_rRVRV_JQ303225,1_4_15_2_4_2_2,415,364
Scaffold291-6160_6403,cPa339,0.365079365079365,31,6387,6176,cPa174-cPa486-hybrid_cPa174-rRVRV_JQ303225-hybrid_cPa254_cPa254-cPa339-hybrid_cPa254-cPa353-hybrid_cPa254-cPa486-hybrid_cPa254-cPa516-hybrid_cPa254-rRVRV_JQ303225-hybrid_cPa254-SIV_NC001870-hybrid_cPa339_cPa353_cPa353-cPa516-hybrid_cPa392-cPa486-hybrid_cPa392-SIV_NC001870-hybrid_cPa394-cPa339-hybrid_cPa394-cPa353-hybrid_cPa394-cPa486-hybrid_cPa394-rRVRV_JQ303225-hybrid_cPa404_cPa404-cPa339-hybrid_cPa404-cPa353-hybrid_cPa404-cPa486-hybrid_cPa404-cPa516-hybrid_cPa404-rRVRV_JQ303225-hybrid_cPa419_cPa425_cPa425-cPa339-hybrid_cPa425-cPa353-hybrid_cPa425-cPa486-hybrid_cPa425-rRVRV_JQ303225-hybrid_cPa47-cPa353-hybrid,1_7_1_1_3_2_1_5_2_69_32_1_1_1_2_9_5_9_3_1_10_3_1_7_5_1_1_2_1_1_1,243,211
Scaffold291-6519_6755,cPa339,0.458333333333333,19,6752,6554,cPa174-cPa353-hybrid_cPa174-rRVRV_JQ303225-hybrid_cPa254-cPa353-hybrid_cPa254-rRVRV_JQ303225-hybrid_cPa339_cPa353_cPa353-rRVRV_JQ303225-hybrid_cPa394-cPa353-hybrid_cPa394-cPa486-hybrid_cPa394-rRVRV_JQ303225-hybrid_cPa394-SIV_NC001870-hybrid_cPa404_cPa404-cPa353-hybrid_cPa404-cPa486-hybrid_cPa404-rRVRV_JQ303225-hybrid_cPa404-unknown_cPa419_cPa425_rRVRV_JQ303225,1_1_1_1_66_14_1_18_5_15_4_1_1_1_5_1_3_3_2,236,198
Scaffold291-6778_6986,cPa339,0.6875,14,6985,6780,cPa174-rRVRV_JQ303225-hybrid_cPa254-rRVRV_JQ303225-hybrid_cPa339_cPa353_cPa353-rRVRV_JQ303225-hybrid_cPa394-cPa339-hybrid_cPa394-cPa353-hybrid_cPa394-rRVRV_JQ303225-hybrid_cPa402-cPa353-hybrid_cPa402-rRVRV_JQ303225-hybrid_cPa404-rRVRV_JQ303225-hybrid_cPa492-cPa353-hybrid_cPa492-rRVRV_JQ303225-hybrid_rRVRV_JQ303225,1_1_44_3_1_1_1_2_1_2_1_1_3_2,208,205
Scaffold291-7636_7738,cPa425,0.333333333333333,5,7691,7645,cPa339_cPa402_cPa402-cPa486-hybrid_cPa425_cPa492-rRVRV_JQ303225-hybrid,1_1_1_2_1,102,46
Scaffold291-7785_7887,cPa402_cPa402-cPa353-hybrid,0.4,3,7835,7797,cPa402_cPa402-cPa353-hybrid_cPa425,2_2_1,102,38
Scaffold291-9244_9346,cPa293-cPa183-hybrid_cPa308,0.5,2,9331,9294,cPa293-cPa183-hybrid_cPa308,1_1,102,37
Scaffold292-1525_1627,cPa419,1,1,1575,1533,cPa419,4,102,42
Scaffold292-1989_2091,cPa419,1,1,2075,2039,cPa419,4,102,36
Scaffold292-2333_2435,cPa419,1,1,2402,2383,cPa419,4,102,19
Scaffold293-28217_28323,cPa428,0.75,2,28275,28267,cPa356_cPa428,1_3,106,8
Scaffold295-13517_13619,cPa428,1,1,13567,13567,cPa428,1,102,0
Scaffold296-24332_24434,cPa356,1,1,24382,24382,cPa356,1,102,0
Scaffold296-25712_25814,cPa428,1,1,25762,25762,cPa428,1,102,0
Scaffold297-13049_13151,cPa419,1,1,13099,13099,cPa419,1,102,0
Scaffold297-18293_18395,cPa419,1,1,18361,18296,cPa419,3,102,65
Scaffold297-19376_19478,cPa419,1,1,19426,19426,cPa419,1,102,0
Scaffold297-20381_20498,cPa419,1,1,20446,20431,cPa419,3,117,15
Scaffold297-20650_20752,cPa419,1,1,20747,20700,cPa419,3,102,47
Scaffold297-21035_21137,cPa419,1,1,21085,21035,cPa419,2,102,50
Scaffold297-21379_21481,cPa419,1,1,21429,21429,cPa419,1,102,0
Scaffold298-12191_12348,cPa356,0.666666666666667,2,12320,12212,cPa356_cPa428,4_2,157,108
Scaffold298-12395_12497,cPa356_cPa428,0.5,2,12487,12406,cPa356_cPa428,8_8,102,81
Scaffold298-12811_12913,cPa428,0.666666666666667,2,12861,12815,cPa356_cPa428,1_2,102,46
Scaffold298-13786_13888,cPa356_cPa428,0.5,2,13836,13836,cPa356_cPa428,1_1,102,0
Scaffold298-23614_23716,cPa428,1,1,23702,23664,cPa428,2,102,38
Scaffold298-25868_25970,cPa356,1,1,25918,25907,cPa356,2,102,11
Scaffold298-30648_30750,cPa356,0.625,2,30707,30648,cPa356_cPa428,5_3,102,59
Scaffold301-26248_26350,cPa428,1,1,26298,26298,cPa428,1,102,0
Scaffold301-27211_27313,cPa428,1,1,27261,27261,cPa428,1,102,0
Scaffold301-33321_33431,cPa356,0.666666666666667,2,33379,33371,cPa356_cPa428,2_1,110,8
Scaffold302-29683_29785,cPa419,1,1,29733,29733,cPa419,1,102,0
Scaffold302-29804_29906,cPa419,1,1,29854,29854,cPa419,1,102,0
Scaffold303-11862_11964,cPa419,1,1,11912,11899,cPa419,2,102,13
Scaffold303-16326_16428,cPa419,1,1,16376,16376,cPa419,1,102,0
Scaffold303-17848_17957,cPa419,1,1,17905,17876,cPa419,8,109,29
Scaffold303-18070_18172,cPa419,1,1,18127,18120,cPa419,3,102,7
Scaffold303-18221_18366,cPa419,1,1,18329,18224,cPa419,7,145,105
Scaffold303-19561_19663,cPa419,1,1,19626,19611,cPa419,7,102,15
Scaffold303-19675_19777,cPa419,1,1,19767,19679,cPa419,3,102,88
Scaffold303-20951_21085,cPa419,1,1,21048,21001,cPa419,18,134,47
Scaffold303-26310_26412,cPa419,1,1,26360,26356,cPa419,2,102,4
Scaffold303-29072_29181,cPa419,1,1,29129,29122,cPa419,3,109,7
Scaffold303-5400_5502,cPa419,1,1,5492,5450,cPa419,13,102,42
Scaffold306-10561_10695,cPa428,0.6,2,10690,10560,cPa356_cPa428,4_6,134,130
Scaffold306-12140_12273,cPa428,0.533333333333333,2,12249,12181,cPa356_cPa428,7_8,133,68
Scaffold306-12396_12498,cPa428,0.571428571428571,2,12446,12411,cPa356_cPa428,3_4,102,35
Scaffold306-12781_12883,cPa428,0.666666666666667,2,12868,12793,cPa356_cPa428,1_2,102,75
Scaffold306-14067_14169,cPa428,0.714285714285714,2,14124,14077,cPa356_cPa428,2_5,102,47
Scaffold306-18211_18313,cPa428,1,1,18261,18261,cPa428,1,102,0
Scaffold306-18941_19043,cPa356,1,1,18991,18991,cPa356,1,102,0
Scaffold306-20770_20872,cPa428,0.666666666666667,2,20840,20820,cPa356_cPa428,1_2,102,20
Scaffold306-21087_21257,cPa428,1,1,21205,21137,cPa428,1,170,68
Scaffold306-21737_21839,cPa428,0.555555555555556,2,21824,21781,cPa356_cPa428,4_5,102,43
Scaffold306-22027_22129,cPa428,0.526315789473684,2,22128,22030,cPa356_cPa428,9_10,102,98
Scaffold306-24930_25032,cPa428,0.571428571428571,2,24986,24974,cPa356_cPa428,3_4,102,12
Scaffold306-25905_26197,cPa428,0.611111111111111,2,26184,25923,cPa356_cPa428,14_22,292,261
Scaffold306-26317_26419,cPa356,0.7,2,26419,26360,cPa356_cPa428,7_3,102,59
Scaffold306-33319_33421,cPa428,1,1,33369,33369,cPa428,1,102,0
Scaffold306-33952_34054,cPa428,0.666666666666667,2,34030,33999,cPa356_cPa428,1_2,102,31
Scaffold306-34371_34473,cPa428,1,1,34421,34421,cPa428,1,102,0
Scaffold306-8332_8700,cPa356,0.537037037037037,2,8653,8353,cPa356_cPa428,29_25,368,300
Scaffold306-8855_9079,cPa356,0.538461538461538,2,9067,8905,cPa356_cPa428,14_12,224,162
Scaffold306-9159_9313,cPa428,0.625,2,9313,9209,cPa356_cPa428,3_5,154,104
Scaffold306-9611_9780,cPa428,0.625,2,9778,9661,cPa356_cPa428,3_5,169,117
Scaffold308-11766_11890,cPa67,0.523809523809524,3,11868,11768,cPa339_cPa339-unknown_cPa67,3_7_11,124,100
Scaffold308-14343_14445,cPa229-cPa391-hybrid,1,1,14393,14393,cPa229-cPa391-hybrid,1,102,0
Scaffold308-14621_14797,cPa229-cPa391-hybrid,1,1,14745,14671,cPa229-cPa391-hybrid,8,176,74
Scaffold308-14866_15124,cPa391,1,1,15072,14910,cPa391,17,258,162
Scaffold308-17894_17996,cPa434-MLV_Mpmv5-hybrid_MLV_Mpmv5-cPa371-hybrid,0.4,3,17984,17908,cPa434-MLV_Mpmv5-hybrid_MLV_Mpmv5_MLV_Mpmv5-cPa371-hybrid,2_1_2,102,76
Scaffold308-18529_18631,cPa434-cPa371-hybrid,0.35042735042735,18,18631,18528,cPa270-cPa323-hybrid_cPa270-cPa371-hybrid_cPa323_cPa323-cPa371-hybrid_cPa333_cPa333-cPa323-hybrid_cPa333-cPa371-hybrid_cPa379-cPa371-hybrid_cPa434-cPa323-hybrid_cPa434-cPa333-hybrid_cPa434-cPa371-hybrid_cPa568-cPa158-hybrid_cPa568-cPa18-hybrid_cPa568-cPa323-hybrid_cPa568-cPa333-hybrid_cPa568-cPa371-hybrid_cPa568-unknown_MLV_Mpmv5,1_2_17_1_1_2_1_1_8_11_41_1_6_6_2_10_5_1,102,103
Scaffold308-2306_2493,cPa456,0.416666666666667,6,2441,2322,cPa363_cPa452-cPa587-hybrid_cPa456_cPa67_cPa67-cPa34-hybrid_cPa67-cPa587-hybrid,2_2_5_1_1_1,187,119
Scaffold308-24920_25022,cPa168_cPa182-cPa339-hybrid,0.5,2,24970,24970,cPa168_cPa182-cPa339-hybrid,1_1,102,0
Scaffold308-26116_26259,cPa492,0.684210526315789,4,26246,26144,cPa419_cPa492_cPa492-unknown_cPa539-unknown,1_26_5_6,143,102
Scaffold308-2807_2909,cPa363_cPa456_cPa539,0.25,5,2887,2829,cPa363_cPa456_cPa456-cPa264-hybrid_cPa456-cPa587-hybrid_cPa539,2_2_1_1_2,102,58
Scaffold308-2935_3039,cPa67,0.29126213592233,12,3031,2955,cPa285-cPa587-hybrid_cPa285-cPa75-hybrid_cPa315-cPa587-hybrid_cPa363_cPa452_cPa452-cPa587-hybrid_cPa456_cPa456-cPa587-hybrid_cPa587_cPa67_cPa67-cPa587-hybrid_cPa75,5_1_1_27_13_3_16_1_2_30_1_3,104,76
Scaffold310-376_478,cPa428,0.555555555555556,2,428,420,cPa356_cPa428,4_5,102,8
Scaffold312-10109_10211,cPa428,1,1,10159,10159,cPa428,1,102,0
Scaffold312-22726_22828,cPa356,1,1,22776,22776,cPa356,1,102,0
Scaffold313-1231_1422,cPa407,0.625,3,1370,1247,cPa407_cPa407-cPa475-hybrid_cPa419,5_1_2,191,123
Scaffold313-1450_1552,cPa419,0.857142857142857,2,1538,1470,cPa255-STLV1_NC000858-hybrid_cPa419,1_6,102,68
Scaffold313-20255_20357,cPa339,0.9,2,20346,20292,cPa339_cPa339-unknown,9_1,102,54
Scaffold313-20655_20801,cPa339,0.454545454545455,4,20765,20681,cPa339_cPa339-cPa256-hybrid_cPa419_FIV_NC001482-cPa256-hybrid,10_9_1_2,146,84
Scaffold313-20978_21080,cPa339_cPa339-cPa256-hybrid,0.5,2,21071,21028,cPa339_cPa339-cPa256-hybrid,1_1,102,43
Scaffold313-23331_23433,cPa339-cPa542-hybrid,1,1,23381,23381,cPa339-cPa542-hybrid,1,102,0
Scaffold314-22454_22660,cPa419,0.238095238095238,13,22650,22504,cPa118-cPa308-hybrid_cPa118-cPa450-hybrid_cPa118-cPa475-hybrid_cPa15-cPa450-hybrid_cPa15-cPa475-hybrid_cPa257-cPa475-hybrid_cPa419_cPa419-cPa475-hybrid_cPa428_cPa469_cPa469-cPa450-hybrid_cPa482-cPa475-hybrid_cPa546-cPa450-hybrid,1_1_1_2_2_1_5_1_1_3_1_1_1,206,146
Scaffold314-28768_29101,cPa15,0.430379746835443,16,29089,28776,cPa118_cPa118-cPa268-hybrid_cPa118-cPa75-hybrid_cPa118-unknown_cPa15_cPa15-cPa113-hybrid_cPa15-cPa118-hybrid_cPa15-cPa419-hybrid_cPa15-unknown_cPa285_cPa419_cPa575-GaLV_M26927-hybrid_cPa62_cPa75_GaLV_M26927_WDSV_NC001867,13_1_1_1_34_1_2_1_1_1_10_1_7_2_2_1,333,313
Scaffold314-31093_31195,cPa419,0.666666666666667,3,31172,31097,cPa15_cPa268-cPa118-hybrid_cPa419,1_1_4,102,75
Scaffold314-32138_32240,cPa419,1,1,32188,32188,cPa419,1,102,0
Scaffold314-33175_33374,cPa419,0.5,4,33322,33214,cPa419_HERV-Fb_repbase_HERVH48I_MER48_HERV-Fb_repbase_HERVH48I_MER48-unknown_HML8_repbase_HERVK11I_MER11A-unknown,3_1_1_1,199,108
Scaffold315-13414_13520,cPa107-unknown_cPa381-cPa228-hybrid_cPa381-cPa449-hybrid_cPa419-cPa413-hybrid,0.25,4,13468,13441,cPa107-unknown_cPa381-cPa228-hybrid_cPa381-cPa449-hybrid_cPa419-cPa413-hybrid,1_1_1_1,106,27
Scaffold315-1392_1494,cPa61,1,1,1479,1442,cPa61,2,102,37
Scaffold315-18505_18607,cPa104-unknown,1,1,18555,18555,cPa104-unknown,1,102,0
Scaffold315-20062_20164,cPa523-cPa447-hybrid,1,1,20112,20112,cPa523-cPa447-hybrid,1,102,0
Scaffold315-20891_21040,cPa177,0.333333333333333,11,20988,20925,cPa14-cPa272-hybrid_cPa14-cPa575-hybrid_cPa14-PERV_AJ293656-hybrid_cPa158-cPa272-hybrid_cPa177_cPa177-cPa272-hybrid_cPa308_cPa413-cPa379-hybrid_cPa413-cPa62-hybrid_cPa523-cPa193-hybrid_PERV_AJ293656,2_1_1_1_6_1_1_1_1_1_2,149,63
Scaffold315-21069_21240,cPa272,0.318181818181818,8,21225,21072,cPa14-cPa272-hybrid_cPa216-cPa272-hybrid_cPa272_cPa413-cPa272-hybrid_cPa572-PERV_AJ293656-hybrid_cPa75-cPa177-hybrid_cPa75-cPa272-hybrid_PERV_AJ293656,1_1_7_4_1_1_6_1,171,153
Scaffold315-21320_21422,cPa413-cPa272-hybrid,0.307692307692308,9,21398,21319,cPa177_cPa272_cPa413-cPa177-hybrid_cPa413-cPa272-hybrid_cPa413-PERV_AJ293656-hybrid_cPa523-cPa518-hybrid_cPa75-cPa193-hybrid_cPa75-cPa413-hybrid_cPa75-unknown,1_2_1_4_1_1_1_1_1,102,79
Scaffold315-24384_24513,cPa549,1,1,24461,24434,cPa549,7,129,27
Scaffold315-26815_26917,cPa419,1,1,26865,26860,cPa419,2,102,5
Scaffold315-28419_28521,cPa419_cPa61-cPa125-hybrid,0.5,2,28498,28469,cPa419_cPa61-cPa125-hybrid,1_1,102,29
Scaffold315-28652_28754,cPa358-cPa125-hybrid,1,1,28702,28702,cPa358-cPa125-hybrid,1,102,0
Scaffold315-32498_32600,cPa223_cPa223-cPa424-hybrid,0.444444444444444,3,32597,32520,cPa223_cPa223-cPa424-hybrid_cPa419,4_4_1,102,77
Scaffold315-32882_33120,cPa363-cPa424-hybrid,0.171875,31,33112,32886,cPa16-cPa224-hybrid_cPa183-cPa224-hybrid_cPa183-cPa424-hybrid_cPa183-cPa75-hybrid_cPa223_cPa223-cPa224-hybrid_cPa223-cPa419-hybrid_cPa223-cPa424-hybrid_cPa223-cPa512-hybrid_cPa223-cPa61-hybrid_cPa223-unknown_cPa327_cPa327-cPa424-hybrid_cPa356-cPa424-hybrid_cPa363-cPa193-hybrid_cPa363-cPa224-hybrid_cPa363-cPa371-hybrid_cPa363-cPa424-hybrid_cPa363-cPa512-hybrid_cPa363-cPa61-hybrid_cPa363-unknown_cPa379-cPa424-hybrid_cPa419_cPa424_cPa452-cPa424-hybrid_cPa463-cPa224-hybrid_cPa568-cPa424-hybrid_cPa71-cPa224-hybrid_cPa71-cPa323-hybrid_cPa71-cPa75-hybrid_cPa75,4_1_2_1_1_6_1_5_1_1_2_1_2_1_1_4_1_11_1_1_1_1_3_1_3_1_1_2_1_1_1,238,226
Scaffold315-3361_3548,cPa549-unknown,0.571428571428571,2,3517,3411,cPa419_cPa549-unknown,3_4,187,106
Scaffold315-4606_4716,cPa34-cPa526-hybrid_cPa419,0.5,2,4664,4656,cPa34-cPa526-hybrid_cPa419,1_1,110,8
Scaffold315-5161_5284,cPa34-cPa526-hybrid,1,1,5232,5211,cPa34-cPa526-hybrid,3,123,21
Scaffold315-5640_5742,cPa177-cPa526-hybrid_cPa34-cPa526-hybrid,0.5,2,5723,5690,cPa177-cPa526-hybrid_cPa34-cPa526-hybrid,1_1,102,33
Scaffold315-5949_6051,cPa526,0.6,2,6047,5991,cPa177-cPa526-hybrid_cPa526,2_3,102,56
Scaffold317-7891_7993,cPa419,0.962962962962963,2,7993,7935,cPa356_cPa419,1_26,102,58
Scaffold317-8238_8340,cPa419,1,1,8293,8288,cPa419,2,102,5
Scaffold317-8799_8953,cPa419,1,1,8901,8801,cPa419,33,154,100
Scaffold317-9477_9579,cPa419,1,1,9528,9512,cPa419,7,102,16
Scaffold317-9727_9857,cPa419,1,1,9824,9760,cPa419,34,130,64
Scaffold318-612_714,cPa419,1,1,662,662,cPa419,1,102,0
Scaffold319-16517_16619,cPa428,0.75,2,16609,16550,cPa356_cPa428,1_3,102,59
Scaffold319-17613_17728,cPa428,0.714285714285714,2,17677,17663,cPa356_cPa428,2_5,115,14
Scaffold319-24890_25050,cPa428,0.555555555555556,2,25046,24940,cPa356_cPa428,4_5,160,106
Scaffold319-25272_25374,cPa356,0.666666666666667,2,25362,25279,cPa356_cPa428,2_1,102,83
Scaffold319-26502_26604,cPa428,0.666666666666667,2,26552,26523,cPa356_cPa428,1_2,102,29
Scaffold319-4620_4725,cPa356_cPa428,0.5,2,4676,4668,cPa356_cPa428,5_5,105,8
Scaffold320-31312_31414,cPa419,1,1,31362,31359,cPa419,2,102,3
Scaffold323-22495_22597,cPa163,1,1,22545,22545,cPa163,1,102,0
Scaffold323-24708_24810,cPa117-unknown_cPa308-cPa75-hybrid_cPa308-unknown_cPa523-cPa62-hybrid,0.25,4,24759,24750,cPa117-unknown_cPa308-cPa75-hybrid_cPa308-unknown_cPa523-cPa62-hybrid,1_1_1_1,102,9
Scaffold323-24926_25028,cPa117-cPa62-hybrid,1,1,24976,24976,cPa117-cPa62-hybrid,1,102,0
Scaffold323-25048_25150,cPa308-cPa62-hybrid_cPa523-cPa62-hybrid,0.5,2,25098,25098,cPa308-cPa62-hybrid_cPa523-cPa62-hybrid,1_1,102,0
Scaffold323-3531_3648,cPa290,0.666666666666667,6,3596,3534,cPa290_cPa290-Cer1_U15406-hybrid_cPa290-unknown_cPa581-Cer1_U15406-hybrid_cPa581-cPa290-hybrid_cPa581-unknown,24_1_6_1_2_2,117,62
Scaffold323-7255_7357,cPa223-cPa199-hybrid_cPa223-cPa323-hybrid_cPa223-cPa553-hybrid,0.333333333333333,3,7306,7304,cPa223-cPa199-hybrid_cPa223-cPa323-hybrid_cPa223-cPa553-hybrid,1_1_1,102,2
Scaffold324-5049_5151,cPa428,0.666666666666667,2,5138,5071,cPa356_cPa428,2_4,102,67
Scaffold327-16773_16875,cPa419,1,1,16823,16823,cPa419,1,102,0
Scaffold327-16928_17030,cPa419,1,1,16978,16978,cPa419,1,102,0
Scaffold327-18220_18339,cPa419,1,1,18322,18221,cPa419,68,119,101
Scaffold327-19720_19822,cPa419,1,1,19794,19770,cPa419,3,102,24
Scaffold327-19831_19933,cPa419,1,1,19881,19860,cPa419,2,102,21
Scaffold327-19969_20084,cPa419,1,1,20032,19975,cPa419,44,115,57
Scaffold327-20161_20437,cPa419,1,1,20390,20194,cPa419,35,276,196
Scaffold327-20749_20851,cPa419,1,1,20816,20756,cPa419,5,102,60
Scaffold327-20876_21005,cPa419,1,1,21002,20892,cPa419,15,129,110
Scaffold327-21126_21281,cPa419,1,1,21248,21138,cPa419,8,155,110
Scaffold327-21303_21405,cPa419,1,1,21353,21353,cPa419,1,102,0
Scaffold327-22457_22597,cPa419,1,1,22545,22507,cPa419,1,140,38
Scaffold328-11628_11730,cPa419,1,1,11682,11678,cPa419,2,102,4
Scaffold328-26755_26857,cPa419,1,1,26813,26793,cPa419,4,102,20
Scaffold329-15752_15854,cPa428,1,1,15802,15802,cPa428,1,102,0
Scaffold329-29328_29430,cPa428,1,1,29378,29353,cPa428,2,102,25
Scaffold329-29756_29858,cPa356_cPa428,0.5,2,29806,29806,cPa356_cPa428,1_1,102,0
Scaffold330-21668_21770,cPa356,1,1,21718,21677,cPa356,2,102,41
Scaffold330-22688_22823,cPa356,0.583333333333333,2,22772,22735,cPa356_cPa428,7_5,135,37
Scaffold330-22879_22983,cPa428,0.545454545454545,2,22931,22926,cPa356_cPa428,5_6,104,5
Scaffold330-23086_23194,cPa356,0.6,2,23156,23085,cPa356_cPa428,6_4,108,71
Scaffold331-29664_29766,cPa356_cPa428,0.5,2,29714,29714,cPa356_cPa428,1_1,102,0
Scaffold331-30222_30348,cPa428,0.75,2,30343,30272,cPa356_cPa428,1_3,126,71
Scaffold331-30924_31026,cPa356_cPa428,0.5,2,31015,30928,cPa356_cPa428,3_3,102,87
Scaffold331-31322_31426,cPa428,0.666666666666667,2,31386,31337,cPa356_cPa428,2_4,104,49
Scaffold331-32300_32402,cPa356,0.6,2,32393,32350,cPa356_cPa428,3_2,102,43
Scaffold331-32930_33076,cPa356,0.535211267605634,2,33064,32930,cPa356_cPa428,38_33,146,134
Scaffold332-13141_13243,cPa419,1,1,13191,13191,cPa419,1,102,0
Scaffold332-13593_13695,cPa419,1,1,13690,13643,cPa419,6,102,47
Scaffold332-16417_16519,cPa419,1,1,16479,16439,cPa419,5,102,40
Scaffold332-16525_16627,cPa419,1,1,16582,16528,cPa419,6,102,54
Scaffold332-17063_17184,cPa419,1,1,17132,17075,cPa419,3,121,57
Scaffold332-17250_17352,cPa419,1,1,17300,17300,cPa419,1,102,0
Scaffold332-27660_27830,cPa419,1,1,27810,27667,cPa419,11,170,143
Scaffold332-28683_28785,cPa419,1,1,28752,28699,cPa419,10,102,53
Scaffold332-3612_3714,cPa419,1,1,3662,3658,cPa419,2,102,4
Scaffold334-16039_16141,cPa419,1,1,16089,16052,cPa419,4,102,37
Scaffold334-17696_17798,cPa419,0.75,2,17747,17736,cPa419_cPa75,9_3,102,11
Scaffold334-18451_18553,cPa419_cPa75,0.5,2,18501,18459,cPa419_cPa75,1_1,102,42
Scaffold334-1935_2191,cPa482,0.636363636363636,22,2176,1934,cPa130-PERVB_AY099324-hybrid_cPa130-PERVC_HM159246-hybrid_cPa332-cPa117-hybrid_cPa332-cPa164-hybrid_cPa332-cPa177-hybrid_cPa332-cPa205-hybrid_cPa332-EIAV_NC001450-hybrid_cPa419_cPa419-cPa164-hybrid_cPa456_cPa456-cPa177-hybrid_cPa456-cPa205-hybrid_cPa456-cPa293-hybrid_cPa456-cPa308-hybrid_cPa456-cPa447-hybrid_cPa456-cPa512-hybrid_cPa482_cPa512_cPa512-cPa177-hybrid_cPa555_cPa75_PERVC_HM159246,1_1_1_1_2_1_1_5_1_8_1_1_1_3_1_1_63_2_1_1_1_1,256,242
Scaffold334-22990_23330,cPa456,0.454054054054054,18,23327,22992,cPa117-cPa363-hybrid_cPa117-cPa456-hybrid_cPa117-cPa587-hybrid_cPa247-cPa587-hybrid_cPa358_cPa363_cPa363-cPa456-hybrid_cPa363-cPa587-hybrid_cPa363-unknown_cPa419_cPa452-cPa363-hybrid_cPa452-cPa456-hybrid_cPa452-cPa587-hybrid_cPa452-unknown_cPa456_cPa456-cPa587-hybrid_cPa583_cPa75,7_5_9_3_2_30_1_2_1_13_3_4_12_1_84_2_3_3,340,335
Scaffold334-28119_28328,cPa339-cPa194-hybrid,0.420289855072464,13,28314,28169,cPa130_cPa130-cPa194-hybrid_cPa339-cPa130-hybrid_cPa339-cPa194-hybrid_cPa339-cPa380-hybrid_cPa339-cPa541-hybrid_cPa339-cPa543-hybrid_cPa339-cPa575-hybrid_cPa339-HERVFc2_repbase-hybrid_cPa356-cPa194-hybrid_cPa419_cPa419-cPa194-hybrid_HERV-R_repbase_HERV3_LTR4-cPa194-hybrid,10_5_6_58_1_4_14_1_18_1_9_2_9,209,145
Scaffold334-3217_3403,cPa482,0.941176470588235,3,3391,3224,cPa371_cPa419_cPa482,3_2_80,186,167
Scaffold334-3440_3706,cPa482,0.689075630252101,22,3706,3475,ALVJ_Z46390-cPa308-hybrid_cPa167-cPa472-hybrid_cPa227-cPa456-hybrid_cPa228-cPa308-hybrid_cPa254-cPa308-hybrid_cPa332-cPa447-hybrid_cPa357-cPa456-hybrid_cPa419_cPa456_cPa469-cPa177-hybrid_cPa469-cPa182-hybrid_cPa469-cPa205-hybrid_cPa469-cPa308-hybrid_cPa469-cPa456-hybrid_cPa469-cPa482-hybrid_cPa482_cPa62-cPa177-hybrid_cPa62-cPa182-hybrid_cPa62-cPa205-hybrid_cPa62-cPa308-hybrid_cPa62-cPa456-hybrid_cPa62-cPa510-hybrid,1_1_3_1_1_1_1_7_17_1_1_1_7_1_1_164_8_1_6_11_2_1,266,231
Scaffold334-4513_5109,cPa62,0.267281105990783,42,5099,4513,cPa133_cPa167-cPa117-hybrid_cPa205-cPa555-hybrid_cPa227-cPa475-hybrid_cPa254_cPa254-cPa469-hybrid_cPa254-cPa475-hybrid_cPa332-cPa419-hybrid_cPa332-cPa469-hybrid_cPa363_cPa381-cPa456-hybrid_cPa419_cPa428_cPa456_cPa456-cPa452-hybrid_cPa469_cPa469-cPa176-hybrid_cPa469-cPa177-hybrid_cPa469-cPa205-hybrid_cPa469-cPa449-hybrid_cPa469-cPa456-hybrid_cPa469-cPa475-hybrid_cPa469-unknown_cPa475_cPa482_cPa482-cPa475-hybrid_cPa512-cPa469-hybrid_cPa512-cPa475-hybrid_cPa555_cPa62_cPa62-cPa133-hybrid_cPa62-cPa176-hybrid_cPa62-cPa177-hybrid_cPa62-cPa308-hybrid_cPa62-cPa419-hybrid_cPa62-cPa449-hybrid_cPa62-cPa456-hybrid_cPa62-cPa469-hybrid_cPa62-cPa475-hybrid_cPa62-cPa482-hybrid_cPa62-unknown_cPa75-cPa475-hybrid,1_1_1_2_2_2_2_1_1_1_1_15_2_1_1_24_1_1_2_1_1_13_3_2_8_5_1_8_1_58_1_2_1_3_1_1_1_3_32_1_7_1,596,586
Scaffold335-15955_16057,cPa428,1,1,16005,16005,cPa428,1,102,0
Scaffold335-25721_25823,cPa356_cPa428,0.5,2,25823,25771,cPa356_cPa428,4_4,102,52
Scaffold335-26736_26838,cPa356,0.75,2,26829,26736,cPa356_cPa428,3_1,102,93
Scaffold335-9597_9703,cPa428,1,1,9653,9618,cPa428,4,106,35
Scaffold336-19712_19859,cPa428,0.833333333333333,2,19807,19748,cPa356_cPa428,1_5,147,59
Scaffold336-28662_28764,cPa428,1,1,28712,28712,cPa428,1,102,0
Scaffold337-10402_10504,cPa356,1,1,10452,10452,cPa356,1,102,0
Scaffold337-11085_11187,cPa356,0.75,2,11135,11123,cPa356_cPa428,3_1,102,12
Scaffold337-9532_9798,cPa356_cPa428,0.5,2,9748,9582,cPa356_cPa428,26_26,266,166
Scaffold341-23400_23502,cPa356,1,1,23450,23450,cPa356,1,102,0
Scaffold341-24327_24429,cPa356,0.545454545454545,2,24409,24357,cPa356_cPa428,6_5,102,52
Scaffold341-24493_24599,cPa356,0.538461538461538,2,24571,24543,cPa356_cPa428,7_6,106,28
Scaffold341-24715_24821,cPa356,0.555555555555556,3,24770,24765,cPa356_cPa428_cPa428-unknown,10_7_1,106,5
Scaffold341-25262_25364,cPa428,1,1,25312,25312,cPa428,1,102,0
Scaffold341-3591_3790,cPa428,0.588235294117647,2,3738,3607,cPa356_cPa428,7_10,199,131
Scaffold341-4524_4626,cPa428,1,1,4574,4569,cPa428,2,102,5
Scaffold342-14461_14563,cPa428,0.8,2,14558,14511,cPa356_cPa428,1_4,102,47
Scaffold343-6252_6354,HML3_repbase_HERVK9I_MER9,1,1,6302,6302,HML3_repbase_HERVK9I_MER9,1,102,0
Scaffold343-6658_6760,cPa205_HML3_repbase_HERVK9I_MER9,0.5,2,6708,6679,cPa205_HML3_repbase_HERVK9I_MER9,1_1,102,29
Scaffold343-6883_6985,cPa205,1,1,6933,6933,cPa205,1,102,0
Scaffold344-26690_26792,cPa75,1,1,26740,26740,cPa75,1,102,0
Scaffold345-1038_1140,cPa174,0.4,6,1131,1088,cPa174_cPa174-cPa47-hybrid_cPa254_cPa425_cPa425-cPa47-hybrid_cPa47,4_1_1_2_1_1,102,43
Scaffold345-18795_18897,cPa434,1,1,18845,18845,cPa434,1,102,0
Scaffold345-1990_2092,cPa47,0.333333333333333,6,2048,2008,cPa174_cPa254_cPa425_cPa425-cPa254-hybrid_cPa425-unknown_cPa47,3_4_1_1_1_5,102,40
Scaffold345-22530_22632,BFV_NC001831_cPa117,0.5,2,22618,22580,BFV_NC001831_cPa117,3_3,102,38
Scaffold345-23613_23816,cPa145,0.5,3,23764,23662,cPa145_cPa145-cPa15-hybrid_cPa145-cPa413-hybrid,2_1_1,203,102
Scaffold345-23960_24068,cPa145,0.705882352941177,4,24019,23995,cPa145_cPa145-cPa15-hybrid_cPa145-cPa248-hybrid_cPa145-unknown,12_3_1_1,108,24
Scaffold345-24123_24262,cPa145,0.777777777777778,3,24242,24161,cPa145_cPa145-cPa15-hybrid_cPa543-cPa248-hybrid,7_1_1,139,81
Scaffold345-7793_7898,cPa145-cPa381-hybrid_cPa16-cPa381-hybrid,0.5,2,7846,7843,cPa145-cPa381-hybrid_cPa16-cPa381-hybrid,1_1,105,3
Scaffold346-29687_29789,cPa419,1,1,29737,29690,cPa419,2,102,47
Scaffold346-30043_30167,cPa419,1,1,30115,30076,cPa419,5,124,39
Scaffold346-30499_30812,cPa419,1,1,30799,30498,cPa419,35,313,301
Scaffold350-10304_10406,cPa356,0.666666666666667,2,10354,10333,cPa356_cPa428,2_1,102,21
Scaffold350-10645_10753,cPa428,0.5625,3,10737,10644,cPa356_cPa356-unknown_cPa428,6_1_9,108,93
Scaffold350-1535_1637,cPa428,1,1,1593,1585,cPa428,2,102,8
Scaffold350-16602_16820,cPa456,0.393939393939394,10,16779,16604,cPa363_cPa363-cPa452-hybrid_cPa363-cPa456-hybrid_cPa363-HTLV1_NC001436-hybrid_cPa452_cPa456_cPa456-cPa452-hybrid_HTLV1_NC001436_HTLV1_NC001436-cPa363-hybrid_HTLV1_NC001436-cPa456-hybrid,21_7_2_1_2_52_1_43_1_2,218,175
Scaffold350-16886_17116,cPa456,0.326530612244898,11,17073,16927,cPa117-cPa452-hybrid_cPa363_cPa363-cPa452-hybrid_cPa363-cPa456-hybrid_cPa363-HTLV1_NC001436-hybrid_cPa452_cPa456_cPa456-HTLV1_NC001436-hybrid_HTLV1_NC001436_HTLV1_NC001436-cPa452-hybrid_HTLV1_NC001436-cPa456-hybrid,2_6_4_1_2_1_16_1_14_1_1,230,146
Scaffold350-17159_17341,cPa456,0.294117647058824,7,17315,17205,cPa308-cPa452-hybrid_cPa363_cPa363-cPa456-hybrid_cPa456_cPa587_HTLV1_NC001436_HTLV1_NC001436-cPa456-hybrid,2_2_1_5_3_3_1,182,110
Scaffold350-17437_17539,cPa587,0.419354838709677,5,17488,17440,cPa363_cPa363-cPa452-hybrid_cPa363-cPa587-hybrid_cPa456_cPa587,6_2_1_9_13,102,48
Scaffold350-17605_17716,cPa456,0.448275862068966,8,17702,17633,cPa363_cPa363-unknown_cPa456_cPa456-HTLV1_NC001436-hybrid_cPa456-unknown_cPa587_cPa587-HTLV1_NC001436-hybrid_cPa75,6_1_13_2_1_4_1_1,111,69
Scaffold350-23953_24055,cPa15_cPa174,0.272727272727273,7,24054,23952,cPa15_cPa174_cPa285-cPa199-hybrid_cPa285-cPa47-hybrid_cPa404_cPa555-cPa254-hybrid_PERV_AJ293656-cPa47-hybrid,3_3_1_1_1_1_1,102,102
Scaffold350-24106_24297,cPa174_cPa555-cPa174-hybrid,0.09375,24,24297,24119,cPa15_cPa174_cPa268_cPa285-cPa118-hybrid_cPa285-cPa140-hybrid_cPa285-cPa199-hybrid_cPa285-cPa268-hybrid_cPa285-cPa404-hybrid_cPa404_cPa404-cPa174-hybrid_cPa47_cPa555-cPa125-hybrid_cPa555-cPa140-hybrid_cPa555-cPa15-hybrid_cPa555-cPa174-hybrid_cPa555-cPa268-hybrid_cPa555-cPa404-hybrid_cPa555-cPa47-hybrid_HERV-ADP_repbase_HERVP71A_I_LTR71A-cPa404-hybrid_PERV_AJ293656-cPa125-hybrid_PERV_AJ293656-cPa140-hybrid_PERV_AJ293656-cPa174-hybrid_PERV_AJ293656-cPa268-hybrid_PERV_AJ293656-cPa425-hybrid,1_3_2_1_1_1_1_1_2_1_1_1_1_1_3_1_1_1_1_1_2_1_2_1,191,178
Scaffold350-25902_26098,cPa419_HERV-ADP_repbase_HERVP71A_I_LTR71A-cPa428-hybrid,0.5,2,26046,25952,cPa419_HERV-ADP_repbase_HERVP71A_I_LTR71A-cPa428-hybrid,1_1,196,94
Scaffold350-26188_26323,HERV-ADP_repbase_HERVP71A_I_LTR71A-cPa428-hybrid,0.4,5,26271,26238,cPa419_HERV-ADP_repbase_HERVP71A_I_LTR71A-cPa356-hybrid_HERV-ADP_repbase_HERVP71A_I_LTR71A-cPa428-hybrid_HERV-ADP_repbase_HERVP71A_I_LTR71A-cPa553-hybrid_HERV-E_repbase_HERVE_LTR2-cPa553-hybrid,1_1_4_3_1,135,33
Scaffold350-26539_26641,cPa553_HERV-ADP_repbase_HERVP71A_I_LTR71A-cPa356-hybrid,0.5,2,26626,26589,cPa553_HERV-ADP_repbase_HERVP71A_I_LTR71A-cPa356-hybrid,1_1,102,37
Scaffold350-403_505,cPa428,0.535714285714286,2,475,418,cPa356_cPa428,13_15,102,57
Scaffold350-4614_4716,cPa356,0.666666666666667,2,4700,4618,cPa356_cPa428,2_1,102,82
Scaffold350-609_711,cPa428,0.575,2,698,644,cPa356_cPa428,34_46,102,54
Scaffold350-9645_9747,cPa428,1,1,9695,9695,cPa428,1,102,0
Scaffold350-9798_9900,cPa428,1,1,9848,9848,cPa428,1,102,0
Scaffold351-12582_12796,cPa419,1,1,12744,12589,cPa419,22,214,155
Scaffold351-25653_25755,cPa419,1,1,25750,25703,cPa419,3,102,47
Scaffold351-9768_9900,cPa419,1,1,9848,9818,cPa419,3,132,30
Scaffold351-9982_10084,cPa419,1,1,10032,10032,cPa419,1,102,0
Scaffold352-24008_24185,cPa419,1,1,24133,24030,cPa419,26,177,103
Scaffold352-25635_25737,cPa419,1,1,25704,25635,cPa419,20,102,69
Scaffold352-4189_4291,cPa419,1,1,4265,4210,cPa419,4,102,55
Scaffold352-4438_4606,cPa419,1,1,4554,4488,cPa419,4,168,66
Scaffold353-21718_21820,cPa428,1,1,21768,21768,cPa428,1,102,0
Scaffold353-22005_22199,cPa428,0.8,2,22180,22055,cPa356_cPa428,3_12,194,125
Scaffold353-22349_22451,cPa428,1,1,22399,22399,cPa428,1,102,0
Scaffold353-23061_23163,cPa356,1,1,23111,23111,cPa356,1,102,0
Scaffold353-23354_23456,cPa428,1,1,23404,23404,cPa428,1,102,0
Scaffold353-23493_23625,cPa356,0.666666666666667,2,23573,23510,cPa356_cPa428,8_4,132,63
Scaffold353-23953_24090,cPa356,0.5625,2,24088,23996,cPa356_cPa428,9_7,137,92
Scaffold353-29810_29912,cPa356,1,1,29860,29860,cPa356,1,102,0
Scaffold353-30895_30997,cPa428,0.833333333333333,2,30958,30942,cPa356-unknown_cPa428,1_5,102,16
Scaffold356-12330_12432,cPa356_cPa428,0.5,2,12390,12380,cPa356_cPa428,1_1,102,10
Scaffold356-14873_14975,cPa356,1,1,14923,14923,cPa356,1,102,0
Scaffold357-16451_16669,cPa223-cPa247-hybrid,0.705882352941177,6,16635,16501,cPa223_cPa223-cPa247-hybrid_cPa363-cPa228-hybrid_cPa363-cPa247-hybrid_cPa452-cPa247-hybrid_cPa452-cPa545-hybrid,1_12_1_1_1_1,218,134
Scaffold357-17216_17347,cPa452-cPa247-hybrid,0.6,2,17295,17266,cPa223-cPa247-hybrid_cPa452-cPa247-hybrid,2_3,131,29
Scaffold357-17843_18076,cPa228,0.333333333333333,6,18032,17863,cPa223-cPa247-hybrid_cPa228_cPa228-cPa247-hybrid_cPa228-cPa75-hybrid_cPa546-cPa247-hybrid_cPa546-cPa463-hybrid,1_4_3_1_2_1,233,169
Scaffold357-19199_19321,cPa546_cPa546-cPa247-hybrid,0.1875,10,19272,19198,cPa228-cPa51-hybrid_cPa228-cPa75-hybrid_cPa419_cPa51_cPa51-cPa546-hybrid_cPa546_cPa546-cPa228-hybrid_cPa546-cPa247-hybrid_cPa546-cPa545-hybrid_cPa75,2_2_1_1_1_3_1_3_1_1,122,74
Scaffold357-861_1068,SIV_NC001870-unknown,0.428571428571429,6,1016,911,cPa425_cPa71-unknown_SIV_NC001870-cPa4-hybrid_SIV_NC001870-cPa425-hybrid_SIV_NC001870-EqFV_NC002201-hybrid_SIV_NC001870-unknown,1_1_3_2_1_6,207,105
Scaffold358-17776_17880,cPa419_cPa75-HERV-ADP_repbase_HERVP71A_I_LTR71A-hybrid_PERVB_AY099324-HERV30_repbase_HERV30I_LTR30-hybrid,0.333333333333333,3,17828,17814,cPa419_cPa75-HERV-ADP_repbase_HERVP71A_I_LTR71A-hybrid_PERVB_AY099324-HERV30_repbase_HERV30I_LTR30-hybrid,1_1_1,104,14
Scaffold358-19793_19895,cPa223,0.18,43,19895,19793,cPa199_cPa199-cPa223-hybrid_cPa199-cPa323-hybrid_cPa199-cPa371-hybrid_cPa199-unknown_cPa223_cPa227-cPa150-hybrid_cPa227-cPa223-hybrid_cPa227-cPa290-hybrid_cPa227-cPa353-hybrid_cPa227-cPa371-hybrid_cPa227-cPa381-hybrid_cPa227-cPa479-hybrid_cPa227-cPa61-hybrid_cPa227-unknown_cPa273-cPa223-hybrid_cPa273-cPa323-hybrid_cPa273-cPa333-hybrid_cPa273-cPa353-hybrid_cPa273-cPa371-hybrid_cPa273-cPa479-hybrid_cPa273-cPa486-hybrid_cPa323_cPa333_cPa333-cPa290-hybrid_cPa333-cPa323-hybrid_cPa333-cPa371-hybrid_cPa345-cPa223-hybrid_cPa345-cPa333-hybrid_cPa345-cPa428-hybrid_cPa345-cPa479-hybrid_cPa345-cPa486-hybrid_cPa345-unknown_cPa419_cPa450-cPa223-hybrid_cPa450-cPa381-hybrid_cPa553-cPa223-hybrid_cPa553-cPa290-hybrid_cPa553-cPa371-hybrid_cPa553-cPa479-hybrid_cPa553-cPa61-hybrid_cPa553-unknown_cPa568-cPa371-hybrid,2_9_1_4_1_18_1_2_1_1_1_1_2_1_2_1_1_1_2_1_1_1_1_13_1_4_3_3_1_1_1_1_1_3_1_1_3_1_2_1_1_1_1,102,102
Scaffold358-19901_20006,HERV-R_repbase_HERV3_LTR4-cPa371-hybrid,0.175824175824176,31,20002,19900,cPa199_cPa199-cPa223-hybrid_cPa199-cPa358-hybrid_cPa199-cPa363-hybrid_cPa199-cPa381-hybrid_cPa223_cPa227-cPa223-hybrid_cPa273-cPa479-hybrid_cPa333-cPa223-hybrid_cPa333-cPa358-hybrid_cPa333-cPa479-hybrid_cPa345-cPa223-hybrid_cPa345-cPa308-hybrid_cPa345-cPa353-hybrid_cPa345-cPa486-hybrid_cPa419_cPa450-cPa353-hybrid_cPa450-cPa363-hybrid_cPa50-cPa223-hybrid_cPa553-cPa223-hybrid_cPa553-cPa353-hybrid_cPa553-cPa358-hybrid_cPa553-cPa486-hybrid_HERV-R_repbase_HERV3_LTR4_HERV-R_repbase_HERV3_LTR4-cPa290-hybrid_HERV-R_repbase_HERV3_LTR4-cPa323-hybrid_HERV-R_repbase_HERV3_LTR4-cPa333-hybrid_HERV-R_repbase_HERV3_LTR4-cPa371-hybrid_HERV-R_repbase_HERV3_LTR4-cPa50-hybrid_PERVA_AY099323-cPa223-hybrid_PERVB_AY099324-cPa223-hybrid,6_2_2_1_1_11_1_1_7_1_1_1_1_1_1_3_1_1_1_8_1_2_1_1_1_6_1_16_1_1_8,105,102
Scaffold358-20014_20116,cPa333,0.294117647058824,11,20116,20013,cPa323_cPa333_cPa345-cPa323-hybrid_cPa371_cPa419_cPa50_HERV-R_repbase_HERV3_LTR4-cPa323-hybrid_HERV-R_repbase_HERV3_LTR4-cPa353-hybrid_HERV-R_repbase_HERV3_LTR4-cPa371-hybrid_MLV_Pmv4-cPa371-hybrid_PERVB_AY099324-cPa323-hybrid,1_5_1_1_2_1_1_1_1_2_1,102,103
Scaffold358-21080_21182,cPa419,0.3,7,21181,21130,cPa260-cPa61-hybrid_cPa273-cPa290-hybrid_cPa290_cPa419_HERV-R_repbase_HERV3_LTR4-cPa290-hybrid_MLV_Pmv4-cPa223-hybrid_MLV_Pmv4-unknown,1_1_2_3_1_1_1,102,51
Scaffold358-2124_2371,rRVRV_JQ303225,0.622222222222222,6,2364,2142,cPa419_rRVRV_JQ303225_rRVRV_JQ303225-BFV_NC001831-hybrid_rRVRV_JQ303225-cPa419-hybrid_rRVRV_JQ303225-HML8_repbase_HERVK11I_MER11A-hybrid_rRVRV_JQ303225-unknown,6_112_1_1_1_59,247,222
Scaffold358-21273_21375,cPa450-cPa357-hybrid,0.25,7,21372,21299,cPa199-cPa357-hybrid_cPa227-cPa357-hybrid_cPa290-cPa371-hybrid_cPa345-cPa357-hybrid_cPa419_cPa450-cPa357-hybrid_cPa75-cPa357-hybrid,1_1_1_1_1_2_1,102,73
Scaffold358-22692_23001,cPa199,0.26865671641791,21,22997,22705,cPa199_cPa199-cPa223-hybrid_cPa223_cPa224-cPa223-hybrid_cPa227_cPa227-cPa199-hybrid_cPa227-cPa223-hybrid_cPa227-cPa290-hybrid_cPa227-cPa345-hybrid_cPa34-cPa223-hybrid_cPa345_cPa345-cPa223-hybrid_cPa419_cPa419-cPa199-hybrid_cPa419-cPa428-hybrid_cPa450_cPa450-cPa199-hybrid_cPa450-cPa223-hybrid_cPa450-cPa290-hybrid_cPa450-unknown_cPa553,36_3_2_1_2_1_2_1_1_1_16_2_4_1_1_24_4_17_2_3_10,309,292
Scaffold358-23040_23142,cPa199-cPa223-hybrid,1,1,23090,23080,cPa199-cPa223-hybrid,2,102,10
Scaffold358-4795_4924,cPa425_cPa425-cPa51-hybrid,0.5,2,4872,4845,cPa425_cPa425-cPa51-hybrid,1_1,129,27
Scaffold358-6367_6661,cPa566-unknown,0.360869565217391,17,6652,6369,cPa410-cPa219-hybrid_cPa410-cPa258-hybrid_cPa410-cPa51-hybrid_cPa410-PyERV_AF500296-hybrid_cPa419_cPa443-MMTV_NC001503-hybrid_cPa566-cPa219-hybrid_cPa566-cPa258-hybrid_cPa566-cPa419-hybrid_cPa566-cPa425-hybrid_cPa566-cPa51-hybrid_cPa566-KoRV_AF151794-hybrid_cPa566-PyERV_AF500296-hybrid_cPa566-SFV_U04327-hybrid_cPa566-unknown_cPa61-cPa51-hybrid_cPa61-PyERV_AF500296-hybrid,3_2_37_2_3_1_6_2_1_1_73_1_6_1_83_5_3,294,283
Scaffold359-10334_10438,cPa419,1,1,10386,10335,cPa419,12,104,51
Scaffold359-10505_10607,cPa419,1,1,10593,10555,cPa419,3,102,38
Scaffold359-10875_10977,cPa419,1,1,10925,10877,cPa419,3,102,48
Scaffold359-11056_11158,cPa419,1,1,11134,11079,cPa419,7,102,55
Scaffold359-12003_12235,cPa419,1,1,12233,12043,cPa419,38,232,190
Scaffold359-12435_12537,cPa419,1,1,12520,12446,cPa419,8,102,74
Scaffold359-12711_12980,cPa419,1,1,12965,12727,cPa419,43,269,238
Scaffold359-13360_13462,cPa419,1,1,13415,13407,cPa419,3,102,8
Scaffold359-25308_25410,cPa419,1,1,25358,25351,cPa419,7,102,7
Scaffold359-25578_25680,cPa419,1,1,25628,25615,cPa419,2,102,13
Scaffold359-27557_27659,cPa419,1,1,27610,27607,cPa419,2,102,3
Scaffold359-5118_5241,cPa419,1,1,5241,5142,cPa419,22,123,99
Scaffold360-19848_19950,cPa75,1,1,19898,19898,cPa75,1,102,0
Scaffold360-20524_20626,cPa75,1,1,20574,20574,cPa75,1,102,0
Scaffold360-6076_6178,cPa285,1,1,6126,6126,cPa285,1,102,0
Scaffold361-16499_16623,cPa419_cPa419-unknown,0.5,2,16571,16549,cPa419_cPa419-unknown,1_1,124,22
Scaffold362-10146_10248,cPa419,1,1,10196,10192,cPa419,2,102,4
Scaffold362-1081_1216,cPa419,1,1,1164,1086,cPa419,28,135,78
Scaffold362-14266_14445,cPa419,1,1,14393,14316,cPa419,4,179,77
Scaffold362-14501_14608,cPa419,1,1,14556,14551,cPa419,2,107,5
Scaffold362-16367_16473,cPa419,1,1,16421,16417,cPa419,1,106,4
Scaffold362-16630_16732,cPa419,1,1,16680,16646,cPa419,2,102,34
Scaffold362-1861_1964,cPa419,1,1,1918,1911,cPa419,5,103,7
Scaffold362-21163_21302,cPa419,1,1,21252,21190,cPa419,6,139,62
Scaffold362-21397_21517,cPa419,1,1,21496,21404,cPa419,5,120,92
Scaffold362-24412_24514,cPa419,1,1,24462,24449,cPa419,4,102,13
Scaffold362-26725_26827,cPa419,1,1,26775,26775,cPa419,1,102,0
Scaffold362-28208_28315,cPa419,1,1,28263,28258,cPa419,4,107,5
Scaffold362-28330_28432,cPa419,1,1,28380,28375,cPa419,2,102,5
Scaffold362-28835_28937,cPa419,1,1,28905,28842,cPa419,10,102,63
Scaffold362-29164_29594,cPa419,0.974358974358974,2,29590,29205,cPa379_cPa419,2_76,430,385
Scaffold362-29610_29739,cPa419,1,1,29735,29614,cPa419,73,129,121
Scaffold362-3032_3194,cPa419,1,1,3142,3082,cPa419,5,162,60
Scaffold362-30400_30502,cPa419,1,1,30475,30402,cPa419,55,102,73
Scaffold362-30773_30875,cPa419,1,1,30841,30786,cPa419,34,102,55
Scaffold362-31190_31292,cPa419,1,1,31249,31232,cPa419,5,102,17
Scaffold362-3446_3548,cPa419,1,1,3542,3496,cPa419,6,102,46
Scaffold362-3693_3795,cPa419,1,1,3793,3743,cPa419,7,102,50
Scaffold362-3936_4125,cPa419,1,1,4073,3953,cPa419,8,189,120
Scaffold363-10614_10716,cPa428,1,1,10664,10664,cPa428,1,102,0
Scaffold363-10865_10967,cPa356_cPa428,0.5,2,10939,10915,cPa356_cPa428,1_1,102,24
Scaffold363-13465_13567,cPa356,0.75,2,13560,13515,cPa356_cPa428,3_1,102,45
Scaffold363-27372_27474,cPa428,0.6,3,27461,27385,cPa356_cPa356-cPa428-hybrid_cPa428,1_1_3,102,76
Scaffold363-27757_27859,cPa428,0.666666666666667,2,27840,27807,cPa356_cPa428,2_4,102,33
Scaffold363-4488_4590,cPa356_cPa428,0.5,2,4538,4529,cPa356_cPa428,2_2,102,9
Scaffold364-29310_29477,cPa356,0.666666666666667,2,29425,29360,cPa356_cPa428,2_1,167,65
Scaffold365-2036_2138,cPa356_cPa428,0.5,2,2109,2086,cPa356_cPa428,1_1,102,23
Scaffold365-2788_2890,cPa356_cPa428,0.5,2,2838,2835,cPa356_cPa428,1_1,102,3
Scaffold366-14587_14689,cPa419,1,1,14637,14637,cPa419,1,102,0
Scaffold366-16404_16506,cPa419,1,1,16464,16414,cPa419,48,102,50
Scaffold366-16546_16648,cPa419,1,1,16596,16596,cPa419,1,102,0
Scaffold366-16782_16908,cPa419,1,1,16870,16797,cPa419,20,126,73
Scaffold366-22910_23012,cPa419,1,1,23011,22914,cPa419,4,102,97
Scaffold366-23443_23545,cPa419,1,1,23493,23493,cPa419,1,102,0
Scaffold366-24407_24658,cPa419,1,1,24642,24457,cPa419,15,251,185
Scaffold366-26245_26347,cPa419,1,1,26330,26265,cPa419,3,102,65
Scaffold366-4858_4960,cPa419,1,1,4908,4908,cPa419,1,102,0
Scaffold367-1813_1943,cPa419,0.96,2,1903,1856,cPa419_HML4_repbase_HERVK13I_LTR13-unknown,24_1,130,47
Scaffold367-1996_2098,cPa419,1,1,2075,2046,cPa419,6,102,29
Scaffold367-26699_26801,cPa419,1,1,26751,26706,cPa419,7,102,45
Scaffold369-11545_11661,MoMLV_J02255,0.914893617021277,5,11609,11545,cPa142-MoMLV_J02255-hybrid_cPa419_MoMLV_J02255_MoMLV_J02255-cPa241-hybrid_MoMLV_J02255-unknown,1_1_43_1_1,116,64
Scaffold369-27202_27304,cPa62,1,1,27252,27214,cPa62,2,102,38
Scaffold369-2745_2885,cPa526,0.243243243243243,37,2854,2748,cPa145-cPa260-hybrid_cPa176-SIV_NC001870-hybrid_cPa270-cPa543-hybrid_cPa387-unknown_cPa425-BIV_NC001413-hybrid_cPa425-cPa260-hybrid_cPa425-cPa469-hybrid_cPa425-cPa543-hybrid_cPa425-cPa549-hybrid_cPa425-MDEV_AF053745-hybrid_cPa447_cPa447-cPa260-hybrid_cPa447-cPa419-hybrid_cPa447-cPa543-hybrid_cPa447-MDEV_AF053745-hybrid_cPa447-PyERV_AF500296-hybrid_cPa447-SIV_NC001870-hybrid_cPa447-unknown_cPa469_cPa478-cPa549-hybrid_cPa511-cPa419-hybrid_cPa518-MDEV_AF053745-hybrid_cPa526_cPa526-BIV_NC001413-hybrid_cPa526-cPa216-hybrid_cPa526-cPa469-hybrid_cPa526-cPa549-hybrid_cPa526-MDEV_AF053745-hybrid_cPa526-SIV_NC001870-hybrid_cPa549_cPa551-PyERV_AF500296-hybrid_ENTV_NC004994-BIV_NC001413-hybrid_ENTV_NC004994-SIV_NC001870-hybrid_PyERV_AF500296_PyERV_AF500296-BIV_NC001413-hybrid_PyERV_AF500296-cPa526-hybrid_PyERV_AF500296-MDEV_AF053745-hybrid,2_1_1_1_5_4_1_3_2_4_7_1_2_1_2_1_1_1_1_1_1_1_27_2_1_1_1_7_3_3_1_2_1_13_3_1_1,140,106
Scaffold369-29794_29970,cPa542,0.260869565217391,10,29918,29806,cPa111-cPa390-hybrid_cPa199-cPa390-hybrid_cPa223-cPa390-hybrid_cPa273_cPa450_cPa450-cPa199-hybrid_cPa450-cPa390-hybrid_cPa542_cPa542-cPa62-hybrid_cPa553,1_1_1_4_4_1_1_6_1_3,176,112
Scaffold369-3342_3528,cPa526,0.172413793103448,16,3523,3347,cPa419_cPa425-BIV_NC001413-hybrid_cPa425-CAEV_NC001463-hybrid_cPa425-cPa260-hybrid_cPa425-cPa419-hybrid_cPa425-cPa469-hybrid_cPa425-unknown_cPa478_cPa478-BIV_NC001413-hybrid_cPa478-cPa260-hybrid_cPa511-cPa260-hybrid_cPa526_cPa531-MDEV_AF053745-hybrid_ENTV_NC004994-BIV_NC001413-hybrid_ENTV_NC004994-cPa543-hybrid_PyERV_AF500296,1_4_1_3_1_1_1_1_2_1_2_5_1_1_1_3,186,176
Scaffold369-3559_3665,cPa425,0.625,4,3613,3596,cPa425_cPa425-cPa413-hybrid_cPa511-unknown_cPa526,5_1_1_1,106,17
Scaffold369-4346_4458,cPa425-cPa413-hybrid,0.6,3,4432,4396,cPa425-cPa413-hybrid_cPa511-cPa413-hybrid_ENTV_NC004994-cPa413-hybrid,3_1_1,112,36
Scaffold369-7503_7606,cPa463,1,1,7554,7553,cPa463,3,103,1
Scaffold369-7666_7842,cPa463,0.222222222222222,8,7835,7700,cPa131-cPa75-hybrid_cPa450-S71_repbase_HERVS71_LTR6A-hybrid_cPa463_cPa531-cPa61-hybrid_cPa531-S71_repbase_HERVS71_LTR6A-hybrid_cPa542-cPa463-hybrid_cPa542-cPa75-hybrid_HML5_repbase_HERVK22I_LTR22-S71_repbase_HERVS71_LTR6A-hybrid,1_1_2_1_1_1_1_1,176,135
Scaffold369-8567_8669,HML5_repbase_HERVK22I_LTR22-unknown,1,1,8617,8617,HML5_repbase_HERVK22I_LTR22-unknown,1,102,0
Scaffold369-8711_8913,HML5_repbase_HERVK22I_LTR22-cPa117-hybrid,0.4,4,8864,8761,cPa142-cPa395-hybrid_cPa142-cPa61-hybrid_cPa142-S71_repbase_HERVS71_LTR6A-hybrid_HML5_repbase_HERVK22I_LTR22-cPa117-hybrid,1_1_1_2,202,103
Scaffold370-4127_4229,cPa285-unknown,0.571428571428571,4,4177,4153,cPa285-cPa183-hybrid_cPa285-unknown_cPa293-cPa183-hybrid_cPa293-unknown,1_4_1_1,102,24
Scaffold373-10664_10866,cPa15,0.611940298507463,9,10853,10668,cPa118_cPa15_cPa248_cPa248-cPa118-hybrid_cPa248-cPa15-hybrid_cPa248-cPa62-hybrid_cPa254-cPa118-hybrid_cPa419_cPa456-cPa118-hybrid,10_41_7_1_2_1_1_3_1,202,185
Scaffold373-10883_10985,cPa15,0.466666666666667,6,10977,10902,cPa15_cPa248_cPa419_cPa419-cPa118-hybrid_cPa443_cPa456-cPa118-hybrid,7_1_4_1_1_1,102,75
Scaffold373-13430_13532,cPa419,0.545454545454545,7,13532,13460,cPa254_cPa285_cPa356_cPa419_cPa456-cPa419-hybrid_cPa62_cPa75,1_1_2_12_1_3_2,102,72
Scaffold373-13622_13724,cPa419,1,1,13719,13644,cPa419,5,102,75
Scaffold373-17918_18020,cPa419,0.666666666666667,3,17995,17931,cPa390-cPa424-hybrid_cPa419_cPa553,1_4_1,102,64
Scaffold373-18076_18178,cPa419,0.5,4,18172,18092,cPa339_cPa381-cPa444-hybrid_cPa419_cPa447-cPa424-hybrid,1_1_3_1,102,80
Scaffold373-18978_19082,cPa419,0.214285714285714,9,19030,18988,cPa308_cPa381_cPa381-cPa268-hybrid_cPa381-cPa345-hybrid_cPa419_cPa486_cPa486-cPa345-hybrid_cPa486-cPa465-hybrid_cPa486-unknown,2_2_1_1_3_2_1_1_1,104,42
Scaffold373-19083_19185,cPa419,0.3,7,19170,19087,cPa268_cPa308_cPa308-cPa419-hybrid_cPa308-unknown_cPa419_cPa486-cPa268-hybrid_cPa486-cPa308-hybrid,1_2_1_1_3_1_1,102,83
Scaffold373-19206_19353,cPa308,0.45,10,19352,19210,cPa308_cPa313-cPa381-hybrid_cPa313-cPa404-hybrid_cPa339_cPa353_cPa353-cPa425-hybrid_cPa381_cPa419_cPa486_ENTV_NC004994-cPa353-hybrid,9_1_1_1_3_1_1_1_1_1,147,142
Scaffold373-19372_19568,cPa419,0.346153846153846,14,19557,19393,cPa254-cPa308-hybrid_cPa268_cPa268-cPa353-hybrid_cPa268-cPa486-hybrid_cPa285_cPa308_cPa308-unknown_cPa313-cPa419-hybrid_cPa356_cPa419_cPa428_cPa486_cPa486-cPa353-hybrid_cPa486-cPa381-hybrid,1_1_1_1_1_3_1_1_1_9_1_3_1_1,196,164
Scaffold373-21462_21564,cPa419,0.533333333333333,6,21551,21472,cPa254-cPa285-hybrid_cPa254-cPa363-hybrid_cPa363_cPa419_cPa75_ENTV_NC004994-cPa363-hybrid,1_1_3_8_1_1,102,79
Scaffold373-25282_25384,cPa419,0.235294117647059,10,25375,25281,cPa199_cPa199-cPa174-hybrid_cPa227_cPa273_cPa273-cPa394-hybrid_cPa345_cPa419_cPa428_cPa450_cPa553,2_1_3_1_1_2_4_1_1_1,102,94
Scaffold373-25397_25647,cPa199,0.337078651685393,20,25637,25401,cPa199_cPa199-unknown_cPa223_cPa223-cPa199-hybrid_cPa223-cPa450-hybrid_cPa223-cPa515-hybrid_cPa227_cPa227-HERV-F_repbase_HERVFH19I_LTR19A-hybrid_cPa273_cPa273-cPa450-hybrid_cPa345_cPa345-HERV-F_repbase_HERVFH19I_LTR19A-hybrid_cPa356_cPa419_cPa419-cPa199-hybrid_cPa419-cPa394-hybrid_cPa428_cPa450_cPa542-cPa227-hybrid_cPa62,30_1_4_1_1_1_15_1_8_1_1_1_1_15_1_1_2_2_1_1,250,236
Scaffold373-27330_27739,cPa199,0.205357142857143,46,27731,27331,cPa199_cPa223_cPa223-cPa434-hybrid_cPa227-HERV-XA34_repbase_HERVFH21I_LTR21A-hybrid_cPa254_cPa273_cPa273-cPa199-hybrid_cPa273-cPa387-hybrid_cPa273-cPa434-hybrid_cPa273-cPa450-hybrid_cPa273-cPa452-hybrid_cPa273-cPa542-hybrid_cPa273-cPa553-hybrid_cPa273-HTLV2_M10060-hybrid_cPa273-unknown_cPa285_cPa285-cPa199-hybrid_cPa345_cPa402-cPa542-hybrid_cPa419_cPa419-cPa434-hybrid_cPa434_cPa434-cPa553-hybrid_cPa446-cPa434-hybrid_cPa446-cPa542-hybrid_cPa450_cPa450-cPa227-hybrid_cPa450-cPa452-hybrid_cPa450-unknown_cPa50-cPa553-hybrid_cPa515_cPa518-cPa199-hybrid_cPa542_cPa542-cPa199-hybrid_cPa542-cPa285-hybrid_cPa542-unknown_cPa553_cPa553-cPa199-hybrid_cPa553-cPa227-hybrid_cPa553-cPa363-hybrid_cPa553-cPa434-hybrid_cPa553-unknown_cPa62_cPa75_PtERV1_AC142352-cPa428-hybrid_SIV_NC001870,46_1_1_1_1_16_2_2_1_1_1_2_1_2_2_5_1_2_2_15_1_15_1_1_1_8_1_1_2_1_5_1_42_2_1_1_25_1_1_1_1_1_2_1_1_1,409,400
Scaffold373-28038_28140,cPa273,0.2,9,28135,28046,cPa199-unknown_cPa273_cPa273-cPa199-hybrid_cPa402-cPa62-hybrid_cPa419_cPa446-cPa387-hybrid_cPa450_cPa518-cPa542-hybrid_PtERV1_AC142352-cPa450-hybrid,1_2_1_1_1_1_1_1_1,102,89
Scaffold373-28749_28931,cPa419,0.470588235294118,9,28930,28763,cPa273-cPa387-hybrid_cPa356_cPa402_cPa402-cPa553-hybrid_cPa419_cPa450-cPa75-hybrid_cPa518-cPa387-hybrid_cPa518-cPa542-hybrid_HERV-F_repbase_HERVFH19I_LTR19A-cPa482-hybrid,1_1_2_1_8_1_1_1_1,182,167
Scaffold373-29673_29775,cPa419,1,1,29723,29722,cPa419,2,102,1
Scaffold376-910_1012,cPa118,1,1,960,960,cPa118,1,102,0
Scaffold377-15352_15454,cPa581,0.5,3,15452,15402,cPa194_cPa581_cPa581-unknown,1_2_1,102,50
Scaffold377-22888_23010,cPa285-cPa254-hybrid,0.666666666666667,2,22958,22938,cPa285_cPa285-cPa254-hybrid,1_2,122,20
Scaffold377-25207_25309,cPa285,1,1,25257,25257,cPa285,1,102,0
Scaffold378-22026_22128,cPa224_HML1a_repbase_HERV-K14CI_LTR14C,0.5,2,22085,22076,cPa224_HML1a_repbase_HERV-K14CI_LTR14C,1_1,102,9
Scaffold378-4110_4212,HERV-I_repbase_HERVI_LTR10B,0.666666666666667,2,4160,4141,cPa285_HERV-I_repbase_HERVI_LTR10B,1_2,102,19
Scaffold379-12119_12221,cPa428,0.6,2,12220,12126,cPa356_cPa428,4_6,102,94
Scaffold379-12784_12886,cPa428,0.75,2,12859,12834,cPa356_cPa428,2_6,102,25
Scaffold379-13281_13383,cPa428,1,1,13331,13331,cPa428,1,102,0
Scaffold379-25494_25596,cPa428,1,1,25544,25544,cPa428,1,102,0
Scaffold39-14158_14260,cPa339,1,1,14224,14208,cPa339,2,102,16
Scaffold39-14298_14400,cPa339,1,1,14381,14348,cPa339,2,102,33
Scaffold39-14415_14538,cPa339,1,1,14486,14418,cPa339,8,123,68
Scaffold39-14974_15077,cPa339,1,1,15035,15024,cPa339,3,103,11
Scaffold390-12982_13268,HIV1_NC001802-unknown,0.469387755102041,6,13216,13032,cPa358-FrMuLV_NC001362-hybrid_cPa358-unknown_cPa419_cPa545-unknown_HIV1_NC001802-FrMuLV_NC001362-hybrid_HIV1_NC001802-unknown,2_6_5_12_1_23,286,184
Scaffold390-14217_14319,cPa419,0.5,4,14267,14242,cPa223_cPa223-unknown_cPa371-unknown_cPa419,1_1_1_3,102,25
Scaffold390-1502_1604,cPa15,1,1,1552,1552,cPa15,1,102,0
Scaffold391-12813_12915,cPa356,0.5,3,12876,12830,cPa356_cPa356-unknown_cPa428,45_1_44,102,46
Scaffold391-12996_13236,cPa428,0.619047619047619,2,13229,13025,cPa356_cPa428,8_13,240,204
Scaffold391-14310_14448,cPa428,0.565789473684211,2,14446,14310,cPa356_cPa428,33_43,138,136
Scaffold391-14462_14564,cPa356,0.52,2,14558,14471,cPa356_cPa428,39_36,102,87
Scaffold393-17069_17171,cPa391,0.5,3,17119,17068,cPa246-cPa18-hybrid_cPa298-cPa18-hybrid_cPa391,1_1_2,102,51
Scaffold393-22435_22727,cPa145,0.777777777777778,3,22695,22485,cPa145_cPa260-cPa145-hybrid_HML6_repbase_HERVK3I_LTR3-cPa145-hybrid,7_1_1,292,210
Scaffold393-4418_4634,cPa47,0.379310344827586,7,4589,4426,cPa254_cPa254-cPa174-hybrid_cPa254-cPa425-hybrid_cPa254-unknown_cPa404_cPa425_cPa47,2_1_2_5_2_6_11,216,163
Scaffold393-4697_4826,cPa425,0.416666666666667,5,4793,4738,cPa254_cPa254-cPa425-hybrid_cPa254-unknown_cPa425_cPa47,2_1_1_5_3,129,55
Scaffold393-6300_6432,PRIMA41_repbase_PRIMA41_MER41A-HERV-F_repbase_HERVFH19I_LTR19A-hybrid,1,1,6380,6350,PRIMA41_repbase_PRIMA41_MER41A-HERV-F_repbase_HERVFH19I_LTR19A-hybrid,5,132,30
Scaffold393-6516_6649,PRIMA41_repbase_PRIMA41_MER41A-HERV-F_repbase_HERVFH19I_LTR19A-hybrid,0.5,4,6597,6566,PRIMA41_repbase_PRIMA41_MER41A-cPa224-hybrid_PRIMA41_repbase_PRIMA41_MER41A-cPa293-hybrid_PRIMA41_repbase_PRIMA41_MER41A-HERV-F_repbase_HERVFH19I_LTR19A-hybrid_PRIMA41_repbase_PRIMA41_MER41A-HERV-W_repbase_HERV17_LTR17-hybrid,1_7_10_2,133,31
Scaffold393-6861_6993,PRIMA41_repbase_PRIMA41_MER41A-cPa293-hybrid,1,1,6941,6911,PRIMA41_repbase_PRIMA41_MER41A-cPa293-hybrid,2,132,30
Scaffold393-7046_7148,PRIMA41_repbase_PRIMA41_MER41A-HERV-F_repbase_HERVFH19I_LTR19A-hybrid,1,1,7096,7096,PRIMA41_repbase_PRIMA41_MER41A-HERV-F_repbase_HERVFH19I_LTR19A-hybrid,1,102,0
Scaffold394-18266_18368,cPa419,1,1,18316,18316,cPa419,1,102,0
Scaffold394-24193_24350,cPa419,0.88,2,24348,24231,cPa419_cPa527-unknown,22_3,157,117
Scaffold394-24691_24875,cPa419,1,1,24823,24723,cPa419,13,184,100
Scaffold394-25259_25361,cPa419,1,1,25359,25309,cPa419,8,102,50
Scaffold394-25997_26100,cPa419,1,1,26051,26038,cPa419,7,103,13
Scaffold395-17848_17950,cPa356,0.657142857142857,3,17941,17877,cPa356_cPa428_cPa428-unknown,23_11_1,102,64
Scaffold395-18056_18158,cPa356,0.65,2,18148,18056,cPa356_cPa428,13_7,102,92
Scaffold395-19531_19636,cPa428,0.514285714285714,2,19624,19581,cPa356_cPa428,17_18,105,43
Scaffold395-19755_19904,cPa356,0.571428571428571,2,19852,19783,cPa356_cPa428,12_9,149,69
Scaffold395-20132_20234,cPa428,1,1,20182,20182,cPa428,1,102,0
Scaffold395-5234_5345,cPa356,0.692307692307692,3,5345,5280,cPa356_cPa428_cPa428-HERV-ADP_repbase_HERVP71A_I_LTR71A-hybrid,9_3_1,111,65
Scaffold396-15063_15266,cPa419,1,1,15220,15100,cPa419,50,203,120
Scaffold396-15304_15406,cPa419,1,1,15354,15351,cPa419,2,102,3
Scaffold396-16831_16998,cPa419,1,1,16994,16846,cPa419,15,167,148
Scaffold396-17032_17173,cPa419,1,1,17121,17082,cPa419,3,141,39
Scaffold396-19684_19876,cPa419,1,1,19824,19712,cPa419,16,192,112
Scaffold396-26203_26403,cPa419,1,1,26351,26206,cPa419,6,200,145
Scaffold396-26558_26660,cPa419,1,1,26608,26608,cPa419,1,102,0
Scaffold396-26765_26867,cPa419,1,1,26843,26798,cPa419,3,102,45
Scaffold396-26881_26983,cPa419,1,1,26981,26931,cPa419,5,102,50
Scaffold396-27510_27612,cPa419,1,1,27560,27560,cPa419,1,102,0
Scaffold396-27820_27922,cPa419,1,1,27870,27861,cPa419,2,102,9
Scaffold396-28923_29025,cPa419,1,1,29020,28927,cPa419,11,102,93
Scaffold396-29113_29215,cPa419,1,1,29197,29163,cPa419,3,102,34
Scaffold397-10689_10791,cPa75,1,1,10762,10739,cPa75,2,102,23
Scaffold397-11009_11111,cPa419,0.75,2,11074,11057,cPa419_cPa75-cPa391-hybrid,3_1,102,17
Scaffold397-11616_11718,cPa419_cPa75,0.5,2,11680,11666,cPa419_cPa75,1_1,102,14
Scaffold397-11820_12014,cPa456,0.357142857142857,6,12013,11870,cPa287-cPa391-hybrid_cPa293_cPa363-cPa452-hybrid_cPa456_cPa75_cPa75-cPa452-hybrid,1_2_1_5_4_1,194,143
Scaffold397-12024_12167,cPa75-cPa426-hybrid,0.25,7,12147,12074,cPa293-cPa426-hybrid_cPa391_cPa419_cPa426_cPa456-cPa426-hybrid_cPa75_cPa75-cPa426-hybrid,1_1_1_1_1_1_2,143,73
Scaffold397-12960_13067,cPa75,0.5,5,13030,12991,cPa308_cPa419_cPa75_cPa75-cPa427-hybrid_cPa75-unknown,1_2_12_1_8,107,39
Scaffold397-13714_13816,cPa75,1,1,13764,13722,cPa75,2,102,42
Scaffold397-15717_15820,cPa75,0.833333333333333,2,15788,15762,cPa75_cPa75-unknown,5_1,103,26
Scaffold397-15826_16214,cPa75,0.772727272727273,3,16209,15876,cPa419_cPa75_cPa75-unknown,1_17_4,388,333
Scaffold397-16241_16450,cPa75,0.75,2,16398,16291,cPa419_cPa75,1_3,209,107
Scaffold397-17712_18068,cPa199,0.111111111111111,53,18066,17720,ALV_NC001408-cPa447-hybrid_ALV_NC001408-cPa482-hybrid_cPa199_cPa199-cPa482-hybrid_cPa223_cPa223-cPa183-hybrid_cPa223-cPa199-hybrid_cPa223-cPa227-hybrid_cPa223-cPa273-hybrid_cPa223-cPa345-hybrid_cPa223-cPa356-hybrid_cPa223-cPa42-hybrid_cPa223-cPa447-hybrid_cPa223-cPa450-hybrid_cPa223-cPa482-hybrid_cPa223-cPa539-hybrid_cPa223-cPa553-hybrid_cPa223-KWERV_GQ222416-hybrid_cPa223-MLV_Xmv43-hybrid_cPa227_cPa227-cPa199-hybrid_cPa227-cPa345-hybrid_cPa227-cPa42-hybrid_cPa227-cPa447-hybrid_cPa227-cPa450-hybrid_cPa227-cPa482-hybrid_cPa227-cPa553-hybrid_cPa227-KWERV_GQ222416-hybrid_cPa273_cPa345_cPa345-cPa450-hybrid_cPa356_cPa356-cPa273-hybrid_cPa356-cPa345-hybrid_cPa356-cPa450-hybrid_cPa356-KWERV_GQ222416-hybrid_cPa419_cPa434_cPa434-cPa482-hybrid_cPa434-MLV_Xmv43-hybrid_cPa447_cPa450_cPa542_cPa542-cPa199-hybrid_cPa542-cPa273-hybrid_cPa542-cPa447-hybrid_cPa542-cPa450-hybrid_cPa542-cPa482-hybrid_cPa542-cPa553-hybrid_cPa542-KWERV_GQ222416-hybrid_cPa553_cPa75_cPa75-cPa447-hybrid,1_1_44_1_1_1_5_1_4_12_4_3_11_6_19_2_4_3_1_24_1_2_1_2_1_3_1_3_42_30_1_14_1_1_1_1_3_7_1_1_40_42_17_1_1_4_2_4_1_1_13_1_4,356,346
Scaffold397-18820_18922,cPa273,0.293193717277487,34,18922,18819,ALV_NC001408-cPa482-hybrid_ALV_NC001408-cPa553-hybrid_cPa193-cPa482-hybrid_cPa199_cPa199-cPa482-hybrid_cPa223-cPa273-hybrid_cPa223-cPa482-hybrid_cPa223-cPa553-hybrid_cPa227_cPa227-cPa273-hybrid_cPa227-cPa345-hybrid_cPa227-cPa450-hybrid_cPa273_cPa345_cPa356-cPa273-hybrid_cPa356-cPa482-hybrid_cPa419_cPa425-cPa345-hybrid_cPa425-cPa482-hybrid_cPa450_cPa469_cPa482_cPa505-cPa482-hybrid_cPa542_cPa542-cPa273-hybrid_cPa542-cPa482-hybrid_cPa542-cPa553-hybrid_cPa553_cPa75_cPa75-cPa199-hybrid_cPa75-cPa273-hybrid_cPa75-cPa356-hybrid_cPa75-cPa450-hybrid_cPa75-cPa553-hybrid,3_1_1_6_1_2_37_7_7_1_1_1_56_3_1_1_4_1_1_13_3_1_1_4_1_2_1_16_7_2_1_1_1_2,102,103
Scaffold397-21485_21587,cPa419,0.4,4,21535,21497,cPa107-MoMLV_J02255-hybrid_cPa223-cPa47-hybrid_cPa419_cPa419-cPa15-hybrid,1_1_2_1,102,38
Scaffold397-21749_21853,cPa419_cPa542,0.5,2,21801,21783,cPa419_cPa542,1_1,104,18
Scaffold397-22807_22977,cPa434-cPa308-hybrid,0.566666666666667,6,22925,22857,cPa176-cPa308-hybrid_cPa394-cPa308-hybrid_cPa434-cPa308-hybrid_cPa434-cPa327-hybrid_cPa551-cPa308-hybrid_cPa551-cPa327-hybrid,1_3_51_8_25_2,170,68
Scaffold397-23167_23583,cPa434-cPa308-hybrid,0.547169811320755,6,23531,23217,cPa176-cPa308-hybrid_cPa339-cPa308-hybrid_cPa394-cPa308-hybrid_cPa434-cPa308-hybrid_cPa434-cPa327-hybrid_cPa551-cPa308-hybrid,10_10_7_58_7_14,416,314
Scaffold397-23794_23926,cPa434-cPa308-hybrid,0.625,4,23874,23844,cPa394-cPa308-hybrid_cPa434-cPa308-hybrid_cPa434-cPa327-hybrid_cPa551-cPa308-hybrid,1_5_1_1,132,30
Scaffold397-24773_24875,cPa434-cPa308-hybrid,1,1,24823,24823,cPa434-cPa308-hybrid,2,102,0
Scaffold397-26776_26878,cPa449,1,1,26826,26826,cPa449,1,102,0
Scaffold397-7935_8043,cPa75,0.666666666666667,2,7993,7985,cPa539-unknown_cPa75,1_2,108,8
Scaffold398-10528_10630,cPa400,0.916666666666667,2,10624,10559,cPa400_cPa419,11_1,102,65
Scaffold398-10731_10980,cPa400,0.901234567901235,4,10971,10777,cPa400_cPa409_cPa419_cPa75,73_1_6_1,249,194
Scaffold398-11491_11631,cPa400,0.959183673469388,2,11624,11490,cPa400_cPa419,47_2,140,134
Scaffold398-14149_14297,cPa419,0.857142857142857,2,14251,14163,cPa356-cPa523-hybrid_cPa419,1_6,148,88
Scaffold398-16283_16470,cPa419,0.354166666666667,19,16421,16293,ALVE_FJ793550-cPa419-hybrid_ALVE_FJ793550-cPa475-hybrid_ALVE_FJ793550-cPa75-hybrid_cPa145-cPa356-hybrid_cPa145-cPa523-hybrid_cPa356_cPa419_cPa447_cPa447-cPa227-hybrid_cPa447-cPa356-hybrid_cPa447-cPa425-hybrid_cPa447-cPa428-hybrid_cPa447-cPa475-hybrid_cPa447-cPa523-hybrid_cPa447-JSRV_DQ838494-hybrid_cPa475_cPa587-cPa475-hybrid_cPa75_JSRV_DQ838494-cPa356-hybrid,1_1_1_1_1_4_17_5_1_2_1_1_1_2_1_1_2_4_1,187,128
Scaffold398-17513_17615,JSRV_DQ838494,0.416666666666667,6,17606,17541,ALVE_FJ793550-cPa356-hybrid_cPa419_cPa447_cPa75_JSRV_DQ838494_JSRV_DQ838494-cPa356-hybrid,1_2_1_2_5_1,102,65
Scaffold398-17805_17907,cPa419,0.25,9,17875,17811,ALVE_FJ793550-cPa356-hybrid_ALVE_FJ793550-JSRV_DQ838494-hybrid_cPa356_cPa419_cPa447_cPa447-cPa142-hybrid_cPa447-cPa356-hybrid_cPa447-cPa425-hybrid_HERV-Fb_repbase_HERVH48I_MER48-cPa356-hybrid,3_2_1_5_3_1_3_1_1,102,64
Scaffold398-18409_18511,cPa400,0.71875,4,18510,18411,ALVE_FJ793550-cPa75-hybrid_cPa400_cPa419_cPa75,2_23_4_3,102,99
Scaffold398-19348_19450,cPa400,0.7,4,19450,19348,cPa117_cPa356_cPa400_cPa419,5_1_21_3,102,102
Scaffold398-20369_20471,cPa400,1,1,20469,20400,cPa400,13,102,69
Scaffold398-21533_21635,cPa400,1,1,21625,21545,cPa400,15,102,80
Scaffold398-21745_21849,cPa400,0.891891891891892,2,21844,21764,cPa400_cPa419,33_4,104,80
Scaffold398-22212_22314,cPa400,0.888888888888889,2,22314,22219,cPa400_cPa419,8_1,102,95
Scaffold398-22342_22455,cPa400,0.840909090909091,2,22455,22343,cPa400_cPa419,37_7,113,112
Scaffold398-22473_22575,cPa400,0.857142857142857,2,22575,22504,cPa400_cPa419,12_2,102,71
Scaffold398-22652_22768,cPa400,0.809090909090909,4,22768,22654,cPa285-cPa400-hybrid_cPa400_cPa419_cPa75,1_89_15_5,116,114
Scaffold398-25048_25151,cPa419,0.6,2,25110,25057,cPa400_cPa419,2_3,103,53
Scaffold398-6047_6149,cPa400-cPa502-hybrid_cPa75,0.5,2,6117,6097,cPa400-cPa502-hybrid_cPa75,1_1,102,20
Scaffold398-6369_6471,cPa363-cPa447-hybrid,1,1,6419,6419,cPa363-cPa447-hybrid,1,102,0
Scaffold398-6843_6945,cPa227-cPa447-hybrid_cPa452,0.5,2,6893,6877,cPa227-cPa447-hybrid_cPa452,1_1,102,16
Scaffold398-8154_8269,cPa400,0.909090909090909,2,8224,8185,cPa400_cPa447,10_1,115,39
Scaffold398-8898_9000,cPa400,1,1,8984,8907,cPa400,6,102,77
Scaffold398-9948_10050,cPa400,1,1,10000,9991,cPa400,19,102,9
Scaffold399-19970_20072,cPa356_cPa428,0.5,2,20064,20020,cPa356_cPa428,1_1,102,44
Scaffold399-23396_23590,cPa428,0.565217391304348,3,23580,23400,cPa356_cPa419_cPa428,9_1_13,194,180
Scaffold399-23652_23819,cPa356,0.543478260869565,2,23793,23666,cPa356_cPa428,25_21,167,127
Scaffold399-24195_24328,cPa356,0.7,2,24314,24217,cPa356_cPa428,7_3,133,97
Scaffold399-24497_24617,cPa356,0.6,2,24611,24547,cPa356_cPa428,9_6,120,64
Scaffold399-24632_24734,cPa356,0.75,2,24727,24649,cPa356_cPa428,6_2,102,78
Scaffold399-25055_25169,cPa356,0.75,2,25134,25089,cPa356_cPa428,3_1,114,45
Scaffold399-27281_27430,cPa356,0.515463917525773,2,27412,27281,cPa356_cPa428,50_47,149,131
Scaffold399-27598_27700,cPa428,0.666666666666667,2,27664,27648,cPa356_cPa428,1_2,102,16
Scaffold399-28386_28488,cPa428,0.6,2,28448,28419,cPa356_cPa428,2_3,102,29
Scaffold399-28567_28695,cPa428,0.526315789473684,2,28655,28571,cPa356_cPa428,9_10,128,84
Scaffold40-12490_12620,cPa117-cPa145-hybrid,1,1,12568,12540,cPa117-cPa145-hybrid,4,130,28
Scaffold40-14469_14579,ALVJ_Z46390-cPa254-hybrid,1,1,14527,14519,ALVJ_Z46390-cPa254-hybrid,2,110,8
Scaffold400-20572_20674,cPa428,1,1,20622,20622,cPa428,1,102,0
Scaffold400-8170_8272,cPa428,1,1,8220,8220,cPa428,1,102,0
Scaffold400-9106_9210,cPa356,0.666666666666667,2,9158,9155,cPa356_cPa428,4_2,104,3
Scaffold400-9256_9377,cPa356,0.6,2,9325,9306,cPa356_cPa428,3_2,121,19
Scaffold401-11308_11720,cPa413,0.697560975609756,7,11690,11358,cPa15-cPa208-hybrid_cPa15-cPa308-hybrid_cPa308_cPa308-cPa413-hybrid_cPa395-cPa308-hybrid_cPa413_HML1a_repbase_HERV-K14CI_LTR14C-cPa308-hybrid,1_2_11_1_45_143_2,412,332
Scaffold401-13091_13193,cPa492,0.8,2,13167,13097,cPa419_cPa492,2_8,102,70
Scaffold401-1476_1578,cPa572-cPa413-hybrid_cPa572-unknown,0.5,2,1527,1526,cPa572-cPa413-hybrid_cPa572-unknown,1_1,102,1
Scaffold401-21867_22023,cPa107-cPa176-hybrid_cPa544-cPa176-hybrid,0.5,2,21971,21917,cPa107-cPa176-hybrid_cPa544-cPa176-hybrid,1_1,156,54
Scaffold401-24741_24964,MMTV_NC001503-cPa413-hybrid,0.444444444444444,4,24912,24791,cPa119-cPa413-hybrid_cPa119-cPa555-hybrid_cPa419_MMTV_NC001503-cPa413-hybrid,2_1_2_4,223,121
Scaffold401-25282_25403,cPa413,0.689655172413793,7,25399,25326,cPa138_cPa138-cPa413-hybrid_cPa138-cPa555-hybrid_cPa339-cPa413-hybrid_cPa413_cPa425_MMTV_NC001503-cPa413-hybrid,1_3_2_1_20_1_1,121,73
Scaffold401-26300_26486,cPa419,0.466666666666667,8,26483,26318,cPa138-cPa254-hybrid_cPa138-cPa425-hybrid_cPa413-cPa174-hybrid_cPa419_cPa572-cPa254-hybrid_cPa572-cPa413-hybrid_cPa75-cPa413-hybrid_REV_NC006934-cPa413-hybrid,1_1_2_7_1_1_1_1,186,165
Scaffold401-27762_28003,cPa572-cPa395-hybrid,0.833333333333333,2,27951,27785,cPa395_cPa572-cPa395-hybrid,1_5,241,166
Scaffold401-3485_3587,cPa201-unknown,1,1,3535,3535,cPa201-unknown,1,102,0
Scaffold401-9532_9798,cPa395-cPa308-hybrid,0.454545454545455,7,9746,9570,cPa395-BFV_NC001831-hybrid_cPa395-cPa308-hybrid_cPa395-cPa413-hybrid_cPa395-cPa500-hybrid_cPa395-cPa539-hybrid_cPa395-unknown_cPa500,1_10_2_4_2_1_2,266,176
Scaffold403-10094_10196,cPa194,0.338983050847458,17,10194,10094,cPa109_cPa109-cPa194-hybrid_cPa109-cPa227-hybrid_cPa109-cPa323-hybrid_cPa173-cPa194-hybrid_cPa194_cPa199-cPa285-hybrid_cPa419_cPa419-cPa194-hybrid_cPa434-cPa194-hybrid_cPa434-cPa227-hybrid_cPa434-cPa323-hybrid_cPa443-cPa194-hybrid_cPa463-cPa194-hybrid_cPa61-cPa227-hybrid_cPa71-cPa339-hybrid_cPa71-cPa447-hybrid,16_11_1_3_1_40_1_5_1_17_3_5_2_1_1_2_8,102,100
Scaffold403-10913_11283,cPa390,0.25,34,11283,10926,cPa109-cPa339-hybrid_cPa109-cPa447-hybrid_cPa109-cPa62-hybrid_cPa117-cPa339-hybrid_cPa246-cPa339-hybrid_cPa339_cPa356-cPa339-hybrid_cPa390_cPa390-cPa227-hybrid_cPa390-cPa339-hybrid_cPa390-cPa419-hybrid_cPa390-cPa447-hybrid_cPa419_cPa419-cPa339-hybrid_cPa428-cPa227-hybrid_cPa428-cPa339-hybrid_cPa434-cPa339-hybrid_cPa434-cPa419-hybrid_cPa434-cPa447-hybrid_cPa434-cPa62-hybrid_cPa444_cPa444-cPa173-hybrid_cPa444-cPa227-hybrid_cPa444-cPa246-hybrid_cPa444-cPa339-hybrid_cPa444-cPa390-hybrid_cPa444-cPa419-hybrid_cPa444-cPa447-hybrid_cPa444-cPa62-hybrid_cPa447_cPa452-cPa447-hybrid_cPa56-cPa227-hybrid_cPa71-cPa339-hybrid_cPa71-cPa447-hybrid,7_1_4_1_1_22_1_71_4_4_1_1_7_1_2_2_3_1_3_1_2_1_61_1_25_2_1_16_6_27_1_1_1_1,370,357
Scaffold403-20088_20248,MER52A_repbase_MER52AI_MER52A-unknown,0.571428571428571,5,20236,20103,cPa419_MER52A_repbase_MER52AI_MER52A_MER52A_repbase_MER52AI_MER52A-cPa419-hybrid_MER52A_repbase_MER52AI_MER52A-cPa62-hybrid_MER52A_repbase_MER52AI_MER52A-unknown,1_14_2_1_24,160,133
Scaffold403-20423_20525,MER52A_repbase_MER52AI_MER52A-unknown,1,1,20473,20473,MER52A_repbase_MER52AI_MER52A-unknown,1,102,0
Scaffold403-22133_22310,cPa208,0.238095238095238,13,22267,22148,cPa193_cPa193-cPa208-hybrid_cPa208_cPa208-CAEV_NC001463-hybrid_cPa208-cPa193-hybrid_cPa208-cPa555-hybrid_cPa208-unknown_cPa333_cPa333-cPa193-hybrid_cPa333-cPa555-hybrid_cPa333-unknown_cPa419_cPa75,1_1_5_1_3_1_1_2_2_1_1_1_1,177,119
Scaffold403-24747_25238,cPa308,0.341772151898734,13,25186,24779,cPa308_cPa308-CAEV_NC001463-hybrid_cPa308-cPa298-hybrid_cPa308-cPa333-hybrid_cPa308-cPa419-hybrid_cPa308-cPa465-hybrid_cPa308-cPa539-hybrid_cPa308-cPa549-hybrid_cPa308-MER52A_repbase_MER52AI_MER52A-hybrid_cPa308-unknown_cPa419_cPa540-cPa549-hybrid_MER52A_repbase_MER52AI_MER52A-unknown,27_3_12_2_2_1_1_6_1_4_16_1_3,491,407
Scaffold403-25561_25663,cPa419,0.5,3,25626,25611,cPa308-cPa549-hybrid_cPa419_cPa549,2_3_1,102,15
Scaffold403-25671_25820,cPa308-cPa549-hybrid,0.434782608695652,4,25769,25719,cPa308-cPa549-hybrid_cPa333-cPa298-hybrid_cPa419_cPa549,10_1_4_8,149,50
Scaffold403-25938_26040,cPa419_cPa425-cPa549-hybrid,0.5,2,26040,25959,cPa419_cPa425-cPa549-hybrid,5_5,102,81
Scaffold403-27888_28019,cPa425-unknown,0.666666666666667,3,28006,27938,cPa419_cPa425-unknown_GaLV_M26927-HML1b_repbase_HERV-K14I_LTR14A-hybrid,1_4_1,131,68
Scaffold403-9788_9908,cPa444-cPa194-hybrid,0.163879598662207,56,9908,9788,cPa109_cPa109-cPa194-hybrid_cPa109-cPa199-hybrid_cPa109-cPa227-hybrid_cPa109-cPa323-hybrid_cPa109-cPa339-hybrid_cPa109-cPa390-hybrid_cPa109-cPa447-hybrid_cPa109-cPa62-hybrid_cPa118-cPa61-hybrid_cPa194_cPa199-cPa227-hybrid_cPa254-cPa61-hybrid_cPa339_cPa356-cPa194-hybrid_cPa390_cPa390-cPa194-hybrid_cPa390-cPa323-hybrid_cPa390-cPa419-hybrid_cPa390-cPa62-hybrid_cPa419_cPa428-cPa194-hybrid_cPa434_cPa434-cPa194-hybrid_cPa434-cPa199-hybrid_cPa434-cPa227-hybrid_cPa434-cPa339-hybrid_cPa434-cPa390-hybrid_cPa434-cPa447-hybrid_cPa434-cPa62-hybrid_cPa443_cPa443-cPa227-hybrid_cPa443-cPa447-hybrid_cPa444_cPa444-cPa194-hybrid_cPa444-cPa199-hybrid_cPa444-cPa227-hybrid_cPa444-cPa323-hybrid_cPa444-cPa339-hybrid_cPa444-cPa390-hybrid_cPa444-cPa419-hybrid_cPa444-cPa447-hybrid_cPa444-cPa566-hybrid_cPa444-cPa62-hybrid_cPa447_cPa566_cPa566-cPa447-hybrid_cPa61_cPa61-cPa194-hybrid_cPa61-cPa227-hybrid_cPa61-cPa447-hybrid_cPa62_cPa71-cPa109-hybrid_cPa71-cPa194-hybrid_SnRV_NC001724-cPa227-hybrid_SnRV_NC001724-cPa339-hybrid,5_8_1_23_1_6_1_17_2_1_14_1_1_9_4_15_3_2_1_1_7_2_1_13_1_25_11_1_8_2_9_1_1_1_49_3_2_11_2_1_1_5_1_1_6_3_1_2_1_1_1_1_1_5_1_1,120,120
Scaffold404-16502_16604,cPa356,0.625,2,16592,16518,cPa356_cPa428,5_3,102,74
Scaffold404-16958_17060,cPa356,1,1,17008,17008,cPa356,1,102,0
Scaffold404-17473_17575,cPa428,0.666666666666667,2,17541,17523,cPa356_cPa428,1_2,102,18
Scaffold405-8972_9074,cPa75,1,1,9067,9012,cPa75,3,102,55
Scaffold406-1349_1627,cPa434,0.586666666666667,10,1626,1350,cPa356_cPa356-cPa434-hybrid_cPa356-cPa443-hybrid_cPa356-cPa566-hybrid_cPa356-unknown_cPa402-cPa443-hybrid_cPa402-cPa566-hybrid_cPa434_cPa434-cPa118-hybrid_cPa575,21_1_2_1_1_2_1_44_1_1,278,276
Scaffold406-13541_13643,cPa447-cPa392-hybrid,0.5,3,13591,13546,cPa339_cPa392-cPa339-hybrid_cPa447-cPa392-hybrid,1_1_2,102,45
Scaffold406-13766_13902,cPa447-cPa174-hybrid_cPa47-cPa425-hybrid_REV_NC006934-cPa223-hybrid_REV_NC006934-cPa392-hybrid,0.25,4,13850,13798,cPa447-cPa174-hybrid_cPa47-cPa425-hybrid_REV_NC006934-cPa223-hybrid_REV_NC006934-cPa392-hybrid,1_1_1_1,136,52
Scaffold406-16267_16369,cPa434,0.75,2,16338,16307,cPa356_cPa434,1_3,102,31
Scaffold406-16499_16601,cPa356,0.545454545454545,6,16599,16498,cPa356_cPa356-cPa434-hybrid_cPa390-cPa566-hybrid_cPa434_cPa434-cPa566-hybrid_cPa450-cPa456-hybrid,6_1_1_1_1_1,102,101
Scaffold406-1695_1910,cPa356,0.583333333333333,5,1892,1712,cPa356_cPa434_cPa434-cPa356-hybrid_cPa434-unknown_cPa575,14_7_1_1_1,215,180
Scaffold406-17227_17329,cPa356,0.666666666666667,2,17277,17231,cPa356_cPa356-cPa15-hybrid,2_1,102,46
Scaffold406-23964_24066,cPa75-cPa505-hybrid,1,1,24014,24014,cPa75-cPa505-hybrid,1,102,0
Scaffold406-24141_24448,cPa75-cPa505-hybrid,0.25531914893617,7,24396,24191,cPa109-cPa505-hybrid_cPa425-cPa505-hybrid_cPa452-cPa505-hybrid_cPa505_cPa75_cPa75-cPa505-hybrid_cPa75-unknown,3_2_1_11_9_12_9,307,205
Scaffold406-8300_8481,cPa270_cPa398_cPa410_cPa419,0.25,4,8429,8350,cPa270_cPa398_cPa410_cPa419,1_1_1_1,181,79
Scaffold406-9450_9734,cPa270,0.430555555555556,14,9705,9450,cPa270_cPa381_cPa398_cPa410_cPa410-cPa270-hybrid_cPa410-cPa381-hybrid_cPa413-cPa199-hybrid_cPa413-cPa270-hybrid_cPa413-cPa398-hybrid_cPa419_cPa486_cPa587_cPa587-cPa381-hybrid_cPa62-cPa381-hybrid,31_7_7_8_1_1_1_1_1_1_7_1_4_1,284,255
Scaffold407-11185_11287,cPa356,0.571428571428571,2,11241,11235,cPa356_cPa428,4_3,102,6
Scaffold407-2219_2321,cPa428,0.8,2,2278,2222,cPa356_cPa428,1_4,102,56
Scaffold407-27099_27201,cPa428,0.666666666666667,2,27182,27149,cPa356_cPa428,1_2,102,33
Scaffold407-3538_3640,cPa428,0.8,2,3598,3546,cPa356_cPa428,1_4,102,52
Scaffold407-5188_5370,cPa428,0.571428571428571,2,5355,5195,cPa356_cPa428,21_28,182,160
Scaffold407-5372_5474,cPa356,0.666666666666667,2,5422,5398,cPa356_cPa428,2_1,102,24
Scaffold407-5591_5693,cPa356,0.75,2,5641,5614,cPa356_cPa428,3_1,102,27
Scaffold407-6149_6251,cPa356,0.545454545454545,2,6249,6193,cPa356_cPa428,18_15,102,56
Scaffold407-6500_6602,cPa428,1,1,6550,6541,cPa428,2,102,9
Scaffold407-6731_6879,cPa428,0.555555555555556,2,6855,6756,cPa356_cPa428,4_5,148,99
Scaffold407-8214_8344,cPa356_cPa428,0.5,2,8298,8234,cPa356_cPa428,15_15,130,64
Scaffold409-11286_11388,cPa356,0.615384615384615,2,11383,11303,cPa356_cPa428,8_5,102,80
Scaffold409-2634_2736,cPa356,0.666666666666667,3,2711,2683,cPa356_cPa428_cPa428-cPa356-hybrid,4_1_1,102,28
Scaffold409-699_801,cPa428,1,1,749,749,cPa428,1,102,0
Scaffold409-7503_7729,cPa428,0.530612244897959,3,7716,7514,cPa356_cPa428_cPa428-unknown,22_26_1,226,202
Scaffold409-7774_7984,cPa428,0.547368421052632,2,7932,7775,cPa356_cPa428,43_52,210,157
Scaffold409-8143_8396,cPa428,0.517857142857143,2,8344,8182,cPa356_cPa428,27_29,253,162
Scaffold409-8518_8620,cPa356_cPa428,0.5,2,8568,8518,cPa356_cPa428,4_4,102,50
Scaffold409-8633_8735,cPa428,0.666666666666667,2,8726,8677,cPa356_cPa428,2_4,102,49
Scaffold409-8837_8944,cPa428,0.696969696969697,2,8941,8837,cPa356_cPa428,10_23,107,104
Scaffold409-8986_9088,cPa428,0.625,2,9036,8987,cPa356_cPa428,3_5,102,49
Scaffold409-9104_9206,cPa356_cPa428,0.5,2,9154,9154,cPa356_cPa428,1_1,102,0
Scaffold409-9401_9503,cPa428,0.785714285714286,2,9455,9410,cPa356_cPa428,3_11,102,45
Scaffold409-9781_10095,cPa428,0.545,2,10050,9827,cPa356_cPa428,91_109,314,223
Scaffold41-17567_17748,cPa434,0.714285714285714,2,17738,17600,cPa356_cPa434,2_5,181,138
Scaffold41-3704_3806,cPa75,1,1,3754,3754,cPa75,1,102,0
Scaffold411-12374_12476,cPa419,1,1,12424,12387,cPa419,2,102,37
Scaffold411-12584_12686,cPa419,1,1,12634,12634,cPa419,1,102,0
Scaffold411-12772_12874,cPa419,1,1,12823,12821,cPa419,7,102,2
Scaffold411-14491_14593,cPa419,1,1,14541,14541,cPa419,1,102,0
Scaffold411-14626_14728,cPa419,1,1,14685,14676,cPa419,3,102,9
Scaffold411-16683_16858,cPa419,1,1,16806,16685,cPa419,34,175,121
Scaffold411-2043_2145,cPa419,1,1,2117,2081,cPa419,14,102,36
Scaffold411-7877_7979,cPa419,1,1,7937,7913,cPa419,3,102,24
Scaffold414-10461_10563,cPa293-cPa356-hybrid_cPa419,0.5,2,10552,10511,cPa293-cPa356-hybrid_cPa419,1_1,102,41
Scaffold414-10718_10840,cPa293-cPa356-hybrid,1,1,10788,10768,cPa293-cPa356-hybrid,2,122,20
Scaffold414-11578_11680,cPa356,1,1,11669,11597,cPa356,8,102,72
Scaffold414-11727_11829,cPa356,1,1,11791,11777,cPa356,2,102,14
Scaffold414-13016_13152,cPa419,0.210526315789474,13,13147,13024,cPa174_cPa194_cPa254_cPa258_cPa392_cPa404_cPa419_cPa434-cPa315-hybrid_cPa447-cPa194-hybrid_cPa67_cPa75_HERV-W_repbase_HERV17_LTR17-cPa404-hybrid_HERV-XA34_repbase_HERVFH21I_LTR21A-cPa447-hybrid,1_1_2_1_1_1_4_1_1_3_1_1_1,136,123
Scaffold414-13231_13333,cPa419,0.333333333333333,6,13328,13238,cPa194_cPa258_cPa404_cPa419_cPa67_cPa67-cPa404-hybrid,1_1_1_3_1_2,102,90
Scaffold414-14223_14325,cPa419_cPa75,0.5,2,14280,14273,cPa419_cPa75,1_1,102,7
Scaffold414-14800_14902,cPa419,1,1,14878,14850,cPa419,2,102,28
Scaffold414-18257_18359,cPa332-SnRV_NC001724-hybrid_cPa450-cPa75-hybrid,0.5,2,18358,18307,cPa332-SnRV_NC001724-hybrid_cPa450-cPa75-hybrid,1_1,102,51
Scaffold414-18484_18797,cPa419,0.565217391304348,10,18794,18520,cPa15-cPa75-hybrid_cPa15-SnRV_NC001724-hybrid_cPa315-SnRV_NC001724-hybrid_cPa332-cPa327-hybrid_cPa332-cPa392-hybrid_cPa332-cPa419-hybrid_cPa419_cPa419-SnRV_NC001724-hybrid_cPa426-SnRV_NC001724-hybrid_cPa75,1_2_1_1_1_1_13_1_1_1,313,274
Scaffold414-20374_20476,cPa419,0.769230769230769,3,20442,20384,cPa117_cPa15-cPa456-hybrid_cPa419,2_1_10,102,58
Scaffold414-26411_26513,cPa200-cPa552-hybrid,1,1,26461,26461,cPa200-cPa552-hybrid,1,102,0
Scaffold414-26773_26875,cPa413,1,1,26823,26823,cPa413,1,102,0
Scaffold414-27336_27454,cPa75-cPa140-hybrid,0.4,5,27402,27380,cPa360-cPa140-hybrid_cPa419_cPa447_cPa75-cPa140-hybrid_cPa75-EIAV_NC001450-hybrid,1_1_3_4_1,118,22
Scaffold414-27769_27871,cPa447,0.388888888888889,6,27871,27776,cPa264-cPa140-hybrid_cPa356-cPa140-hybrid_cPa447_cPa447-cPa140-hybrid_cPa75-cPa410-hybrid_cPa95-cPa566-hybrid,1_6_7_2_1_1,102,95
Scaffold414-3903_4005,cPa356_cPa394-MMTV_NC001503-hybrid,0.5,2,3955,3953,cPa356_cPa394-MMTV_NC001503-hybrid,1_1,102,2
Scaffold414-4059_4362,cPa308-cPa356-hybrid,0.516129032258065,7,4327,4109,cPa308-cPa356-hybrid_cPa308-cPa61-hybrid_cPa308-HERV-F_repbase_HERVFH19I_LTR19A-hybrid_cPa308-HERV-W_repbase_HERV17_LTR17-hybrid_cPa327-cPa356-hybrid_cPa356_cPa449-cPa356-hybrid,16_1_1_2_1_9_1,303,218
Scaffold414-8752_8854,PRIMA41_repbase_PRIMA41_MER41A,0.5,3,8834,8767,cPa15-cPa428-hybrid_cPa293-cPa428-hybrid_PRIMA41_repbase_PRIMA41_MER41A,1_2_3,102,67
Scaffold415-2061_2227,cPa75,1,1,2176,2111,cPa75,3,166,65
Scaffold416-21870_22052,cPa356_cPa428,0.5,2,22000,21920,cPa356_cPa428,3_3,182,80
Scaffold416-22746_22848,cPa428,0.576923076923077,2,22838,22760,cPa356_cPa428,11_15,102,78
Scaffold416-22897_23065,cPa356,0.625,2,23035,22920,cPa356_cPa428,5_3,168,115
Scaffold416-23203_23309,cPa356_cPa428,0.5,2,23298,23211,cPa356_cPa428,16_16,106,87
Scaffold416-24334_24436,cPa428,0.555555555555556,2,24431,24384,cPa356_cPa428,4_5,102,47
Scaffold416-26999_27101,cPa428,0.727272727272727,2,27076,27049,cPa356_cPa428,3_8,102,27
Scaffold416-27387_27520,cPa356_cPa428,0.5,2,27513,27419,cPa356_cPa428,30_30,133,94
Scaffold416-3584_3720,cPa356,1,1,3668,3634,cPa356,2,136,34
Scaffold416-5851_5953,cPa356_cPa428,0.5,2,5951,5901,cPa356_cPa428,2_2,102,50
Scaffold418-26033_26135,cPa356,0.714285714285714,2,26133,26083,cPa356_cPa428,5_2,102,50
Scaffold418-27332_27434,cPa356,0.75,2,27382,27373,cPa356_cPa428,6_2,102,9
Scaffold419-10045_10147,cPa356_cPa428,0.5,2,10095,10095,cPa356_cPa428,1_1,102,0
Scaffold419-10412_10515,cPa428,0.6,2,10471,10439,cPa356_cPa428,4_6,103,32
Scaffold419-11170_11272,cPa356_cPa428,0.5,2,11220,11175,cPa356_cPa428,2_2,102,45
Scaffold419-20543_20664,cPa356,0.833333333333333,2,20646,20585,cPa356_cPa428,5_1,121,61
Scaffold419-20716_20825,cPa428,0.578947368421053,2,20792,20765,cPa356_cPa428,8_11,109,27
Scaffold419-20916_21020,cPa428,0.555555555555556,2,20987,20937,cPa356_cPa428,8_10,104,50
Scaffold419-22242_22375,cPa356,0.583333333333333,2,22342,22250,cPa356_cPa428,21_15,133,92
Scaffold419-23832_23934,cPa428,0.533333333333333,2,23934,23882,cPa356_cPa428,7_8,102,52
Scaffold419-23975_24077,cPa428,0.666666666666667,2,24027,23977,cPa356_cPa428,1_2,102,50
Scaffold419-2545_2664,cPa428,0.529411764705882,2,2647,2553,cPa356_cPa428,8_9,119,94
Scaffold419-2882_3004,cPa356,0.529411764705882,2,2972,2911,cPa356_cPa428,9_8,122,61
Scaffold42-16408_16510,cPa434,1,1,16458,16458,cPa434,1,102,0
Scaffold42-18404_18506,cPa434,0.888888888888889,2,18497,18418,cPa425-cPa434-hybrid_cPa434,1_8,102,79
Scaffold42-20855_21064,cPa434,0.523809523809524,3,21012,20868,cPa356_cPa356-unknown_cPa434,9_1_11,209,144
Scaffold42-39685_39908,cPa67,1,1,39856,39735,cPa67,28,223,121
Scaffold42-40434_40728,cPa67,1,1,40725,40437,cPa67,113,294,288
Scaffold42-41146_41255,cPa67,0.971014492753623,3,41255,41150,cPa339-cPa419-hybrid_cPa433-unknown_cPa67,1_1_67,109,105
Scaffold42-41364_42016,cPa67,0.940140845070423,10,42011,41404,cPa15-cPa447-hybrid_cPa15-HERV-I_repbase_HERVI_LTR10B-hybrid_cPa15-KoRV_AF151794-hybrid_cPa15-unknown_cPa264-cPa447-hybrid_cPa419_cPa447_cPa555-BaEV_D10032-hybrid_cPa67_FeFV_NC001871-KoRV_AF151794-hybrid,3_1_1_7_1_1_1_1_267_1,652,607
Scaffold42-42320_42422,cPa67,0.857142857142857,2,42403,42329,cPa447-cPa168-hybrid_cPa67,1_6,102,74
Scaffold42-43638_43740,cPa339,1,1,43688,43687,cPa339,2,102,1
Scaffold42-45157_45296,cPa339,0.666666666666667,2,45244,45170,cPa339_cPa339-cPa502-hybrid,4_2,139,74
Scaffold42-45397_45499,cPa339,1,1,45447,45443,cPa339,2,102,4
Scaffold42-45610_45712,cPa339,0.714285714285714,2,45709,45660,cPa339_cPa502,5_2,102,49
Scaffold42-45853_46105,cPa502,0.872727272727273,4,46096,45861,cPa339_cPa339-cPa502-hybrid_cPa419_cPa502,5_1_1_48,252,235
Scaffold42-46865_46967,cPa502,0.714285714285714,2,46966,46915,cPa339_cPa502,2_5,102,51
Scaffold42-49017_49119,cPa339,1,1,49067,49067,cPa339,1,102,0
Scaffold42-51319_51429,cPa339,0.782608695652174,2,51377,51360,cPa339_cPa390-cPa339-hybrid,18_5,110,17
Scaffold42-55026_55128,cPa339,0.866666666666667,3,55077,55032,cPa339_cPa419_HML7_repbase_HERVK11DI_MER11D,13_1_1,102,45
Scaffold42-8015_8117,cPa224-cPa362-hybrid,1,1,8065,8065,cPa224-cPa362-hybrid,1,102,0
Scaffold420-13433_13624,cPa419,1,1,13577,13468,cPa419,11,191,109
Scaffold420-14629_14731,cPa419,1,1,14679,14679,cPa419,1,102,0
Scaffold420-14831_14933,cPa419,1,1,14881,14877,cPa419,2,102,4
Scaffold420-15626_15728,cPa419,1,1,15676,15676,cPa419,1,102,0
Scaffold420-4120_4222,cPa419,1,1,4170,4168,cPa419,7,102,2
Scaffold420-5182_5284,cPa419,1,1,5232,5232,cPa419,1,102,0
Scaffold420-5473_5575,cPa419,1,1,5544,5472,cPa419,9,102,72
Scaffold420-5626_5777,cPa419,1,1,5753,5644,cPa419,39,151,109
Scaffold420-6488_6590,cPa419,1,1,6538,6538,cPa419,1,102,0
Scaffold422-1222_1324,cPa428,0.666666666666667,2,1273,1269,cPa356_cPa428,2_4,102,4
Scaffold422-1431_1533,cPa428,1,1,1481,1481,cPa428,1,102,0
Scaffold422-2095_2197,cPa356,1,1,2145,2145,cPa356,1,102,0
Scaffold422-2415_2517,cPa428,1,1,2465,2465,cPa428,1,102,0
Scaffold425-20601_20703,cPa356,1,1,20651,20651,cPa356,1,102,0
Scaffold425-20943_21045,cPa428,1,1,20993,20993,cPa428,1,102,0
Scaffold425-22244_22346,cPa356,0.625,2,22322,22285,cPa356_cPa428,5_3,102,37
Scaffold429-19558_19797,cPa61,0.791666666666667,3,19795,19608,cPa419_cPa585-cPa61-hybrid_cPa61,3_2_19,239,187
Scaffold429-19854_19956,cPa61,0.545454545454545,4,19908,19855,cPa419_cPa61_cPa61-unknown_cPa75,3_6_1_1,102,53
Scaffold429-20857_21347,cPa400,0.310996563573883,51,21339,20856,cPa104-cPa2-hybrid_cPa104-cPa435-hybrid_cPa106_cPa106-cPa435-hybrid_cPa106-cPa61-hybrid_cPa106-unknown_cPa174-cPa194-hybrid_cPa174-cPa435-hybrid_cPa194_cPa196-cPa194-hybrid_cPa196-cPa585-hybrid_cPa2_cPa254-cPa435-hybrid_cPa254-cPa67-hybrid_cPa254-HERV-W_repbase_HERV17_LTR17-hybrid_cPa258_cPa258-cPa194-hybrid_cPa258-cPa67-hybrid_cPa258-unknown_cPa270-cPa2-hybrid_cPa308_cPa356_cPa400_cPa419_cPa419-cPa194-hybrid_cPa428_cPa435_cPa435-cPa194-hybrid_cPa435-cPa566-hybrid_cPa435-cPa585-hybrid_cPa435-cPa61-hybrid_cPa435-cPa67-hybrid_cPa435-unknown_cPa452-cPa258-hybrid_cPa452-cPa435-hybrid_cPa521-cPa106-hybrid_cPa521-cPa435-hybrid_cPa566-cPa47-hybrid_cPa585_cPa585-cPa118-hybrid_cPa585-cPa194-hybrid_cPa585-cPa435-hybrid_cPa585-cPa61-hybrid_cPa585-cPa67-hybrid_cPa61-cPa106-hybrid_cPa61-cPa194-hybrid_cPa61-cPa67-hybrid_cPa67_cPa67-cPa61-hybrid_cPa75_HERV-W_repbase_HERV17_LTR17-cPa419-hybrid,1_1_167_3_2_1_1_1_19_1_1_3_1_1_1_4_1_1_1_1_1_1_181_21_1_1_47_1_1_1_4_1_2_1_1_1_1_1_80_1_3_2_1_1_1_6_2_2_1_1_1,490,483
Scaffold429-23192_23730,cPa521,0.223684210526316,79,23728,23197,cPa104_cPa104-cPa220-hybrid_cPa104-cPa419-hybrid_cPa104-cPa521-hybrid_cPa104-cPa566-hybrid_cPa104-RELIK_ERVK-hybrid_cPa15-cPa433-hybrid_cPa194-cPa196-hybrid_cPa194-cPa220-hybrid_cPa196_cPa196-cPa194-hybrid_cPa196-cPa219-hybrid_cPa196-cPa220-hybrid_cPa196-cPa308-hybrid_cPa196-cPa419-hybrid_cPa219_cPa219-cPa196-hybrid_cPa219-cPa220-hybrid_cPa219-cPa308-hybrid_cPa219-cPa379-hybrid_cPa219-cPa566-hybrid_cPa220_cPa247-cPa220-hybrid_cPa247-cPa75-hybrid_cPa258_cPa258-cPa220-hybrid_cPa258-cPa419-hybrid_cPa285-cPa220-hybrid_cPa305-cPa220-hybrid_cPa305-cPa75-hybrid_cPa305-unknown_cPa308-cPa220-hybrid_cPa308-cPa42-hybrid_cPa308-unknown_cPa327-RELIK_ERVK-hybrid_cPa339-cPa379-hybrid_cPa339-cPa42-hybrid_cPa379-cPa220-hybrid_cPa390-cPa379-hybrid_cPa390-cPa42-hybrid_cPa419_cPa424-RELIK_ERVK-hybrid_cPa428_cPa428-cPa196-hybrid_cPa433_cPa433-cPa196-hybrid_cPa433-cPa220-hybrid_cPa433-cPa419-hybrid_cPa433-cPa75-hybrid_cPa434-cPa308-hybrid_cPa447-cPa379-hybrid_cPa447-cPa42-hybrid_cPa447-unknown_cPa452_cPa452-cPa75-hybrid_cPa459-cPa16-hybrid_cPa459-cPa194-hybrid_cPa459-cPa196-hybrid_cPa459-cPa220-hybrid_cPa459-cPa379-hybrid_cPa459-cPa67-hybrid_cPa459-cPa75-hybrid_cPa459-unknown_cPa521_cPa521-cPa118-hybrid_cPa521-cPa15-hybrid_cPa521-cPa16-hybrid_cPa521-cPa194-hybrid_cPa521-cPa196-hybrid_cPa521-cPa220-hybrid_cPa521-cPa62-hybrid_cPa521-HML3_repbase_HERVK9I_MER9-hybrid_cPa521-RELIK_ERVK-hybrid_cPa521-unknown_cPa62-cPa220-hybrid_cPa62-cPa379-hybrid_cPa75_cPa75-cPa220-hybrid_cPa75-unknown,5_15_1_1_1_1_1_1_1_22_1_1_6_1_1_9_1_1_1_1_1_10_2_1_5_2_1_1_1_1_1_4_1_1_1_1_1_1_1_1_17_1_3_1_21_3_6_3_2_1_1_1_1_1_1_1_1_2_1_2_1_1_3_85_1_1_1_1_1_8_1_1_1_7_3_1_78_4_1,538,531
Scaffold429-4209_4311,cPa381_cPa486,0.285714285714286,5,4303,4209,cPa308_cPa353_cPa381_cPa449-cPa308-hybrid_cPa486,1_1_2_1_2,102,94
Scaffold429-8332_8434,cPa109-cPa360-hybrid_cPa505_cPa505-cPa163-hybrid_cPa505-cPa360-hybrid,0.25,4,8434,8333,cPa109-cPa360-hybrid_cPa505_cPa505-cPa163-hybrid_cPa505-cPa360-hybrid,1_1_1_1,102,101
Scaffold43-10441_10546,cPa339,0.525,5,10545,10478,cPa339_cPa353_cPa353-cPa227-hybrid_cPa353-cPa273-hybrid_cPa419,21_16_1_1_1,105,67
Scaffold43-1673_1775,cPa339,1,1,1723,1723,cPa339,1,102,0
Scaffold43-2579_2681,cPa339-unknown,0.666666666666667,2,2629,2579,cPa339_cPa339-unknown,1_2,102,50
Scaffold43-2714_2867,cPa339,1,1,2815,2764,cPa339,3,153,51
Scaffold43-2963_3065,cPa339,1,1,3029,2978,cPa339,7,102,51
Scaffold43-4704_4806,cPa339,0.666666666666667,2,4805,4754,cPa339_cPa542,2_1,102,51
Scaffold43-5958_6078,cPa339,0.571428571428571,4,6035,6005,cPa339_cPa339-cPa256-hybrid_SnRV_NC001724-cPa256-hybrid_SnRV_NC001724-cPa339-hybrid,4_1_1_1,120,30
Scaffold43-6542_6644,cPa332,1,1,6592,6592,cPa332,1,102,0
Scaffold43-6879_7087,SnRV_NC001724-cPa256-hybrid,0.307692307692308,4,7041,6929,cPa256_cPa339_cPa339-cPa256-hybrid_SnRV_NC001724-cPa256-hybrid,3_3_3_4,208,112
Scaffold43-7267_7427,cPa256_cPa339-cPa256-hybrid,0.25,6,7423,7269,cPa227-cPa256-hybrid_cPa256_cPa339_cPa339-cPa256-hybrid_cPa419_cPa47-cPa256-hybrid,1_2_1_2_1_1,160,154
Scaffold43-835_937,cPa339,1,1,885,885,cPa339,1,102,0
Scaffold430-14035_14237,cPa356,0.588235294117647,2,14237,14078,cPa356_cPa428,10_7,202,159
Scaffold430-15226_15356,cPa428,0.571428571428571,2,15352,15257,cPa356_cPa428,3_4,130,95
Scaffold430-15484_15586,cPa356,0.538461538461538,2,15572,15524,cPa356_cPa428,7_6,102,48
Scaffold430-16084_16186,cPa428,0.666666666666667,2,16137,16134,cPa356_cPa428,1_2,102,3
Scaffold430-6302_6404,cPa428,0.666666666666667,2,6357,6352,cPa356_cPa428,1_2,102,5
Scaffold431-11679_11781,cPa426-cPa527-hybrid,1,1,11729,11729,cPa426-cPa527-hybrid,1,102,0
Scaffold431-12714_12892,cPa426-cPa472-hybrid,0.508474576271186,13,12844,12748,cPa118-cPa472-hybrid_cPa15-cPa472-hybrid_cPa15-cPa527-hybrid_cPa157-cPa168-hybrid_cPa157-cPa472-hybrid_cPa20-cPa472-hybrid_cPa293-cPa168-hybrid_cPa293-cPa357-hybrid_cPa293-cPa472-hybrid_cPa293-cPa527-hybrid_cPa426-cPa168-hybrid_cPa426-cPa472-hybrid_cPa426-cPa527-hybrid,2_3_1_2_5_1_1_1_3_1_4_30_5,178,96
Scaffold431-12988_13113,cPa426-cPa472-hybrid,0.466666666666667,5,13061,13003,cPa15-cPa472-hybrid_cPa293-cPa472-hybrid_cPa426-cPa472-hybrid_cPa426-cPa527-hybrid_cPa527,2_2_7_3_1,125,58
Scaffold431-1342_1444,cPa502,1,1,1442,1341,cPa502,100,102,101
Scaffold431-14704_14806,cPa395,0.4,4,14754,14713,cPa138_cPa138-cPa472-hybrid_cPa395_cPa472,1_1_2_1,102,41
Scaffold431-15318_15567,cPa395_cPa542,0.235294117647059,11,15515,15339,cPa138_cPa138-cPa272-hybrid_cPa138-cPa395-hybrid_cPa138-cPa472-hybrid_cPa395_cPa419_cPa518_cPa527_cPa542_cPa572_cPa575,1_2_2_1_8_1_6_2_8_2_1,249,176
Scaffold431-17841_17943,cPa150_cPa529,0.4,3,17941,17849,cPa150_cPa419_cPa529,2_1_2,102,92
Scaffold431-20583_20685,cPa395_cPa527,0.5,2,20633,20603,cPa395_cPa527,1_1,102,30
Scaffold431-20940_21077,cPa583,0.435483870967742,18,21066,20940,cPa138_cPa251_cPa251-cPa140-hybrid_cPa358_cPa395_cPa419_cPa472_cPa472-cPa140-hybrid_cPa472-cPa251-hybrid_cPa472-cPa339-hybrid_cPa527_cPa527-cPa140-hybrid_cPa527-cPa15-hybrid_cPa527-cPa268-hybrid_cPa527-cPa583-hybrid_cPa575_cPa583_cPa583-cPa358-hybrid,1_7_1_4_1_1_2_2_1_1_5_2_1_1_2_2_27_1,137,126
Scaffold431-22582_22684,cPa472,1,1,22632,22632,cPa472,1,102,0
Scaffold431-22733_22835,cPa527-unknown,1,1,22783,22783,cPa527-unknown,1,102,0
Scaffold431-3319_3464,cPa75-cPa308-hybrid,0.5,4,3414,3369,cPa419-cPa308-hybrid_cPa463-cPa308-hybrid_cPa502_cPa75-cPa308-hybrid,1_1_1_3,145,45
Scaffold431-6338_6440,cPa47-cPa75-hybrid_cPa47-unknown,0.5,2,6416,6388,cPa47-cPa75-hybrid_cPa47-unknown,1_1,102,28
Scaffold431-6942_7056,cPa47-cPa75-hybrid,0.75,2,7008,6973,cPa419_cPa47-cPa75-hybrid,1_3,114,35
Scaffold431-7693_7795,cPa75,0.666666666666667,2,7791,7716,cPa47-cPa75-hybrid_cPa75,1_2,102,75
Scaffold431-9126_9289,cPa75,1,1,9249,9176,cPa75,4,163,73
Scaffold431-9393_9654,cPa75,0.904761904761905,2,9602,9443,cPa34-cPa75-hybrid_cPa75,2_19,261,159
Scaffold431-9673_9815,cPa75,1,1,9763,9723,cPa75,10,142,40
Scaffold433-17533_17635,cPa428,1,1,17583,17583,cPa428,1,102,0
Scaffold433-6156_6258,cPa356,0.516129032258065,2,6211,6164,cPa356_cPa428,16_15,102,47
Scaffold434-10586_10703,cPa183-cPa75-hybrid,0.388888888888889,7,10701,10627,cPa174_cPa183-cPa75-hybrid_cPa308-cPa419-hybrid_cPa434-cPa308-hybrid_cPa505_cPa75-cPa505-hybrid_HTLV2_M10060-cPa174-hybrid,6_7_1_1_1_1_1,117,74
Scaffold434-11595_11796,cPa434-cPa505-hybrid,0.333333333333333,6,11744,11619,cPa183-cPa188-hybrid_cPa183-cPa587-hybrid_cPa183-unknown_cPa419_cPa434-cPa505-hybrid_HERVFc2_repbase-cPa174-hybrid,1_1_2_1_3_1,201,125
Scaffold434-13588_13690,cPa356,1,1,13685,13612,cPa356,6,102,73
Scaffold434-3625_3902,cPa168-cPa16-hybrid_cPa168-cPa323-hybrid,0.266666666666667,7,3886,3675,cPa16_cPa168-cPa16-hybrid_cPa168-cPa323-hybrid_cPa168-HERV-E_repbase_HERVE_LTR2-hybrid_cPa227-cPa323-hybrid_cPa392-cPa16-hybrid_cPa419,1_4_4_2_1_1_2,277,211
Scaffold434-6060_6162,cPa425-cPa15-hybrid,0.222222222222222,11,6160,6088,cPa168-cPa15-hybrid_cPa168-cPa268-hybrid_cPa168-cPa308-hybrid_cPa194-cPa15-hybrid_cPa227-cPa15-hybrid_cPa227-cPa268-hybrid_cPa392-cPa75-hybrid_cPa419_cPa425-cPa118-hybrid_cPa425-cPa15-hybrid_cPa425-cPa268-hybrid,1_2_1_1_1_1_1_2_1_4_3,102,72
Scaffold434-7832_7934,cPa67,0.333333333333333,5,7902,7867,cPa168-cPa194-hybrid_cPa168-cPa67-hybrid_cPa194_cPa67_cPa75,1_1_1_2_1,102,35
Scaffold434-7982_8084,cPa194_cPa67,0.5,2,8062,8021,cPa194_cPa67,2_2,102,41
Scaffold434-8897_8999,cPa75,0.857142857142857,2,8947,8931,cPa419_cPa75,1_6,102,16
Scaffold435-15735_15960,cPa356,0.556390977443609,3,15957,15740,cPa356_cPa428_cPa428-unknown,74_58_1,225,217
Scaffold435-17253_17355,cPa356,0.538461538461538,2,17347,17282,cPa356_cPa428,7_6,102,65
Scaffold435-17387_17489,cPa428,0.8,2,17452,17434,cPa356_cPa428,1_4,102,18
Scaffold435-17736_17838,cPa428,0.625,2,17797,17740,cPa356_cPa428,3_5,102,57
Scaffold435-18162_18325,cPa428,0.777777777777778,2,18310,18186,cPa356_cPa428,4_14,163,124
Scaffold435-18406_18537,cPa428,0.545454545454545,2,18496,18448,cPa356_cPa428,5_6,131,48
Scaffold435-18617_18719,cPa356,0.5,3,18710,18623,cPa356_cPa419_cPa428,6_1_5,102,87
Scaffold435-18729_18831,cPa428,0.571428571428571,2,18831,18738,cPa356_cPa428,3_4,102,93
Scaffold435-18962_19064,cPa356,1,1,19043,19012,cPa356,3,102,31
Scaffold435-19270_19372,cPa356,0.531914893617021,3,19370,19291,cPa356_cPa419_cPa428,25_1_21,102,79
Scaffold435-19716_19818,cPa356,0.52,3,19807,19719,cPa356_cPa419_cPa428,39_3_33,102,88
Scaffold435-20027_20156,cPa356,0.642857142857143,2,20156,20028,cPa356_cPa428,9_5,129,128
Scaffold435-20406_20508,cPa356,0.5,3,20505,20407,cPa356_cPa419_cPa428,24_3_21,102,98
Scaffold435-20561_20663,cPa356,0.666666666666667,2,20663,20560,cPa356_cPa428,8_4,102,103
Scaffold435-20963_21127,cPa356,0.555555555555556,2,21099,20974,cPa356_cPa428,20_16,164,125
Scaffold435-21155_21257,cPa356,0.714285714285714,2,21256,21184,cPa356_cPa428,5_2,102,72
Scaffold435-21272_21553,cPa428,0.538011695906433,2,21548,21277,cPa356_cPa428,79_92,281,271
Scaffold435-21606_21841,cPa356,0.563380281690141,2,21840,21616,cPa356_cPa428,40_31,235,224
Scaffold435-21866_22051,cPa428,0.5234375,4,22033,21865,cPa356_cPa419_cPa428_cPa463,59_1_67_1,185,168
Scaffold435-22164_22266,cPa356,0.584905660377358,3,22259,22163,cPa127-cPa419-hybrid_cPa356_cPa428,1_31_21,102,96
Scaffold435-22358_22460,cPa428,0.541666666666667,2,22456,22362,cPa356_cPa428,11_13,102,94
Scaffold435-22885_23052,cPa356,0.6,2,23044,22909,cPa356_cPa428,27_18,167,135
Scaffold435-23154_23256,cPa428,0.6,3,23247,23156,cPa127-cPa363-hybrid_cPa356_cPa428,1_5_9,102,91
Scaffold435-24067_24169,cPa356,0.523809523809524,2,24140,24069,cPa356_cPa428,22_20,102,71
Scaffold435-24249_24351,cPa356,0.571428571428571,2,24351,24296,cPa356_cPa428,12_9,102,55
Scaffold435-24770_24872,cPa356,0.48,5,24872,24770,cPa356_cPa356-cPa540-hybrid_cPa428_cPa428-unknown_cPa540,24_2_22_1_1,102,102
Scaffold435-25029_25138,cPa356,0.456896551724138,9,25134,25033,cPa11-cPa540-hybrid_cPa241_cPa356_cPa356-cPa540-hybrid_cPa428_cPa428-cPa241-hybrid_cPa428-cPa363-hybrid_cPa428-unknown_cPa540,1_2_53_1_52_1_1_2_3,109,101
Scaffold437-1067_1243,cPa356,0.637096774193548,9,1236,1117,cPa356_cPa356-cPa447-hybrid_cPa425-cPa356-hybrid_cPa425-cPa387-hybrid_cPa425-cPa447-hybrid_cPa434_cPa447_HERVHcons-cPa356-hybrid_HERVHcons-cPa447-hybrid,79_1_3_10_19_8_2_1_1,176,119
Scaffold437-13691_13793,cPa356-cPa394-hybrid,0.333333333333333,5,13781,13694,cPa339-cPa371-hybrid_cPa356-cPa394-hybrid_cPa394_cPa434-cPa394-hybrid_MMTV_NC001503-cPa394-hybrid,1_2_1_1_1,102,87
Scaffold437-13804_13924,cPa434,0.388888888888889,10,13910,13808,cPa254-cPa394-hybrid_cPa339_cPa356-cPa394-hybrid_cPa356-cPa456-hybrid_cPa363-cPa394-hybrid_cPa394_cPa394-cPa371-hybrid_cPa419_cPa434_cPa434-cPa394-hybrid,1_1_1_2_1_6_3_3_14_4,120,102
Scaffold437-13936_14095,cPa394-cPa371-hybrid,0.384615384615385,5,14043,13937,cPa339_cPa356-cPa434-hybrid_cPa394-cPa371-hybrid_cPa434_cPa61-cPa456-hybrid,3_2_5_2_1,159,106
Scaffold437-14297_14399,cPa363-cPa371-hybrid_cPa452-cPa371-hybrid,0.5,2,14361,14347,cPa363-cPa371-hybrid_cPa452-cPa371-hybrid,1_1,102,14
Scaffold437-20004_20108,MER52A_repbase_MER52AI_MER52A,0.714285714285714,4,20101,20025,cPa360_cPa75-cPa360-hybrid_cPa75-unknown_MER52A_repbase_MER52AI_MER52A,1_1_2_10,104,76
Scaffold437-20409_20572,cPa75,0.571428571428571,4,20563,20433,cPa111-unknown_cPa273-unknown_cPa356_cPa75,1_1_1_4,163,130
Scaffold437-20635_20737,cPa75,1,1,20685,20685,cPa75,1,102,0
Scaffold437-20857_20959,cPa75,1,1,20907,20907,cPa75,1,102,0
Scaffold437-2548_2650,cPa425,1,1,2607,2548,cPa425,10,102,59
Scaffold437-923_1035,cPa356,0.666666666666667,3,987,972,cPa356_cPa387_cPa447,4_1_1,112,15
Scaffold438-10084_10186,cPa419,1,1,10138,10134,cPa419,2,102,4
Scaffold438-10209_10387,cPa419,1,1,10358,10239,cPa419,41,178,119
Scaffold438-10494_10770,cPa419,1,1,10730,10494,cPa419,17,276,236
Scaffold438-13137_13239,cPa419,1,1,13202,13162,cPa419,5,102,40
Scaffold438-13435_13537,cPa419,1,1,13508,13468,cPa419,3,102,40
Scaffold438-15826_15937,cPa419,1,1,15885,15876,cPa419,2,111,9
Scaffold438-3401_3687,cPa419,1,1,3649,3404,cPa419,28,286,245
Scaffold438-3850_3952,cPa419,1,1,3900,3900,cPa419,1,102,0
Scaffold438-5091_5193,cPa419,1,1,5141,5106,cPa419,2,102,35
Scaffold438-5711_5825,cPa419,1,1,5783,5714,cPa419,11,114,69
Scaffold438-5827_5929,cPa419,1,1,5928,5877,cPa419,12,102,51
Scaffold438-6532_6634,cPa419,1,1,6585,6549,cPa419,8,102,36
Scaffold438-6645_6747,BaEV_D10032_cPa419,0.5,2,6695,6695,BaEV_D10032_cPa419,1_1,102,0
Scaffold438-6811_6913,cPa419,1,1,6861,6861,cPa419,1,102,0
Scaffold438-7370_7472,cPa419,1,1,7443,7405,cPa419,7,102,38
Scaffold438-7756_7902,cPa419,1,1,7850,7806,cPa419,1,146,44
Scaffold438-8066_8179,cPa419,1,1,8127,8116,cPa419,2,113,11
Scaffold438-8932_9039,cPa419,1,1,9001,8982,cPa419,7,107,19
Scaffold438-9683_9785,cPa419,1,1,9775,9686,cPa419,20,102,89
Scaffold439-24753_24855,cPa419,1,1,24852,24754,cPa419,9,102,98
Scaffold44-11401_11503,cPa413,0.473684210526316,6,11500,11400,cPa199_cPa268-cPa199-hybrid_cPa413_cPa419_cPa486_cPa486-cPa199-hybrid,14_1_18_1_1_3,102,100
Scaffold44-12973_13086,cPa486,0.52,9,13083,12973,cPa268_cPa308_cPa381_cPa381-cPa62-hybrid_cPa381-unknown_cPa486_cPa486-unknown_cPa62_cPa62-unknown,1_2_1_1_1_13_4_1_1,113,110
Scaffold44-13102_13394,cPa486,0.508474576271186,15,13342,13152,cPa118_cPa15_cPa268_cPa268-CAEV_NC001463-hybrid_cPa268-unknown_cPa356_cPa381_cPa381-cPa118-hybrid_cPa381-cPa196-hybrid_cPa381-cPa199-hybrid_cPa381-unknown_cPa443-cPa205-hybrid_cPa486_cPa486-unknown_cPa75-cPa268-hybrid,1_2_1_1_1_1_4_1_1_1_1_1_30_12_1,292,190
Scaffold44-15331_15433,cPa356,1,1,15428,15346,cPa356,7,102,82
Scaffold44-16023_16267,cPa173-cPa109-hybrid,0.444444444444444,20,16216,16026,cPa106-cPa356-hybrid_cPa152-cPa177-hybrid_cPa152-cPa356-hybrid_cPa173-cPa106-hybrid_cPa173-cPa109-hybrid_cPa173-cPa152-hybrid_cPa173-cPa371-hybrid_cPa173-cPa400-hybrid_cPa173-unknown_cPa177-cPa106-hybrid_cPa177-cPa109-hybrid_cPa177-unknown_cPa205-cPa505-hybrid_cPa333-cPa356-hybrid_cPa356_cPa419_cPa452-cPa356-hybrid_cPa75-cPa106-hybrid_cPa75-cPa109-hybrid_cPa75-cPa356-hybrid,1_1_2_4_36_2_5_1_1_1_2_1_1_8_1_1_1_2_9_1,244,190
Scaffold44-16288_16390,cPa106-cPa356-hybrid,1,1,16338,16338,cPa106-cPa356-hybrid,1,102,0
Scaffold44-4657_4759,cPa339,1,1,4751,4707,cPa339,2,102,44
Scaffold44-4985_5087,cPa339,1,1,5071,5035,cPa339,2,102,36
Scaffold44-8124_8226,cPa339_cPa353_cPa419,0.333333333333333,3,8193,8174,cPa339_cPa353_cPa419,1_1_1,102,19
Scaffold44-8841_9018,cPa339,0.909090909090909,2,8997,8891,cPa339_cPa353,10_1,177,106
Scaffold44-9090_9201,cPa353,0.64,3,9179,9095,cPa339_cPa353_cPa419,8_16_1,111,84
Scaffold44-9279_9394,cPa339,0.5625,2,9352,9304,cPa339_cPa353,9_7,115,48
Scaffold44-9701_9803,cPa353,0.769230769230769,2,9786,9700,cPa339_cPa353,3_10,102,86
Scaffold440-20208_20314,cPa356,0.588235294117647,2,20305,20241,cPa356_cPa428,10_7,106,64
Scaffold440-20571_20673,cPa428,0.666666666666667,2,20628,20585,cPa356_cPa428,3_6,102,43
Scaffold442-17184_17294,cPa402_cPa74-cPa402-hybrid_cPa74-unknown,0.3,4,17254,17186,cPa402_cPa74-cPa402-hybrid_cPa74-EIAV_NC001450-hybrid_cPa74-unknown,3_3_1_3,110,68
Scaffold442-17323_17494,cPa402,0.437185929648241,5,17447,17366,cPa402_cPa74_cPa74-cPa402-hybrid_cPa74-EIAV_NC001450-hybrid_cPa74-unknown,174_7_69_1_147,171,81
Scaffold443-22177_22279,cPa428,1,1,22227,22227,cPa428,1,102,0
Scaffold449-12457_12559,cPa475-unknown,1,1,12541,12502,cPa475-unknown,3,102,39
Scaffold449-5685_5787,cPa47,1,1,5735,5735,cPa47,1,102,0
Scaffold449-7333_7445,cPa168,0.827586206896552,4,7434,7368,cPa152-cPa168-hybrid_cPa152-cPa75-hybrid_cPa168_cPa75,3_1_24_1,112,66
Scaffold449-9148_9333,cPa482-cPa583-hybrid,0.470588235294118,10,9318,9148,cPa152-cPa419-hybrid_cPa157-cPa583-hybrid_cPa395-cPa583-hybrid_cPa419_cPa482_cPa482-cPa168-hybrid_cPa482-cPa419-hybrid_cPa482-cPa583-hybrid_cPa62_cPa75,1_4_2_9_2_15_1_32_1_1,185,170
Scaffold45-1111_1309,cPa268-cPa356-hybrid,0.75,3,1257,1143,cPa268-cPa356-hybrid_cPa308-cPa356-hybrid_cPa381-cPa356-hybrid,18_4_2,198,114
Scaffold45-18122_18224,cPa176,0.666666666666667,2,18211,18172,cPa176_cPa452-cPa196-hybrid,2_1,102,39
Scaffold45-19435_19537,cPa176,0.185185185185185,13,19530,19462,cPa16_cPa176_cPa308_cPa308-cPa452-hybrid_cPa363_cPa424-cPa16-hybrid_cPa446_cPa452_cPa459_cPa459-cPa196-hybrid_cPa459-cPa446-hybrid_cPa71_cPa71-cPa446-hybrid,2_5_4_1_2_1_3_2_1_3_1_1_1,102,68
Scaffold45-19991_20093,cPa176,0.363636363636364,6,20060,19994,cPa16_cPa176_cPa363_cPa446_cPa452_cPa459-cPa363-hybrid,1_4_2_2_1_1,102,66
Scaffold45-2801_3047,cPa109-cPa356-hybrid,0.369942196531792,20,3034,2807,cPa106-cPa356-hybrid_cPa109-cPa177-hybrid_cPa109-cPa356-hybrid_cPa152-cPa177-hybrid_cPa152-cPa356-hybrid_cPa152-cPa419-hybrid_cPa173-cPa152-hybrid_cPa173-cPa177-hybrid_cPa173-cPa201-hybrid_cPa173-cPa356-hybrid_cPa173-unknown_cPa177_cPa177-cPa152-hybrid_cPa177-cPa356-hybrid_cPa177-unknown_cPa356_cPa505-cPa356-hybrid_cPa554-cPa152-hybrid_cPa554-cPa177-hybrid_cPa554-cPa356-hybrid,8_1_64_1_5_1_2_1_1_18_6_2_1_3_1_54_1_1_1_1,246,227
Scaffold45-33750_33904,cPa357-unknown,0.451612903225806,13,33859,33752,cPa177-cPa356-hybrid_cPa256-cPa356-hybrid_cPa339-CAEV_NC001463-hybrid_cPa339-cPa205-hybrid_cPa339-cPa356-hybrid_cPa339-unknown_cPa357-cPa145-hybrid_cPa357-cPa356-hybrid_cPa357-cPa380-hybrid_cPa357-unknown_cPa419_cPa62-cPa205-hybrid_HML4_repbase_HERVK13I_LTR13-unknown,1_1_1_1_2_2_1_4_1_14_1_1_1,154,107
Scaffold45-34017_34148,cPa201-cPa356-hybrid,0.8,2,34096,34064,cPa201-cPa356-hybrid_cPa357-cPa356-hybrid,4_1,131,32
Scaffold45-35789_35980,cPa201-cPa208-hybrid,0.37037037037037,13,35978,35812,cPa199-cPa208-hybrid_cPa201-cPa208-hybrid_cPa201-cPa450-hybrid_cPa223-cPa356-hybrid_cPa223-cPa450-hybrid_cPa357-cPa208-hybrid_cPa357-cPa356-hybrid_cPa381-cPa208-hybrid_cPa419_cPa446-cPa419-hybrid_cPa450_cPa486-cPa208-hybrid_MLV_Mpmv5-cPa208-hybrid,2_10_1_1_1_1_1_2_2_1_3_1_1,191,166
Scaffold45-3695_3940,cPa109-cPa333-hybrid,0.224137931034483,13,3888,3745,cPa106-cPa201-hybrid_cPa106-cPa333-hybrid_cPa109_cPa109-cPa152-hybrid_cPa109-cPa201-hybrid_cPa109-cPa333-hybrid_cPa152_cPa152-cPa333-hybrid_cPa173-cPa371-hybrid_cPa201-cPa333-hybrid_cPa505_cPa505-cPa201-hybrid_cPa505-cPa333-hybrid,1_10_6_1_4_13_11_6_1_1_2_1_1,245,143
Scaffold45-37048_37209,cPa381,0.597014925373134,12,37206,37048,Cer1_U15406_Cer1_U15406-unknown_cPa152-cPa208-hybrid_cPa199-cPa208-hybrid_cPa201_cPa223-cPa208-hybrid_cPa381_cPa381-Cer1_U15406-hybrid_cPa381-cPa419-hybrid_cPa419_FrMuLV_NC001362-cPa208-hybrid_MLV_Mpmv5-cPa208-hybrid,1_1_1_8_2_1_40_1_1_2_3_6,161,158
Scaffold45-37243_37359,cPa381,0.878787878787879,3,37355,37272,cPa201-cPa379-hybrid_cPa381_MLV_Mpmv5-cPa208-hybrid,1_29_3,116,83
Scaffold45-4135_4550,cPa106-cPa333-hybrid,0.259259259259259,11,4498,4185,cPa106-cPa201-hybrid_cPa106-cPa333-hybrid_cPa109_cPa109-cPa152-hybrid_cPa109-cPa201-hybrid_cPa109-cPa333-hybrid_cPa109-cPa371-hybrid_cPa152_cPa152-cPa333-hybrid_cPa201-cPa333-hybrid_cPa505-cPa333-hybrid,1_7_2_1_1_5_1_4_1_1_3,415,313
Scaffold45-8114_8216,cPa419,1,1,8164,8164,cPa419,1,102,0
Scaffold45-8469_8630,cPa387,0.625,3,8582,8519,cPa164-cPa308-hybrid_cPa308_cPa387,1_2_5,161,63
Scaffold450-1103_1205,cPa428,0.6,2,1172,1153,cPa356_cPa428,8_12,102,19
Scaffold450-1675_1777,cPa356_cPa428,0.5,2,1767,1725,cPa356_cPa428,1_1,102,42
Scaffold450-23525_23886,cPa75,0.458100558659218,28,23847,23575,cPa199_cPa199-cPa285-hybrid_cPa199-cPa500-hybrid_cPa199-cPa587-hybrid_cPa199-cPa62-hybrid_cPa199-cPa75-hybrid_cPa199-HERV-F_repbase_HERVFH19I_LTR19A-hybrid_cPa199-unknown_cPa260-unknown_cPa285_cPa285-unknown_cPa293-HERV-F_repbase_HERVFH19I_LTR19A-hybrid_cPa293-unknown_cPa308-PERV_AJ293656-hybrid_cPa75_cPa75-cPa285-hybrid_cPa75-cPa563-hybrid_cPa75-cPa587-hybrid_cPa75-HERV-F_repbase_HERVFH19I_LTR19A-hybrid_cPa75-unknown_HERV-F_repbase_HERVFH19I_LTR19A_HERV-W_repbase_HERV17_LTR17_HERV-W_repbase_HERV17_LTR17-cPa199-hybrid_HERV-W_repbase_HERV17_LTR17-cPa285-hybrid_HERV-W_repbase_HERV17_LTR17-unknown_HERV-XA34_repbase_HERVFH21I_LTR21A-cPa75-hybrid_PERV_AJ293656_PERVA_AY099323-cPa75-hybrid,24_6_1_3_1_2_10_10_1_6_1_1_1_1_82_2_1_1_2_12_1_4_1_1_1_1_1_1,361,272
Scaffold450-23919_24021,cPa419_cPa75-unknown,0.5,2,23998,23969,cPa419_cPa75-unknown,1_1,102,29
Scaffold450-3846_4108,cPa428,0.539823008849557,3,4072,3855,cPa356_cPa428_cPa511-unknown,49_61_3,262,217
Scaffold450-4146_4248,cPa428,0.533333333333333,3,4222,4145,cPa356_cPa428_cPa428-unknown,13_16_1,102,77
Scaffold450-5664_5766,cPa428,0.666666666666667,2,5745,5674,cPa356_cPa428,2_4,102,71
Scaffold450-5955_6157,cPa428,0.739130434782609,2,6118,5980,cPa356_cPa428,6_17,202,138
Scaffold450-6369_6551,cPa428,0.520547945205479,3,6550,6371,cPa356_cPa419_cPa428,34_1_38,182,179
Scaffold450-6742_6894,cPa356,0.5,3,6867,6765,cPa356_cPa419_cPa428,6_1_5,152,102
Scaffold450-743_845,cPa428,1,1,793,793,cPa428,1,102,0
Scaffold450-927_1029,cPa356,0.8,2,982,956,cPa356_cPa428,4_1,102,26
Scaffold451-12835_13031,cPa199-cPa587-hybrid,0.222222222222222,14,13028,12848,cPa199_cPa199-cPa381-hybrid_cPa199-cPa413-hybrid_cPa199-cPa587-hybrid_cPa228-cPa270-hybrid_cPa228-cPa587-hybrid_cPa270-cPa113-hybrid_cPa410-cPa381-hybrid_cPa413_cPa419_cPa419-cPa413-hybrid_cPa449-cPa381-hybrid_cPa449-cPa587-hybrid_cPa587,4_3_2_6_1_1_1_1_2_2_1_1_1_1,196,180
Scaffold451-18385_18487,cPa264-unknown,1,1,18435,18394,cPa264-unknown,2,102,41
Scaffold451-18514_18616,cPa119-cPa526-hybrid,1,1,18564,18564,cPa119-cPa526-hybrid,1,102,0
Scaffold451-18721_18823,cPa264-GaLV_M26927-hybrid_cPa264-unknown,0.5,2,18809,18771,cPa264-GaLV_M26927-hybrid_cPa264-unknown,1_1,102,38
Scaffold451-2483_2585,cPa308,0.75,2,2585,2505,cPa118-cPa308-hybrid_cPa308,1_3,102,80
Scaffold451-9852_10130,cPa228-cPa482-hybrid,0.24375,26,10085,9851,cPa163-cPa402-hybrid_cPa199_cPa228-cPa199-hybrid_cPa228-cPa402-hybrid_cPa228-cPa482-hybrid_cPa308-cPa402-hybrid_cPa308-cPa482-hybrid_cPa335-cPa482-hybrid_cPa356-cPa482-hybrid_cPa381-cPa199-hybrid_cPa381-cPa482-hybrid_cPa410-cPa199-hybrid_cPa410-cPa482-hybrid_cPa413-cPa199-hybrid_cPa413-cPa482-hybrid_cPa419_cPa419-cPa199-hybrid_cPa419-cPa482-hybrid_cPa428-cPa482-hybrid_cPa449-cPa199-hybrid_cPa449-cPa402-hybrid_cPa449-cPa482-hybrid_cPa521-cPa199-hybrid_cPa521-cPa482-hybrid_cPa62-cPa482-hybrid_cPa75-cPa199-hybrid,1_1_22_1_39_9_1_1_2_1_1_1_2_2_1_8_2_1_1_24_4_31_1_1_1_1,278,234
Scaffold452-14535_15008,cPa223,0.431535269709544,23,14956,14553,cPa118_cPa118-cPa15-hybrid_cPa118-cPa223-hybrid_cPa118-cPa315-hybrid_cPa118-unknown_cPa15_cPa15-unknown_cPa223_cPa223-unknown_cPa248-cPa419-hybrid_cPa248-unknown_cPa268-cPa15-hybrid_cPa268-unknown_cPa315_cPa315-cPa419-hybrid_cPa315-unknown_cPa391_cPa419_cPa419-cPa315-hybrid_cPa419-unknown_cPa428_cPa75_cPa75-cPa223-hybrid,11_1_3_2_22_24_17_104_1_1_1_1_8_10_1_6_2_19_1_1_1_3_1,473,403
Scaffold452-15767_15869,cPa248-cPa118-hybrid_cPa419_cPa75,0.333333333333333,3,15817,15772,cPa248-cPa118-hybrid_cPa419_cPa75,1_1_1,102,45
Scaffold452-15989_16091,cPa402_cPa450-GaLV_M26927-hybrid_cPa75,0.333333333333333,3,16039,16023,cPa402_cPa450-GaLV_M26927-hybrid_cPa75,1_1_1,102,16
Scaffold452-16911_17013,cPa463-cPa402-hybrid_cPa463-cPa413-hybrid,0.5,2,16961,16961,cPa463-cPa402-hybrid_cPa463-cPa413-hybrid,1_1,102,0
Scaffold452-17558_17873,cPa356,0.5,9,17821,17608,cPa111_cPa21-cPa356-hybrid_cPa356_cPa356-cPa111-hybrid_cPa356-GaLV_M26927-hybrid_cPa402-cPa356-hybrid_cPa463_cPa463-cPa356-hybrid_cPa463-GaLV_M26927-hybrid,1_1_9_1_1_1_1_1_2,315,213
Scaffold452-3337_3439,cPa308-unknown,1,1,3406,3387,cPa308-unknown,2,102,19
Scaffold452-3627_3729,cPa308-cPa60-hybrid,1,1,3677,3677,cPa308-cPa60-hybrid,1,102,0
Scaffold453-1540_1658,cPa502,0.862903225806452,5,1606,1542,cPa339_cPa379_cPa419_cPa450-cPa482-hybrid_cPa502,14_1_1_1_107,118,64
Scaffold453-16865_17116,cPa492,0.5,4,17064,16869,cPa339_cPa419_cPa492_cPa492-unknown,1_5_7_1,251,195
Scaffold453-18270_18383,cPa339,0.833333333333333,3,18371,18318,cPa339_cPa419_cPa492-cPa402-hybrid,10_1_1,113,53
Scaffold453-1857_1959,cPa390-cPa356-hybrid,1,1,1907,1907,cPa390-cPa356-hybrid,1,102,0
Scaffold453-19080_19182,cPa339,1,1,19130,19122,cPa339,2,102,8
Scaffold453-21312_21414,cPa205-cPa413-hybrid_cPa339,0.5,2,21373,21362,cPa205-cPa413-hybrid_cPa339,1_1,102,11
Scaffold453-21504_21693,cPa339_cPa339-cPa413-hybrid_cPa353_cPa419,0.181818181818182,7,21688,21554,cPa339_cPa339-cPa413-hybrid_cPa353_cPa353-cPa413-hybrid_cPa419_cPa444-cPa413-hybrid_cPa486,2_2_2_1_2_1_1,189,134
Scaffold453-22858_22960,cPa339-cPa413-hybrid_cPa413,0.5,2,22933,22908,cPa339-cPa413-hybrid_cPa413,1_1,102,25
Scaffold453-5971_6109,cPa482,0.833333333333333,2,6057,5976,cPa419_cPa482,1_5,138,81
Scaffold453-6275_6387,cPa419_cPa469-cPa521-hybrid_cPa482-cPa435-hybrid_cPa75,0.25,4,6342,6325,cPa419_cPa469-cPa521-hybrid_cPa482-cPa435-hybrid_cPa75,1_1_1_1,112,17
Scaffold453-6482_6584,BLV_NC001414-cPa435-hybrid_cPa482-unknown,0.5,2,6533,6532,BLV_NC001414-cPa435-hybrid_cPa482-unknown,1_1,102,1
Scaffold453-7331_7732,cPa254,0.5850622406639,10,7682,7381,cPa176-cPa254-hybrid_cPa176-unknown_cPa254_cPa254-cPa121-hybrid_cPa254-cPa435-hybrid_cPa254-cPa521-hybrid_cPa254-unknown_cPa419_cPa469-cPa254-hybrid_cPa469-unknown,5_28_141_1_2_1_27_3_1_32,401,301
Scaffold453-7786_7888,cPa254-unknown_cPa419_cPa469-cPa419-hybrid,0.333333333333333,3,7875,7836,cPa254-unknown_cPa419_cPa469-cPa419-hybrid,1_1_1,102,39
Scaffold454-10236_10338,cPa308-cPa402-hybrid_cPa308-cPa434-hybrid,0.5,2,10286,10275,cPa308-cPa402-hybrid_cPa308-cPa434-hybrid,1_1,102,11
Scaffold454-10350_10452,cPa308-cPa223-hybrid,1,1,10400,10400,cPa308-cPa223-hybrid,1,102,0
Scaffold454-16318_16515,cPa425,0.323529411764706,20,16509,16326,cPa109-cPa34-hybrid_cPa194-cPa118-hybrid_cPa194-cPa15-hybrid_cPa194-cPa268-hybrid_cPa194-cPa392-hybrid_cPa254-cPa15-hybrid_cPa419_cPa425_cPa425-cPa104-hybrid_cPa425-cPa194-hybrid_cPa425-cPa34-hybrid_cPa425-cPa479-hybrid_cPa425-cPa583-hybrid_cPa425-SnRV_NC001724-hybrid_cPa67-cPa118-hybrid_cPa67-cPa15-hybrid_cPa75-cPa34-hybrid_SnRV_NC001724-cPa118-hybrid_SnRV_NC001724-cPa15-hybrid_SnRV_NC001724-cPa392-hybrid,1_5_2_1_1_1_3_22_1_1_13_2_4_2_1_1_2_2_2_1,197,183
Scaffold454-16557_16659,cPa425-cPa34-hybrid,0.642857142857143,9,16620,16589,cPa194-cPa118-hybrid_cPa194-cPa15-hybrid_cPa419_cPa425-cPa104-hybrid_cPa425-cPa194-hybrid_cPa425-cPa255-hybrid_cPa425-cPa34-hybrid_cPa67-cPa15-hybrid_SnRV_NC001724-cPa118-hybrid,3_1_1_1_1_1_18_1_1,102,31
Scaffold454-17417_17602,cPa67,0.438848920863309,18,17602,17418,cPa194_cPa194-cPa118-hybrid_cPa194-cPa15-hybrid_cPa194-unknown_cPa356-cPa583-hybrid_cPa419_cPa419-cPa34-hybrid_cPa425_cPa425-cPa194-hybrid_cPa425-cPa34-hybrid_cPa425-cPa583-hybrid_cPa447-cPa34-hybrid_cPa67_cPa75-cPa583-hybrid_SnRV_NC001724_SnRV_NC001724-cPa268-hybrid_SnRV_NC001724-cPa34-hybrid_SnRV_NC001724-unknown,50_1_1_3_1_4_3_1_1_1_1_1_61_1_4_1_3_1,185,184
Scaffold454-17619_17721,cPa425-cPa34-hybrid,0.291666666666667,9,17713,17620,cPa194_cPa356-cPa34-hybrid_cPa419_cPa425-cPa34-hybrid_cPa425-cPa583-hybrid_cPa67_SnRV_NC001724-cPa118-hybrid_SnRV_NC001724-cPa15-hybrid_SnRV_NC001724-cPa34-hybrid,6_1_1_7_1_5_1_1_1,102,93
Scaffold454-19001_19226,cPa356,0.688,16,19209,19003,cPa356_cPa356-cPa34-hybrid_cPa356-cPa583-hybrid_cPa356-MDEV_AF053745-hybrid_cPa356-unknown_cPa387-cPa34-hybrid_cPa419_cPa447_cPa447-cPa163-hybrid_cPa447-cPa34-hybrid_cPa447-MDEV_AF053745-hybrid_cPa447-unknown_MDEV_AF053745-cPa434-hybrid_MDEV_AF053745-cPa583-hybrid_PERVA_AY099323-MDEV_AF053745-hybrid_SIV_NC001870-cPa67-hybrid,86_1_1_4_9_1_2_4_1_4_7_1_1_1_1_1,225,206
Scaffold454-19237_19393,cPa356,0.9375,2,19372,19276,cPa356_cPa447-cPa34-hybrid,30_2,156,96
Scaffold454-2041_2337,cPa434-unknown,0.272300469483568,43,2301,2052,BFV_NC001831-cPa118-hybrid_cPa15-cPa229-hybrid_cPa176-cPa15-hybrid_cPa176-cPa313-hybrid_cPa176-cPa394-hybrid_cPa176-unknown_cPa199-cPa394-hybrid_cPa229_cPa339-cPa15-hybrid_cPa339-cPa229-hybrid_cPa339-cPa356-hybrid_cPa339-cPa542-hybrid_cPa356-cPa313-hybrid_cPa394_cPa394-cPa15-hybrid_cPa394-cPa229-hybrid_cPa394-FrMuLV_NC001362-hybrid_cPa394-unknown_cPa419_cPa434_cPa434-cPa118-hybrid_cPa434-cPa15-hybrid_cPa434-cPa229-hybrid_cPa434-cPa313-hybrid_cPa434-cPa356-hybrid_cPa434-cPa394-hybrid_cPa434-cPa404-hybrid_cPa434-cPa425-hybrid_cPa434-cPa542-hybrid_cPa434-FrMuLV_NC001362-hybrid_cPa434-unknown_cPa551_cPa551-cPa118-hybrid_cPa551-cPa15-hybrid_cPa551-cPa229-hybrid_cPa551-cPa313-hybrid_cPa551-cPa356-hybrid_cPa551-cPa394-hybrid_cPa551-cPa425-hybrid_cPa551-cPa542-hybrid_cPa551-unknown_HERV-W_repbase_HERV17_LTR17-cPa394-hybrid_VISNA_S55323-cPa356-hybrid,1_1_1_1_1_1_2_2_1_1_1_2_1_9_1_3_1_2_5_4_1_10_10_2_3_4_1_1_9_2_58_1_1_6_9_1_8_4_1_1_37_1_1,296,249
Scaffold454-20492_20621,MDEV_AF053745-unknown,0.5,3,20612,20542,cPa194-cPa264-hybrid_MDEV_AF053745-unknown_SIV_NC001870-unknown,1_2_1,129,70
Scaffold454-20664_20837,cPa15-cPa248-hybrid_cPa15-unknown,0.333333333333333,8,20833,20669,cPa15_cPa15-cPa248-hybrid_cPa15-cPa387-hybrid_cPa15-MDEV_AF053745-hybrid_cPa15-unknown_cPa419_cPa447-cPa15-hybrid_cPa450-unknown,3_8_1_1_8_1_1_1,173,164
Scaffold454-20871_20973,cPa15_cPa15-cPa248-hybrid_cPa15-MDEV_AF053745-hybrid_cPa419_SIV_NC001870-cPa248-hybrid,0.2,5,20968,20921,cPa15_cPa15-cPa248-hybrid_cPa15-MDEV_AF053745-hybrid_cPa419_SIV_NC001870-cPa248-hybrid,1_1_1_1_1,102,47
Scaffold454-2354_2456,cPa199-cPa229-hybrid_cPa229,0.285714285714286,5,2455,2404,cPa199-cPa229-hybrid_cPa199-cPa542-hybrid_cPa229_HERV-F_repbase_HERVFH19I_LTR19A-cPa542-hybrid_HERV-W_repbase_HERV17_LTR17-cPa229-hybrid,2_1_2_1_1,102,51
Scaffold454-4588_4731,cPa199-cPa223-hybrid_cPa419_HERV-W_repbase_HERV17_LTR17-cPa223-hybrid,0.285714285714286,4,4679,4617,cPa199-cPa223-hybrid_cPa199-cPa353-hybrid_cPa419_HERV-W_repbase_HERV17_LTR17-cPa223-hybrid,2_1_2_2,143,62
Scaffold454-5834_5936,cPa419,0.6,6,5936,5884,cPa353-cPa479-hybrid_cPa4-cPa479-hybrid_cPa419_cPa472-cPa479-hybrid_cPa527-cPa479-hybrid_cPa554-cPa223-hybrid,2_1_12_3_1_1,102,52
Scaffold454-7442_7633,cPa472-cPa434-hybrid,0.25,11,7597,7492,cPa4-cPa371-hybrid_cPa4-cPa394-hybrid_cPa4-cPa434-hybrid_cPa419_cPa425_cPa425-cPa256-hybrid_cPa425-cPa47-hybrid_cPa47_cPa472-cPa371-hybrid_cPa472-cPa394-hybrid_cPa472-cPa434-hybrid,1_2_1_2_1_1_1_2_2_2_5,191,105
Scaffold454-7723_7860,cPa4-cPa434-hybrid,0.5,4,7808,7742,cPa18-cPa434-hybrid_cPa4-cPa394-hybrid_cPa4-cPa434-hybrid_cPa472-cPa394-hybrid,1_1_3_1,137,66
Scaffold454-7881_8085,cPa394,0.413333333333333,23,8049,7904,cPa174-cPa371-hybrid_cPa174-cPa394-hybrid_cPa254-cPa394-hybrid_cPa308_cPa308-cPa371-hybrid_cPa353-cPa371-hybrid_cPa353-cPa394-hybrid_cPa353-cPa434-hybrid_cPa353-unknown_cPa394_cPa394-cPa434-hybrid_cPa394-cPa554-hybrid_cPa394-unknown_cPa4-cPa371-hybrid_cPa4-cPa394-hybrid_cPa4-cPa434-hybrid_cPa419_cPa425-cPa371-hybrid_cPa472-cPa371-hybrid_cPa472-cPa394-hybrid_cPa472-cPa434-hybrid_cPa541-cPa394-hybrid_cPa551-cPa554-hybrid,1_1_1_1_2_3_3_1_2_31_1_1_3_1_5_6_2_1_1_5_1_1_1,204,145
Scaffold454-8194_8301,cPa394,0.272727272727273,8,8301,8200,cPa256_cPa308-cPa394-hybrid_cPa353-cPa394-hybrid_cPa394_cPa4-cPa434-hybrid_cPa419_cPa472-cPa394-hybrid_cPa541-cPa394-hybrid,1_1_1_3_1_2_1_1,107,101
Scaffold455-11123_11225,HML4_repbase_HERVK13I_LTR13,1,1,11206,11173,HML4_repbase_HERVK13I_LTR13,3,102,33
Scaffold455-12987_13089,cPa145,0.608695652173913,3,13084,12986,cPa145_cPa177-cPa145-hybrid_cPa216,14_3_6,102,98
Scaffold455-13182_13603,cPa145,0.575757575757576,14,13597,13188,cPa106-cPa446-hybrid_cPa109-cPa145-hybrid_cPa145_cPa145-HML4_repbase_HERVK13I_LTR13-hybrid_cPa145-unknown_cPa177-HML4_repbase_HERVK13I_LTR13-hybrid_cPa216_cPa216-cPa308-hybrid_cPa308_cPa308-cPa145-hybrid_cPa308-HML4_repbase_HERVK13I_LTR13-hybrid_cPa419_cPa449-cPa216-hybrid_cPa542-cPa308-hybrid,1_1_38_1_1_1_6_1_10_2_1_1_1_1,421,409
Scaffold455-20531_20633,cPa419,1,1,20604,20542,cPa419,3,102,62
Scaffold455-20804_20906,cPa419,0.75,2,20879,20839,cPa15_cPa419,1_3,102,40
Scaffold455-3806_3988,cPa425,0.866666666666667,4,3973,3807,cPa345_cPa413-cPa109-hybrid_cPa413-cPa194-hybrid_cPa425,1_4_1_39,182,166
Scaffold455-4022_4134,cPa425,0.777777777777778,7,4082,4024,cPa111-cPa510-hybrid_cPa345_cPa345-cPa34-hybrid_cPa413-cPa194-hybrid_cPa413-cPa75-hybrid_cPa425_cPa75,1_1_1_3_1_28_1,112,58
Scaffold455-4223_4340,cPa425,0.614285714285714,6,4340,4257,cPa413_cPa413-cPa109-hybrid_cPa413-cPa194-hybrid_cPa413-cPa583-hybrid_cPa413-cPa75-hybrid_cPa425,5_12_4_4_2_43,117,83
Scaffold455-4431_4533,cPa111-cPa75-hybrid,0.3,5,4532,4432,cPa111-cPa109-hybrid_cPa111-cPa75-hybrid_cPa356-cPa109-hybrid_cPa413-cPa194-hybrid_cPa425,2_3_2_1_2,102,100
Scaffold455-4623_4961,cPa111-cPa194-hybrid,0.366771159874608,25,4930,4627,cPa111-cPa109-hybrid_cPa111-cPa194-hybrid_cPa111-cPa34-hybrid_cPa111-cPa434-hybrid_cPa111-cPa583-hybrid_cPa111-cPa75-hybrid_cPa34_cPa34-cPa194-hybrid_cPa345-cPa194-hybrid_cPa345-cPa34-hybrid_cPa356_cPa356-cPa194-hybrid_cPa356-cPa34-hybrid_cPa356-cPa434-hybrid_cPa356-cPa583-hybrid_cPa356-cPa75-hybrid_cPa413-cPa109-hybrid_cPa413-cPa194-hybrid_cPa413-cPa34-hybrid_cPa413-cPa434-hybrid_cPa413-cPa583-hybrid_cPa419_cPa425_cPa583_cPa75,4_117_5_2_19_2_30_1_1_1_35_22_3_1_2_2_1_43_6_1_6_1_5_8_1,338,303
Scaffold455-5280_5382,cPa111-cPa194-hybrid,0.428571428571429,7,5378,5330,cPa111-cPa194-hybrid_cPa111-cPa34-hybrid_cPa111-cPa583-hybrid_cPa111-cPa67-hybrid_cPa356_cPa356-cPa194-hybrid_cPa356-cPa345-hybrid,6_1_1_1_2_2_1,102,48
Scaffold455-659_774,cPa121-unknown,0.476923076923077,10,741,707,cPa121-cPa158-hybrid_cPa121-cPa248-hybrid_cPa121-cPa402-hybrid_cPa121-unknown_cPa158_cPa229-cPa158-hybrid_cPa34-cPa323-hybrid_cPa34-unknown_cPa402_cPa402-unknown,9_2_2_31_1_1_1_5_11_2,115,34
Scaffold455-6604_6706,cPa356,0.75,3,6676,6612,cPa356_cPa447-cPa293-hybrid_cPa447-cPa356-hybrid,6_1_1,102,64
Scaffold455-6815_6951,cPa356,0.5,4,6899,6846,cPa356_cPa356-MDEV_AF053745-hybrid_cPa447-cPa363-hybrid_cPa447-MDEV_AF053745-hybrid,3_1_1_1,136,53
Scaffold455-7420_7522,cPa419_cPa419-cPa164-hybrid_SMRV_NC001514-cPa293-hybrid,0.333333333333333,3,7508,7470,cPa419_cPa419-cPa164-hybrid_SMRV_NC001514-cPa293-hybrid,1_1_1,102,38
Scaffold456-10891_10993,cPa67,1,1,10941,10922,cPa67,2,102,19
Scaffold456-11018_11357,cPa67,0.652173913043478,3,11329,11068,cPa199_cPa345-cPa62-hybrid_cPa67,7_1_15,339,261
Scaffold456-11373_11475,cPa67,0.8,3,11441,11384,cPa199_cPa542-PtERV1_AC142352-hybrid_cPa67,1_1_8,102,57
Scaffold456-11626_11807,cPa67,0.785714285714286,4,11755,11627,cPa345-cPa62-hybrid_cPa419_cPa67_cPa75-PtERV1_AC142352-hybrid,1_1_11_1,181,128
Scaffold456-12052_12308,cPa67,1,1,12263,12058,cPa67,27,256,205
Scaffold456-12417_12519,cPa67,0.946428571428571,3,12518,12428,cPa419_cPa419-unknown_cPa67,2_1_53,102,90
Scaffold456-12646_12748,cPa67,0.878787878787879,4,12742,12645,cPa199-PtERV1_AC142352-hybrid_cPa433-cPa419-hybrid_cPa67_FrMuLV_NC001362-cPa62-hybrid,2_1_29_1,102,97
Scaffold456-13568_13670,cPa67,1,1,13670,13567,cPa67,23,102,103
Scaffold456-13675_13777,cPa67,1,1,13775,13683,cPa67,18,102,92
Scaffold456-13788_14099,cPa67,0.957446808510638,4,14083,13790,BLV_NC001414-cPa587-hybrid_cPa419_cPa62_cPa67,1_2_1_90,311,293
Scaffold456-14102_14204,cPa67,1,1,14163,14116,cPa67,14,102,47
Scaffold456-19220_19901,cPa391,0.463815789473684,16,19891,19224,cPa256_cPa256-cPa390-hybrid_cPa256-cPa61-hybrid_cPa260_cPa260-cPa104-hybrid_cPa260-cPa298-hybrid_cPa260-cPa390-hybrid_cPa260-unknown_cPa298_cPa390_cPa391_cPa391-cPa390-hybrid_cPa391-unknown_cPa392_cPa392-cPa298-hybrid_cPa419,4_1_1_123_2_1_1_11_1_5_141_1_2_1_1_8,681,667
Scaffold456-22560_22699,S71_repbase_HERVS71_LTR6A,0.333333333333333,5,22647,22609,cPa390_cPa419_cPa515_cPa553_S71_repbase_HERVS71_LTR6A,1_1_1_1_2,139,38
Scaffold456-22809_22931,cPa419_cPa515,0.4,3,22884,22854,cPa419_cPa515_S71_repbase_HERVS71_LTR6A,2_2_1,122,30
Scaffold456-2824_3031,cPa434,0.636363636363636,3,3029,2870,cPa434_cPa434-cPa404-hybrid_cPa434-unknown,7_1_3,207,159
Scaffold456-5398_5500,cPa356,0.666666666666667,2,5477,5401,cPa356_cPa492-cPa356-hybrid,4_2,102,76
Scaffold456-5640_5768,cPa492-cPa356-hybrid,0.333333333333333,4,5717,5643,cPa356_cPa492_cPa492-cPa356-hybrid_cPa492-unknown,4_4_5_2,128,74
Scaffold458-9108_9210,cPa356,0.8,2,9177,9149,cPa356_cPa428,4_1,102,28
Scaffold46-12435_12537,cPa345,0.888888888888889,2,12528,12460,cPa227-cPa345-hybrid_cPa345,1_8,102,68
Scaffold46-20417_20629,cPa61,0.451923076923077,13,20623,20427,cPa199-cPa450-hybrid_cPa205_cPa205-unknown_cPa227_cPa419_cPa419-cPa521-hybrid_cPa450-cPa434-hybrid_cPa450-cPa500-hybrid_cPa56-cPa500-hybrid_cPa582-cPa227-hybrid_cPa582-cPa62-hybrid_cPa61_cPa62,1_43_1_3_1_1_1_1_1_1_2_47_1,212,196
Scaffold46-20632_20734,cPa205,0.5,3,20702,20648,cPa205_cPa419_cPa61,3_1_2,102,54
Scaffold46-20741_20843,cPa205,0.6,4,20842,20740,cPa205_cPa273-cPa521-hybrid_cPa419_cPa61,6_1_1_2,102,102
Scaffold46-21178_21280,cPa205,0.5,4,21247,21187,cPa205_cPa419_cPa428_cPa61,3_1_1_1,102,60
Scaffold46-21561_21663,cPa205,0.428571428571429,4,21656,21583,cPa205_cPa419_cPa582-cPa229-hybrid_cPa61,3_1_1_2,102,73
Scaffold46-22025_22127,cPa205,0.666666666666667,2,22127,22028,cPa205_cPa61,6_3,102,99
Scaffold46-23237_23339,cPa205,0.588235294117647,5,23335,23241,cPa205_cPa339-HTLV2_M10060-hybrid_cPa419_cPa568_cPa61,20_1_1_1_11,102,94
Scaffold46-23551_23667,cPa205,0.692307692307692,2,23667,23572,cPa205_cPa61,27_12,116,95
Scaffold46-25630_25732,cPa358,0.5,3,25728,25654,cPa251_cPa358_cPa358-unknown,4_5_1,102,74
Scaffold46-25808_25910,cPa358,0.571428571428571,4,25896,25834,cPa251_cPa358_cPa358-cPa251-hybrid_cPa419,3_8_2_1,102,62
Scaffold46-4172_4425,cPa502,0.222222222222222,11,4373,4222,cPa270-cPa254-hybrid_cPa339_cPa392_cPa392-cPa254-hybrid_cPa392-unknown_cPa404-cPa339-hybrid_cPa425_cPa444-cPa62-hybrid_cPa47_cPa502_cPa521,1_1_1_1_1_1_3_1_2_4_2,253,151
Scaffold46-5822_5924,cPa419_cPa502,0.5,2,5872,5823,cPa419_cPa502,1_1,102,49
Scaffold46-58938_59040,cPa339_cPa456,0.5,2,58997,58988,cPa339_cPa456,1_1,102,9
Scaffold46-59875_59977,cPa339,1,1,59946,59893,cPa339,5,102,53
Scaffold46-60256_60358,cPa339,1,1,60325,60292,cPa339,4,102,33
Scaffold46-60649_60751,cPa339-cPa492-hybrid,0.4,4,60749,60696,cPa339_cPa339-cPa492-hybrid_cPa339-unknown_cPa419,1_2_1_1,102,53
Scaffold46-60809_61344,cPa379-cPa492-hybrid,0.657342657342657,8,61344,60811,cPa339_cPa339-cPa492-hybrid_cPa379_cPa379-cPa339-hybrid_cPa379-cPa492-hybrid_cPa379-unknown_cPa419_cPa492,4_24_3_1_94_7_2_8,535,533
Scaffold46-61383_61546,cPa492,0.533333333333333,4,61494,61433,cPa379-cPa492-hybrid_cPa419_cPa459-cPa492-hybrid_cPa492,5_1_1_8,163,61
Scaffold46-61571_61738,cPa379-cPa492-hybrid,0.625,3,61686,61621,cPa379-cPa492-hybrid_cPa379-unknown_cPa492,5_1_2,167,65
Scaffold46-63943_64045,cPa257-cPa174-hybrid,0.333333333333333,7,63995,63943,cPa257-cPa174-hybrid_cPa257-cPa254-hybrid_cPa285-cPa492-hybrid_cPa400-cPa174-hybrid_cPa404-cPa492-hybrid_cPa425_cPa75-cPa357-hybrid,3_1_1_1_1_1_1,102,52
Scaffold46-64221_64486,cPa257-cPa174-hybrid,0.359223300970874,26,64484,64259,cPa174_cPa254_cPa257-cPa174-hybrid_cPa257-cPa254-hybrid_cPa257-cPa392-hybrid_cPa257-cPa47-hybrid_cPa285-cPa174-hybrid_cPa285-cPa254-hybrid_cPa400-cPa174-hybrid_cPa400-cPa254-hybrid_cPa404_cPa404-cPa174-hybrid_cPa404-cPa254-hybrid_cPa404-cPa47-hybrid_cPa419_cPa419-cPa174-hybrid_cPa425_cPa425-cPa174-hybrid_cPa456-cPa174-hybrid_cPa47_cPa544-cPa174-hybrid_cPa546-cPa174-hybrid_cPa75-cPa174-hybrid_cPa75-cPa254-hybrid_MoMLV_J02255-cPa174-hybrid_MoMLV_J02255-cPa254-hybrid,4_1_37_2_2_1_3_1_7_1_5_17_3_1_5_1_1_1_1_2_1_2_1_1_1_1,265,225
Scaffold46-66052_66154,HML1b_repbase_HERV-K14I_LTR14A,1,1,66102,66102,HML1b_repbase_HERV-K14I_LTR14A,1,102,0
Scaffold460-15731_15833,cPa356_cPa428,0.5,2,15827,15781,cPa356_cPa428,4_4,102,46
Scaffold460-16369_16471,cPa428,0.8,2,16467,16417,cPa356_cPa428,1_4,102,50
Scaffold460-17243_17347,cPa428,0.583333333333333,2,17320,17246,cPa356_cPa428,5_7,104,74
Scaffold460-18695_18797,cPa428,0.75,2,18747,18730,cPa356_cPa428,1_3,102,17
Scaffold460-3075_3177,cPa428,0.666666666666667,2,3128,3119,cPa356_cPa428,1_2,102,9
Scaffold461-16192_16294,cPa419,1,1,16242,16242,cPa419,1,102,0
Scaffold461-18295_18449,cPa419,1,1,18426,18310,cPa419,22,154,116
Scaffold461-18470_18572,cPa419,1,1,18561,18484,cPa419,13,102,77
Scaffold461-18749_18853,cPa419,1,1,18850,18761,cPa419,12,104,89
Scaffold461-19401_19503,cPa419,1,1,19451,19402,cPa419,4,102,49
Scaffold461-19822_19927,cPa419,1,1,19884,19823,cPa419,9,105,61
Scaffold461-20189_20291,cPa419,1,1,20239,20239,cPa419,1,102,0
Scaffold461-20571_20673,cPa419,1,1,20672,20578,cPa419,18,102,94
Scaffold461-21639_21741,cPa419,1,1,21689,21641,cPa419,4,102,48
Scaffold461-21872_21974,cPa419,1,1,21971,21897,cPa419,9,102,74
Scaffold461-22018_22121,cPa419,1,1,22117,22022,cPa419,35,103,95
Scaffold461-22661_22768,cPa419,0.688405797101449,3,22729,22689,cPa229_cPa229-unknown_cPa419,19_24_95,107,40
Scaffold461-22793_22954,cPa419,1,1,22907,22842,cPa419,18,161,65
Scaffold461-22985_23087,cPa419,1,1,23037,22988,cPa419,5,102,49
Scaffold461-8415_8519,cPa419,1,1,8512,8422,cPa419,8,104,90
Scaffold461-8993_9095,cPa419,1,1,9062,9007,cPa419,13,102,55
Scaffold462-23850_23952,cPa447-STLV2_NC001815-hybrid,1,1,23900,23900,cPa447-STLV2_NC001815-hybrid,1,102,0
Scaffold462-6607_6709,cPa482-HERV-I_repbase_HERVI_LTR10B-hybrid,1,1,6657,6657,cPa482-HERV-I_repbase_HERVI_LTR10B-hybrid,1,102,0
Scaffold462-9001_9103,cPa285,0.666666666666667,2,9077,9006,cPa285_cPa293,2_1,102,71
Scaffold463-18955_19065,cPa391,0.8,3,19065,18965,cPa391_cPa391-cPa18-hybrid_cPa391-unknown,8_1_1,110,100
Scaffold463-3284_3386,cPa413,1,1,3352,3334,cPa413,4,102,18
Scaffold464-10552_10654,cPa419,1,1,10620,10556,cPa419,7,102,64
Scaffold464-10750_10852,cPa419,1,1,10850,10800,cPa419,5,102,50
Scaffold464-11140_11242,cPa419,1,1,11190,11180,cPa419,2,102,10
Scaffold464-11335_11437,cPa419,1,1,11412,11385,cPa419,2,102,27
Scaffold464-11483_11672,cPa419,1,1,11647,11533,cPa419,8,189,114
Scaffold464-3167_3269,cPa419,1,1,3237,3210,cPa419,3,102,27
Scaffold464-3288_3390,cPa419,1,1,3390,3292,cPa419,5,102,98
Scaffold464-3445_3547,cPa419,1,1,3519,3446,cPa419,29,102,73
Scaffold464-4119_4221,cPa419,1,1,4169,4149,cPa419,4,102,20
Scaffold464-4888_4990,cPa419,1,1,4938,4938,cPa419,1,102,0
Scaffold464-8934_9036,cPa419,1,1,9031,8984,cPa419,4,102,47
Scaffold464-9051_9214,cPa419,1,1,9203,9065,cPa419,37,163,138
Scaffold464-9234_9380,cPa419,1,1,9380,9235,cPa419,41,146,145
Scaffold464-9474_9599,cPa419,1,1,9584,9505,cPa419,16,125,79
Scaffold464-9636_9738,cPa419,1,1,9734,9669,cPa419,26,102,65
Scaffold464-9755_10288,cPa419,0.96,3,10281,9780,cPa229_cPa229-unknown_cPa419,2_3_120,533,501
Scaffold466-11048_11285,cPa566-cPa21-hybrid,0.380281690140845,25,11255,11064,cPa119-cPa21-hybrid_cPa125-cPa21-hybrid_cPa16_cPa16-cPa21-hybrid_cPa174-cPa21-hybrid_cPa21_cPa270-S71_repbase_HERVS71_LTR6A-hybrid_cPa379_cPa379-cPa21-hybrid_cPa404-cPa21-hybrid_cPa419_cPa419-cPa21-hybrid_cPa425-cPa21-hybrid_cPa443-cPa21-hybrid_cPa443-S71_repbase_HERVS71_LTR6A-hybrid_cPa446_cPa446-cPa21-hybrid_cPa566-cPa118-hybrid_cPa566-cPa140-hybrid_cPa566-cPa15-hybrid_cPa566-cPa16-hybrid_cPa566-cPa21-hybrid_cPa566-cPa268-hybrid_cPa566-cPa419-hybrid_cPa566-cPa443-hybrid,1_3_3_2_5_2_1_3_1_1_2_4_1_3_1_1_1_2_1_2_1_27_1_1_1,237,191
Scaffold466-16231_16414,cPa492-cPa512-hybrid,0.75,4,16406,16281,cPa419_cPa492-cPa512-hybrid_cPa492-unknown_HML6_repbase_HERVK3I_LTR3-BaEV_D10032-hybrid,1_9_1_1,183,125
Scaffold466-19026_19302,cPa101-cPa208-hybrid,0.733333333333333,12,19250,19076,cPa101_cPa101-cPa208-hybrid_cPa101-cPa512-hybrid_cPa101-cPa75-hybrid_cPa101-unknown_cPa145-cPa419-hybrid_cPa232-cPa208-hybrid_cPa419_cPa428_cPa582-cPa208-hybrid_cPa67-cPa232-hybrid_cPa67-cPa419-hybrid,2_44_1_1_1_1_1_3_1_3_1_1,276,174
Scaffold466-19340_19456,cPa315-cPa208-hybrid,0.5,3,19431,19390,cPa101-cPa75-hybrid_cPa145-cPa208-hybrid_cPa315-cPa208-hybrid,1_2_3,116,41
Scaffold466-19925_20125,cPa315-cPa208-hybrid,0.389558232931727,28,20114,19925,CAEV_NC001463-cPa208-hybrid_cPa101-cPa167-hybrid_cPa101-cPa323-hybrid_cPa101-cPa333-hybrid_cPa101-cPa381-hybrid_cPa101-cPa50-hybrid_cPa145-CAEV_NC001463-hybrid_cPa145-cPa167-hybrid_cPa145-cPa208-hybrid_cPa145-cPa323-hybrid_cPa145-cPa333-hybrid_cPa145-cPa381-hybrid_cPa145-cPa50-hybrid_cPa145-cPa568-hybrid_cPa145-cPa75-hybrid_cPa145-unknown_cPa190-cPa75-hybrid_cPa260-cPa208-hybrid_cPa315-cPa208-hybrid_cPa315-cPa521-hybrid_cPa315-cPa75-hybrid_cPa67-CAEV_NC001463-hybrid_cPa67-cPa208-hybrid_cPa67-cPa323-hybrid_cPa67-cPa333-hybrid_cPa67-cPa381-hybrid_cPa67-cPa75-hybrid_cPa67-unknown,3_4_5_2_5_1_1_4_24_24_18_21_2_1_1_5_1_2_97_1_2_1_3_9_2_8_1_1,200,189
Scaffold466-21336_21438,cPa315-cPa333-hybrid,0.2,8,21436,21368,cPa190-cPa323-hybrid_cPa199-cPa323-hybrid_cPa199-cPa333-hybrid_cPa199-cPa381-hybrid_cPa199-cPa568-hybrid_cPa315-cPa323-hybrid_cPa315-cPa333-hybrid_cPa315-cPa381-hybrid,2_2_2_1_1_2_3_2,102,68
Scaffold466-22099_22240,cPa541,0.540540540540541,8,22188,22145,cPa190_cPa190-cPa541-hybrid_cPa199-cPa381-hybrid_cPa223-cPa333-hybrid_cPa260-cPa323-hybrid_cPa345-cPa381-hybrid_cPa482-cPa323-hybrid_cPa541,10_2_1_1_1_1_1_20,141,43
Scaffold466-22962_23120,cPa190-cPa113-hybrid_cPa190-cPa395-hybrid_cPa482-cPa113-hybrid_cPa482-unknown,0.25,4,23068,23012,cPa190-cPa113-hybrid_cPa190-cPa395-hybrid_cPa482-cPa113-hybrid_cPa482-unknown,1_1_1_1,158,56
Scaffold466-23165_23530,cPa113,0.381538461538462,40,23530,23215,cPa104-cPa332-hybrid_cPa113_cPa113-unknown_cPa174-cPa332-hybrid_cPa190-cPa113-hybrid_cPa190-cPa332-hybrid_cPa190-cPa395-hybrid_cPa190-cPa402-hybrid_cPa190-cPa527-hybrid_cPa190-cPa566-hybrid_cPa199-cPa113-hybrid_cPa199-cPa223-hybrid_cPa199-cPa332-hybrid_cPa199-cPa566-hybrid_cPa199-unknown_cPa205-cPa332-hybrid_cPa205-cPa566-hybrid_cPa205-unknown_cPa223-cPa113-hybrid_cPa223-cPa332-hybrid_cPa223-cPa566-hybrid_cPa260-cPa113-hybrid_cPa260-cPa332-hybrid_cPa315-cPa113-hybrid_cPa315-cPa332-hybrid_cPa315-cPa566-hybrid_cPa332_cPa345-cPa332-hybrid_cPa413-cPa113-hybrid_cPa413-cPa332-hybrid_cPa413-cPa395-hybrid_cPa413-cPa566-hybrid_cPa413-SIV_NC001870-hybrid_cPa425-cPa381-hybrid_cPa450-cPa113-hybrid_cPa482-cPa113-hybrid_cPa482-cPa332-hybrid_cPa482-unknown_cPa541-cPa113-hybrid_cPa541-cPa332-hybrid,1_124_1_1_5_46_1_1_1_13_16_1_20_2_4_4_5_1_2_3_1_3_3_8_2_5_19_2_3_10_1_6_1_1_1_1_2_1_2_1,365,315
Scaffold466-4824_4943,cPa163-PERVC_HM159246-hybrid,0.223684210526316,23,4942,4874,cPa118-cPa125-hybrid_cPa125_cPa125-PERVC_HM159246-hybrid_cPa15-PERVC_HM159246-hybrid_cPa163-cPa125-hybrid_cPa163-PERVC_HM159246-hybrid_cPa176-PERVC_HM159246-hybrid_cPa194_cPa205-cPa125-hybrid_cPa205-PERVC_HM159246-hybrid_cPa264-PERVC_HM159246-hybrid_cPa268-PERVC_HM159246-hybrid_cPa308-PERVC_HM159246-hybrid_cPa339-PERVC_HM159246-hybrid_cPa394-cPa107-hybrid_cPa394-PERVC_HM159246-hybrid_cPa410-PERVC_HM159246-hybrid_cPa419_cPa465-cPa194-hybrid_cPa465-cPa199-hybrid_cPa465-PERVC_HM159246-hybrid_cPa61-cPa125-hybrid_cPa61-PERVC_HM159246-hybrid,1_1_1_2_3_17_1_6_1_7_2_1_2_1_1_8_1_2_5_1_10_1_1,119,68
Scaffold466-5672_5976,cPa163-cPa194-hybrid,0.200854700854701,48,5973,5684,cPa118-cPa125-hybrid_cPa118-cPa194-hybrid_cPa125-cPa194-hybrid_cPa138-PERVC_HM159246-hybrid_cPa140-PERVC_HM159246-hybrid_cPa15_cPa15-cPa125-hybrid_cPa15-cPa194-hybrid_cPa15-PERVC_HM159246-hybrid_cPa163-cPa125-hybrid_cPa163-cPa194-hybrid_cPa163-PERVC_HM159246-hybrid_cPa176-cPa194-hybrid_cPa176-PERVC_HM159246-hybrid_cPa205-cPa107-hybrid_cPa205-cPa194-hybrid_cPa264-cPa194-hybrid_cPa264-PERVC_HM159246-hybrid_cPa268-cPa194-hybrid_cPa268-PERVC_HM159246-hybrid_cPa308-cPa125-hybrid_cPa308-PERVC_HM159246-hybrid_cPa394-cPa199-hybrid_cPa394-cPa273-hybrid_cPa394-cPa345-hybrid_cPa410_cPa419_cPa419-cPa345-hybrid_cPa419-PERVC_HM159246-hybrid_cPa443_cPa443-PERVC_HM159246-hybrid_cPa452-cPa194-hybrid_cPa465-cPa125-hybrid_cPa465-cPa194-hybrid_cPa465-cPa199-hybrid_cPa465-cPa345-hybrid_cPa465-cPa419-hybrid_cPa516_cPa542_cPa542-cPa125-hybrid_cPa542-cPa194-hybrid_cPa542-cPa199-hybrid_cPa542-cPa227-hybrid_cPa542-cPa273-hybrid_cPa542-cPa345-hybrid_cPa566-cPa285-hybrid_cPa61-cPa194-hybrid_cPa61-cPa345-hybrid,1_1_2_1_1_4_1_2_3_3_47_17_3_6_1_15_1_8_1_4_1_4_2_1_1_1_3_1_1_3_6_1_2_34_1_1_1_1_9_1_20_5_3_3_3_1_1_1,304,289
Scaffold466-6113_6496,cPa163-cPa194-hybrid,0.19560878243513,100,6496,6112,cPa118_cPa118-cPa345-hybrid_cPa118-cPa553-hybrid_cPa119-cPa118-hybrid_cPa119-cPa199-hybrid_cPa119-cPa223-hybrid_cPa119-cPa273-hybrid_cPa119-cPa345-hybrid_cPa119-cPa553-hybrid_cPa125_cPa125-cPa273-hybrid_cPa138-cPa194-hybrid_cPa15_cPa15-cPa118-hybrid_cPa15-cPa125-hybrid_cPa15-cPa194-hybrid_cPa15-cPa199-hybrid_cPa15-cPa223-hybrid_cPa15-cPa450-hybrid_cPa163-cPa125-hybrid_cPa163-cPa194-hybrid_cPa163-cPa199-hybrid_cPa163-cPa223-hybrid_cPa163-cPa227-hybrid_cPa163-cPa273-hybrid_cPa163-cPa345-hybrid_cPa163-cPa450-hybrid_cPa163-cPa553-hybrid_cPa163-cPa61-hybrid_cPa163-PERVC_HM159246-hybrid_cPa176-cPa194-hybrid_cPa176-cPa199-hybrid_cPa176-cPa273-hybrid_cPa176-cPa553-hybrid_cPa199_cPa199-cPa125-hybrid_cPa205-cPa107-hybrid_cPa205-cPa125-hybrid_cPa205-cPa140-hybrid_cPa205-cPa194-hybrid_cPa205-cPa199-hybrid_cPa205-cPa223-hybrid_cPa205-cPa273-hybrid_cPa205-cPa308-hybrid_cPa205-cPa345-hybrid_cPa205-cPa404-hybrid_cPa205-cPa450-hybrid_cPa205-cPa553-hybrid_cPa205-cPa566-hybrid_cPa223_cPa255-cPa140-hybrid_cPa268-cPa194-hybrid_cPa308_cPa308-cPa125-hybrid_cPa308-cPa194-hybrid_cPa339-cPa194-hybrid_cPa345_cPa394-cPa199-hybrid_cPa394-cPa223-hybrid_cPa394-cPa345-hybrid_cPa394-cPa419-hybrid_cPa410-cPa345-hybrid_cPa419_cPa419-cPa345-hybrid_cPa443_cPa443-cPa194-hybrid_cPa452-cPa194-hybrid_cPa452-cPa273-hybrid_cPa452-cPa450-hybrid_cPa452-PERVC_HM159246-hybrid_cPa465-cPa107-hybrid_cPa465-cPa118-hybrid_cPa465-cPa125-hybrid_cPa465-cPa140-hybrid_cPa465-cPa15-hybrid_cPa465-cPa176-hybrid_cPa465-cPa194-hybrid_cPa465-cPa199-hybrid_cPa465-cPa223-hybrid_cPa465-cPa227-hybrid_cPa465-cPa273-hybrid_cPa465-cPa308-hybrid_cPa465-cPa345-hybrid_cPa465-cPa450-hybrid_cPa465-cPa553-hybrid_cPa465-cPa566-hybrid_cPa465-unknown_cPa516_cPa516-cPa450-hybrid_cPa542_cPa542-cPa125-hybrid_cPa542-cPa199-hybrid_cPa542-cPa273-hybrid_cPa542-cPa553-hybrid_cPa553_cPa553-cPa125-hybrid_cPa553-cPa345-hybrid_cPa566_cPa61_MPMVs_NC001550-cPa194-hybrid,1_1_2_1_5_4_1_2_4_7_1_1_18_1_1_7_3_1_1_12_98_8_2_2_4_19_2_9_1_4_4_1_1_1_2_1_1_1_1_8_7_3_4_2_6_1_3_5_1_1_1_1_1_1_2_1_1_3_1_1_1_3_5_1_6_1_5_1_1_2_2_2_8_2_2_2_25_25_10_8_21_1_30_4_16_1_2_2_1_5_1_2_1_1_2_1_2_3_2_1,383,384
Scaffold466-7387_7489,cPa308,0.210526315789474,11,7437,7387,cPa119-PERVB_AY099324-hybrid_cPa140_cPa163-cPa443-hybrid_cPa176_cPa308_cPa419_cPa419-cPa140-hybrid_cPa452-cPa140-hybrid_cPa452-cPa174-hybrid_cPa452-cPa176-hybrid_cPa452-cPa443-hybrid,3_1_1_3_4_1_1_2_1_1_1,102,50
Scaffold466-7969_8105,cPa176,0.389312977099237,39,8080,7976,cPa118_cPa119_cPa119-cPa174-hybrid_cPa119-cPa273-hybrid_cPa119-cPa425-hybrid_cPa119-cPa47-hybrid_cPa140_cPa15_cPa15-cPa199-hybrid_cPa163-cPa118-hybrid_cPa163-cPa125-hybrid_cPa163-cPa140-hybrid_cPa163-cPa15-hybrid_cPa163-cPa174-hybrid_cPa163-cPa176-hybrid_cPa163-cPa419-hybrid_cPa176_cPa176-cPa118-hybrid_cPa176-cPa125-hybrid_cPa176-cPa199-hybrid_cPa176-cPa268-hybrid_cPa176-cPa308-hybrid_cPa176-cPa345-hybrid_cPa176-cPa47-hybrid_cPa254-cPa140-hybrid_cPa268_cPa339-cPa443-hybrid_cPa404_cPa404-cPa199-hybrid_cPa419_cPa419-cPa404-hybrid_cPa419-cPa443-hybrid_cPa425_cPa452-cPa118-hybrid_cPa452-cPa125-hybrid_cPa452-cPa140-hybrid_cPa452-cPa75-hybrid_cPa47_cPa75,1_1_1_1_1_1_1_22_1_1_1_7_2_1_1_1_51_1_1_1_1_1_1_1_1_1_1_1_1_9_1_1_3_1_1_1_1_5_1,136,104
Scaffold468-1305_1469,cPa407,0.571428571428571,3,1469,1331,cPa2_cPa407_cPa510-cPa142-hybrid,2_4_1,164,138
Scaffold468-14733_14986,cPa360_cPa360-cPa75-hybrid_cPa542-cPa360-hybrid,0.333333333333333,3,14934,14783,cPa360_cPa360-cPa75-hybrid_cPa542-cPa360-hybrid,1_1_1,253,151
Scaffold468-15011_15113,cPa402-cPa75-hybrid,0.375,4,15065,15015,ALVJ_Z46390-cPa75-hybrid_cPa193_cPa402-cPa75-hybrid_cPa419,1_2_3_2,102,50
Scaffold468-17233_17444,cPa447-cPa75-hybrid,0.4,4,17397,17280,cPa419_cPa447-cPa2-hybrid_cPa447-cPa75-hybrid_cPa515,2_3_4_1,211,117
Scaffold469-15274_15423,cPa428,0.625,2,15377,15281,cPa356_cPa428,12_20,149,96
Scaffold469-15555_15697,cPa428,0.6,2,15685,15583,cPa356_cPa428,12_18,142,102
Scaffold47-18629_18731,cPa339,0.909090909090909,2,18697,18637,cPa339_cPa419,10_1,102,60
Scaffold47-20531_20775,cPa339,0.891891891891892,3,20723,20532,cPa339_cPa353_cPa419,33_1_3,244,191
Scaffold47-20821_20974,cPa339,0.843137254901961,6,20966,20833,cPa339_cPa339-unknown_cPa353_cPa353-unknown_cPa459-cPa435-hybrid_HML7_repbase_HERVK11DI_MER11D,43_2_3_1_1_1,153,133
Scaffold47-21117_21219,cPa339,1,1,21171,21117,cPa339,12,102,54
Scaffold47-23010_23112,cPa339_cPa459-cPa208-hybrid,0.5,2,23076,23060,cPa339_cPa459-cPa208-hybrid,1_1,102,16
Scaffold47-23118_23274,HML1a_repbase_HERV-K14CI_LTR14C,0.647058823529412,3,23261,23168,cPa339-HML1a_repbase_HERV-K14CI_LTR14C-hybrid_cPa459-cPa208-hybrid_HML1a_repbase_HERV-K14CI_LTR14C,1_5_11,156,93
Scaffold47-4182_4284,cPa362-HERV-XA34_repbase_HERVFH21I_LTR21A-hybrid_EIAV_NC001450-cPa248-hybrid,0.5,2,4269,4232,cPa362-HERV-XA34_repbase_HERVFH21I_LTR21A-hybrid_EIAV_NC001450-cPa248-hybrid,1_1,102,37
Scaffold47-7507_7652,cPa168,0.471910112359551,15,7620,7533,cPa152-unknown_cPa168_cPa168-unknown_cPa199-cPa315-hybrid_cPa199-unknown_cPa419_HERV-I_repbase_HERVI_LTR10B-cPa168-hybrid_HERV-I_repbase_HERVI_LTR10B-cPa315-hybrid_HERV-I_repbase_HERVI_LTR10B-unknown_JSRV_DQ838494-cPa315-hybrid_JSRV_DQ838494-unknown_SIV_NC001870-cPa315-hybrid_SIV_NC001870-cPa492-hybrid_SIV_NC001870-cPa75-hybrid_SIV_NC001870-unknown,12_42_2_1_2_1_1_1_9_1_6_1_1_1_8,145,87
Scaffold470-2805_2907,cPa219,1,1,2855,2855,cPa219,1,102,0
Scaffold470-804_906,cPa360,1,1,854,854,cPa360,1,102,0
Scaffold475-12967_13069,cPa371,0.285714285714286,6,13028,12966,cPa118_cPa260_cPa260-cPa308-hybrid_cPa260-cPa419-hybrid_cPa371_cPa434,1_1_1_1_2_1,102,62
Scaffold475-13086_13332,cPa434,0.610062893081761,19,13308,13113,cPa130_cPa260_cPa264-cPa308-hybrid_cPa264-cPa425-hybrid_cPa308_cPa371_cPa379-cPa260-hybrid_cPa419_cPa434_cPa434-cPa118-hybrid_cPa434-cPa260-hybrid_cPa434-cPa308-hybrid_cPa434-cPa371-hybrid_cPa434-cPa425-hybrid_cPa434-cPa459-hybrid_cPa434-unknown_cPa459_cPa492-cPa308-hybrid_HML1a_repbase_HERV-K14CI_LTR14C-cPa308-hybrid,1_1_1_1_2_10_1_9_97_2_1_5_1_6_2_16_1_1_1,246,195
Scaffold475-13468_13570,cPa434-unknown,0.666666666666667,2,13565,13475,cPa434-unknown_cPa492-cPa260-hybrid,2_1,102,90
Scaffold475-13623_13842,cPa419,0.27027027027027,16,13807,13627,cPa199-cPa125-hybrid_cPa199-cPa260-hybrid_cPa199-HERV-XA34_repbase_HERVFH21I_LTR21A-hybrid_cPa270-cPa125-hybrid_cPa270-cPa260-hybrid_cPa270-HERV-XA34_repbase_HERVFH21I_LTR21A-hybrid_cPa381-HERV-XA34_repbase_HERVFH21I_LTR21A-hybrid_cPa390-cPa260-hybrid_cPa419_cPa428_cPa434-cPa539-hybrid_cPa434-unknown_cPa459-cPa260-hybrid_cPa539_cPa62-cPa260-hybrid_HML1a_repbase_HERV-K14CI_LTR14C-cPa459-hybrid,1_1_1_1_1_1_1_3_10_1_2_8_1_1_3_1,219,180
Scaffold475-15345_15447,cPa419_cPa71,0.25,6,15395,15344,cPa293_cPa419_cPa419-cPa254-hybrid_cPa492-cPa125-hybrid_cPa71_HML1a_repbase_HERV-K14CI_LTR14C-cPa125-hybrid,1_2_1_1_2_1,102,51
Scaffold475-15751_15884,HML2_Pheonix,0.722222222222222,11,15834,15750,cPa125_cPa199-cPa125-hybrid_cPa293-cPa71-hybrid_cPa387-cPa125-hybrid_cPa387-cPa71-hybrid_cPa419_cPa428-cPa71-hybrid_cPa505-cPa71-hybrid_HML2_Pheonix_HML2_Pheonix-cPa71-hybrid_HML2_Pheonix-unknown,1_2_1_2_1_1_1_1_39_2_3,133,84
Scaffold475-19681_19836,cPa419,0.6,6,19828,19717,cPa254_cPa285-cPa254-hybrid_cPa419_cPa428_cPa62_HIV2_NC001722-cPa62-hybrid,1_1_9_1_2_1,155,111
Scaffold475-19926_20052,cPa419,0.666666666666667,3,20018,19970,cPa254_cPa419_cPa62,1_4_1,126,48
Scaffold475-8872_9113,cPa177,0.55,5,9106,8922,cPa177_cPa419_cPa56-cPa419-hybrid_cPa56-cPa551-hybrid_cPa56-unknown,11_2_1_2_4,241,184
Scaffold476-13794_14047,cPa428,0.532467532467532,2,14013,13814,cPa356_cPa428,36_41,253,199
Scaffold476-14084_14329,cPa428,0.513513513513513,2,14317,14134,cPa356_cPa428,36_38,245,183
Scaffold476-14734_14836,cPa428,0.620689655172414,2,14812,14755,cPa356_cPa428,11_18,102,57
Scaffold476-15066_15268,cPa428,0.636363636363636,2,15230,15116,cPa356_cPa428,4_7,202,114
Scaffold476-18007_18109,cPa428,1,1,18057,18057,cPa428,1,102,0
Scaffold476-20545_20732,cPa428,0.565217391304348,2,20680,20561,cPa356_cPa428,30_39,187,119
Scaffold476-20978_21082,cPa428,0.625,2,21038,21016,cPa356_cPa428,3_5,104,22
Scaffold476-22383_22485,cPa356,0.571428571428571,2,22468,22383,cPa356_cPa428,12_9,102,85
Scaffold477-1922_2162,cPa356,0.519685039370079,3,2158,1941,cPa356_cPa356-unknown_cPa428,66_1_60,240,217
Scaffold478-20373_20475,cPa428,1,1,20423,20423,cPa428,1,102,0
Scaffold479-7753_7855,cPa75-unknown,1,1,7803,7803,cPa75-unknown,1,102,0
Scaffold48-10664_10775,cPa339,0.76056338028169,2,10743,10666,cPa339_cPa353,54_17,111,77
Scaffold48-11119_11221,cPa339,0.828358208955224,4,11219,11118,cPa339_cPa353_cPa353-unknown_cPa419,111_21_1_1,102,101
Scaffold48-17955_18161,BFV_NC001831-cPa285-hybrid,0.129032258064516,21,18109,18005,BFV_NC001831-cPa285-hybrid_BFV_NC001831-cPa287-hybrid_BFV_NC001831-cPa75-hybrid_cPa15-cPa75-hybrid_cPa257-cPa138-hybrid_cPa257-cPa224-hybrid_cPa257-cPa254-hybrid_cPa285_cPa357-cPa138-hybrid_cPa357-unknown_cPa400-cPa224-hybrid_cPa400-cPa285-hybrid_cPa400-cPa456-hybrid_cPa400-cPa62-hybrid_cPa400-cPa75-hybrid_cPa456_cPa456-cPa224-hybrid_cPa456-cPa285-hybrid_cPa456-cPa62-hybrid_cPa456-cPa75-hybrid_cPa456-unknown,4_2_3_1_1_1_1_1_1_1_1_3_1_1_1_1_1_2_2_1_1,206,104
Scaffold48-18225_18345,cPa456-cPa138-hybrid_cPa544-cPa285-hybrid,0.155555555555556,21,18293,18258,BFV_NC001831-cPa254-hybrid_BFV_NC001831-cPa285-hybrid_BFV_NC001831-cPa287-hybrid_BFV_NC001831-cPa456-hybrid_BFV_NC001831-cPa75-hybrid_cPa247-cPa285-hybrid_cPa247-cPa287-hybrid_cPa247-cPa62-hybrid_cPa257-cPa138-hybrid_cPa400_cPa400-cPa138-hybrid_cPa456-cPa138-hybrid_cPa544-cPa254-hybrid_cPa544-cPa285-hybrid_cPa544-cPa287-hybrid_cPa544-cPa293-hybrid_cPa544-cPa62-hybrid_cPa544-cPa75-hybrid_cPa545-cPa254-hybrid_cPa545-cPa285-hybrid_cPa545-cPa287-hybrid,1_4_2_1_1_1_1_1_1_1_6_7_1_7_2_1_2_1_1_1_2,120,35
Scaffold48-18608_18710,BFV_NC001831-cPa287-hybrid_cPa257-cPa138-hybrid,0.285714285714286,5,18665,18647,BFV_NC001831-cPa285-hybrid_BFV_NC001831-cPa287-hybrid_BFV_NC001831-cPa75-hybrid_cPa257-cPa138-hybrid_cPa456-cPa138-hybrid,1_2_1_2_1,102,18
Scaffold48-19015_19118,cPa138,0.909090909090909,2,19114,19065,cPa138_cPa400-cPa138-hybrid,10_1,103,49
Scaffold48-19130_19301,BFV_NC001831-unknown,0.181818181818182,17,19296,19180,BFV_NC001831-cPa138-hybrid_BFV_NC001831-cPa285-hybrid_BFV_NC001831-cPa400-hybrid_BFV_NC001831-FeFV_NC001871-hybrid_BFV_NC001831-unknown_cPa117-cPa138-hybrid_cPa138_cPa247-cPa138-hybrid_cPa247-unknown_cPa332-cPa138-hybrid_cPa400-cPa138-hybrid_cPa544-cPa138-hybrid_cPa544-cPa492-hybrid_cPa544-unknown_cPa545-cPa138-hybrid_cPa545-cPa400-hybrid_cPa545-unknown,5_1_1_2_6_3_2_1_1_1_1_3_1_1_2_1_1,171,116
Scaffold48-5348_5450,cPa572-cPa109-hybrid,1,1,5398,5398,cPa572-cPa109-hybrid,1,102,0
Scaffold48-7761_7899,HML1a_repbase_HERV-K14CI_LTR14C,0.611111111111111,4,7861,7789,cPa208_cPa208-cPa109-hybrid_HML1a_repbase_HERV-K14CI_LTR14C_HML1a_repbase_HERV-K14CI_LTR14C-unknown,4_1_11_2,138,72
Scaffold48-7973_8214,HML1a_repbase_HERV-K14CI_LTR14C,0.630769230769231,9,8212,8013,cPa109-HML1a_repbase_HERV-K14CI_LTR14C-hybrid_cPa208_cPa339_cPa339-unknown_cPa419-HML1a_repbase_HERV-K14CI_LTR14C-hybrid_cPa459_cPa61_HML1a_repbase_HERV-K14CI_LTR14C_STLV1_NC000858-cPa208-hybrid,1_8_6_1_1_1_4_41_2,241,199
Scaffold482-10176_10278,cPa356,1,1,10226,10226,cPa356,1,102,0
Scaffold482-10432_10534,cPa356,1,1,10482,10482,cPa356,1,102,0
Scaffold482-10956_11058,cPa428,1,1,11006,11006,cPa428,1,102,0
Scaffold482-12695_12797,cPa428,0.666666666666667,2,12759,12745,cPa356_cPa428,1_2,102,14
Scaffold482-13073_13175,cPa356_cPa428,0.5,2,13157,13123,cPa356_cPa428,2_2,102,34
Scaffold482-13208_13310,cPa428,0.75,2,13297,13258,cPa356_cPa428,1_3,102,39
Scaffold482-13666_13768,cPa428,0.571428571428571,3,13755,13690,cPa356_cPa356-unknown_cPa428,5_1_8,102,65
Scaffold482-7697_7799,cPa428,1,1,7747,7747,cPa428,1,102,0
Scaffold484-10806_10962,cPa273,0.785714285714286,5,10928,10854,cPa273_cPa273-cPa419-hybrid_cPa419_cPa62-cPa273-hybrid_cPa75,33_1_6_1_1,156,74
Scaffold484-1171_1413,cPa75,1,1,1407,1219,cPa75,17,242,188
Scaffold484-11833_11935,cPa419,0.666666666666667,2,11910,11834,cPa419_cPa75,2_1,102,76
Scaffold484-12731_12833,cPa419,0.666666666666667,2,12791,12733,cPa419_cPa75,2_1,102,58
Scaffold484-1500_1634,cPa75,1,1,1633,1501,cPa75,50,134,132
Scaffold484-15819_15921,cPa419,0.5,4,15882,15818,cPa323-cPa223-hybrid_cPa323-cPa419-hybrid_cPa323-unknown_cPa419,1_1_2_4,102,64
Scaffold484-2250_2705,cPa75,0.878048780487805,4,2689,2254,cPa542_cPa542-cPa200-hybrid_cPa75_cPa95-cPa74-hybrid,2_1_36_2,455,435
Scaffold484-3347_3467,cPa308,0.37037037037037,11,3453,3365,cPa16_cPa287-cPa200-hybrid_cPa293-cPa74-hybrid_cPa308_cPa308-cPa16-hybrid_cPa308-unknown_cPa419_cPa95-cPa308-hybrid_cPa95-cPa391-hybrid_cPa95-cPa426-hybrid_cPa95-unknown,17_1_1_20_2_1_3_1_1_1_6,120,88
Scaffold484-4457_4574,cPa308,0.833333333333333,4,4522,4457,cPa199-cPa308-hybrid_cPa308_cPa419_cPa452,1_20_2_1,117,65
Scaffold484-6585_6687,cPa345,0.764705882352941,5,6674,6588,cPa247_cPa345_cPa363_cPa452_cPa71,1_13_1_1_1,102,86
Scaffold484-6717_6819,cPa345,0.75,2,6775,6737,cPa247_cPa345,2_6,102,38
Scaffold484-7077_7179,cPa345,1,1,7166,7127,cPa345,4,102,39
Scaffold484-7272_7374,cPa345,0.875,3,7359,7276,cPa345_cPa345-unknown_cPa419,14_1_1,102,83
Scaffold484-8659_8859,cPa345,0.555555555555556,5,8836,8677,cPa199_cPa199-cPa273-hybrid_cPa227_cPa345_cPa450,1_1_1_5_1,200,159
Scaffold484-956_1060,cPa75,0.818181818181818,2,1057,965,cPa447_cPa75,2_9,104,92
Scaffold485-1510_1705,cPa356_cPa428,0.5,2,1653,1560,cPa356_cPa428,1_1,195,93
Scaffold485-21461_21563,cPa356_cPa428,0.5,2,21536,21511,cPa356_cPa428,2_2,102,25
Scaffold485-21638_21740,cPa428,0.666666666666667,2,21688,21640,cPa356_cPa428,1_2,102,48
Scaffold485-21852_21954,cPa356,0.571428571428571,3,21932,21851,cPa356_cPa356-unknown_cPa428,8_1_5,102,81
Scaffold485-22089_22191,cPa356,1,1,22139,22107,cPa356,3,102,32
Scaffold487-11148_11250,cPa419,1,1,11198,11198,cPa419,1,102,0
Scaffold487-12846_12948,cPa419,1,1,12896,12896,cPa419,1,102,0
Scaffold487-1493_1595,cPa419,1,1,1543,1543,cPa419,1,102,0
Scaffold487-16500_16602,cPa419,1,1,16550,16550,cPa419,1,102,0
Scaffold487-1687_1827,cPa419,1,1,1823,1688,cPa419,23,140,135
Scaffold487-17926_18028,cPa419,1,1,17976,17976,cPa419,1,102,0
Scaffold487-2359_2526,cPa419,1,1,2474,2391,cPa419,73,167,83
Scaffold487-2724_2881,cPa419,1,1,2838,2732,cPa419,41,157,106
Scaffold487-2916_3275,cPa419,1,1,3266,2915,cPa419,77,359,351
Scaffold488-11128_11230,cPa419,0.222222222222222,12,11230,11128,cPa118_cPa118-cPa285-hybrid_cPa118-cPa62-hybrid_cPa118-cPa75-hybrid_cPa118-unknown_cPa15-cPa285-hybrid_cPa15-cPa75-hybrid_cPa248-cPa75-hybrid_cPa419_cPa443-cPa419-hybrid_cPa443-unknown_cPa62,1_1_1_1_1_1_1_2_4_1_1_3,102,102
Scaffold488-17054_17156,cPa447-cPa521-hybrid,1,1,17104,17104,cPa447-cPa521-hybrid,1,102,0
Scaffold488-6493_6595,cPa419,0.666666666666667,2,6584,6543,cPa419_cPa428,2_1,102,41
Scaffold488-7575_7677,cPa62,0.4375,9,7662,7586,cPa254_cPa419_cPa419-HML1a_repbase_HERV-K14CI_LTR14C-hybrid_cPa47_cPa582-unknown_cPa62_cPa75_cPa75-unknown_MDEV_AF053745,1_11_1_1_1_14_1_1_1,102,76
Scaffold488-9134_9236,rRVRV_JQ303225,0.368421052631579,6,9222,9142,cPa356_cPa419_cPa539-unknown_cPa62_rRVRV_JQ303225_rRVRV_JQ303225-unknown,1_5_1_2_7_3,102,80
Scaffold489-10139_10241,cPa413,0.666666666666667,3,10192,10165,cPa413_cPa413-unknown_cPa419,6_2_1,102,27
Scaffold489-10258_10425,cPa413,0.91304347826087,2,10373,10294,cPa413_cPa413-unknown,21_2,167,79
Scaffold489-10442_10544,cPa413,1,1,10492,10492,cPa413,1,102,0
Scaffold489-11445_11547,cPa413-cPa255-hybrid,1,1,11495,11495,cPa413-cPa255-hybrid,1,102,0
Scaffold489-1232_1708,cPa413,0.811475409836066,10,1707,1252,cPa199_cPa199-cPa273-hybrid_cPa199-cPa413-hybrid_cPa199-unknown_cPa273_cPa413_cPa413-unknown_cPa419_cPa486_cPa62,29_1_2_6_3_198_1_2_1_1,476,455
Scaffold489-12648_12972,cPa15,0.329545454545455,14,12920,12652,cPa118-cPa323-hybrid_cPa118-cPa585-hybrid_cPa15_cPa15-cPa308-hybrid_cPa15-cPa323-hybrid_cPa15-cPa539-hybrid_cPa15-cPa585-hybrid_cPa15-unknown_cPa248-cPa118-hybrid_cPa268-cPa585-hybrid_cPa456_cPa456-cPa323-hybrid_cPa456-cPa585-hybrid_cPa456-unknown,2_8_29_1_1_2_17_19_1_2_2_1_1_2,324,268
Scaffold489-13002_13175,cPa585,0.842105263157895,4,13123,13023,cPa539_cPa539-cPa585-hybrid_cPa585_HML6_repbase_HERVK3I_LTR3,1_1_16_1,173,100
Scaffold489-13982_14084,cPa552,0.666666666666667,2,14055,14032,cPa552_cPa75,2_1,102,23
Scaffold489-14157_14259,cPa552_cPa552-unknown,0.5,2,14210,14207,cPa552_cPa552-unknown,1_1,102,3
Scaffold489-2268_2370,cPa199,0.571428571428571,6,2330,2279,cPa199_cPa390-cPa486-hybrid_cPa413_cPa419_cPa486_cPa62,8_1_1_1_2_1,102,51
Scaffold489-6320_6656,cPa413,0.879781420765027,9,6656,6320,cPa332-cPa425-hybrid_cPa413_cPa419_cPa456-CAEV_NC001463-hybrid_cPa456-cPa232-hybrid_cPa456-cPa425-hybrid_cPa583-cPa425-hybrid_SFV_U04327-cPa188-hybrid_SFV_U04327-cPa61-hybrid,2_161_2_1_1_2_2_8_4,336,336
Scaffold489-6659_6831,cPa413,0.926605504587156,7,6820,6690,cPa332-cPa425-hybrid_cPa413_cPa419_cPa456-CAEV_NC001463-hybrid_cPa456-cPa425-hybrid_cPa583-cPa425-hybrid_SFV_U04327,2_101_2_1_1_1_1,172,130
Scaffold489-8102_8536,cPa456,0.267267267267267,34,8485,8111,cPa188_cPa332_cPa332-cPa188-hybrid_cPa332-cPa425-hybrid_cPa332-cPa456-hybrid_cPa332-cPa61-hybrid_cPa332-cPa75-hybrid_cPa332-cPa95-hybrid_cPa332-MMTV_NC001503-hybrid_cPa332-unknown_cPa357-cPa188-hybrid_cPa402-cPa545-hybrid_cPa402-cPa61-hybrid_cPa413-cPa61-hybrid_cPa413-cPa95-hybrid_cPa413-MMTV_NC001503-hybrid_cPa456_cPa456-cPa188-hybrid_cPa456-cPa332-hybrid_cPa456-cPa425-hybrid_cPa456-cPa61-hybrid_cPa456-unknown_cPa545-cPa188-hybrid_cPa545-cPa61-hybrid_cPa583-cPa188-hybrid_cPa583-cPa425-hybrid_cPa583-cPa456-hybrid_cPa583-cPa505-hybrid_cPa583-cPa545-hybrid_cPa583-cPa61-hybrid_cPa583-cPa95-hybrid_cPa583-MMTV_NC001503-hybrid_cPa583-unknown_SFV_U04327-cPa188-hybrid,36_40_37_1_4_4_1_1_2_6_1_1_1_3_2_3_89_39_2_1_7_5_1_1_22_1_3_1_1_6_3_2_5_1,434,374
Scaffold489-8600_8702,cPa413-cPa188-hybrid,0.6,3,8691,8631,cPa188_cPa413-cPa188-hybrid_cPa456,1_3_1,102,60
Scaffold49-16264_16366,cPa434,1,1,16349,16314,cPa434,4,102,35
Scaffold49-16547_16759,cPa404-cPa356-hybrid_EIAV_NC001450-cPa254-hybrid,0.2,8,16707,16584,cPa404-cPa356-hybrid_cPa404-cPa400-hybrid_cPa425-cPa130-hybrid_cPa425-cPa356-hybrid_cPa434-cPa404-hybrid_cPa434-cPa47-hybrid_EIAV_NC001450-cPa254-hybrid_EIAV_NC001450-cPa527-hybrid,2_1_1_1_1_1_2_1,212,123
Scaffold49-16811_16936,cPa434,0.317073170731707,20,16888,16861,cPa164-cPa174-hybrid_cPa392-cPa356-hybrid_cPa404-cPa130-hybrid_cPa404-cPa356-hybrid_cPa404-cPa400-hybrid_cPa425-cPa356-hybrid_cPa425-cPa400-hybrid_cPa434_cPa434-cPa174-hybrid_cPa434-cPa254-hybrid_cPa434-cPa404-hybrid_cPa75-cPa434-hybrid_EIAV_NC001450-cPa174-hybrid_EIAV_NC001450-cPa223-hybrid_EIAV_NC001450-cPa254-hybrid_EIAV_NC001450-cPa380-hybrid_HERV-E_repbase_HERVE_LTR2-cPa223-hybrid_HERV-E_repbase_HERVE_LTR2-cPa254-hybrid_HERV-E_repbase_HERVE_LTR2-cPa380-hybrid_HERV-E_repbase_HERVE_LTR2-cPa50-hybrid,1_3_1_2_1_1_1_13_1_1_1_1_4_1_2_1_1_1_3_1,125,27
Scaffold49-17065_17167,cPa434,0.333333333333333,10,17147,17104,cPa254_cPa392-cPa356-hybrid_cPa404-cPa356-hybrid_cPa404-cPa400-hybrid_cPa434_cPa434-cPa174-hybrid_EIAV_NC001450-cPa223-hybrid_EIAV_NC001450-cPa254-hybrid_EIAV_NC001450-cPa392-hybrid_EIAV_NC001450-cPa47-hybrid,1_2_2_1_8_1_3_4_1_1,102,43
Scaffold49-19627_19798,cPa434,0.657657657657658,14,19746,19649,cPa356-cPa425-hybrid_cPa425_cPa434_cPa75-cPa138-hybrid_cPa75-cPa425-hybrid_cPa75-cPa47-hybrid_cPa75-unknown_PtERV1_AC142352-cPa425-hybrid_PtERV1_AC142352-unknown_S71_repbase_HERVS71_LTR6A-cPa254-hybrid_S71_repbase_HERVS71_LTR6A-cPa256-hybrid_S71_repbase_HERVS71_LTR6A-cPa404-hybrid_S71_repbase_HERVS71_LTR6A-cPa425-hybrid_S71_repbase_HERVS71_LTR6A-unknown,2_1_73_1_4_1_2_1_3_1_1_2_10_9,171,97
Scaffold49-2192_2578,cPa391,0.852941176470588,4,2526,2242,cPa391_cPa391-cPa224-hybrid_cPa391-unknown_cPa71-cPa224-hybrid,29_1_3_1,386,284
Scaffold49-25503_25683,cPa67,0.875,3,25679,25523,cPa118-HML4_repbase_HERVK13I_LTR13-hybrid_cPa67_MSFV_NC010819-cPa118-hybrid,1_14_1,180,156
Scaffold49-25856_25958,cPa67,0.857142857142857,2,25953,25865,cPa410_cPa67,1_6,102,88
Scaffold49-4873_5055,cPa75,0.183962264150943,45,5036,4873,cPa130-cPa254-hybrid_cPa130-HERV-W_repbase_HERV17_LTR17-hybrid_cPa257_cPa257-cPa224-hybrid_cPa257-cPa254-hybrid_cPa257-cPa285-hybrid_cPa257-cPa391-hybrid_cPa257-cPa395-hybrid_cPa257-cPa434-hybrid_cPa257-cPa566-hybrid_cPa257-cPa62-hybrid_cPa257-cPa75-hybrid_cPa257-PERV_AJ293656-hybrid_cPa257-unknown_cPa285-HERV-W_repbase_HERV17_LTR17-hybrid_cPa356_cPa356-cPa254-hybrid_cPa356-cPa285-hybrid_cPa357-cPa224-hybrid_cPa357-cPa285-hybrid_cPa392-cPa285-hybrid_cPa392-cPa62-hybrid_cPa395-cPa285-hybrid_cPa400-cPa224-hybrid_cPa400-cPa254-hybrid_cPa400-cPa285-hybrid_cPa400-cPa391-hybrid_cPa400-cPa395-hybrid_cPa400-cPa566-hybrid_cPa400-cPa62-hybrid_cPa400-cPa75-hybrid_cPa400-HERV-W_repbase_HERV17_LTR17-hybrid_cPa400-unknown_cPa402-cPa285-hybrid_cPa402-cPa75-hybrid_cPa419_cPa434-cPa285-hybrid_cPa546-cPa224-hybrid_cPa546-cPa285-hybrid_cPa546-cPa62-hybrid_cPa75_cPa75-cPa285-hybrid_HERV-Fb_repbase_HERVH48I_MER48-cPa62-hybrid_HERV-Fb_repbase_HERVH48I_MER48-HERV-W_repbase_HERV17_LTR17-hybrid_SIV_NC001870-cPa285-hybrid,1_1_13_8_7_22_3_1_1_7_6_2_1_2_1_1_3_3_2_3_1_1_1_6_7_12_2_1_4_4_1_3_3_5_1_6_11_1_6_3_39_3_1_1_1,182,163
Scaffold49-5842_5944,cPa434,0.651162790697674,14,5933,5843,cPa356-HERV-W_repbase_HERV17_LTR17-hybrid_cPa392-cPa173-hybrid_cPa400-cPa356-hybrid_cPa400-cPa447-hybrid_cPa400-cPa566-hybrid_cPa402-cPa356-hybrid_cPa402-cPa447-hybrid_cPa434_cPa434-cPa447-hybrid_cPa434-cPa575-hybrid_cPa75-cPa447-hybrid_cPa75-cPa575-hybrid_HERV-Fb_repbase_HERVH48I_MER48-cPa447-hybrid_HERV-Fb_repbase_HERVH48I_MER48-cPa566-hybrid,1_1_1_1_1_1_1_28_1_1_3_1_1_1,102,90
Scaffold49-6053_6155,cPa434,0.666666666666667,2,6143,6103,cPa434_cPa75,2_1,102,40
Scaffold49-6634_7489,cPa356,0.738636363636364,13,7483,6642,cPa356_cPa356-cPa447-hybrid_cPa356-unknown_cPa400-cPa125-hybrid_cPa400-cPa447-hybrid_cPa400-cPa566-hybrid_cPa434_cPa434-cPa447-hybrid_cPa447_cPa456-cPa545-hybrid_cPa75-cPa125-hybrid_cPa75-cPa356-hybrid_cPa75-cPa566-hybrid,130_4_1_1_1_1_26_1_3_1_1_1_5,855,841
Scaffold49-8048_8239,cPa400-HERV-F_repbase_HERVFH19I_LTR19A-hybrid_cPa75-HERV-F_repbase_HERVFH19I_LTR19A-hybrid_cPa75-HERV-W_repbase_HERV17_LTR17-hybrid,0.235294117647059,7,8187,8075,cPa163-HERV-F_repbase_HERVFH19I_LTR19A-hybrid_cPa400-cPa539-hybrid_cPa400-HERV-F_repbase_HERVFH19I_LTR19A-hybrid_cPa75-cPa447-hybrid_cPa75-HERV-F_repbase_HERVFH19I_LTR19A-hybrid_cPa75-HERV-W_repbase_HERV17_LTR17-hybrid_cPa75-unknown,1_2_4_1_4_4_1,191,112
Scaffold49-8734_8836,cPa75-HERV-F_repbase_HERVFH19I_LTR19A-hybrid,1,1,8784,8784,cPa75-HERV-F_repbase_HERVFH19I_LTR19A-hybrid,1,102,0
Scaffold49-9399_9775,cPa75-cPa394-hybrid,0.476190476190476,8,9737,9440,cPa117-cPa510-hybrid_cPa118-HERV-F_repbase_HERVFH19I_LTR19A-hybrid_cPa419_cPa539_cPa539-cPa510-hybrid_cPa75-cPa394-hybrid_cPa75-cPa510-hybrid_cPa75-cPa539-hybrid,1_2_1_1_1_10_4_1,376,297
Scaffold491-10815_10934,cPa356,0.666666666666667,2,10882,10852,cPa356_cPa428,4_2,119,30
Scaffold491-13323_13425,cPa428,1,1,13373,13373,cPa428,1,102,0
Scaffold491-13768_13870,cPa356_cPa428,0.5,2,13830,13788,cPa356_cPa428,6_6,102,42
Scaffold491-16642_16744,cPa356_cPa428,0.5,2,16692,16651,cPa356_cPa428,1_1,102,41
Scaffold491-16970_17072,cPa356_cPa428,0.5,2,17020,17020,cPa356_cPa428,1_1,102,0
Scaffold491-2131_2233,cPa356,0.571428571428571,2,2214,2171,cPa356_cPa428,4_3,102,43
Scaffold491-2950_3052,cPa356_cPa428,0.5,2,3016,3000,cPa356_cPa428,2_2,102,16
Scaffold494-3353_3455,cPa419,1,1,3403,3382,cPa419,2,102,21
Scaffold496-11911_12013,cPa356,1,1,11961,11961,cPa356,1,102,0
Scaffold496-12655_12757,cPa356_cPa428,0.5,2,12705,12705,cPa356_cPa428,1_1,102,0
Scaffold496-12893_12995,cPa356,1,1,12943,12943,cPa356,1,102,0
Scaffold496-14800_14902,cPa428,1,1,14850,14850,cPa428,1,102,0
Scaffold496-14929_15109,cPa428,0.428571428571429,4,15057,14931,cPa356_cPa356-unknown_cPa428_cPa428-unknown,2_1_3_1,180,126
Scaffold496-7286_7391,cPa428,0.7,2,7391,7335,cPa356_cPa428,3_7,105,56
Scaffold496-7430_7532,cPa356_cPa428,0.5,2,7480,7470,cPa356_cPa428,6_6,102,10
Scaffold496-7591_7693,cPa356_cPa428,0.5,2,7642,7637,cPa356_cPa428,8_8,102,5
Scaffold496-9141_9243,cPa356_cPa428,0.5,2,9191,9191,cPa356_cPa428,1_1,102,0
Scaffold496-9638_9809,cPa356,0.583333333333333,2,9797,9688,cPa356_cPa428,14_10,171,109
Scaffold496-9858_9960,cPa356,0.666666666666667,2,9908,9863,cPa356_cPa428,2_1,102,45
Scaffold497-14554_14656,cPa356,1,1,14604,14604,cPa356,1,102,0
Scaffold497-14807_14968,cPa428,0.6,2,14916,14810,cPa356_cPa428,8_12,161,106
Scaffold499-5198_5300,cPa356,1,1,5248,5248,cPa356,1,102,0
Scaffold50-14835_14937,cPa75,1,1,14885,14885,cPa75,1,102,0
Scaffold50-1626_1803,cPa434,0.633587786259542,30,1797,1675,cPa118-cPa201-hybrid_cPa118-cPa273-hybrid_cPa118-cPa400-hybrid_cPa118-HERV-Fb_repbase_HERVH48I_MER48-hybrid_cPa118-HERV-W_repbase_HERV17_LTR17-hybrid_cPa15-cPa201-hybrid_cPa15-HERV-W_repbase_HERV17_LTR17-hybrid_cPa15-HTLV1_NC001436-hybrid_cPa15-PtERV1_AC142352-hybrid_cPa150-PtERV1_AC142352-hybrid_cPa164-cPa356-hybrid_cPa164-unknown_cPa174-cPa356-hybrid_cPa247-cPa356-hybrid_cPa247-SIV_NC001870-hybrid_cPa308-cPa74-hybrid_cPa308-PtERV1_AC142352-hybrid_cPa315-cPa356-hybrid_cPa315-cPa486-hybrid_cPa356-cPa273-hybrid_cPa356-cPa400-hybrid_cPa356-PtERV1_AC142352-hybrid_cPa434_cPa443-cPa273-hybrid_cPa443-HERV-W_repbase_HERV17_LTR17-hybrid_cPa443-PtERV1_AC142352-hybrid_cPa566-HERV-Fb_repbase_HERVH48I_MER48-hybrid_cPa575-PtERV1_AC142352-hybrid_REV_NC006934-PtERV1_AC142352-hybrid_REV_NC006934-SIV_NC001870-hybrid,1_5_2_4_2_1_1_1_3_1_1_2_2_2_1_1_3_1_1_1_1_1_83_3_1_1_1_1_2_1,177,122
Scaffold50-6086_6204,cPa434,1,1,6152,6134,cPa434,4,118,18
Scaffold500-10106_10299,cPa428,0.666666666666667,2,10247,10138,cPa356_cPa428,1_2,193,109
Scaffold500-10335_10437,cPa428,0.666666666666667,2,10391,10385,cPa356_cPa428,1_2,102,6
Scaffold500-12030_12132,cPa356_cPa428,0.5,2,12098,12080,cPa356_cPa428,1_1,102,18
Scaffold500-14760_14862,cPa428,0.666666666666667,2,14820,14810,cPa356_cPa428,1_2,102,10
Scaffold500-20062_20188,cPa428,0.528301886792453,5,20184,20061,cPa356_cPa356-unknown_cPa428_cPa428-cPa356-hybrid_cPa428-unknown,19_2_28_2_2,126,123
Scaffold500-4596_4698,cPa428,1,1,4646,4646,cPa428,1,102,0
Scaffold500-9007_9109,cPa356,1,1,9057,9057,cPa356,1,102,0
Scaffold502-10308_10410,cPa419,1,1,10358,10340,cPa419,7,102,18
Scaffold502-10659_10761,cPa419,1,1,10738,10709,cPa419,8,102,29
Scaffold502-11240_11342,cPa419,1,1,11290,11290,cPa419,1,102,0
Scaffold502-11596_11698,cPa419,1,1,11646,11646,cPa419,1,102,0
Scaffold502-13957_14059,cPa419,1,1,14007,14007,cPa419,1,102,0
Scaffold502-15627_15774,cPa419,1,1,15722,15628,cPa419,7,147,94
Scaffold502-15804_15919,cPa419,1,1,15875,15808,cPa419,4,115,67
Scaffold502-16174_16276,cPa419,1,1,16239,16224,cPa419,2,102,15
Scaffold502-16532_16634,cPa419,1,1,16629,16582,cPa419,3,102,47
Scaffold502-16850_16952,cPa419,1,1,16931,16900,cPa419,3,102,31
Scaffold502-18243_18345,cPa419,1,1,18293,18272,cPa419,2,102,21
Scaffold502-18359_18461,cPa419,1,1,18409,18409,cPa419,1,102,0
Scaffold502-20160_20262,cPa419,1,1,20210,20210,cPa419,1,102,0
Scaffold502-20909_21409,cPa419,1,1,21372,20926,cPa419,41,500,446
Scaffold502-5044_5146,cPa419,1,1,5094,5094,cPa419,1,102,0
Scaffold503-13463_13565,cPa434,1,1,13541,13481,cPa434,20,102,60
Scaffold503-13625_13727,cPa434,1,1,13675,13626,cPa434,4,102,49
Scaffold503-13904_14006,cPa434,1,1,13999,13954,cPa434,4,102,45
Scaffold503-14132_14234,cPa434,1,1,14194,14155,cPa434,7,102,39
Scaffold503-14357_14548,cPa434,1,1,14496,14358,cPa434,7,191,138
Scaffold503-14687_14789,cPa434,1,1,14746,14737,cPa434,2,102,9
Scaffold503-2408_2573,cPa434,1,1,2552,2455,cPa434,9,165,97
Scaffold503-2645_2755,cPa434,1,1,2703,2695,cPa434,6,110,8
Scaffold503-4444_4546,cPa434,1,1,4503,4494,cPa434,1,102,9
Scaffold503-6275_6382,cPa434,1,1,6337,6289,cPa434,13,107,48
Scaffold503-6484_6586,cPa434,1,1,6534,6485,cPa434,6,102,49
Scaffold503-6603_6705,cPa434,1,1,6653,6616,cPa434,6,102,37
Scaffold503-7246_7448,cPa434,0.986301369863014,2,7402,7271,cPa14-unknown_cPa434,1_72,202,131
Scaffold503-7491_7732,cPa434,0.977011494252874,3,7680,7541,cPa14_cPa14-unknown_cPa434,1_1_85,241,139
Scaffold503-7751_7853,cPa434,1,1,7801,7752,cPa434,9,102,49
Scaffold503-7907_8009,cPa434,1,1,7957,7908,cPa434,3,102,49
Scaffold503-8017_8341,cPa434,0.989690721649485,2,8300,8024,cPa14_cPa434,1_96,324,276
Scaffold503-8361_8569,cPa434,1,1,8567,8363,cPa434,19,208,204
Scaffold503-8573_8676,cPa434,1,1,8672,8580,cPa434,12,103,92
Scaffold503-8973_9075,cPa434,1,1,9055,8981,cPa434,47,102,74
Scaffold505-10876_11010,cPa428,0.539325842696629,2,11005,10895,cPa356_cPa428,41_48,134,110
Scaffold505-11485_11593,cPa356,0.583333333333333,2,11589,11486,cPa356_cPa428,14_10,108,103
Scaffold505-11608_11935,cPa356,0.551724137931034,2,11921,11615,cPa356_cPa428,16_13,327,306
Scaffold505-6200_6313,cPa356,0.533333333333333,2,6276,6222,cPa356_cPa428,8_7,113,54
Scaffold505-6404_6506,cPa356,0.631578947368421,2,6495,6404,cPa356_cPa428,12_7,102,91
Scaffold505-7737_7839,cPa356,0.538461538461538,2,7787,7738,cPa356_cPa428,7_6,102,49
Scaffold505-9460_9587,cPa428,0.526315789473684,2,9542,9479,cPa356_cPa428,9_10,127,63
Scaffold505-9616_9718,cPa356_cPa428,0.5,2,9696,9618,cPa356_cPa428,9_9,102,78
Scaffold507-12742_12844,HERVFc2_repbase-cPa75-hybrid,0.636363636363636,5,12841,12787,cPa255-cPa75-hybrid_cPa526_HERVFc2_repbase_HERVFc2_repbase-cPa75-hybrid_HERVFc2_repbase-unknown,1_1_1_7_1,102,54
Scaffold507-16242_16344,cPa254,1,1,16292,16292,cPa254,1,102,0
Scaffold507-17722_18151,MSFV_NC010819,0.19047619047619,43,18151,17739,cPa109_cPa109-cPa174-hybrid_cPa109-cPa425-hybrid_cPa109-cPa47-hybrid_cPa109-MSFV_NC010819-hybrid_cPa109-unknown_cPa174_cPa199-cPa391-hybrid_cPa199-cPa47-hybrid_cPa254_cPa293_cPa293-cPa254-hybrid_cPa293-cPa391-hybrid_cPa293-cPa404-hybrid_cPa293-cPa425-hybrid_cPa293-cPa47-hybrid_cPa293-MSFV_NC010819-hybrid_cPa293-unknown_cPa419_cPa425_cPa425-cPa109-hybrid_cPa425-cPa47-hybrid_cPa428_cPa456-cPa47-hybrid_cPa47_cPa539_cPa539-cPa109-hybrid_cPa539-unknown_cPa62_cPa62-cPa47-hybrid_HIV1_NC001802_HIV1_NC001802-cPa47-hybrid_HML4_repbase_HERVK13I_LTR13_HML4_repbase_HERVK13I_LTR13-MPMVs_NC001550-hybrid_MSFV_NC010819_MSFV_NC010819-cPa109-hybrid_MSFV_NC010819-cPa174-hybrid_MSFV_NC010819-cPa254-hybrid_MSFV_NC010819-cPa404-hybrid_MSFV_NC010819-cPa419-hybrid_MSFV_NC010819-cPa425-hybrid_MSFV_NC010819-cPa47-hybrid_MSFV_NC010819-unknown,34_1_3_5_1_1_2_1_1_9_20_1_1_2_1_4_1_1_17_22_1_1_2_1_17_4_1_1_11_1_1_1_2_1_48_3_1_2_1_1_3_8_12,429,412
Scaffold507-18407_18509,cPa293_HML4_repbase_HERVK13I_LTR13,0.285714285714286,5,18503,18425,cPa199-cPa109-hybrid_cPa293_cPa419_HML4_repbase_HERVK13I_LTR13_KWERV_GQ222416-MSFV_NC010819-hybrid,1_2_1_2_1,102,78
Scaffold507-4412_4514,cPa75,0.375,7,4494,4418,cPa199-unknown_cPa308-cPa75-hybrid_cPa356-cPa75-hybrid_cPa419_cPa75_cPa75-cPa539-hybrid_cPa75-unknown,2_1_1_3_6_1_2,102,76
Scaffold508-1320_1422,cPa75-unknown,0.777777777777778,2,1370,1326,cPa75_cPa75-unknown,2_7,102,44
Scaffold51-14126_14553,cPa392-unknown,0.393258426966292,23,14550,14128,cPa106-cPa127-hybrid_cPa106-cPa14-hybrid_cPa106-cPa246-hybrid_cPa106-cPa544-hybrid_cPa106-cPa75-hybrid_cPa106-unknown_cPa107-cPa14-hybrid_cPa127_cPa15-cPa419-hybrid_cPa15-unknown_cPa360_cPa392_cPa392-cPa14-hybrid_cPa392-cPa246-hybrid_cPa392-cPa290-hybrid_cPa392-cPa543-hybrid_cPa392-cPa544-hybrid_cPa392-unknown_cPa419_cPa75_cPa75-cPa246-hybrid_HERV-Fb_repbase_HERVH48I_MER48_PERV_AJ293656-cPa14-hybrid,1_2_2_1_1_13_1_1_1_2_1_7_1_2_1_1_2_35_9_2_1_1_1,427,422
Scaffold51-15216_15318,cPa360,0.454545454545455,5,15307,15237,cPa127-cPa224-hybrid_cPa360_cPa392-cPa452-hybrid_cPa419_cPa75,1_5_1_1_3,102,70
Scaffold51-15967_16069,MLV_Xmv43-cPa224-hybrid,1,1,16017,16017,MLV_Xmv43-cPa224-hybrid,1,102,0
Scaffold51-16598_16763,cPa360,0.476190476190476,9,16718,16648,cPa142-cPa224-hybrid_cPa224_cPa256-cPa224-hybrid_cPa360_cPa360-cPa224-hybrid_cPa61-cPa224-hybrid_cPa75_cPa75-cPa224-hybrid_MLV_Xmv43-cPa224-hybrid,2_1_1_10_1_1_3_1_1,165,70
Scaffold51-16823_16925,cPa419,1,1,16873,16873,cPa419,1,102,0
Scaffold51-17384_17535,cPa224,0.5,5,17534,17434,cPa224_cPa419_cPa61-cPa224-hybrid_cPa61-cPa360-hybrid_cPa61-unknown,4_1_1_1_1,151,100
Scaffold51-21202_21324,cPa163,0.573529411764706,5,21272,21223,cPa163_cPa182-cPa419-hybrid_cPa182-unknown_cPa360_cPa419,39_1_26_1_1,122,49
Scaffold51-21402_21504,cPa163,1,1,21452,21452,cPa163,1,102,0
Scaffold51-21576_21744,cPa163,0.8,6,21692,21621,cPa163_cPa182-cPa163-hybrid_cPa182-cPa224-hybrid_cPa182-cPa360-hybrid_cPa224_cPa360,164_1_8_4_7_21,168,71
Scaffold51-21991_22093,cPa163,0.666666666666667,3,22051,22027,cPa163_cPa224_cPa360,4_1_1,102,24
Scaffold51-22122_22340,cPa163,0.441176470588235,6,22336,22157,cPa163_cPa182-cPa360-hybrid_cPa224_cPa360_cPa360-cPa224-hybrid_cPa419,30_1_20_15_1_1,218,179
Scaffold51-23486_23588,cPa360,1,1,23584,23536,cPa360,2,102,48
Scaffold51-35421_35611,cPa492-unknown,0.545454545454545,6,35589,35443,cPa356_cPa419_cPa492-cPa168-hybrid_cPa492-cPa400-hybrid_cPa492-cPa475-hybrid_cPa492-unknown,1_1_1_1_1_6,190,146
Scaffold51-35825_36022,cPa492-unknown,1,1,36010,35875,cPa492-unknown,22,197,135
Scaffold51-43999_44101,cPa67,1,1,44082,43998,cPa67,10,102,84
Scaffold51-44168_44270,cPa67,1,1,44238,44179,cPa67,5,102,59
Scaffold51-45966_46068,cPa67,1,1,46016,45975,cPa67,6,102,41
Scaffold51-7220_7364,cPa254,0.571428571428571,5,7312,7245,cPa254_cPa254-cPa425-hybrid_cPa254-unknown_cPa425_cPa47,16_1_3_7_1,144,67
Scaffold510-10260_10362,cPa419,1,1,10361,10274,cPa419,38,102,87
Scaffold510-10363_10465,cPa419,1,1,10460,10369,cPa419,36,102,91
Scaffold510-11094_11208,cPa419,1,1,11170,11127,cPa419,26,114,43
Scaffold510-11229_11371,cPa419,1,1,11343,11276,cPa419,35,142,67
Scaffold510-11468_11570,cPa419,1,1,11535,11468,cPa419,12,102,67
Scaffold510-11590_11692,cPa419,1,1,11683,11605,cPa419,3,102,78
Scaffold510-11737_11908,cPa419,1,1,11856,11756,cPa419,13,171,100
Scaffold510-11977_12303,cPa419,1,1,12252,12027,cPa419,26,326,225
Scaffold510-12328_12495,cPa419,1,1,12463,12378,cPa419,12,167,85
Scaffold510-12648_12790,cPa419,0.958333333333333,2,12773,12676,cPa419_MER52A_repbase_MER52AI_MER52A-cPa360-hybrid,23_1,142,97
Scaffold510-16193_16295,cPa419,1,1,16260,16205,cPa419,9,102,55
Scaffold510-16391_16614,cPa419,1,1,16563,16440,cPa419,82,223,123
Scaffold510-7016_7354,cPa419,1,1,7336,7066,cPa419,68,338,270
Scaffold510-8268_8370,cPa419,1,1,8319,8312,cPa419,14,102,7
Scaffold510-8541_8699,cPa419,1,1,8658,8587,cPa419,28,158,71
Scaffold510-9099_9201,cPa419,1,1,9191,9108,cPa419,5,102,83
Scaffold510-9486_9592,cPa419,1,1,9592,9536,cPa419,16,106,56
Scaffold512-10099_10201,cPa356_cPa428,0.5,2,10149,10149,cPa356_cPa428,1_1,102,0
Scaffold512-10713_10815,cPa356,1,1,10763,10763,cPa356,1,102,0
Scaffold512-11892_11994,cPa428,1,1,11942,11942,cPa428,1,102,0
Scaffold512-12118_12220,cPa356_cPa356-unknown,0.5,2,12204,12168,cPa356_cPa356-unknown,1_1,102,36
Scaffold512-1351_1453,cPa356,1,1,1401,1401,cPa356,1,102,0
Scaffold512-17747_17940,cPa356,0.527777777777778,2,17888,17765,cPa356_cPa428,19_17,193,123
Scaffold512-18683_18785,cPa428,0.8,2,18748,18722,cPa356_cPa428,1_4,102,26
Scaffold512-19689_19872,cPa428,0.518518518518518,2,19854,19699,cPa356_cPa428,13_14,183,155
Scaffold512-3972_4076,cPa428,0.571428571428571,2,4024,3980,cPa356_cPa428,6_8,104,44
Scaffold512-4190_4292,cPa356,0.555555555555556,2,4245,4235,cPa356_cPa428,5_4,102,10
Scaffold512-4605_4707,cPa356_cPa428,0.5,2,4655,4655,cPa356_cPa428,1_1,102,0
Scaffold512-5598_5700,cPa356,0.8,2,5676,5648,cPa356_cPa428,4_1,102,28
Scaffold512-6258_6360,cPa428,0.75,2,6356,6265,cPa356_cPa428,2_6,102,91
Scaffold512-6779_6881,cPa428,0.6,2,6857,6780,cPa356_cPa428,2_3,102,77
Scaffold512-6969_7071,cPa356_cPa428,0.5,2,7067,6971,cPa356_cPa428,7_7,102,96
Scaffold512-7274_7376,cPa356_cPa428,0.5,2,7355,7310,cPa356_cPa428,5_5,102,45
Scaffold512-8184_8286,cPa428,0.538461538461538,3,8282,8199,cPa356_cPa428_cPa428-unknown,11_14_1,102,83
Scaffold512-9051_9153,cPa356_cPa428,0.476190476190476,3,9138,9065,cPa356_cPa428_cPa428-unknown,10_10_1,102,73
Scaffold512-9204_9306,cPa356,0.533333333333333,2,9302,9254,cPa356_cPa428,8_7,102,48
Scaffold513-19324_19426,cPa407-cPa254-hybrid_cPa407-cPa257-hybrid_cPa62,0.333333333333333,3,19424,19344,cPa407-cPa254-hybrid_cPa407-cPa257-hybrid_cPa62,1_1_1,102,80
Scaffold513-20204_20306,cPa254,0.352941176470588,8,20303,20253,cPa254_cPa419_cPa539-cPa254-hybrid_cPa62_cPa62-cPa254-hybrid_HML8_repbase_HERVK11I_MER11A_HML8_repbase_HERVK11I_MER11A-cPa254-hybrid_HML8_repbase_HERVK11I_MER11A-cPa257-hybrid,6_1_1_1_1_1_3_3,102,50
Scaffold513-9589_10225,cPa419,0.582417582417582,9,10173,9596,cPa256-cPa74-hybrid_cPa402_cPa402-cPa74-hybrid_cPa402-unknown_cPa419_cPa419-cPa74-hybrid_cPa419-unknown_cPa581-cPa402-hybrid_cPa74,2_76_44_12_212_9_4_1_4,636,577
Scaffold514-11126_11228,cPa356,0.8,2,11217,11149,cPa356_cPa428,4_1,102,68
Scaffold514-11240_11377,cPa428,0.513513513513513,2,11360,11274,cPa356_cPa428,18_19,137,86
Scaffold514-11974_12076,cPa356,1,1,12024,12024,cPa356,1,102,0
Scaffold514-13307_13409,cPa356,0.75,2,13382,13351,cPa356_cPa428,3_1,102,31
Scaffold514-13639_13762,cPa356,0.571428571428571,2,13718,13645,cPa356_cPa428,8_6,123,73
Scaffold514-15812_15914,cPa356_cPa428,0.5,2,15906,15846,cPa356_cPa428,16_16,102,60
Scaffold514-17309_17411,cPa428,0.625,2,17369,17311,cPa356_cPa428,3_5,102,58
Scaffold514-17583_17780,cPa428,0.533333333333333,2,17780,17586,cPa356_cPa428,14_16,197,194
Scaffold514-17944_18208,cPa428,0.55952380952381,2,18207,17943,cPa356_cPa428,37_47,264,264
Scaffold514-18336_18450,cPa428,0.545454545454545,2,18448,18363,cPa356_cPa428,5_6,114,85
Scaffold514-18822_18924,cPa356,0.51219512195122,2,18907,18839,cPa356_cPa428,21_20,102,68
Scaffold517-10304_10406,cPa413,1,1,10354,10354,cPa413,1,102,0
Scaffold517-3357_3459,cPa521_cPa75,0.5,2,3407,3407,cPa521_cPa75,1_1,102,0
Scaffold518-1322_1424,cPa356_cPa428,0.5,2,1372,1372,cPa356_cPa428,1_1,102,0
Scaffold518-8544_8646,cPa428,1,1,8594,8594,cPa428,1,102,0
Scaffold518-944_1046,cPa428,1,1,994,979,cPa428,2,102,15
Scaffold519-19526_19628,cPa356,0.666666666666667,2,19576,19557,cPa356_cPa428,2_1,102,19
Scaffold519-19712_19814,cPa356,0.523809523809524,3,19796,19730,cPa356_cPa428_cPa428-cPa356-hybrid,11_9_1,102,66
Scaffold52-13269_13442,cPa67,0.984615384615385,2,13435,13312,cPa450_cPa67,1_64,173,123
Scaffold52-13499_13812,cPa67,0.991935483870968,2,13805,13516,cPa118_cPa67,1_123,313,289
Scaffold52-13944_14149,cPa67,0.95,2,14132,13957,cPa583-unknown_cPa67,1_19,205,175
Scaffold52-17954_18130,cPa323,0.444444444444444,7,18125,17981,cPa323_cPa323-cPa449-hybrid_cPa333_cPa333-cPa323-hybrid_cPa371-cPa486-hybrid_cPa419_cPa486,8_1_2_1_1_1_4,176,144
Scaffold52-20777_20909,cPa587,0.323076923076923,16,20857,20827,cPa270_cPa270-cPa486-hybrid_cPa270-unknown_cPa381_cPa390-cPa381-hybrid_cPa410_cPa410-cPa381-hybrid_cPa410-cPa398-hybrid_cPa410-cPa419-hybrid_cPa410-cPa486-hybrid_cPa410-unknown_cPa419_cPa486_cPa587_cPa587-cPa381-hybrid_cPa587-cPa486-hybrid,2_1_1_15_1_3_5_2_1_2_2_5_1_21_1_2,132,30
Scaffold52-20980_21083,cPa587,0.466666666666667,7,21044,21028,cPa270_cPa270-unknown_cPa381_cPa410_cPa486_cPa587_cPa587-unknown,1_1_3_1_1_7_1,103,16
Scaffold52-22088_22190,cPa381,0.5,3,22184,22123,cPa381_cPa419_cPa419-unknown,3_2_1,102,61
Scaffold520-19276_19378,cPa428,0.583333333333333,2,19347,19283,cPa356_cPa428,10_14,102,64
Scaffold520-19694_19853,cPa428,0.625,2,19835,19744,cPa356_cPa428,3_5,159,91
Scaffold520-20266_20368,cPa428,0.666666666666667,2,20332,20316,cPa356_cPa428,3_6,102,16
Scaffold521-12940_13042,cPa419,1,1,12990,12990,cPa419,1,102,0
Scaffold521-8350_8452,cPa419,1,1,8400,8400,cPa419,1,102,0
Scaffold521-8566_8668,cPa419,1,1,8616,8616,cPa419,1,102,0
Scaffold521-9199_9301,cPa419,1,1,9251,9240,cPa419,4,102,11
Scaffold524-3140_3242,cPa428,1,1,3190,3190,cPa428,1,102,0
Scaffold524-5981_6083,cPa356_cPa428,0.5,2,6031,6031,cPa356_cPa428,1_1,102,0
Scaffold526-1434_1536,cPa428,0.578947368421053,3,1518,1443,cPa356_cPa356-cPa62-hybrid_cPa428,7_1_11,102,75
Scaffold526-376_478,cPa428,1,1,426,426,cPa428,1,102,0
Scaffold527-18454_18556,cPa205,0.714285714285714,3,18555,18482,cPa205_cPa61_MMTV_NC001503-unknown,5_1_1,102,73
Scaffold527-18577_18683,cPa61,1,1,18636,18585,cPa61,6,106,51
Scaffold527-372_474,cPa449-cPa546-hybrid,1,1,422,422,cPa449-cPa546-hybrid,1,102,0
Scaffold529-12528_12630,cPa356,0.666666666666667,2,12578,12571,cPa356_cPa428,2_1,102,7
Scaffold529-16788_16898,cPa428,0.625,2,16864,16838,cPa356_cPa428,3_5,110,26
Scaffold53-10210_10338,cPa486,0.666666666666667,3,10286,10248,cPa381_cPa419_cPa486,2_2_8,128,38
Scaffold53-19749_19851,cPa339,0.391304347826087,11,19850,19759,cPa293-cPa459-hybrid_cPa339_cPa339-cPa208-hybrid_cPa339-cPa459-hybrid_cPa339-HML1a_repbase_HERV-K14CI_LTR14C-hybrid_cPa419_cPa492_cPa492-cPa339-hybrid_cPa492-cPa459-hybrid_cPa492-unknown_cPa81-cPa542-hybrid,1_18_1_6_4_1_2_1_3_8_1,102,91
Scaffold53-19960_20115,cPa492,0.467391304347826,14,20072,19990,cPa251-cPa539-hybrid_cPa251-HML1a_repbase_HERV-K14CI_LTR14C-hybrid_cPa339_cPa339-cPa208-hybrid_cPa339-cPa459-hybrid_cPa339-HML1a_repbase_HERV-K14CI_LTR14C-hybrid_cPa492_cPa492-cPa208-hybrid_cPa492-cPa302-hybrid_cPa492-cPa339-hybrid_cPa492-cPa459-hybrid_cPa492-HML1a_repbase_HERV-K14CI_LTR14C-hybrid_cPa492-unknown_cPa81-HML1a_repbase_HERV-K14CI_LTR14C-hybrid,1_2_13_3_11_1_43_4_1_1_6_3_2_1,155,82
Scaffold53-21081_21183,cPa339,1,1,21131,21114,cPa339,2,102,17
Scaffold53-5645_5747,cPa381_cPa587_cPa62,0.333333333333333,3,5727,5695,cPa381_cPa587_cPa62,1_1_1,102,32
Scaffold53-6629_6731,cPa381,0.466666666666667,4,6707,6629,cPa381_cPa381-unknown_cPa486_cPa587,7_1_1_6,102,78
Scaffold53-6739_7125,cPa587,0.349514563106796,18,7117,6751,cPa381_cPa381-cPa391-hybrid_cPa381-cPa426-hybrid_cPa381-cPa587-hybrid_cPa381-unknown_cPa390_cPa398_cPa398-unknown_cPa410-cPa270-hybrid_cPa410-cPa390-hybrid_cPa410-cPa391-hybrid_cPa410-cPa419-hybrid_cPa486_cPa486-cPa419-hybrid_cPa587_cPa587-cPa390-hybrid_cPa587-unknown_cPa62,32_1_1_1_4_2_5_1_1_1_1_1_11_1_36_2_1_1,386,366
Scaffold53-7131_7233,cPa398,0.5,4,7226,7181,cPa381_cPa398_cPa410-cPa486-hybrid_cPa486,1_3_1_1,102,45
Scaffold53-7717_7819,cPa381_cPa419,0.5,2,7767,7737,cPa381_cPa419,1_1,102,30
Scaffold53-8898_9001,cPa486,0.8,3,8992,8948,cPa381_cPa410-unknown_cPa486,1_1_8,103,44
Scaffold53-9665_9767,cPa486,0.818181818181818,3,9718,9667,cPa381_cPa419_cPa486,1_1_9,102,51
Scaffold530-18100_18202,cPa339,1,1,18150,18150,cPa339,1,102,0
Scaffold532-14740_14842,cPa425,1,1,14790,14790,cPa425,1,102,0
Scaffold532-15476_15578,cPa379,0.625,3,15551,15482,cPa379_cPa379-unknown_HERV30_repbase_HERV30I_LTR30-unknown,5_2_1,102,69
Scaffold532-16316_16418,cPa379-cPa176-hybrid_HERV30_repbase_HERV30I_LTR30-cPa413-hybrid,0.5,2,16371,16366,cPa379-cPa176-hybrid_HERV30_repbase_HERV30I_LTR30-cPa413-hybrid,1_1,102,5
Scaffold532-2342_2485,cPa358-cPa434-hybrid,0.333333333333333,7,2473,2348,cPa358-cPa434-hybrid_cPa362-cPa434-hybrid_cPa363-cPa434-hybrid_cPa381_cPa381-cPa199-hybrid_cPa381-cPa391-hybrid_cPa381-cPa434-hybrid,5_1_1_1_2_1_4,143,125
Scaffold532-4506_4663,cPa363,0.5,5,4658,4553,cPa358-cPa363-hybrid_cPa363_cPa419_cPa452-cPa549-hybrid_cPa549,1_4_1_1_1,157,105
Scaffold532-4740_4864,cPa363,0.272727272727273,6,4853,4758,cPa358-cPa254-hybrid_cPa358-cPa363-hybrid_cPa358-cPa452-hybrid_cPa358-cPa549-hybrid_cPa363_cPa452,1_2_1_2_3_2,124,95
Scaffold532-5137_5239,cPa358-cPa254-hybrid,0.222222222222222,8,5234,5187,cPa106-cPa363-hybrid_cPa358-cPa254-hybrid_cPa358-cPa285-hybrid_cPa358-cPa545-hybrid_cPa358-cPa549-hybrid_cPa409-cPa363-hybrid_cPa409-cPa545-hybrid_cPa75,1_2_1_1_1_1_1_1,102,47
Scaffold532-9884_9986,cPa505,1,1,9934,9934,cPa505,1,102,0
Scaffold537-16384_16486,cPa447-unknown_cPa75,0.5,2,16434,16432,cPa447-unknown_cPa75,1_1,102,2
Scaffold537-16554_16845,cPa75,0.375,5,16793,16604,cPa446_cPa447_cPa447-cPa75-hybrid_cPa447-unknown_cPa75,2_1_1_1_3,291,189
Scaffold537-16882_16984,cPa75,1,1,16932,16932,cPa75,1,102,0
Scaffold538-2435_2537,cPa428,0.583333333333333,2,2505,2447,cPa356_cPa428,5_7,102,58
Scaffold539-15888_15990,cPa419,1,1,15967,15915,cPa419,31,102,52
Scaffold539-16173_16275,cPa419,1,1,16269,16188,cPa419,8,102,81
Scaffold539-16315_16417,cPa419,1,1,16383,16365,cPa419,2,102,18
Scaffold539-17662_17802,cPa419,1,1,17801,17668,cPa419,38,140,133
Scaffold539-17964_18066,cPa419,1,1,18058,17972,cPa419,28,102,86
Scaffold539-18105_18279,cPa419,0.985294117647059,2,18271,18134,cPa379-unknown_cPa419,1_67,174,137
Scaffold539-19095_19197,cPa419,1,1,19179,19103,cPa419,22,102,76
Scaffold54-10361_10518,cPa419,0.4,6,10499,10371,cPa332-cPa425-hybrid_cPa332-cPa428-hybrid_cPa332-cPa62-hybrid_cPa419_cPa425_cPa62,1_1_1_4_2_1,157,128
Scaffold54-10553_10661,cPa62,0.313725490196078,15,10631,10558,cPa285_cPa285-cPa251-hybrid_cPa285-cPa81-hybrid_cPa293-HML1a_repbase_HERV-K14CI_LTR14C-hybrid_cPa332-cPa492-hybrid_cPa332-cPa81-hybrid_cPa332-HML1a_repbase_HERV-K14CI_LTR14C-hybrid_cPa335-cPa62-hybrid_cPa339-cPa419-hybrid_cPa339-cPa62-hybrid_cPa419_cPa425_cPa425-cPa285-hybrid_cPa459-cPa62-hybrid_cPa62,2_1_1_1_1_1_6_2_1_3_12_1_1_2_16,108,73
Scaffold54-11938_12053,cPa332-unknown,1,1,12012,11988,cPa332-unknown,6,115,24
Scaffold54-12271_12379,cPa332-unknown,1,1,12327,12318,cPa332-unknown,4,108,9
Scaffold54-16622_16929,cPa492,0.734042553191489,3,16877,16672,cPa492_cPa492-cPa400-hybrid_cPa492-unknown,69_2_23,307,205
Scaffold54-1891_1993,cPa587,0.5,6,1986,1908,cPa270_cPa381_cPa390-cPa587-hybrid_cPa410-cPa270-hybrid_cPa410-cPa486-hybrid_cPa587,1_5_1_1_1_9,102,78
Scaffold54-2391_2493,cPa381,0.705882352941177,5,2489,2434,cPa381_cPa381-unknown_cPa486_cPa587_cPa62,12_1_2_1_1,102,55
Scaffold54-2811_3007,cPa381,0.276595744680851,13,3000,2824,cPa381_cPa381-cPa62-hybrid_cPa390_cPa390-cPa486-hybrid_cPa390-cPa62-hybrid_cPa398_cPa410-cPa587-hybrid_cPa419-cPa270-hybrid_cPa486_cPa587_cPa62_cPa62-cPa390-hybrid_cPa62-cPa410-hybrid,13_1_4_2_1_2_1_1_4_10_6_1_1,196,176
Scaffold540-12710_12986,cPa428,0.555555555555556,3,12950,12760,cPa356_cPa428_cPa428-cPa356-hybrid,7_10_1,276,190
Scaffold540-14754_14867,cPa428,0.666666666666667,2,14815,14804,cPa356_cPa428,1_2,113,11
Scaffold540-1586_1688,cPa356_cPa428,0.5,2,1636,1615,cPa356_cPa428,1_1,102,21
Scaffold540-18674_18776,cPa428,1,1,18724,18724,cPa428,2,102,0
Scaffold540-2484_2587,cPa428,0.75,2,2535,2528,cPa356_cPa428,1_3,103,7
Scaffold540-5186_5288,cPa428,1,1,5236,5236,cPa428,1,102,0
Scaffold540-5872_5974,cPa356,0.75,2,5926,5915,cPa356_cPa428,6_2,102,11
Scaffold540-7347_7449,cPa428,0.666666666666667,2,7397,7366,cPa356_cPa428,1_2,102,31
Scaffold540-8868_8970,cPa428,1,1,8918,8918,cPa428,1,102,0
Scaffold541-3009_3111,cPa356_cPa428,0.5,2,3059,3059,cPa356_cPa428,1_1,102,0
Scaffold544-11475_11577,cPa434,1,1,11525,11483,cPa434,2,102,42
Scaffold544-11747_11950,cPa434,0.933333333333333,5,11898,11776,cPa254-cPa75-hybrid_cPa434_cPa434-cPa75-hybrid_cPa566-cPa392-hybrid_cPa566-unknown,1_56_1_1_1,203,122
Scaffold544-12050_12164,cPa434_cPa434-cPa356-hybrid,0.416666666666667,4,12122,12052,cPa419_cPa434_cPa434-cPa356-hybrid_cPa434-cPa447-hybrid,1_5_5_1,114,70
Scaffold544-12527_12629,cPa434,0.6,3,12581,12574,cPa434_cPa434-cPa356-hybrid_HERV-F_repbase_HERVFH19I_LTR19A-cPa356-hybrid,6_3_1,102,7
Scaffold544-13009_13177,cPa434-cPa356-hybrid,0.375,7,13172,13016,cPa356_cPa419_cPa434_cPa434-cPa356-hybrid_cPa434-cPa447-hybrid_cPa447-cPa356-hybrid_cPa566-cPa356-hybrid,4_1_2_6_1_1_1,168,156
Scaffold544-13831_13933,cPa193-unknown_cPa356,0.5,2,13881,13878,cPa193-unknown_cPa356,1_1,102,3
Scaffold544-1818_1920,cPa394-unknown,0.363636363636364,7,1884,1823,cPa394-cPa118-hybrid_cPa394-cPa125-hybrid_cPa394-unknown_cPa510-cPa118-hybrid_cPa510-unknown_cPa539-cPa118-hybrid_cPa539-unknown,1_1_4_1_2_1_1,102,61
Scaffold544-1995_2166,cPa394-cPa118-hybrid,0.5,3,2114,2045,cPa394-cPa118-hybrid_cPa394-unknown_cPa539-cPa118-hybrid,2_1_1,171,69
Scaffold544-5415_5517,cPa339-cPa118-hybrid,1,1,5465,5465,cPa339-cPa118-hybrid,1,102,0
Scaffold544-5523_5642,cPa339-unknown,0.565217391304348,3,5590,5525,cPa339_cPa339-unknown_cPa419,9_13_1,119,65
Scaffold544-5739_5952,cPa339-unknown,0.478260869565217,5,5949,5762,cPa339_cPa339-cPa117-hybrid_cPa339-cPa131-hybrid_cPa339-cPa391-hybrid_cPa339-unknown,7_1_1_3_11,213,187
Scaffold544-8583_8761,cPa356,0.677966101694915,13,8761,8583,cPa223-cPa4-hybrid_cPa229-cPa117-hybrid_cPa229-cPa131-hybrid_cPa229-HML4_repbase_HERVK13I_LTR13-hybrid_cPa229-unknown_cPa356_cPa356-unknown_cPa447_cPa447-cPa4-hybrid_cPa463_cPa463-cPa404-hybrid_cPa463-cPa425-hybrid_cPa463-unknown,1_1_1_1_1_40_4_5_1_1_1_1_1,178,178
Scaffold544-9013_9115,cPa356,0.545454545454545,5,9096,9012,cPa356_cPa356-unknown_cPa434-cPa174-hybrid_cPa434-cPa447-hybrid_cPa434-unknown,6_1_1_1_2,102,84
Scaffold544-9233_9431,cPa356,0.58974358974359,5,9420,9237,cPa356_cPa356-cPa392-hybrid_cPa356-cPa452-hybrid_cPa434_cPa434-unknown,23_1_1_12_2,198,183
Scaffold545-12609_12742,cPa356,0.615384615384615,2,12725,12633,cPa356_cPa428,16_10,133,92
Scaffold545-13127_13229,cPa356,0.555555555555556,2,13205,13134,cPa356_cPa428,20_16,102,71
Scaffold546-10412_10514,cPa428,0.615384615384615,2,10462,10447,cPa356_cPa428,5_8,102,15
Scaffold546-12130_12232,cPa356,1,1,12180,12180,cPa356,1,102,0
Scaffold547-16395_16550,cPa428,0.565217391304348,2,16543,16411,cPa356_cPa428,10_13,155,132
Scaffold547-16728_16999,cPa428,0.558139534883721,2,16947,16748,cPa356_cPa428,19_24,271,199
Scaffold547-17024_17126,cPa428,0.521739130434783,2,17124,17024,cPa356_cPa428,11_12,102,100
Scaffold548-8097_8304,MSEV_CT990572,0.206451612903226,67,8300,8129,cPa16-cPa67-hybrid_cPa232-cPa449-hybrid_cPa285-cPa67-hybrid_cPa419_cPa419-cPa285-hybrid_cPa419-cPa449-hybrid_cPa419-cPa67-hybrid_cPa419-HERV-F_repbase_HERVFH19I_LTR19A-hybrid_cPa419-MDEV_AF053745-hybrid_cPa419-PERVA_AY099323-hybrid_cPa419-PERVB_AY099324-hybrid_cPa428-cPa285-hybrid_cPa428-cPa67-hybrid_cPa434-cPa67-hybrid_cPa452-FrMuLV_NC001362-hybrid_cPa459-HERV-F_repbase_HERVFH19I_LTR19A-hybrid_cPa62_cPa62-cPa285-hybrid_cPa62-cPa449-hybrid_cPa62-cPa67-hybrid_cPa62-PERVC_HM159246-hybrid_cPa67_cPa75_cPa75-cPa67-hybrid_GaLV_M26927-cPa67-hybrid_GaLV_M26927-PERVA_AY099323-hybrid_GaLV_M26927-PERVB_AY099324-hybrid_GaLV_M26927-PERVC_HM159246-hybrid_HERV-F_repbase_HERVFH19I_LTR19A_HERV-W_repbase_HERV17_LTR17_HIV1_NC001802-cPa285-hybrid_HIV1_NC001802-cPa449-hybrid_HIV1_NC001802-cPa67-hybrid_HML4_repbase_HERVK13I_LTR13-cPa67-hybrid_KoRV_AF151794_KoRV_AF151794-cPa118-hybrid_KoRV_AF151794-cPa449-hybrid_KoRV_AF151794-cPa67-hybrid_KoRV_AF151794-MDEV_AF053745-hybrid_KoRV_AF151794-PERVC_HM159246-hybrid_MDEV_AF053745_MDEV_AF053745-cPa16-hybrid_MDEV_AF053745-cPa285-hybrid_MDEV_AF053745-cPa502-hybrid_MDEV_AF053745-cPa67-hybrid_MLV_Xmv43_MLV_Xmv43-cPa16-hybrid_MLV_Xmv43-cPa285-hybrid_MLV_Xmv43-cPa449-hybrid_MLV_Xmv43-cPa75-hybrid_MLV_Xmv43-PERV_AJ293656-hybrid_MSEV_CT990572_MSEV_CT990572-cPa449-hybrid_MSEV_CT990572-GaLV_M26927-hybrid_MSEV_CT990572-HERV-F_repbase_HERVFH19I_LTR19A-hybrid_PERV_AJ293656_PERV_AJ293656-cPa285-hybrid_PERV_AJ293656-cPa449-hybrid_PERV_AJ293656-cPa502-hybrid_PERVB_AY099324_PERVB_AY099324-cPa449-hybrid_PERVB_AY099324-cPa67-hybrid_PERVB_AY099324-MDEV_AF053745-hybrid_PERVB_AY099324-PERVC_HM159246-hybrid_PERVC_HM159246_PERVC_HM159246-cPa449-hybrid_PERVC_HM159246-HERV-F_repbase_HERVFH19I_LTR19A-hybrid,1_1_5_2_3_3_4_1_1_1_1_1_1_1_1_2_1_1_1_1_1_1_1_1_2_1_1_1_1_55_1_1_1_1_87_1_13_4_1_1_38_1_4_1_1_19_1_3_3_1_2_96_3_1_1_25_1_1_1_21_1_1_1_1_26_1_1,207,171
Scaffold549-10173_10275,cPa428,0.7,2,10259,10223,cPa356_cPa428,3_7,102,36
Scaffold549-10388_10490,cPa356,0.666666666666667,2,10486,10407,cPa356_cPa428,6_3,102,79
Scaffold549-10953_11153,cPa428,0.5625,2,11153,10977,cPa356_cPa428,7_9,200,176
Scaffold549-11257_11359,cPa356,0.571428571428571,2,11340,11271,cPa356_cPa428,4_3,102,69
Scaffold549-16029_16154,cPa356,0.625,2,16126,16028,cPa356_cPa428,5_3,125,98
Scaffold549-8176_8278,cPa428,1,1,8226,8226,cPa428,1,102,0
Scaffold549-8707_8809,cPa356,1,1,8757,8757,cPa356,1,102,0
Scaffold549-9537_9639,cPa356,0.666666666666667,2,9633,9587,cPa356_cPa428,2_1,102,46
Scaffold55-16107_16209,cPa356_cPa434,0.5,2,16157,16153,cPa356_cPa434,1_1,102,4
Scaffold55-16296_16398,cPa434,1,1,16346,16346,cPa434,1,102,0
Scaffold55-18434_18536,cPa425-cPa193-hybrid,0.883720930232558,4,18506,18470,cPa254-cPa193-hybrid_cPa392_cPa392-cPa193-hybrid_cPa425-cPa193-hybrid,1_1_3_38,102,36
Scaffold55-18779_18881,cPa425-cPa193-hybrid,0.7,4,18838,18794,cPa254-cPa193-hybrid_cPa392-cPa193-hybrid_cPa404-cPa193-hybrid_cPa425-cPa193-hybrid,1_1_1_7,102,44
Scaffold55-20459_20561,cPa434,1,1,20545,20509,cPa434,7,102,36
Scaffold55-20767_20869,cPa434,1,1,20852,20809,cPa434,18,102,43
Scaffold55-3446_3839,cPa145,0.83739837398374,11,3839,3481,cPa145_cPa168-cPa145-hybrid_cPa308-cPa298-hybrid_cPa357-cPa145-hybrid_cPa357-cPa193-hybrid_cPa402_cPa419_cPa425-unknown_cPa543_cPa75_HERV-W_repbase_HERV17_LTR17,103_2_1_1_1_6_4_1_1_2_1,393,358
Scaffold55-7545_7647,cPa425,1,1,7595,7595,cPa425,1,102,0
Scaffold55-8684_8786,cPa47-cPa125-hybrid,1,1,8734,8734,cPa47-cPa125-hybrid,1,102,0
Scaffold550-14212_14386,cPa357,0.448275862068966,11,14334,14255,cPa200_cPa200-cPa357-hybrid_cPa200-cPa510-hybrid_cPa200-unknown_cPa357_cPa357-unknown_cPa544_cPa544-cPa357-hybrid_cPa544-cPa510-hybrid_cPa544-cPa75-hybrid_cPa544-unknown,2_2_1_2_39_2_1_8_5_1_24,174,79
Scaffold550-14417_14552,cPa357,0.330508474576271,12,14500,14462,cPa107-cPa357-hybrid_cPa107-cPa510-hybrid_cPa200_cPa200-cPa357-hybrid_cPa357_cPa357-cPa200-hybrid_cPa357-unknown_cPa544_cPa544-cPa200-hybrid_cPa544-cPa357-hybrid_cPa544-cPa510-hybrid_cPa544-unknown,2_1_22_1_39_1_4_1_1_13_4_29,135,38
Scaffold551-8574_8676,cPa75-cPa486-hybrid,1,1,8624,8624,cPa75-cPa486-hybrid,1,102,0
Scaffold551-9340_9645,cPa486,0.961538461538462,2,9642,9363,cPa486_WDSV_NC001867,25_1,305,279
Scaffold552-4979_5081,cPa315-unknown_cPa332-cPa51-hybrid_cPa332-unknown,0.333333333333333,3,5065,5029,cPa315-unknown_cPa332-cPa51-hybrid_cPa332-unknown,1_1_1,102,36
Scaffold552-9101_9203,SIV_NC001870-cPa425-hybrid,1,1,9151,9151,SIV_NC001870-cPa425-hybrid,1,102,0
Scaffold558-10182_10284,cPa419,1,1,10232,10232,cPa419,1,102,0
Scaffold558-17382_17484,cPa419,1,1,17432,17432,cPa419,1,102,0
Scaffold559-10198_10431,ALVJ_Z46390-cPa75-hybrid,0.571428571428571,6,10380,10248,ALVJ_Z46390-cPa2-hybrid_ALVJ_Z46390-cPa542-hybrid_ALVJ_Z46390-cPa75-hybrid_ALVJ_Z46390-HERVHcons-hybrid_cPa402-cPa75-hybrid_cPa518-cPa75-hybrid,3_1_12_1_2_2,233,132
Scaffold559-14230_14332,cPa452-unknown,0.8,2,14325,14269,cPa419_cPa452-unknown,1_4,102,56
Scaffold559-15128_15230,cPa419_cPa452-GaLV_M26927-hybrid,0.5,2,15216,15178,cPa419_cPa452-GaLV_M26927-hybrid,2_2,102,38
Scaffold559-16596_16698,cPa199-cPa358-hybrid_cPa356-cPa358-hybrid_cPa542-cPa358-hybrid_cPa75-cPa358-hybrid,0.25,4,16688,16601,cPa199-cPa358-hybrid_cPa356-cPa358-hybrid_cPa542-cPa358-hybrid_cPa75-cPa358-hybrid,1_1_1_1,102,87
Scaffold559-3772_3874,cPa190-unknown,0.545454545454545,4,3871,3782,cPa190-cPa419-hybrid_cPa190-cPa511-hybrid_cPa190-unknown_cPa419,1_1_6_3,102,89
Scaffold559-4134_4336,cPa190-unknown,0.833333333333333,3,4321,4141,cPa190-ALVJ_Z46390-hybrid_cPa190-unknown_cPa419,1_20_3,202,180
Scaffold559-6390_6492,cPa163-unknown_cPa413-cPa145-hybrid,0.5,2,6486,6440,cPa163-unknown_cPa413-cPa145-hybrid,1_1,102,46
Scaffold559-9943_10055,ALVJ_Z46390-cPa75-hybrid,0.4,4,10003,9993,ALVJ_Z46390-cPa75-hybrid_cPa402-cPa2-hybrid_cPa402-cPa75-hybrid_cPa452-cPa542-hybrid,2_1_1_1,112,10
Scaffold56-15104_15272,cPa200,0.4,9,15250,15154,cPa104-cPa200-hybrid_cPa104-cPa229-hybrid_cPa104-unknown_cPa200_cPa257-cPa200-hybrid_cPa543-cPa200-hybrid_cPa543-cPa229-hybrid_cPa61-cPa229-hybrid_HERV-F_repbase_HERVFH19I_LTR19A-cPa200-hybrid,1_2_1_6_1_1_1_1_1,168,96
Scaffold56-15835_15937,cPa391,0.857142857142857,2,15916,15845,cPa391_cPa391-cPa260-hybrid,6_1,102,71
Scaffold56-1614_1829,cPa434,0.533333333333333,6,1777,1664,cPa150-cPa425-hybrid_cPa193-cPa75-hybrid_cPa434_cPa434-cPa174-hybrid_cPa434-cPa404-hybrid_cPa434-unknown,1_1_8_3_1_1,215,113
Scaffold56-1982_2088,cPa193-cPa434-hybrid,0.5,4,2082,1981,cPa111-cPa434-hybrid_cPa193-cPa434-hybrid_cPa434-cPa254-hybrid_cPa434-cPa404-hybrid,1_3_1_1,106,101
Scaffold56-20017_20119,cPa223_cPa47-cPa223-hybrid,0.5,2,20067,20063,cPa223_cPa47-cPa223-hybrid,1_1,102,4
Scaffold56-20356_20458,cPa47-cPa208-hybrid,1,1,20406,20406,cPa47-cPa208-hybrid,1,102,0
Scaffold56-29091_29193,RELIK_ERVK,1,1,29141,29141,RELIK_ERVK,1,102,0
Scaffold56-29862_30099,cPa199,0.863636363636364,3,30096,29869,cPa199_cPa419_cPa510-cPa411-hybrid,19_2_1,237,227
Scaffold56-3039_3141,cPa434-cPa174-hybrid,0.375,7,3107,3047,cPa193-cPa434-hybrid_cPa400-cPa174-hybrid_cPa434_cPa434-cPa174-hybrid_cPa434-cPa254-hybrid_cPa434-cPa425-hybrid_cPa434-cPa47-hybrid,3_1_1_6_3_1_1,102,60
Scaffold56-30530_30632,cPa419,0.6,3,30600,30552,cPa199_cPa419_cPa510-unknown,1_3_1,102,48
Scaffold56-33595_33710,cPa391,0.605263157894737,11,33682,33594,cPa256-unknown_cPa260_cPa260-unknown_cPa298_cPa298-unknown_cPa363_cPa363-cPa298-hybrid_cPa363-unknown_cPa391_cPa391-cPa298-hybrid_cPa391-unknown,1_1_1_7_1_21_1_4_69_1_7,115,88
Scaffold56-33719_33863,cPa391,0.466666666666667,4,33823,33729,cPa363_cPa363-cPa298-hybrid_cPa363-unknown_cPa391,11_1_4_14,144,94
Scaffold56-33866_34023,cPa391,0.685714285714286,6,34020,33869,cPa106-cPa298-hybrid_cPa106-unknown_cPa298_cPa391_cPa391-cPa298-hybrid_cPa391-unknown,6_1_1_96_1_35,157,151
Scaffold56-34032_34159,cPa391,0.846153846153846,3,34135,34082,cPa119-unknown_cPa256-cPa107-hybrid_cPa391,1_1_11,127,53
Scaffold56-3415_3517,cPa193-cPa555-hybrid,0.666666666666667,2,3465,3450,cPa193-cPa555-hybrid_cPa434,2_1,102,15
Scaffold56-38650_38752,cPa67,0.975609756097561,2,38735,38673,cPa526-HML4_repbase_HERVK13I_LTR13-hybrid_cPa67,1_40,102,62
Scaffold56-38814_39368,cPa67,0.770909090909091,15,39358,38852,BaEV_D10032-cPa410-hybrid_BaEV_D10032-cPa587-hybrid_cPa118-cPa587-hybrid_cPa15-cPa177-hybrid_cPa15-cPa410-hybrid_cPa15-cPa587-hybrid_cPa410_cPa443-cPa410-hybrid_cPa516-cPa410-hybrid_cPa526-cPa177-hybrid_cPa526-cPa410-hybrid_cPa526-cPa587-hybrid_cPa526-HML4_repbase_HERVK13I_LTR13-hybrid_cPa587_cPa67,1_1_1_3_20_18_5_1_1_1_4_2_1_4_212,554,506
Scaffold56-42236_42338,cPa356,0.681818181818182,4,42336,42237,cPa356_cPa356-cPa125-hybrid_cPa356-cPa434-hybrid_cPa447,15_1_1_5,102,99
Scaffold56-42422_42564,cPa356,0.825,6,42550,42428,cPa356_cPa356-cPa125-hybrid_cPa356-cPa447-hybrid_cPa447_cPa447-cPa356-hybrid_cPa575-cPa447-hybrid,33_1_1_3_1_1,142,122
Scaffold56-42572_42790,cPa356,0.894736842105263,3,42776,42597,cPa356_cPa356-unknown_cPa447,17_1_1,218,179
Scaffold56-4730_4850,cPa434,0.944444444444444,2,4828,4736,cPa434_cPa434-cPa356-hybrid,17_1,120,92
Scaffold56-5625_5727,cPa434,1,1,5675,5675,cPa434,1,102,0
Scaffold56-5910_6012,cPa356_cPa434,0.5,2,5960,5930,cPa356_cPa434,1_1,102,30
Scaffold56-6902_7004,cPa356,1,1,6972,6952,cPa356,2,102,20
Scaffold561-15500_15637,cPa428,0.428571428571429,3,15585,15503,cPa356_cPa428_cPa428-unknown,2_3_2,137,82
Scaffold561-15646_15834,cPa428,0.75,2,15808,15696,cPa356_cPa428,1_3,188,112
Scaffold562-10541_10643,cPa419,1,1,10603,10560,cPa419,10,102,43
Scaffold562-11707_11809,cPa419,1,1,11776,11725,cPa419,43,102,51
Scaffold562-11822_11924,cPa419,1,1,11921,11821,cPa419,7,102,100
Scaffold562-13297_13418,cPa419,1,1,13366,13328,cPa419,3,121,38
Scaffold562-13530_13632,cPa419,1,1,13585,13573,cPa419,3,102,12
Scaffold562-14343_14445,cPa419,1,1,14393,14386,cPa419,2,102,7
Scaffold562-14513_14615,cPa419,1,1,14582,14563,cPa419,2,102,19
Scaffold562-14809_14911,cPa419,1,1,14906,14811,cPa419,9,102,95
Scaffold562-15682_15784,cPa419,1,1,15775,15682,cPa419,84,102,93
Scaffold562-15977_16079,cPa419,1,1,16043,15986,cPa419,9,102,57
Scaffold562-16279_16381,cPa419,1,1,16362,16289,cPa419,43,102,73
Scaffold562-16406_16508,cPa419,1,1,16505,16412,cPa419,33,102,93
Scaffold562-6640_6742,cPa419,1,1,6690,6690,cPa419,1,102,0
Scaffold562-7188_7509,cPa419,1,1,7457,7238,cPa419,19,321,219
Scaffold562-8795_8897,cPa419,1,1,8862,8814,cPa419,10,102,48
Scaffold562-9023_9125,cPa419,1,1,9120,9052,cPa419,11,102,68
Scaffold562-9225_9327,cPa419,1,1,9312,9227,cPa419,11,102,85
Scaffold563-10193_10296,cPa419,1,1,10257,10241,cPa419,10,103,16
Scaffold563-10573_10675,cPa419,1,1,10623,10583,cPa419,6,102,40
Scaffold563-12125_12227,cPa428,1,1,12175,12175,cPa428,1,102,0
Scaffold563-13640_13742,cPa428,0.56,2,13709,13639,cPa356_cPa428,11_14,102,70
Scaffold563-14023_14125,cPa356,0.6,2,14078,14068,cPa356_cPa428,3_2,102,10
Scaffold563-9869_9977,cPa419,1,1,9976,9909,cPa419,67,108,67
Scaffold564-12166_12331,cPa434,0.205882352941176,14,12303,12204,cPa111_cPa356_cPa356-cPa111-hybrid_cPa356-cPa546-hybrid_cPa356-unknown_cPa434_cPa434-cPa111-hybrid_cPa434-cPa75-hybrid_cPa434-unknown_HERV-I_repbase_HERVI_LTR10B-cPa111-hybrid_HERV-I_repbase_HERVI_LTR10B-cPa356-hybrid_HERV-I_repbase_HERVI_LTR10B-cPa546-hybrid_HERV-I_repbase_HERVI_LTR10B-cPa75-hybrid_HERV-I_repbase_HERVI_LTR10B-unknown,1_5_1_1_2_7_1_2_3_1_1_2_3_4,165,99
Scaffold564-16963_17360,cPa425,0.587570621468927,16,17320,17009,cPa118-cPa356-hybrid_cPa315-cPa356-hybrid_cPa315-cPa75-hybrid_cPa356_cPa356-cPa75-hybrid_cPa404-cPa356-hybrid_cPa419-cPa201-hybrid_cPa425_cPa425-cPa174-hybrid_cPa425-cPa223-hybrid_cPa425-cPa47-hybrid_cPa425-FeFV_NC001871-hybrid_cPa47-cPa109-hybrid_cPa47-cPa356-hybrid_HTLV1_NC001436_S71_repbase_HERVS71_LTR6A,1_3_1_53_1_1_1_104_1_4_1_1_1_1_1_2,397,311
Scaffold564-17393_17504,cPa425,0.758064516129032,5,17502,17437,cPa356_cPa356-cPa75-hybrid_cPa425_cPa425-cPa174-hybrid_cPa47-cPa356-hybrid,12_1_47_1_1,111,65
Scaffold564-7572_7696,cPa425_cPa425-cPa469-hybrid,0.5,2,7644,7622,cPa425_cPa425-cPa469-hybrid,1_1,124,22
Scaffold564-7825_7987,cPa425,0.8,2,7937,7875,cPa425_cPa425-cPa469-hybrid,4_1,162,62
Scaffold564-8185_8545,cPa425,0.365853658536585,7,8493,8235,cPa34_cPa425_cPa425-cPa34-hybrid_cPa425-cPa469-hybrid_cPa425-cPa552-hybrid_cPa425-cPa75-hybrid_cPa75,6_15_2_5_1_2_10,360,258
Scaffold564-8636_8933,cPa75,0.625,3,8881,8686,cPa425-cPa469-hybrid_cPa425-cPa75-hybrid_cPa75,2_1_5,297,195
Scaffold564-8977_9149,cPa75,0.666666666666667,4,9141,9023,cPa254-cPa75-hybrid_cPa34-cPa469-hybrid_cPa425-cPa469-hybrid_cPa75,1_1_3_10,172,118
Scaffold564-9914_10016,cPa425,0.7,4,10008,9940,cPa404-cPa75-hybrid_cPa419_cPa425_cPa425-cPa419-hybrid,1_1_7_1,102,68
Scaffold565-13652_13773,cPa356,0.6,2,13735,13685,cPa356_cPa428,12_8,121,50
Scaffold565-14428_14530,cPa356,0.666666666666667,2,14478,14476,cPa356_cPa428,2_1,102,2
Scaffold565-9143_9245,cPa428,1,1,9193,9193,cPa428,1,102,0
Scaffold567-10005_10191,cPa553,0.476190476190476,17,10164,10029,cPa199_cPa199-cPa183-hybrid_cPa199-cPa260-hybrid_cPa199-cPa273-hybrid_cPa223-cPa199-hybrid_cPa273_cPa273-cPa482-hybrid_cPa345_cPa419_cPa424-cPa273-hybrid_cPa424-cPa345-hybrid_cPa482_cPa542_cPa553_cPa553-cPa482-hybrid_cPa62_cPa75,1_1_1_1_1_2_1_3_3_1_1_1_2_20_1_1_1,186,135
Scaffold567-10484_10586,cPa553,0.666666666666667,2,10538,10519,cPa419_cPa553,1_2,102,19
Scaffold567-11393_11635,cPa51-cPa482-hybrid_cPa553,0.0655737704918033,69,11631,11392,cPa183-cPa199-hybrid_cPa183-cPa273-hybrid_cPa183-cPa298-hybrid_cPa183-cPa482-hybrid_cPa183-cPa542-hybrid_cPa183-unknown_cPa199-cPa482-hybrid_cPa223_cPa223-cPa199-hybrid_cPa223-cPa273-hybrid_cPa223-cPa482-hybrid_cPa273-cPa482-hybrid_cPa327-cPa542-hybrid_cPa363-cPa199-hybrid_cPa363-cPa273-hybrid_cPa363-cPa298-hybrid_cPa363-cPa482-hybrid_cPa363-cPa542-hybrid_cPa379-cPa199-hybrid_cPa379-cPa273-hybrid_cPa379-cPa298-hybrid_cPa379-cPa424-hybrid_cPa379-cPa482-hybrid_cPa379-cPa542-hybrid_cPa379-cPa553-hybrid_cPa419_cPa419-cPa553-hybrid_cPa424_cPa424-cPa199-hybrid_cPa424-cPa273-hybrid_cPa424-cPa482-hybrid_cPa424-cPa553-hybrid_cPa446_cPa446-cPa199-hybrid_cPa446-cPa273-hybrid_cPa446-cPa298-hybrid_cPa446-cPa424-hybrid_cPa446-cPa482-hybrid_cPa446-cPa542-hybrid_cPa446-unknown_cPa450-cPa482-hybrid_cPa452-cPa199-hybrid_cPa452-cPa273-hybrid_cPa452-cPa298-hybrid_cPa452-cPa333-hybrid_cPa452-cPa424-hybrid_cPa452-cPa482-hybrid_cPa452-cPa542-hybrid_cPa452-cPa553-hybrid_cPa452-HTLV2_M10060-hybrid_cPa456-cPa553-hybrid_cPa482_cPa51_cPa51-cPa199-hybrid_cPa51-cPa298-hybrid_cPa51-cPa345-hybrid_cPa51-cPa482-hybrid_cPa51-cPa542-hybrid_cPa51-cPa553-hybrid_cPa51-HTLV2_M10060-hybrid_cPa51-unknown_cPa553_cPa553-cPa482-hybrid_cPa71-cPa199-hybrid_cPa71-cPa273-hybrid_cPa71-cPa482-hybrid_cPa71-cPa542-hybrid_cPa71-HTLV2_M10060-hybrid_KWERV_GQ222416-cPa345-hybrid,1_1_1_14_3_2_1_3_3_1_10_2_1_5_3_2_11_2_6_4_2_1_8_1_1_14_1_12_1_1_6_2_8_1_3_2_1_12_1_7_1_3_3_2_1_1_9_1_1_1_1_2_3_3_1_1_16_2_2_1_2_16_1_3_1_2_1_1_1,242,239
Scaffold567-5168_5324,cPa194,0.761904761904762,6,5284,5218,cPa194_cPa194-PRIMA41_repbase_PRIMA41_MER41A-hybrid_cPa583-PRIMA41_repbase_PRIMA41_MER41A-hybrid_PERVC_HM159246-cPa194-hybrid_PERVC_HM159246-cPa472-hybrid_PERVC_HM159246-PRIMA41_repbase_PRIMA41_MER41A-hybrid,16_1_1_1_1_1,156,66
Scaffold567-5384_5486,cPa273-cPa194-hybrid,0.1875,12,5471,5402,cPa199-cPa194-hybrid_cPa199-PRIMA41_repbase_PRIMA41_MER41A-hybrid_cPa223-PRIMA41_repbase_PRIMA41_MER41A-hybrid_cPa273-cPa194-hybrid_cPa419_cPa419-PRIMA41_repbase_PRIMA41_MER41A-hybrid_cPa542-cPa194-hybrid_cPa542-PRIMA41_repbase_PRIMA41_MER41A-hybrid_cPa553-cPa194-hybrid_cPa553-PRIMA41_repbase_PRIMA41_MER41A-hybrid_cPa62-cPa194-hybrid_HML1a_repbase_HERV-K14CI_LTR14C-PRIMA41_repbase_PRIMA41_MER41A-hybrid,1_1_1_3_2_1_1_2_1_1_1_1,102,69
Scaffold567-7679_7781,cPa273,0.5,5,7780,7678,cPa199-PRIMA41_repbase_PRIMA41_MER41A-hybrid_cPa273_cPa419_cPa542_cPa553,1_6_1_2_2,102,102
Scaffold567-7853_7955,cPa553,0.315789473684211,24,7954,7889,cPa199_cPa199-cPa260-hybrid_cPa199-cPa482-hybrid_cPa223_cPa273_cPa273-cPa260-hybrid_cPa419_cPa419-cPa542-hybrid_cPa424-cPa118-hybrid_cPa450_cPa482-cPa260-hybrid_cPa542_cPa542-cPa260-hybrid_cPa542-cPa273-hybrid_cPa542-unknown_cPa553_cPa553-cPa260-hybrid_cPa553-cPa273-hybrid_cPa553-unknown_cPa62_cPa62-cPa542-hybrid_cPa75-cPa450-hybrid_cPa75-cPa482-hybrid_cPa75-unknown,1_1_1_2_6_2_5_1_1_1_1_3_1_1_1_18_1_1_2_3_1_1_1_1,102,65
Scaffold567-7970_8508,cPa273_cPa553,0.15028901734104,54,8508,7970,cPa199_cPa199-cPa260-hybrid_cPa199-cPa482-hybrid_cPa223-cPa260-hybrid_cPa223-cPa482-hybrid_cPa260_cPa273_cPa273-cPa260-hybrid_cPa273-cPa552-hybrid_cPa290-cPa260-hybrid_cPa293-cPa260-hybrid_cPa363_cPa363-cPa199-hybrid_cPa363-cPa379-hybrid_cPa379_cPa419_cPa424_cPa424-cPa260-hybrid_cPa424-cPa482-hybrid_cPa424-cPa542-hybrid_cPa446_cPa450_cPa450-cPa260-hybrid_cPa450-HERVHcons-hybrid_cPa452_cPa452-cPa273-hybrid_cPa482_cPa482-cPa260-hybrid_cPa542_cPa542-cPa260-hybrid_cPa542-cPa450-hybrid_cPa542-cPa482-hybrid_cPa546_cPa553_cPa553-cPa260-hybrid_cPa553-cPa273-hybrid_cPa553-cPa446-hybrid_cPa553-cPa542-hybrid_cPa62_cPa71-cPa118-hybrid_cPa75_cPa75-cPa183-hybrid_cPa75-cPa194-hybrid_cPa75-cPa260-hybrid_cPa75-cPa273-hybrid_cPa75-cPa482-hybrid_cPa75-cPa542-hybrid_cPa75-unknown_HERV-W_repbase_HERV17_LTR17_HERVHcons-cPa260-hybrid_MPMVs_NC001550-cPa260-hybrid_MPMVs_NC001550-cPa273-hybrid_MPMVs_NC001550-cPa542-hybrid_MSEV_CT990572-cPa260-hybrid,1_1_1_1_1_21_26_3_1_1_1_4_1_1_1_10_1_1_1_1_1_3_1_1_3_1_1_1_12_2_1_1_1_26_2_1_1_1_8_1_1_1_1_7_3_1_2_3_1_1_1_1_1_1,538,538
Scaffold567-9746_9951,cPa553,0.411764705882353,8,9941,9757,cPa199_cPa199-cPa482-hybrid_cPa254_cPa273_cPa345_cPa419_cPa542_cPa553,16_2_1_2_3_5_1_21,205,184
Scaffold568-10597_10699,cPa428,0.666666666666667,2,10677,10647,cPa356_cPa428,1_2,102,30
Scaffold568-15176_15278,cPa356,0.545454545454545,3,15266,15178,cPa356_cPa356-unknown_cPa428,6_1_4,102,88
Scaffold568-15335_15437,cPa356,1,1,15385,15360,cPa356,2,102,25
Scaffold568-15847_15949,cPa428,1,1,15897,15878,cPa428,2,102,19
Scaffold57-15210_15312,cPa419,1,1,15288,15260,cPa419,2,102,28
Scaffold572-12006_12108,cPa428,0.6,2,12081,12014,cPa356_cPa428,2_3,102,67
Scaffold572-12299_12401,cPa356,0.5,3,12379,12349,cPa356_cPa428_cPa428-cPa356-hybrid,3_2_1,102,30
Scaffold572-14253_14355,cPa356_cPa428,0.5,2,14303,14277,cPa356_cPa428,5_5,102,26
Scaffold572-14391_14537,cPa428,0.517241379310345,2,14490,14421,cPa356_cPa428,14_15,146,69
Scaffold572-16610_16712,cPa356,0.6,2,16660,16625,cPa356_cPa428,3_2,102,35
Scaffold572-16752_16854,cPa356,0.6,2,16802,16760,cPa356_cPa428,3_2,102,42
Scaffold573-10530_10632,cPa61-cPa75-hybrid,0.8,2,10617,10558,cPa419_cPa61-cPa75-hybrid,1_4,102,59
Scaffold573-13917_14019,cPa15-cPa587-hybrid_cPa223-cPa357-hybrid,0.5,2,13967,13926,cPa15-cPa587-hybrid_cPa223-cPa357-hybrid,1_1,102,41
Scaffold573-1413_1566,cPa47,0.166666666666667,11,1514,1463,cPa118-cPa174-hybrid_cPa118-cPa260-hybrid_cPa118-cPa371-hybrid_cPa118-cPa428-hybrid_cPa196-cPa371-hybrid_cPa196-cPa425-hybrid_cPa404-cPa254-hybrid_cPa433-cPa174-hybrid_cPa434-cPa425-hybrid_cPa47_cPa47-cPa371-hybrid,1_1_1_1_1_1_1_1_1_2_1,153,51
Scaffold573-15129_15473,cPa363,0.298969072164948,38,15472,15132,cPa194-cPa363-hybrid_cPa194-cPa452-hybrid_cPa194-cPa587-hybrid_cPa194-cPa75-hybrid_cPa223-cPa145-hybrid_cPa260-cPa117-hybrid_cPa260-cPa363-hybrid_cPa260-cPa450-hybrid_cPa260-cPa452-hybrid_cPa260-cPa587-hybrid_cPa308-cPa75-hybrid_cPa363_cPa390-cPa117-hybrid_cPa398-cPa273-hybrid_cPa398-cPa456-hybrid_cPa410-cPa273-hybrid_cPa410-cPa456-hybrid_cPa419_cPa444-cPa75-hybrid_cPa452_cPa452-cPa587-hybrid_cPa456_cPa456-cPa145-hybrid_cPa456-cPa176-hybrid_cPa456-cPa199-hybrid_cPa456-cPa260-hybrid_cPa456-cPa363-hybrid_cPa456-cPa452-hybrid_cPa456-cPa526-hybrid_cPa456-cPa549-hybrid_cPa456-cPa587-hybrid_cPa456-unknown_cPa482-cPa450-hybrid_cPa563-PERVE_NC003059-hybrid_cPa587_cPa587-cPa363-hybrid_HML3_repbase_HERVK9I_MER9-cPa587-hybrid_PyERV_AF500296-cPa587-hybrid,3_2_1_2_1_1_1_1_1_2_1_58_1_1_2_1_1_5_1_5_1_28_1_1_1_1_5_5_1_5_1_6_1_1_42_1_1_1,344,340
Scaffold573-15782_15884,cPa456-cPa145-hybrid_cPa526-cPa363-hybrid,0.5,2,15850,15832,cPa456-cPa145-hybrid_cPa526-cPa363-hybrid,1_1,102,18
Scaffold573-4473_4575,cPa428-cPa15-hybrid,0.5,3,4530,4523,cPa428-cPa15-hybrid_cPa433-cPa118-hybrid_cPa434-cPa248-hybrid,2_1_1,102,7
Scaffold573-5191_5344,cPa428-cPa15-hybrid_cPa428-cPa248-hybrid,0.5,2,5292,5241,cPa428-cPa15-hybrid_cPa428-cPa248-hybrid,1_1,153,51
Scaffold573-5434_5536,cPa428-cPa118-hybrid_cPa428-cPa15-hybrid,0.5,2,5484,5477,cPa428-cPa118-hybrid_cPa428-cPa15-hybrid,1_1,102,7
Scaffold573-7349_7451,cPa205,0.230769230769231,14,7450,7349,cPa121-cPa109-hybrid_cPa2-cPa109-hybrid_cPa2-cPa447-hybrid_cPa205_cPa308-cPa447-hybrid_cPa339_cPa390_cPa419_cPa447_cPa447-cPa371-hybrid_cPa486_cPa568-cPa15-hybrid_cPa568-cPa268-hybrid_HERV-ADP_repbase_HERVP71A_I_LTR71A-cPa109-hybrid,1_1_1_9_1_2_7_4_8_1_1_1_1_1,102,101
Scaffold573-7452_7554,cPa419,0.3,7,7554,7461,cPa109-cPa450-hybrid_cPa2-cPa339-hybrid_cPa308_cPa339_cPa419_cPa486-HERV-E_repbase_HERVE_LTR2-hybrid_cPa75,1_1_1_2_3_1_1,102,93
Scaffold573-9140_9545,cPa2-unknown,0.261682242990654,30,9493,9165,cPa2_cPa2-cPa168-hybrid_cPa2-cPa323-hybrid_cPa2-cPa371-hybrid_cPa2-cPa450-hybrid_cPa2-cPa539-hybrid_cPa2-HERV-E_repbase_HERVE_LTR2-hybrid_cPa2-unknown_cPa251_cPa256_cPa256-cPa168-hybrid_cPa256-cPa251-hybrid_cPa256-cPa539-hybrid_cPa256-unknown_cPa308_cPa308-cPa168-hybrid_cPa308-cPa2-hybrid_cPa308-cPa323-hybrid_cPa308-cPa371-hybrid_cPa308-cPa419-hybrid_cPa308-cPa450-hybrid_cPa308-cPa539-hybrid_cPa308-HERV-ADP_repbase_HERVP71A_I_LTR71A-hybrid_cPa308-HERV-E_repbase_HERVE_LTR2-hybrid_cPa308-unknown_cPa419_cPa419-cPa308-hybrid_cPa585-unknown_HERV-E_repbase_HERVE_LTR2_HERV-E_repbase_HERVE_LTR2-cPa323-hybrid,21_3_5_4_2_1_1_56_2_1_1_1_1_1_17_4_1_15_5_1_7_1_1_1_44_9_1_1_4_2,405,328
Scaffold573-9920_10022,cPa2,1,1,9970,9970,cPa2,1,102,0
Scaffold574-1154_1256,cPa419,0.666666666666667,2,1209,1196,BFV_NC001831-cPa371-hybrid_cPa419,1_2,102,13
Scaffold574-12542_12783,cPa62,0.4,4,12731,12576,cPa168_cPa475_cPa527-unknown_cPa62,1_3_2_4,241,155
Scaffold574-3067_3187,BFV_NC001831-cPa575-hybrid_cPa575,0.5,2,3135,3117,BFV_NC001831-cPa575-hybrid_cPa575,1_1,120,18
Scaffold574-3269_3502,cPa575,0.6,2,3450,3319,cPa575_SnRV_NC001724,3_2,233,131
Scaffold574-3513_3657,cPa575,0.735294117647059,3,3605,3563,cPa575_SnRV_NC001724_SnRV_NC001724-cPa575-hybrid,25_8_1,144,42
Scaffold574-9811_9936,cPa62,0.846153846153846,3,9926,9841,cPa450_cPa469_cPa62,1_1_11,125,85
Scaffold575-16647_16749,cPa419,1,1,16697,16697,cPa419,1,102,0
Scaffold576-11989_12226,cPa425,0.6,3,12174,12039,cPa174_cPa425_cPa47,1_3_1,237,135
Scaffold576-6723_6825,cPa248-cPa254-hybrid,1,1,6773,6773,cPa248-cPa254-hybrid,1,102,0
Scaffold576-7765_7876,cPa47,1,1,7855,7815,cPa47,3,111,40
Scaffold576-8628_8736,cPa47,0.625,4,8721,8632,cPa118_cPa174_cPa404_cPa47,1_1_1_5,108,89
Scaffold576-8761_8863,cPa174,0.285714285714286,6,8861,8777,cPa174_cPa174-cPa47-hybrid_cPa174-cPa516-hybrid_cPa404_cPa425_cPa47,2_1_1_1_1_1,102,84
Scaffold577-1297_1446,cPa356,0.666666666666667,2,1418,1307,cPa356_cPa428,8_4,149,111
Scaffold577-14001_14108,KoRV_AF151794-HIV1_NC001802-hybrid,0.285714285714286,6,14056,14022,HERV-W_repbase_HERV17_LTR17-HIV1_NC001802-hybrid_HIV1_NC001802_KoRV_AF151794-HIV1_NC001802-hybrid_KoRV_AF151794-unknown_MDEV_AF053745-HIV1_NC001802-hybrid_MSEV_CT990572-HIV1_NC001802-hybrid,1_3_4_1_2_3,107,34
Scaffold577-1530_1650,cPa356_cPa428,0.476190476190476,3,1636,1538,cPa356_cPa356-cPa75-hybrid_cPa428,10_1_10,120,98
Scaffold577-1867_1974,cPa428,0.53125,3,1962,1880,cPa223-unknown_cPa356_cPa428,1_29_34,107,82
Scaffold578-10529_10631,cPa419,1,1,10579,10579,cPa419,1,102,0
Scaffold578-10704_10866,cPa419,1,1,10831,10754,cPa419,3,162,77
Scaffold578-13979_14081,cPa419,1,1,14029,13979,cPa419,5,102,50
Scaffold578-14773_15024,cPa419,0.520833333333333,2,14972,14823,cPa224_cPa419,23_25,251,149
Scaffold578-15627_16096,cPa428,0.51063829787234,2,16044,15677,cPa356_cPa428,23_24,469,367
Scaffold578-5686_5797,cPa419,0.928571428571429,2,5794,5689,cPa142-unknown_cPa419,1_13,111,105
Scaffold578-5891_6171,cPa419,1,1,6119,5910,cPa419,51,280,209
Scaffold578-7681_7783,cPa419,1,1,7731,7731,cPa419,1,102,0
Scaffold579-4741_4843,cPa356_cPa428,0.5,2,4841,4772,cPa356_cPa428,23_23,102,69
Scaffold579-5270_5372,cPa356,1,1,5320,5320,cPa356,1,102,0
Scaffold579-7305_7407,cPa356_cPa428,0.5,2,7358,7353,cPa356_cPa428,2_2,102,5
Scaffold579-7943_8154,cPa356_cPa428,0.5,2,8138,7993,cPa356_cPa428,19_19,211,145
Scaffold579-8339_8441,cPa356_cPa428,0.5,2,8389,8374,cPa356_cPa428,1_1,102,15
Scaffold579-8448_8550,cPa428,0.529411764705882,2,8543,8488,cPa356_cPa428,8_9,102,55
Scaffold579-9841_9943,cPa428,1,1,9891,9871,cPa428,2,102,20
Scaffold58-10119_10323,cPa456-cPa363-hybrid_cPa456-cPa452-hybrid_cPa587-cPa363-hybrid,0.3,4,10271,10169,cPa456-cPa363-hybrid_cPa456-cPa452-hybrid_cPa587_cPa587-cPa363-hybrid,3_3_1_3,204,102
Scaffold58-14080_14263,cPa391,0.847457627118644,5,14262,14130,cPa199_cPa199-cPa257-hybrid_cPa298-cPa257-hybrid_cPa391_cPa391-unknown,1_1_1_50_6,183,132
Scaffold58-6731_6833,cPa486-cPa363-hybrid,1,1,6781,6781,cPa486-cPa363-hybrid,1,102,0
Scaffold58-9826_10011,cPa456-cPa452-hybrid,0.333333333333333,6,9959,9835,cPa452_cPa456_cPa456-cPa363-hybrid_cPa456-cPa452-hybrid_cPa587-cPa363-hybrid_cPa587-cPa452-hybrid,1_1_2_4_3_1,185,124
Scaffold580-6116_6379,cPa428,0.576923076923077,2,6376,6166,cPa356_cPa428,11_15,263,210
Scaffold580-7068_7170,cPa428,0.523809523809524,2,7169,7068,cPa356_cPa428,10_11,102,101
Scaffold581-10886_11248,cPa391,0.975,2,11247,10895,cPa199-cPa107-hybrid_cPa391,1_39,362,352
Scaffold581-13012_13149,cPa447,0.363636363636364,8,13097,13022,cPa434-cPa199-hybrid_cPa434-cPa254-hybrid_cPa434-cPa339-hybrid_cPa434-cPa353-hybrid_cPa434-cPa391-hybrid_cPa434-unknown_cPa447_cPa447-cPa199-hybrid,1_1_1_1_1_1_4_1,137,75
Scaffold581-13875_13977,cPa447-cPa353-hybrid,1,1,13925,13925,cPa447-cPa353-hybrid,1,102,0
Scaffold581-6675_6777,cPa127-unknown,1,1,6725,6725,cPa127-unknown,1,102,0
Scaffold582-7461_7580,cPa428,0.625,2,7529,7511,cPa356_cPa428,3_5,119,18
Scaffold582-7606_7730,cPa428,0.6,3,7712,7656,cPa356_cPa428_cPa428-cPa356-hybrid,1_3_1,124,56
Scaffold583-10151_10292,cPa356,0.571428571428571,3,10240,10166,cPa356_cPa434-cPa356-hybrid_cPa447-cPa75-hybrid,4_2_1,141,74
Scaffold583-1328_1430,cPa360-unknown,1,1,1378,1378,cPa360-unknown,1,102,0
Scaffold583-14357_14459,cPa425,0.875,2,14407,14356,cPa425_cPa446-cPa425-hybrid,7_1,102,51
Scaffold583-1554_1661,cPa360-unknown,0.647058823529412,3,1611,1590,cPa360-cPa425-hybrid_cPa360-unknown_cPa425,4_11_2,107,21
Scaffold583-16212_16499,cPa67-cPa356-hybrid,0.26797385620915,16,16468,16262,cPa194-cPa356-hybrid_cPa194-cPa447-hybrid_cPa199-cPa356-hybrid_cPa356_cPa381-cPa356-hybrid_cPa381-cPa447-hybrid_cPa434_cPa447_cPa479-cPa356-hybrid_cPa479-cPa447-hybrid_cPa549-cPa447-hybrid_cPa583-cPa356-hybrid_cPa583-cPa447-hybrid_cPa67-cPa356-hybrid_cPa67-cPa447-hybrid_PERVA_AY099323-cPa356-hybrid,13_4_1_18_1_1_1_12_7_1_1_27_5_41_19_1,287,206
Scaffold583-2376_2478,cPa425,1,1,2426,2426,cPa425,1,102,0
Scaffold583-2687_2864,cPa425,0.8,3,2852,2697,cPa425_cPa425-cPa478-hybrid_cPa425-unknown,24_1_5,177,155
Scaffold583-3433_3535,cPa425,0.6,3,3513,3448,cPa425_cPa425-cPa394-hybrid_cPa425-MSEV_CT990572-hybrid,3_1_1,102,65
Scaffold583-4008_4119,cPa478,0.333333333333333,5,4112,4058,cPa425-cPa478-hybrid_cPa425-MDEV_AF053745-hybrid_cPa425-MSEV_CT990572-hybrid_cPa478_MDEV_AF053745,2_1_1_3_2,111,54
Scaffold583-730_832,cPa75-unknown,0.666666666666667,2,821,751,cPa75_cPa75-unknown,1_2,102,70
Scaffold584-2930_3032,HML3_repbase_HERVK9I_MER9,1,1,2980,2980,HML3_repbase_HERVK9I_MER9,1,102,0
Scaffold585-4782_4884,cPa428,1,1,4832,4832,cPa428,1,102,0
Scaffold585-8301_8429,cPa428,0.513888888888889,2,8427,8314,cPa356_cPa428,35_37,128,113
Scaffold585-8563_8665,cPa356,0.518518518518518,2,8653,8572,cPa356_cPa428,28_26,102,81
Scaffold585-8744_8855,cPa428,0.505747126436782,2,8828,8748,cPa356_cPa428,43_44,111,80
Scaffold585-9797_9899,cPa428,0.582089552238806,2,9867,9796,cPa356_cPa428,28_39,102,71
Scaffold59-13231_13370,cPa145_cPa413-cPa145-hybrid,0.5,2,13318,13281,cPa145_cPa413-cPa145-hybrid,1_1,139,37
Scaffold59-14945_15107,CAEV_NC001463-cPa199-hybrid_CAEV_NC001463-unknown_cPa447-unknown_cPa581-cPa71-hybrid,0.25,4,15080,14995,CAEV_NC001463-cPa199-hybrid_CAEV_NC001463-unknown_cPa447-unknown_cPa581-cPa71-hybrid,1_1_1_1,162,85
Scaffold59-2270_2378,cPa200-cPa391-hybrid,0.975,2,2335,2276,cPa200-cPa260-hybrid_cPa200-cPa391-hybrid,1_39,108,59
Scaffold591-16239_16341,cPa356_cPa428-unknown,0.5,2,16289,16265,cPa356_cPa428-unknown,1_1,102,24
Scaffold596-15602_15704,cPa391,0.875,2,15700,15604,cPa391_cPa539,14_2,102,96
Scaffold597-3996_4160,cPa62,1,1,4108,4044,cPa62,8,164,64
Scaffold597-4345_4586,cPa62,0.983606557377049,2,4586,4369,cPa62_cPa75,60_1,241,217
Scaffold597-4598_4878,cPa62,1,1,4871,4642,cPa62,27,280,229
Scaffold597-4891_5027,cPa62,1,1,4981,4900,cPa62,18,136,81
Scaffold597-5167_5269,cPa62,1,1,5222,5200,cPa62,7,102,22
Scaffold598-10477_10579,cPa419,1,1,10527,10527,cPa419,1,102,0
Scaffold598-10658_10760,cPa419,1,1,10708,10708,cPa419,1,102,0
Scaffold598-10789_10926,cPa419,1,1,10876,10802,cPa419,29,137,74
Scaffold598-11066_11187,cPa419,1,1,11186,11093,cPa419,18,121,93
Scaffold598-11211_11313,cPa419,1,1,11274,11228,cPa419,6,102,46
Scaffold598-11583_11792,cPa419,1,1,11792,11633,cPa419,24,209,159
Scaffold598-11832_11990,cPa419,1,1,11959,11854,cPa419,20,158,105
Scaffold598-12069_12280,cPa419,1,1,12237,12110,cPa419,21,211,127
Scaffold598-12351_12453,cPa419,1,1,12447,12371,cPa419,8,102,76
Scaffold598-7056_7158,cPa419,1,1,7117,7102,cPa419,30,102,15
Scaffold598-9101_9203,cPa419,1,1,9151,9151,cPa419,1,102,0
Scaffold598-9809_9911,cPa419,1,1,9874,9831,cPa419,11,102,43
Scaffold60-18142_18244,cPa67-unknown,0.666666666666667,6,18221,18184,cPa419_cPa67-BLV_NC001414-hybrid_cPa67-cPa339-hybrid_cPa67-cPa353-hybrid_cPa67-HERV30_repbase_HERV30I_LTR30-hybrid_cPa67-unknown,1_1_5_3_1_22,102,37
Scaffold60-18597_18699,cPa434_cPa67_cPa67-unknown,0.333333333333333,3,18687,18647,cPa434_cPa67_cPa67-unknown,1_1_1,102,40
Scaffold60-19498_19637,cPa67-cPa339-hybrid,0.620689655172414,6,19588,19548,cPa434_cPa434-cPa339-hybrid_cPa434-cPa353-hybrid_cPa67-cPa339-hybrid_cPa67-cPa353-hybrid_HERV-E_repbase_HERVE_LTR2-cPa339-hybrid,4_2_1_18_2_2,139,40
Scaffold60-19672_19820,HERV-E_repbase_HERVE_LTR2-cPa339-hybrid,0.5,3,19768,19722,cPa434_cPa67-cPa339-hybrid_HERV-E_repbase_HERVE_LTR2-cPa339-hybrid,1_1_2,148,46
Scaffold60-20358_20469,cPa434,0.5,3,20469,20408,cPa229-cPa339-hybrid_cPa434_cPa434-cPa339-hybrid,1_2_1,111,61
Scaffold60-5242_5447,cPa425,0.774647887323944,3,5420,5292,cPa425_cPa425-cPa356-hybrid_cPa425-unknown,55_1_15,205,128
Scaffold60-7418_7564,cPa434,1,1,7512,7422,cPa434,14,146,90
Scaffold60-8628_8730,cPa434,1,1,8711,8678,cPa434,2,102,33
Scaffold60-8798_8900,cPa434,1,1,8893,8848,cPa434,6,102,45
Scaffold60-9592_9883,cPa434,0.775,2,9858,9642,cPa356_cPa434,9_31,291,216
Scaffold600-4922_5046,cPa521-unknown,0.352941176470588,8,5036,4954,cPa177-cPa223-hybrid_cPa196-cPa223-hybrid_cPa196-cPa47-hybrid_cPa356-unknown_cPa419_cPa521-cPa449-hybrid_cPa521-unknown_cPa75-unknown,1_1_1_2_1_1_6_4,124,82
Scaffold600-5214_5316,cPa313,0.297872340425532,9,5313,5240,cPa223_cPa229_cPa313_cPa313-cPa173-hybrid_cPa449_cPa449-cPa223-hybrid_cPa449-cPa229-hybrid_cPa449-cPa313-hybrid_cPa47,4_7_14_1_13_2_1_1_4,102,73
Scaffold600-5814_5916,cPa521-cPa293-hybrid,0.25,7,5865,5825,cPa168-cPa363-hybrid_cPa313-unknown_cPa521-cPa173-hybrid_cPa521-cPa293-hybrid_cPa75-cPa293-hybrid_cPa75-cPa413-hybrid_cPa75-cPa452-hybrid,1_1_1_2_1_1_1,102,40
Scaffold600-6122_6224,cPa363_cPa419_cPa452_cPa71,0.25,4,6193,6172,cPa363_cPa419_cPa452_cPa71,1_1_1_1,102,21
Scaffold601-14680_14782,cPa419,1,1,14763,14711,cPa419,7,102,52
Scaffold601-14798_14900,cPa419,1,1,14848,14848,cPa419,1,102,0
Scaffold601-3339_3441,cPa419,1,1,3389,3356,cPa419,2,102,33
Scaffold603-629_1021,cPa356,0.524137931034483,3,1019,638,cPa356_cPa419_cPa428,76_1_68,392,381
Scaffold604-1416_1518,cPa356,0.636363636363636,2,1511,1416,cPa356_cPa428,7_4,102,95
Scaffold604-14282_14384,cPa428,0.612903225806452,2,14382,14312,cPa356_cPa428,12_19,102,70
Scaffold604-15089_15224,cPa356,0.521739130434783,2,15197,15092,cPa356_cPa428,12_11,135,105
Scaffold604-1814_1924,cPa356_cPa428,0.5,2,1901,1852,cPa356_cPa428,7_7,110,49
Scaffold604-2024_2133,cPa356,0.511111111111111,2,2087,2035,cPa356_cPa428,23_22,109,52
Scaffold604-4201_4378,cPa428,0.538461538461538,2,4337,4251,cPa356_cPa428,6_7,177,86
Scaffold604-4465_4567,cPa428,0.555555555555556,2,4542,4469,cPa356_cPa428,4_5,102,73
Scaffold604-8437_8544,cPa428,0.857142857142857,2,8494,8486,cPa356_cPa428,1_6,107,8
Scaffold604-9059_9166,cPa428,0.666666666666667,2,9114,9109,cPa356_cPa428,1_2,107,5
Scaffold604-9424_9526,cPa356,1,1,9474,9474,cPa356,1,102,0
Scaffold604-9603_9780,cPa428,0.5625,2,9728,9653,cPa356_cPa428,7_9,177,75
Scaffold606-11859_11961,cPa434_cPa434-cPa254-hybrid,0.5,2,11922,11909,cPa434_cPa434-cPa254-hybrid,1_1,102,13
Scaffold607-1862_1964,cPa428,0.6,2,1942,1912,cPa356_cPa428,2_3,102,30
Scaffold607-2298_2400,cPa428,0.583333333333333,2,2386,2298,cPa356_cPa428,5_7,102,88
Scaffold607-2595_2759,cPa428,0.550724637681159,2,2758,2597,cPa356_cPa428,31_38,164,161
Scaffold607-2843_2956,cPa428,0.510204081632653,2,2956,2845,cPa356_cPa428,24_25,113,111
Scaffold607-3116_3218,cPa428,0.518518518518518,2,3212,3134,cPa356_cPa428,13_14,102,78
Scaffold607-3291_3525,cPa356,0.510729613733906,2,3525,3292,cPa356_cPa428,119_114,234,233
Scaffold607-5229_5331,cPa428,1,1,5279,5272,cPa428,2,102,7
Scaffold607-6194_6296,cPa428,0.588235294117647,2,6267,6199,cPa356_cPa428,7_10,102,68
Scaffold607-6494_6596,cPa428,0.583333333333333,2,6594,6510,cPa356_cPa428,5_7,102,84
Scaffold607-6660_6762,cPa356,0.6,2,6762,6669,cPa356_cPa428,3_2,102,93
Scaffold607-8731_8833,cPa428,0.733333333333333,2,8801,8769,cPa356_cPa428,4_11,102,32
Scaffold607-974_1076,cPa356_cPa428,0.5,2,1036,1019,cPa356_cPa428,3_3,102,17
Scaffold61-13287_13389,cPa434,1,1,13354,13327,cPa434,7,102,27
Scaffold612-1780_1907,cPa15,0.307692307692308,10,1906,1780,cPa118_cPa125_cPa15_cPa174_cPa268_cPa404_cPa419_cPa443_cPa47_cPa47-cPa140-hybrid,6_1_8_2_1_1_1_2_3_1,127,126
Scaffold612-1980_2270,cPa15,0.304347826086957,8,2259,1998,cPa118_cPa119_cPa125_cPa140_cPa15_cPa174_cPa268_cPa419,5_3_12_3_14_3_2_4,290,261
Scaffold612-2285_2387,cPa15,0.375,9,2347,2289,cPa118_cPa119_cPa125_cPa15_cPa248-cPa268-hybrid_cPa264_cPa268_cPa419_cPa47,4_1_4_9_1_2_1_1_1,102,58
Scaffold612-2771_2890,cPa15,0.609756097560976,8,2838,2774,cPa118_cPa119_cPa125_cPa140_cPa15_cPa174_cPa248_cPa419,5_1_1_2_25_2_1_4,119,64
Scaffold612-3464_3681,cPa15,0.379928315412186,31,3671,3463,cPa118_cPa119_cPa119-cPa125-hybrid_cPa121-cPa118-hybrid_cPa121-cPa125-hybrid_cPa121-cPa264-hybrid_cPa121-cPa268-hybrid_cPa121-cPa67-hybrid_cPa125_cPa140_cPa15_cPa193-cPa118-hybrid_cPa193-cPa119-hybrid_cPa193-cPa125-hybrid_cPa193-cPa268-hybrid_cPa248_cPa248-cPa15-hybrid_cPa248-cPa264-hybrid_cPa264_cPa268_cPa268-cPa118-hybrid_cPa268-cPa125-hybrid_cPa268-cPa140-hybrid_cPa268-cPa47-hybrid_cPa268-unknown_cPa345_cPa345-cPa140-hybrid_cPa419_cPa443_cPa443-cPa516-hybrid_cPa516,42_5_1_1_2_1_3_1_50_4_106_2_1_1_1_10_1_1_12_5_1_1_2_1_2_2_1_4_5_1_9,217,208
Scaffold612-4129_4231,cPa15,0.43010752688172,15,4227,4133,cPa118_cPa118-cPa15-hybrid_cPa121-cPa118-hybrid_cPa125_cPa15_cPa193-cPa15-hybrid_cPa248_cPa264_cPa264-cPa125-hybrid_cPa264-cPa443-hybrid_cPa268_cPa391_cPa443_cPa443-cPa516-hybrid_cPa516,21_1_1_4_40_2_2_6_1_1_1_1_8_1_3,102,94
Scaffold612-5073_5525,cPa118,0.176739926739927,76,5501,5074,cPa118_cPa118-cPa434-hybrid_cPa118-cPa443-hybrid_cPa119-cPa434-hybrid_cPa119-cPa566-hybrid_cPa119-cPa61-hybrid_cPa121-cPa118-hybrid_cPa121-cPa125-hybrid_cPa121-cPa264-hybrid_cPa121-cPa434-hybrid_cPa121-cPa443-hybrid_cPa121-cPa486-hybrid_cPa121-cPa516-hybrid_cPa121-cPa566-hybrid_cPa121-cPa61-hybrid_cPa121-unknown_cPa125_cPa125-cPa15-hybrid_cPa125-unknown_cPa140_cPa140-cPa566-hybrid_cPa15_cPa15-unknown_cPa183-cPa434-hybrid_cPa193-cPa118-hybrid_cPa193-cPa268-hybrid_cPa193-cPa434-hybrid_cPa193-cPa516-hybrid_cPa193-cPa566-hybrid_cPa193-cPa61-hybrid_cPa193-unknown_cPa248_cPa248-cPa125-hybrid_cPa248-cPa268-hybrid_cPa248-cPa434-hybrid_cPa248-cPa443-hybrid_cPa248-unknown_cPa260_cPa260-cPa419-hybrid_cPa260-cPa434-hybrid_cPa260-cPa67-hybrid_cPa264_cPa264-cPa118-hybrid_cPa264-cPa119-hybrid_cPa264-cPa125-hybrid_cPa264-cPa434-hybrid_cPa264-cPa516-hybrid_cPa264-cPa566-hybrid_cPa264-cPa583-hybrid_cPa264-unknown_cPa268_cPa268-cPa118-hybrid_cPa268-cPa119-hybrid_cPa268-cPa434-hybrid_cPa268-cPa566-hybrid_cPa268-cPa61-hybrid_cPa268-unknown_cPa419_cPa419-cPa434-hybrid_cPa434_cPa443_cPa443-cPa118-hybrid_cPa443-cPa125-hybrid_cPa443-cPa268-hybrid_cPa443-cPa434-hybrid_cPa443-cPa516-hybrid_cPa443-unknown_cPa500-cPa566-hybrid_cPa516_cPa516-cPa125-hybrid_cPa516-cPa434-hybrid_cPa516-cPa566-hybrid_cPa516-cPa67-hybrid_cPa516-unknown_cPa566_cPa61,193_1_1_2_1_1_3_1_3_32_3_2_2_10_3_46_49_1_1_10_1_25_2_1_5_1_2_2_3_1_40_132_1_1_3_1_10_1_1_1_1_128_5_2_1_2_1_1_1_6_18_1_1_1_1_1_6_2_1_19_173_5_1_1_1_2_4_1_61_2_3_1_1_21_16_1,452,427
Scaffold612-835_937,cPa15,0.260869565217391,10,937,841,cPa118_cPa125_cPa15_cPa174_cPa268_cPa363_cPa404_cPa419_cPa443_cPa47,4_3_6_1_1_1_2_3_1_1,102,96
Scaffold612-9428_9530,cPa75-cPa363-hybrid,1,1,9478,9478,cPa75-cPa363-hybrid,1,102,0
Scaffold612-9952_10054,cPa75-cPa199-hybrid_cPa75-cPa62-hybrid,0.5,2,10002,9978,cPa75-cPa199-hybrid_cPa75-cPa62-hybrid,1_1,102,24
Scaffold613-13813_13915,cPa356,1,1,13863,13863,cPa356,1,102,0
Scaffold614-14601_14739,cPa410-cPa75-hybrid,0.666666666666667,2,14687,14651,cPa410-cPa75-hybrid_cPa410-unknown,2_1,138,36
Scaffold614-5934_6048,cPa583,1,1,5996,5984,cPa583,2,114,12
Scaffold62-10855_10957,cPa434,1,1,10905,10905,cPa434,1,102,0
Scaffold62-11440_11542,cPa356,0.571428571428571,10,11523,11449,cPa118-cPa434-hybrid_cPa15-cPa434-hybrid_cPa356_cPa356-unknown_cPa434_cPa443-cPa434-hybrid_cPa447_cPa447-cPa118-hybrid_cPa447-cPa356-hybrid_cPa447-cPa434-hybrid,1_1_20_1_2_1_3_1_1_4,102,74
Scaffold62-11575_11677,cPa356,0.741935483870968,6,11669,11586,cPa34-cPa118-hybrid_cPa356_cPa447_cPa447-cPa434-hybrid_cPa447-unknown_cPa75-cPa356-hybrid,1_23_2_3_1_1,102,83
Scaffold62-14106_14252,cPa67,0.642857142857143,6,14213,14153,cPa118-cPa264-hybrid_cPa264_cPa67_FrMuLV_NC001362-cPa118-hybrid_FrMuLV_NC001362-cPa15-hybrid_FrMuLV_NC001362-cPa443-hybrid,1_1_9_1_1_1,146,60
Scaffold62-14287_14494,cPa67,1,1,14490,14336,cPa67,103,207,154
Scaffold62-15171_15273,cPa67,1,1,15269,15173,cPa67,19,102,96
Scaffold62-15378_15480,cPa67,1,1,15478,15388,cPa67,28,102,90
Scaffold62-15544_15646,cPa67,1,1,15634,15552,cPa67,22,102,82
Scaffold62-16415_16517,cPa67,0.666666666666667,2,16465,16448,cPa339-unknown_cPa67,1_2,102,17
Scaffold62-6535_6911,S71_repbase_HERVS71_LTR6A-unknown,0.545454545454545,3,6859,6534,cPa434_S71_repbase_HERVS71_LTR6A-cPa434-hybrid_S71_repbase_HERVS71_LTR6A-unknown,9_1_12,376,325
Scaffold62-6997_7558,cPa434,0.764150943396226,5,7519,7047,cPa434_cPa434-cPa356-hybrid_S71_repbase_HERVS71_LTR6A-cPa356-hybrid_S71_repbase_HERVS71_LTR6A-cPa434-hybrid_S71_repbase_HERVS71_LTR6A-cPa555-hybrid,81_1_4_19_1,561,472
Scaffold621-1925_2027,cPa224_cPa224-unknown,0.5,2,1975,1933,cPa224_cPa224-unknown,1_1,102,42
Scaffold621-2038_2140,cPa224-unknown,1,1,2131,2088,cPa224-unknown,2,102,43
Scaffold621-7144_7246,cPa360_cPa381,0.5,2,7202,7194,cPa360_cPa381,1_1,102,8
Scaffold623-11370_11472,VISNA_S55323,0.714285714285714,3,11447,11420,cPa177_cPa392-VISNA_S55323-hybrid_VISNA_S55323,1_1_5,102,27
Scaffold623-12160_12262,cPa75,1,1,12210,12210,cPa75,1,102,0
Scaffold623-12278_12382,cPa75,0.5,3,12330,12291,cPa272_cPa551-cPa298-hybrid_cPa75,1_1_2,104,39
Scaffold623-12467_12569,cPa298-cPa285-hybrid_cPa75,0.5,2,12517,12506,cPa298-cPa285-hybrid_cPa75,1_1,102,11
Scaffold623-9025_9127,cPa75-cPa61-hybrid,1,1,9075,9075,cPa75-cPa61-hybrid,1,102,0
Scaffold624-1242_1506,cPa419,1,1,1454,1242,cPa419,26,264,212
Scaffold624-1552_1654,cPa419,1,1,1652,1576,cPa419,10,102,76
Scaffold624-1662_1764,cPa419,1,1,1759,1712,cPa419,2,102,47
Scaffold624-353_455,cPa419,1,1,406,403,cPa419,2,102,3
Scaffold624-4511_4613,cPa419,1,1,4603,4524,cPa419,6,102,79
Scaffold624-4898_5000,cPa419,1,1,4967,4909,cPa419,4,102,58
Scaffold624-6206_6308,cPa419,1,1,6256,6256,cPa419,1,102,0
Scaffold63-12134_12358,cPa67,0.979591836734694,2,12306,12159,cPa381-cPa539-hybrid_cPa67,1_48,224,147
Scaffold63-16943_17045,cPa18-unknown,1,1,16993,16993,cPa18-unknown,1,102,0
Scaffold630-14233_14335,cPa391,0.7,3,14314,14246,cPa391_cPa391-cPa298-hybrid_cPa391-unknown,14_1_5,102,68
Scaffold631-13364_13466,cPa285,1,1,13414,13414,cPa285,1,102,0
Scaffold631-1654_1766,cPa356,0.51219512195122,5,1716,1689,cPa194-HERV-ADP_repbase_HERVP71A_I_LTR71A-hybrid_cPa356_cPa428_cPa428-unknown_cPa446-HERV-ADP_repbase_HERVP71A_I_LTR71A-hybrid,2_21_14_3_1,112,27
Scaffold631-4127_4268,cPa194-cPa75-hybrid,1,1,4220,4177,cPa194-cPa75-hybrid,3,141,43
Scaffold631-8863_8991,cPa75,1,1,8939,8913,cPa75,4,128,26
Scaffold631-9154_9256,cPa75,1,1,9204,9200,cPa75,2,102,4
Scaffold632-10724_10830,cPa356,0.541666666666667,2,10825,10748,cPa356_cPa428,13_11,106,77
Scaffold632-11473_11575,cPa428,0.545454545454545,2,11571,11511,cPa356_cPa428,5_6,102,60
Scaffold632-11849_12040,cPa428,0.6,2,12040,11871,cPa356_cPa428,18_27,191,169
Scaffold634-11947_12049,cPa419,1,1,11997,11997,cPa419,1,102,0
Scaffold634-8232_8343,cPa223-cPa194-hybrid_cPa223-cPa479-hybrid,0.5,2,8291,8282,cPa223-cPa194-hybrid_cPa223-cPa479-hybrid,1_1,111,9
Scaffold636-11400_11502,cPa428,0.666666666666667,2,11451,11447,cPa356_cPa428,1_2,102,4
Scaffold636-11567_11677,cPa356_cPa428,0.5,2,11625,11597,cPa356_cPa428,5_5,110,28
Scaffold636-12269_12421,cPa356,0.497206703910615,3,12369,12276,cPa356_cPa428_cPa428-unknown,89_87_3,152,93
Scaffold636-8526_8628,cPa356_cPa428,0.5,2,8580,8567,cPa356_cPa428,8_8,102,13
Scaffold637-8371_8496,cPa428,0.615384615384615,2,8444,8417,cPa356_cPa428,5_8,125,27
Scaffold638-1284_1404,cPa223-cPa173-hybrid,0.277777777777778,10,1400,1324,cPa106-cPa173-hybrid_cPa223-cPa119-hybrid_cPa223-cPa173-hybrid_cPa223-cPa232-hybrid_cPa223-cPa254-hybrid_cPa223-cPa469-hybrid_cPa223-PRIMA41_repbase_PRIMA41_MER41A-hybrid_cPa223-RELIK_ERVK-hybrid_cPa223-unknown_cPa419,1_8_10_1_3_8_1_1_1_2,120,76
Scaffold638-1862_2099,cPa119_cPa223-cPa173-hybrid,0.2,11,2047,1912,cPa106-cPa119-hybrid_cPa119_cPa119-cPa254-hybrid_cPa119-unknown_cPa173_cPa223-cPa119-hybrid_cPa223-cPa173-hybrid_cPa223-cPa254-hybrid_cPa223-cPa469-hybrid_cPa232_cPa419,1_7_1_1_2_5_7_3_6_1_1,237,135
Scaffold638-2110_2528,cPa119,0.354838709677419,13,2498,2160,cPa106-cPa173-hybrid_cPa119_cPa119-cPa254-hybrid_cPa173_cPa173-cPa254-hybrid_cPa223-cPa119-hybrid_cPa223-cPa173-hybrid_cPa223-cPa254-hybrid_cPa223-cPa469-hybrid_cPa223-cPa479-hybrid_cPa254_cPa308-cPa173-hybrid_SFV_U04327-cPa254-hybrid,1_22_1_3_1_6_7_5_12_1_1_1_1,418,338
Scaffold638-800_902,cPa223-unknown,0.761904761904762,4,897,799,cPa223-cPa173-hybrid_cPa223-cPa469-hybrid_cPa223-unknown_cPa419,1_1_16_3,102,98
Scaffold638-914_1016,cPa223-PyERV_AF500296-hybrid,0.714285714285714,2,980,915,cPa223-PyERV_AF500296-hybrid_cPa223-unknown,5_2,102,65
Scaffold639-13717_13819,cPa428,1,1,13816,13743,cPa428,3,102,73
Scaffold639-7226_7328,cPa428,0.8,2,7287,7276,cPa356_cPa428,1_4,102,11
Scaffold639-7452_7554,cPa356_cPa428,0.5,2,7528,7493,cPa356_cPa428,3_3,102,35
Scaffold64-10231_10435,cPa492-cPa356-hybrid,0.789473684210526,3,10383,10274,cPa492-cPa356-hybrid_cPa75-cPa356-hybrid_EIAV_NC001450-cPa356-hybrid,15_3_1,204,109
Scaffold64-10913_11060,cPa492-cPa356-hybrid,0.8,2,11008,10957,cPa492-cPa356-hybrid_cPa75-cPa356-hybrid,4_1,147,51
Scaffold64-11974_12076,cPa298-cPa356-hybrid,0.75,2,12026,12024,cPa298-cPa356-hybrid_PERVC_HM159246-cPa196-hybrid,3_1,102,2
Scaffold64-12078_12180,cPa298-unknown,1,1,12180,12128,cPa298-unknown,6,102,52
Scaffold645-13923_14025,cPa419,1,1,13973,13973,cPa419,1,102,0
Scaffold647-12594_12696,cPa357_cPa583,0.5,2,12654,12644,cPa357_cPa583,1_1,102,10
Scaffold647-3744_3853,cPa465-cPa113-hybrid,0.428571428571429,4,3840,3754,cPa113-cPa75-hybrid_cPa419_cPa465-cPa113-hybrid_cPa62,1_1_3_2,109,86
Scaffold648-2190_2292,cPa356,1,1,2282,2240,cPa356,3,102,42
Scaffold648-2604_2706,cPa356,0.548387096774194,2,2706,2608,cPa356_cPa428,34_28,102,98
Scaffold648-2889_2991,cPa356,0.558823529411765,2,2988,2889,cPa356_cPa428,19_15,102,99
Scaffold648-3157_3433,cPa356,0.65,2,3433,3197,cPa356_cPa428,13_7,276,236
Scaffold648-4519_4621,cPa356,0.625,2,4590,4566,cPa356_cPa428,5_3,102,24
Scaffold649-1314_1524,cPa428,0.514705882352941,2,1522,1338,cPa356_cPa428,99_105,210,184
Scaffold649-1553_1655,cPa356,0.5625,2,1653,1576,cPa356_cPa428,9_7,102,77
Scaffold649-1884_1986,cPa356,0.509803921568627,2,1969,1903,cPa356_cPa428,26_25,102,66
Scaffold649-2492_2767,cPa356,0.51984126984127,3,2762,2542,cPa356_cPa356-unknown_cPa428,131_1_120,275,220
Scaffold649-2887_3148,cPa356,0.514423076923077,2,3139,2886,cPa356_cPa428,107_101,261,253
Scaffold649-3262_3364,cPa356_cPa428,0.5,2,3360,3265,cPa356_cPa428,14_14,102,95
Scaffold649-3464_3566,cPa428,0.571428571428571,2,3514,3463,cPa356_cPa428,3_4,102,51
Scaffold649-546_648,cPa428,0.533333333333333,2,638,583,cPa356_cPa428,7_8,102,55
Scaffold65-10271_10387,cPa67,1,1,10372,10302,cPa67,6,116,70
Scaffold65-10968_11259,cPa67,1,1,11207,11007,cPa67,29,291,200
Scaffold65-11787_11889,cPa67,1,1,11839,11790,cPa67,10,102,49
Scaffold65-12003_12118,cPa67,1,1,12066,12026,cPa67,7,115,40
Scaffold65-12468_12570,cPa67,1,1,12556,12509,cPa67,9,102,47
Scaffold65-1388_1601,cPa42,0.821428571428571,2,1549,1435,cPa42_cPa42-unknown,23_5,213,114
Scaffold65-1611_1751,cPa42,1,1,1702,1661,cPa42,8,140,41
Scaffold65-4030_4157,cPa391,0.4,5,4155,4069,cPa391_cPa391-cPa293-hybrid_cPa391-cPa298-hybrid_cPa391-cPa492-hybrid_cPa391-unknown,10_5_5_1_4,127,86
Scaffold65-8587_8689,cPa339,0.714285714285714,3,8675,8621,cPa339_cPa339-cPa67-hybrid_cPa339-unknown,5_1_1,102,54
Scaffold650-1374_1558,cPa434,0.8,2,1557,1424,cPa434_cPa434-cPa371-hybrid,4_1,184,133
Scaffold650-1604_1733,cPa371,0.338983050847458,12,1725,1604,cPa167-cPa434-hybrid_cPa228-cPa356-hybrid_cPa228-cPa425-hybrid_cPa228-cPa434-hybrid_cPa228-STLV1_NC000858-hybrid_cPa371_cPa409_cPa419_cPa434_cPa434-cPa371-hybrid_cPa434-unknown_HERV-I_repbase_HERVI_LTR10B-cPa402-hybrid,1_6_1_2_1_20_1_4_18_2_2_1,129,121
Scaffold650-2918_3020,cPa371,0.909090909090909,2,3019,2925,cPa371_cPa419,10_1,102,94
Scaffold650-3962_4064,cPa371,0.75,2,4022,3963,cPa371_cPa428,3_1,102,59
Scaffold650-6955_7057,cPa434,0.75,3,7021,6969,cPa199_cPa371_cPa434,1_1_6,102,52
Scaffold650-7210_7312,cPa199,0.375,7,7302,7210,cPa199_cPa260_cPa428-cPa199-hybrid_cPa434_cPa434-cPa199-hybrid_cPa434-unknown_cPa459,6_1_1_4_1_2_1,102,92
Scaffold650-7316_7455,cPa254-cPa308-hybrid_cPa434,0.2,10,7406,7355,cPa119-cPa392-hybrid_cPa119-cPa425-hybrid_cPa199-cPa425-hybrid_cPa254-cPa308-hybrid_cPa254-cPa425-hybrid_cPa260-cPa425-hybrid_cPa434_cPa434-cPa47-hybrid_cPa446-cPa425-hybrid_cPa459-cPa425-hybrid,1_2_1_3_1_1_3_1_1_1,139,51
Scaffold650-7852_7955,cPa119-cPa425-hybrid,1,1,7903,7902,cPa119-cPa425-hybrid,2,103,1
Scaffold650-8359_8461,cPa119-cPa425-hybrid,1,1,8409,8409,cPa119-cPa425-hybrid,1,102,0
Scaffold650-838_940,cPa434_cPa434-cPa371-hybrid,0.5,2,925,888,cPa434_cPa434-cPa371-hybrid,2_2,102,37
Scaffold651-10893_10995,cPa356,0.620689655172414,2,10977,10894,cPa356_cPa428,18_11,102,83
Scaffold651-11461_11563,cPa428,0.625,2,11511,11460,cPa356_cPa428,6_10,102,51
Scaffold651-13311_13413,cPa428,0.5,3,13411,13311,cPa356_cPa419_cPa428,28_2_30,102,100
Scaffold654-3372_3480,cPa419,1,1,3478,3379,cPa419,26,108,99
Scaffold654-3510_3612,cPa419,1,1,3560,3526,cPa419,3,102,34
Scaffold654-3860_4011,cPa419,1,1,3959,3868,cPa419,4,151,91
Scaffold654-4328_4508,cPa419,1,1,4466,4335,cPa419,8,180,131
Scaffold654-4975_5085,cPa419,1,1,5073,4994,cPa419,8,110,79
Scaffold654-5881_5983,cPa419,1,1,5933,5931,cPa419,2,102,2
Scaffold654-6634_6736,cPa419,1,1,6684,6684,cPa419,1,102,0
Scaffold654-6811_6913,cPa419,1,1,6861,6861,cPa419,1,102,0
Scaffold654-7020_7122,cPa419,1,1,7070,7070,cPa419,1,102,0
Scaffold654-7148_7250,cPa419,1,1,7198,7198,cPa419,1,102,0
Scaffold654-7254_7356,cPa419,1,1,7304,7284,cPa419,2,102,20
Scaffold654-7387_7490,cPa419,1,1,7466,7395,cPa419,8,103,71
Scaffold654-7513_7711,cPa419,0.97752808988764,3,7698,7559,cPa407-unknown_cPa419_HML4_repbase_HERVK13I_LTR13-unknown,1_87_1,198,139
Scaffold655-1953_2055,cPa428,0.513513513513513,4,2030,1983,cPa356_cPa356-unknown_cPa428_cPa428-cPa356-hybrid,15_2_19_1,102,47
Scaffold655-2142_2244,cPa428,1,1,2192,2192,cPa428,1,102,0
Scaffold655-5443_5545,cPa356,1,1,5516,5493,cPa356,2,102,23
Scaffold655-5660_5762,cPa428,0.545454545454545,4,5715,5660,cPa356_cPa356-unknown_cPa428_cPa428-unknown,7_1_12_2,102,55
Scaffold655-5846_5948,cPa428,0.666666666666667,2,5908,5849,cPa356_cPa428,1_2,102,59
Scaffold655-8910_9012,cPa428,1,1,8960,8960,cPa428,1,102,0
Scaffold655-9299_9575,cPa356,0.528,4,9558,9318,cPa356_cPa356-unknown_cPa428_cPa428-unknown,66_4_49_6,276,240
Scaffold657-8269_8371,cPa75,1,1,8319,8319,cPa75,1,102,0
Scaffold657-8409_8820,cPa75,1,1,8768,8431,cPa75,16,411,337
Scaffold657-8822_9394,cPa75,1,1,9373,8872,cPa75,45,572,501
Scaffold659-12366_12540,cPa428,0.485714285714286,4,12531,12376,cPa356_cPa356-unknown_cPa419_cPa428,16_1_1_17,174,155
Scaffold659-3307_3442,cPa356,0.571428571428571,2,3423,3357,cPa356_cPa428,4_3,135,66
Scaffold659-4872_5085,cPa356,0.625,2,5033,4913,cPa356_cPa428,5_3,213,120
Scaffold66-10007_10109,cPa339-unknown,1,1,10057,10057,cPa339-unknown,1,102,0
Scaffold66-5749_5930,cPa67,0.833333333333333,4,5922,5754,cPa419_cPa419-cPa410-hybrid_cPa419-cPa443-hybrid_cPa67,5_1_1_35,181,168
Scaffold66-6083_6210,cPa67,0.868421052631579,6,6198,6096,cPa109-unknown_cPa419_cPa419-SFV_U04327-hybrid_cPa443-cPa410-hybrid_cPa62-cPa248-hybrid_cPa67,1_1_1_1_1_33,127,102
Scaffold66-6573_6675,cPa67,1,1,6674,6579,cPa67,31,102,95
Scaffold66-6782_6884,cPa67,1,1,6884,6782,cPa67,30,102,102
Scaffold66-7787_8037,cPa67,0.916666666666667,6,8037,7793,cPa254-cPa205-hybrid_cPa404_cPa419_cPa425-cPa205-hybrid_cPa47_cPa67,1_1_4_1_1_88,250,244
Scaffold66-8057_8159,cPa67,1,1,8118,8064,cPa67,7,102,54
Scaffold66-9354_9456,cPa339,0.6,2,9408,9364,cPa339_cPa339-unknown,3_2,102,44
Scaffold665-567_669,cPa428,0.75,2,631,617,cPa308-cPa419-hybrid_cPa428,1_3,102,14
Scaffold666-5716_5818,cPa419,1,1,5798,5736,cPa419,3,102,62
Scaffold666-6533_6695,cPa419,1,1,6667,6570,cPa419,37,162,97
Scaffold666-7317_7419,cPa419,1,1,7367,7360,cPa419,2,102,7
Scaffold666-7487_7589,cPa419,1,1,7537,7537,cPa419,1,102,0
Scaffold666-7687_7789,cPa419,1,1,7762,7730,cPa419,3,102,32
Scaffold667-10990_11092,cPa539,1,1,11060,11040,cPa539,2,102,20
Scaffold667-11141_11290,cPa539,1,1,11238,11191,cPa539,2,149,47
Scaffold668-3391_3493,cPa419,1,1,3493,3392,cPa419,35,102,101
Scaffold668-3692_3978,cPa419,1,1,3926,3729,cPa419,8,286,197
Scaffold668-4198_4300,cPa419,1,1,4248,4248,cPa419,1,102,0
Scaffold668-6597_6841,cPa419,1,1,6789,6647,cPa419,16,244,142
Scaffold668-6977_7079,cPa419,1,1,7054,7027,cPa419,3,102,27
Scaffold668-7130_7304,cPa419,1,1,7252,7149,cPa419,5,174,103
Scaffold668-8124_8226,cPa419,1,1,8187,8174,cPa419,9,102,13
Scaffold668-8804_8928,cPa419,1,1,8893,8805,cPa419,35,124,88
Scaffold668-8939_9142,cPa419,1,1,9130,8938,cPa419,49,203,192
Scaffold668-9158_9671,cPa419,1,1,9666,9174,cPa419,224,513,492
Scaffold668-9675_9777,cPa419,1,1,9777,9719,cPa419,3,102,58
Scaffold669-10621_10723,cPa75,1,1,10671,10671,cPa75,1,102,0
Scaffold67-11501_11603,cPa434,0.75,2,11587,11512,cPa356_cPa434,1_3,102,75
Scaffold67-11693_11872,cPa434,1,1,11837,11743,cPa434,7,179,94
Scaffold67-12248_12350,cPa434,1,1,12298,12264,cPa434,6,102,34
Scaffold67-13790_13907,cPa425,0.833333333333333,2,13894,13798,cPa174_cPa425,1_5,117,96
Scaffold67-13908_14031,cPa434,0.357142857142857,7,13979,13917,cPa392_cPa392-cPa174-hybrid_cPa425_cPa425-cPa434-hybrid_cPa425-cPa47-hybrid_cPa425-unknown_cPa434,2_1_1_1_1_3_5,123,62
Scaffold67-17167_17269,cPa434,1,1,17217,17217,cPa434,1,102,0
Scaffold67-20392_20529,cPa529-unknown,0.4,11,20522,20442,cPa456_cPa479-unknown_cPa529-cPa313-hybrid_cPa529-cPa492-hybrid_cPa529-EIAV_NC001450-hybrid_cPa529-unknown_SIV_NC001549-cPa313-hybrid_SIV_NC001549-cPa363-hybrid_SIV_NC001549-cPa492-hybrid_SIV_NC001549-EIAV_NC001450-hybrid_SIV_NC001549-unknown,2_1_1_4_3_36_1_1_5_3_33,137,80
Scaffold67-24156_24258,cPa50-cPa75-hybrid,0.5,4,24206,24165,cPa333-cPa75-hybrid_cPa50-cPa285-hybrid_cPa50-cPa394-hybrid_cPa50-cPa75-hybrid,1_1_1_3,102,41
Scaffold67-25859_25961,HERV-Fb_repbase_HERVH48I_MER48-unknown,1,1,25909,25909,HERV-Fb_repbase_HERVH48I_MER48-unknown,1,102,0
Scaffold67-26046_26150,HERV-Fb_repbase_HERVH48I_MER48_HERV-Fb_repbase_HERVH48I_MER48-unknown,0.5,2,26098,26096,HERV-Fb_repbase_HERVH48I_MER48_HERV-Fb_repbase_HERVH48I_MER48-unknown,1_1,104,2
Scaffold67-4458_4560,cPa339,1,1,4539,4469,cPa339,4,102,70
Scaffold67-6230_6332,cPa67_HML4_repbase_HERVK13I_LTR13-cPa251-hybrid,0.5,2,6280,6280,cPa67_HML4_repbase_HERVK13I_LTR13-cPa251-hybrid,1_1,102,0
Scaffold67-6419_6521,cPa67,1,1,6469,6469,cPa67,2,102,0
Scaffold67-7433_7535,cPa67,1,1,7483,7483,cPa67,1,102,0
Scaffold67-8112_8214,cPa67,0.933333333333333,2,8206,8134,cPa419_cPa67,1_14,102,72
Scaffold67-9224_9445,cPa15,0.236842105263158,15,9393,9224,cPa118_cPa130-cPa109-hybrid_cPa15_cPa15-cPa109-hybrid_cPa15-cPa118-hybrid_cPa264_cPa339_cPa339-cPa109-hybrid_cPa339-cPa138-hybrid_cPa339-cPa15-hybrid_cPa339-cPa419-hybrid_cPa339-unknown_cPa353-cPa109-hybrid_cPa356-cPa443-hybrid_cPa443,3_2_9_2_1_1_3_4_2_1_1_1_1_1_6,221,169
Scaffold673-1598_1722,cPa419,1,1,1675,1648,cPa419,4,124,27
Scaffold673-2075_2214,cPa419,1,1,2162,2086,cPa419,10,139,76
Scaffold673-5233_5666,cPa419,1,1,5661,5243,cPa419,134,433,418
Scaffold673-5681_5783,cPa419,1,1,5753,5685,cPa419,3,102,68
Scaffold673-5867_6068,cPa419,1,1,6016,5917,cPa419,19,201,99
Scaffold673-6084_6371,cPa419,1,1,6366,6134,cPa419,37,287,232
Scaffold673-6452_6607,cPa419,0.966666666666667,2,6598,6461,cPa298-unknown_cPa419,1_29,155,137
Scaffold674-6688_6790,cPa285,1,1,6738,6738,cPa285,1,102,0
Scaffold675-3580_3682,cPa75,1,1,3630,3630,cPa75,1,102,0
Scaffold676-8418_8520,cPa505,0.916666666666667,2,8480,8427,cPa201_cPa505,1_11,102,53
Scaffold676-8929_9135,cPa505,0.772727272727273,4,9100,8935,cPa109_cPa152_cPa505_cPa505-cPa152-hybrid,1_2_17_2,206,165
Scaffold677-1515_1617,cPa356_cPa428,0.5,2,1565,1565,cPa356_cPa428,1_1,102,0
Scaffold677-1670_2000,cPa356,0.5625,2,1977,1677,cPa356_cPa428,9_7,330,300
Scaffold677-2070_2236,cPa428,0.75,2,2205,2120,cPa356_cPa428,1_3,166,85
Scaffold677-2705_2810,cPa356,0.6,2,2800,2741,cPa356_cPa428,9_6,105,59
Scaffold677-3495_3663,cPa428,0.8,2,3632,3545,cPa356_cPa428,1_4,168,87
Scaffold677-4027_4129,cPa428,1,1,4077,4077,cPa428,1,102,0
Scaffold677-5461_5563,cPa428,1,1,5511,5511,cPa428,1,102,0
Scaffold677-870_1489,cPa428,0.53125,3,1437,872,cPa356_cPa428_cPa428-unknown,59_68_1,619,565
Scaffold678-7558_7660,cPa419,1,1,7608,7608,cPa419,1,102,0
Scaffold678-7743_7845,cPa419,1,1,7836,7793,cPa419,3,102,43
Scaffold678-8304_8406,cPa419,1,1,8401,8332,cPa419,5,102,69
Scaffold678-8780_8951,cPa419,1,1,8899,8830,cPa419,4,171,69
Scaffold68-18337_18448,cPa360-cPa174-hybrid,0.666666666666667,2,18396,18349,cPa360-cPa174-hybrid_cPa425-unknown,2_1,111,47
Scaffold68-18451_18615,cPa360-unknown,0.228070175438596,19,18563,18493,cPa163-cPa182-hybrid_cPa163-unknown_cPa182_cPa182-ALVJ_Z46390-hybrid_cPa182-cPa224-hybrid_cPa182-cPa444-hybrid_cPa182-unknown_cPa224_cPa360_cPa360-cPa163-hybrid_cPa360-cPa224-hybrid_cPa360-cPa444-hybrid_cPa360-unknown_cPa425-cPa224-hybrid_cPa425-unknown_cPa444-cPa224-hybrid_cPa568_cPa568-unknown_cPa572-unknown,1_1_8_1_4_1_5_3_2_1_4_1_13_1_1_1_5_3_1,164,70
Scaffold68-18976_19078,cPa182-cPa345-hybrid_cPa568,0.5,2,19026,19023,cPa182-cPa345-hybrid_cPa568,1_1,102,3
Scaffold68-36899_37005,cPa298-cPa199-hybrid,0.45,5,36953,36948,cPa298-cPa199-hybrid_cPa298-cPa391-hybrid_cPa391_cPa475-cPa199-hybrid_cPa526-cPa391-hybrid,9_3_6_1_1,106,5
Scaffold68-37403_37505,cPa298-cPa199-hybrid,0.666666666666667,2,37464,37453,cPa298-cPa199-hybrid_cPa391,2_1,102,11
Scaffold68-378_499,cPa391,1,1,447,428,cPa391,5,121,19
Scaffold68-38633_38735,ALVJ_Z46390-cPa583-hybrid,0.333333333333333,5,38708,38662,ALVJ_Z46390-cPa583-hybrid_cPa15-cPa583-hybrid_cPa434-cPa199-hybrid_cPa459-cPa583-hybrid_PyERV_AF500296-cPa583-hybrid,2_1_1_1_1,102,46
Scaffold68-5061_5166,cPa223,1,1,5114,5100,cPa223,3,105,14
Scaffold68-54522_54624,REV_NC006934-cPa391-hybrid,0.8,2,54606,54572,EIAV_NC001450-cPa475-hybrid_REV_NC006934-cPa391-hybrid,1_4,102,34
Scaffold68-54974_55076,cPa515_cPa553-S71_repbase_HERVS71_LTR6A-hybrid,0.5,2,55024,55001,cPa515_cPa553-S71_repbase_HERVS71_LTR6A-hybrid,1_1,102,23
Scaffold68-55200_55302,cPa553-cPa390-hybrid,0.285714285714286,6,55301,55228,cPa433-cPa390-hybrid_cPa515-cPa390-hybrid_cPa553-cPa390-hybrid_EIAV_NC001450-cPa475-hybrid_EIAV_NC001450-HERV-E_repbase_HERVE_LTR2-hybrid_S71_repbase_HERVS71_LTR6A-HERV-E_repbase_HERVE_LTR2-hybrid,1_1_2_1_1_1,102,73
Scaffold68-617_719,cPa391,0.75,2,682,651,cPa15-cPa391-hybrid_cPa391,1_3,102,31
Scaffold682-1361_1463,cPa419,1,1,1422,1371,cPa419,4,102,51
Scaffold682-1909_2011,cPa419,1,1,1965,1951,cPa419,10,102,14
Scaffold682-2146_2248,cPa419,1,1,2196,2196,cPa419,1,102,0
Scaffold682-2593_2695,cPa419,1,1,2643,2630,cPa419,2,102,13
Scaffold682-2750_2852,cPa419,1,1,2844,2799,cPa419,4,102,45
Scaffold682-2927_3100,cPa419,1,1,3097,2946,cPa419,18,173,151
Scaffold682-3238_3340,cPa419,1,1,3298,3288,cPa419,4,102,10
Scaffold682-3392_3515,cPa419,1,1,3513,3395,cPa419,16,123,118
Scaffold682-3905_4061,cPa419,1,1,4013,3912,cPa419,12,156,101
Scaffold683-3270_3578,Cer1_U15406-unknown,0.190635451505017,50,3566,3275,BaEV_D10032-JSRV_DQ838494-hybrid_Cer1_U15406_Cer1_U15406-cPa205-hybrid_Cer1_U15406-cPa223-hybrid_Cer1_U15406-cPa308-hybrid_Cer1_U15406-cPa450-hybrid_Cer1_U15406-cPa61-hybrid_Cer1_U15406-cPa62-hybrid_Cer1_U15406-HIV1_NC001802-hybrid_Cer1_U15406-JSRV_DQ838494-hybrid_Cer1_U15406-SIV_NC001549-hybrid_Cer1_U15406-unknown_cPa106-cPa450-hybrid_cPa205-JSRV_DQ838494-hybrid_cPa223_cPa223-unknown_cPa227_cPa254_cPa285_cPa285-cPa205-hybrid_cPa285-cPa61-hybrid_cPa285-JSRV_DQ838494-hybrid_cPa285-unknown_cPa308_cPa308-cPa205-hybrid_cPa308-JSRV_DQ838494-hybrid_cPa308-unknown_cPa419_cPa449-cPa205-hybrid_cPa449-cPa223-hybrid_cPa449-cPa61-hybrid_cPa449-JSRV_DQ838494-hybrid_cPa449-unknown_cPa465-cPa223-hybrid_cPa465-JSRV_DQ838494-hybrid_cPa61-cPa450-hybrid_cPa62_cPa62-cPa205-hybrid_cPa62-cPa61-hybrid_cPa62-JSRV_DQ838494-hybrid_cPa62-unknown_cPa75_cPa75-cPa205-hybrid_cPa75-cPa308-hybrid_cPa75-cPa61-hybrid_cPa75-HERV-ADP_repbase_HERVP71A_I_LTR71A-hybrid_cPa75-JSRV_DQ838494-hybrid_cPa75-unknown_HIV1_NC001802_JSRV_DQ838494,1_3_19_3_2_4_16_1_1_12_1_57_1_2_2_1_4_1_4_2_1_1_1_2_1_2_3_5_2_1_8_5_16_1_3_1_15_3_1_3_12_15_1_1_2_1_1_36_3_15,308,291
Scaffold683-3660_3762,Cer1_U15406-cPa61-hybrid,0.666666666666667,2,3717,3710,Cer1_U15406-cPa205-hybrid_Cer1_U15406-cPa61-hybrid,1_2,102,7
Scaffold684-5674_5776,cPa356,1,1,5724,5724,cPa356,1,102,0
Scaffold684-6173_6275,cPa356,1,1,6223,6223,cPa356,1,102,0
Scaffold684-6420_6522,cPa356,1,1,6470,6469,cPa356,4,102,1
Scaffold684-6698_6800,cPa356_cPa428,0.5,2,6782,6743,cPa356_cPa428,5_5,102,39
Scaffold684-6932_7034,cPa356,0.555555555555556,2,7026,6932,cPa356_cPa428,10_8,102,94
Scaffold684-7778_7992,cPa356,0.514705882352941,2,7961,7778,cPa356_cPa428,70_66,214,183
Scaffold684-8047_8165,cPa356,0.528301886792453,2,8164,8047,cPa356_cPa428,28_25,118,117
Scaffold684-8209_8328,cPa356,0.538461538461538,2,8290,8208,cPa356_cPa428,21_18,119,82
Scaffold684-8438_8540,cPa428,0.714285714285714,2,8511,8474,cPa356_cPa428,2_5,102,37
Scaffold685-1635_1745,cPa419,1,1,1737,1636,cPa419,14,110,101
Scaffold685-2466_2593,cPa419,1,1,2552,2479,cPa419,7,127,73
Scaffold685-2835_2937,cPa419,1,1,2885,2885,cPa419,1,102,0
Scaffold686-4729_4896,cPa109-unknown,0.272727272727273,11,4881,4729,cPa109-cPa16-hybrid_cPa109-cPa339-hybrid_cPa109-cPa387-hybrid_cPa109-cPa444-hybrid_cPa109-unknown_cPa447-cPa254-hybrid_cPa447-cPa505-hybrid_cPa486-cPa390-hybrid_cPa486-EqFV_NC002201-hybrid_cPa505-cPa444-hybrid_cPa505-unknown,1_1_1_1_6_1_2_1_1_4_3,167,152
Scaffold686-5392_5494,cPa339_cPa387-cPa447-hybrid,0.5,2,5461,5442,cPa339_cPa387-cPa447-hybrid,1_1,102,19
Scaffold686-5571_5673,cPa444,0.678571428571429,6,5627,5597,cPa109-cPa444-hybrid_cPa16_cPa339_cPa390_cPa444_cPa444-cPa16-hybrid,3_1_1_3_19_1,102,30
Scaffold686-594_696,cPa391_cPa475,0.5,2,644,628,cPa391_cPa475,1_1,102,16
Scaffold686-8182_8304,cPa199-unknown,0.25,7,8256,8212,cPa199-unknown_cPa381-cPa444-hybrid_cPa398-cPa444-hybrid_cPa486_cPa486-cPa444-hybrid_cPa587-cPa444-hybrid_cPa587-unknown,2_1_1_1_1_1_1,122,44
Scaffold687-4653_4755,cPa356,0.666666666666667,2,4724,4703,cPa356_cPa428,2_1,102,21
Scaffold687-5779_5926,cPa428,0.727272727272727,2,5874,5782,cPa356_cPa428,3_8,147,92
Scaffold687-6849_6951,cPa356_cPa428,0.5,2,6939,6877,cPa356_cPa428,4_4,102,62
Scaffold688-1514_1694,cPa419,1,1,1662,1554,cPa419,48,180,108
Scaffold688-1897_2009,cPa419,1,1,2003,1909,cPa419,47,112,94
Scaffold688-385_487,cPa419,1,1,435,402,cPa419,6,102,33
Scaffold688-558_660,cPa419,1,1,649,608,cPa419,7,102,41
Scaffold688-782_884,cPa419,1,1,832,832,cPa419,1,102,0
Scaffold690-1180_1667,cPa194,0.561111111111111,13,1660,1212,cPa194_cPa194-unknown_cPa4-cPa15-hybrid_cPa4-cPa194-hybrid_cPa4-cPa549-hybrid_cPa410-cPa194-hybrid_cPa413-cPa194-hybrid_cPa413-cPa549-hybrid_cPa419_cPa526-cPa194-hybrid_cPa529-cPa194-hybrid_cPa529-cPa549-hybrid_cPa529-unknown,101_2_1_3_2_1_2_3_1_1_23_3_37,487,448
Scaffold690-3036_3138,cPa413-cPa75-hybrid,1,1,3086,3086,cPa413-cPa75-hybrid,1,102,0
Scaffold690-5492_5594,cPa51-unknown,0.5,3,5583,5499,cPa51_cPa51-cPa75-hybrid_cPa51-unknown,1_2_3,102,84
Scaffold694-1552_1654,cPa585,1,1,1602,1602,cPa585,1,102,0
Scaffold694-6962_7064,HERV-Fb_repbase_HERVH48I_MER48,1,1,7049,6993,HERV-Fb_repbase_HERVH48I_MER48,3,102,56
Scaffold698-2655_2757,cPa75-cPa360-hybrid,1,1,2705,2705,cPa75-cPa360-hybrid,1,102,0
Scaffold698-3094_3196,cPa62,1,1,3144,3144,cPa62,1,102,0
Scaffold70-10488_10590,cPa391,1,1,10583,10538,cPa391,20,102,45
Scaffold70-10691_10793,cPa391,1,1,10788,10710,cPa391,17,102,78
Scaffold70-11039_11141,cPa391,0.916666666666667,4,11140,11049,cPa293-cPa298-hybrid_cPa391_cPa475_HML3_repbase_HERVK9I_MER9-cPa475-hybrid,1_33_1_1,102,91
Scaffold70-1348_1781,cPa130,0.421641791044776,11,1732,1366,cPa130_cPa130-unknown_cPa205-cPa118-hybrid_cPa356_cPa356-cPa118-hybrid_cPa356-cPa130-hybrid_cPa356-cPa434-hybrid_cPa356-unknown_cPa419_cPa434_cPa546-cPa356-hybrid,113_3_1_72_2_3_2_1_1_69_1,433,366
Scaffold70-15619_15723,cPa208-cPa333-hybrid,1,1,15671,15669,cPa208-cPa333-hybrid,2,104,2
Scaffold70-15751_15853,cPa223-cPa121-hybrid,1,1,15801,15801,cPa223-cPa121-hybrid,1,102,0
Scaffold70-16003_16140,cPa223-cPa75-hybrid,0.272727272727273,10,16088,16053,cPa208-cPa247-hybrid_cPa208-cPa413-hybrid_cPa208-cPa75-hybrid_cPa208-STLV2_NC001815-hybrid_cPa223-cPa121-hybrid_cPa223-cPa247-hybrid_cPa223-cPa333-hybrid_cPa223-cPa402-hybrid_cPa223-cPa413-hybrid_cPa223-cPa75-hybrid,4_8_9_1_1_5_1_1_10_15,137,35
Scaffold70-16158_16260,cPa75,1,1,16208,16208,cPa75,1,102,0
Scaffold70-16282_16514,cPa208-cPa333-hybrid,0.219178082191781,15,16462,16291,cPa208-cPa121-hybrid_cPa208-cPa333-hybrid_cPa208-STLV2_NC001815-hybrid_cPa223-cPa121-hybrid_cPa223-cPa247-hybrid_cPa223-cPa255-hybrid_cPa223-cPa333-hybrid_cPa223-cPa360-hybrid_cPa223-cPa402-hybrid_cPa223-cPa452-hybrid_cPa223-cPa75-hybrid_cPa223-STLV2_NC001815-hybrid_cPa247_cPa247-cPa75-hybrid_cPa413,1_16_6_5_1_1_12_1_1_1_9_14_2_2_1,232,171
Scaffold70-16516_16670,cPa419_cPa75,0.285714285714286,5,16643,16562,cPa247-cPa75-hybrid_cPa255-cPa333-hybrid_cPa255-cPa413-hybrid_cPa419_cPa75,1_1_1_2_2,154,81
Scaffold70-1813_2027,cPa434,0.466666666666667,8,1977,1863,cPa130_cPa356_cPa356-cPa118-hybrid_cPa356-cPa130-hybrid_cPa434_cPa447-cPa356-hybrid_cPa555-cPa566-hybrid_cPa555-unknown,10_8_2_1_21_1_1_1,214,114
Scaffold70-2429_2630,cPa434,0.512820512820513,10,2626,2430,cPa130-cPa15-hybrid_cPa130-cPa443-hybrid_cPa356_cPa356-cPa118-hybrid_cPa356-cPa15-hybrid_cPa356-cPa434-hybrid_cPa356-cPa443-hybrid_cPa356-cPa566-hybrid_cPa434_cPa555-cPa118-hybrid,1_2_19_8_2_1_3_1_40_1,201,196
Scaffold70-2720_2860,cPa434,0.641025641025641,5,2833,2734,cPa356_cPa356-cPa118-hybrid_cPa356-cPa15-hybrid_cPa356-cPa443-hybrid_cPa434,9_3_1_1_25,140,99
Scaffold70-2892_3022,cPa434,0.541353383458647,12,3022,2894,cPa130-cPa118-hybrid_cPa130-cPa443-hybrid_cPa130-cPa566-hybrid_cPa356_cPa356-cPa118-hybrid_cPa356-cPa130-hybrid_cPa356-cPa15-hybrid_cPa356-cPa566-hybrid_cPa4-cPa443-hybrid_cPa419-cPa566-hybrid_cPa434_cPa555-cPa443-hybrid,3_1_2_35_8_2_4_3_1_1_72_1,130,128
Scaffold70-33619_33781,cPa413,0.731182795698925,5,33740,33640,cPa241-cPa121-hybrid_cPa413_cPa413-cPa121-hybrid_cPa413-cPa333-hybrid_cPa413-unknown,2_68_1_2_20,162,100
Scaffold70-3657_3759,cPa356,0.866666666666667,2,3740,3657,cPa356_cPa447,13_2,102,83
Scaffold70-4451_4553,cPa356-cPa67-hybrid,0.666666666666667,2,4506,4501,cPa356-cPa67-hybrid_cPa67,2_1,102,5
Scaffold70-4679_4789,cPa67,0.75,2,4737,4725,cPa339-cPa356-hybrid_cPa67,1_3,110,12
Scaffold70-5854_5995,cPa67,0.8,3,5995,5854,cPa339_cPa339-unknown_cPa67,1_7_32,141,141
Scaffold701-5912_6014,cPa75,1,1,5962,5962,cPa75,1,102,0
Scaffold701-6230_6401,cPa75,1,1,6349,6280,cPa75,3,171,69
Scaffold701-6579_6681,cPa75,1,1,6667,6629,cPa75,2,102,38
Scaffold702-6475_6577,Cer1_U15406-cPa273-hybrid,1,1,6525,6525,Cer1_U15406-cPa273-hybrid,1,102,0
Scaffold702-6589_6722,cPa360_HML1a_repbase_HERV-K14CI_LTR14C-cPa62-hybrid,0.333333333333333,4,6710,6639,cPa117-cPa62-hybrid_cPa360_HML1a_repbase_HERV-K14CI_LTR14C-cPa200-hybrid_HML1a_repbase_HERV-K14CI_LTR14C-cPa62-hybrid,1_2_1_2,133,71
Scaffold704-5109_5211,cPa285_cPa381_cPa390_cPa67_cPa75_MMTV_NC001503-cPa285-hybrid,0.166666666666667,6,5204,5156,cPa285_cPa381_cPa390_cPa67_cPa75_MMTV_NC001503-cPa285-hybrid,1_1_1_1_1_1,102,48
Scaffold704-5751_5901,cPa75,0.536231884057971,20,5900,5750,cPa119-cPa224-hybrid_cPa119-cPa67-hybrid_cPa119-cPa75-hybrid_cPa285_cPa381_cPa381-cPa224-hybrid_cPa381-cPa583-hybrid_cPa410-cPa67-hybrid_cPa410-cPa75-hybrid_cPa450-cPa75-hybrid_cPa583_cPa583-cPa224-hybrid_cPa583-cPa285-hybrid_cPa583-cPa392-hybrid_cPa583-cPa67-hybrid_cPa67_cPa67-cPa224-hybrid_cPa67-cPa381-hybrid_cPa75_cPa75-cPa67-hybrid,2_1_1_3_3_2_1_1_1_1_2_4_1_1_1_3_2_1_37_1,150,150
Scaffold704-6045_6147,cPa224,0.333333333333333,10,6145,6053,cPa224_cPa224-CAEV_NC001463-hybrid_cPa357-cPa75-hybrid_cPa362_cPa381_cPa450-cPa224-hybrid_cPa583-cPa224-hybrid_cPa75_PyERV_AF500296-cPa224-hybrid_PyERV_AF500296-cPa392-hybrid,7_1_1_1_1_1_1_6_1_1,102,92
Scaffold704-6172_6274,cPa75,0.39344262295082,22,6272,6176,cPa224_cPa273_cPa273-cPa224-hybrid_cPa273-cPa75-hybrid_cPa285_cPa285-cPa224-hybrid_cPa357-cPa392-hybrid_cPa357-cPa75-hybrid_cPa381-cPa390-hybrid_cPa410-cPa75-hybrid_cPa413-cPa224-hybrid_cPa413-cPa392-hybrid_cPa413-cPa75-hybrid_cPa583_cPa583-cPa75-hybrid_cPa67_cPa67-cPa224-hybrid_cPa67-cPa75-hybrid_cPa75_cPa75-cPa224-hybrid_cPa75-cPa583-hybrid_PyERV_AF500296-cPa381-hybrid,5_1_1_1_1_2_1_1_1_1_5_2_4_1_1_3_2_1_24_1_1_1,102,96
Scaffold706-1531_1730,cPa419,0.611111111111111,6,1679,1581,cPa419_PtERV1_AC142352-cPa434-hybrid_PtERV1_AC142352-cPa469-hybrid_PtERV1_AC142352-cPa554-hybrid_PtERV1_AC142352-HIV1_NC001802-hybrid_PtERV1_AC142352-unknown,11_1_2_2_1_1,199,98
Scaffold706-3584_4067,cPa15,0.46195652173913,21,4065,3589,cPa118_cPa118-cPa15-hybrid_cPa118-cPa174-hybrid_cPa118-cPa248-hybrid_cPa118-cPa268-hybrid_cPa118-cPa308-hybrid_cPa118-cPa413-hybrid_cPa118-unknown_cPa15_cPa15-cPa443-hybrid_cPa174-cPa443-hybrid_cPa199_cPa199-cPa425-hybrid_cPa227_cPa268-cPa450-hybrid_cPa273_cPa273-cPa248-hybrid_cPa345-cPa15-hybrid_cPa419_cPa443-cPa450-hybrid_cPa553-cPa413-hybrid,43_4_1_2_2_1_1_18_85_1_1_5_1_1_1_1_1_1_12_1_1,483,476
Scaffold706-541_643,cPa419,0.95,2,630,565,cPa419_PtERV1_AC142352-cPa61-hybrid,19_1,102,65
Scaffold708-1366_1468,cPa428,1,1,1416,1416,cPa428,1,102,0
Scaffold708-2204_2306,cPa428,0.666666666666667,2,2304,2254,cPa356_cPa428,1_2,102,50
Scaffold708-2474_2600,cPa356,0.666666666666667,2,2548,2524,cPa356_cPa428,2_1,126,24
Scaffold708-3852_3954,cPa428,0.75,2,3953,3900,cPa356_cPa428,1_3,102,53
Scaffold708-4054_4156,cPa428,1,1,4104,4104,cPa428,1,102,0
Scaffold708-4502_4604,cPa428,1,1,4552,4552,cPa428,1,102,0
Scaffold708-4810_4912,cPa356_cPa428,0.5,2,4911,4860,cPa356_cPa428,1_1,102,51
Scaffold708-4951_5104,cPa356_cPa428,0.5,2,5092,4953,cPa356_cPa428,6_6,153,139
Scaffold709-3263_3466,cPa391,0.541176470588235,8,3463,3313,cPa130-cPa298-hybrid_cPa130-unknown_cPa298_cPa298-unknown_cPa391_cPa475_cPa475-unknown_SIV_NC001549-unknown,3_3_14_1_46_2_13_3,203,150
Scaffold709-5665_5790,cPa51_cPa585-HTLV2_M10060-hybrid,0.5,2,5738,5715,cPa51_cPa585-HTLV2_M10060-hybrid,1_1,125,23
Scaffold71-1002_1104,cPa67,1,1,1090,1006,cPa67,9,102,84
Scaffold71-10647_10749,cPa47,0.5,4,10726,10666,cPa174-unknown_cPa425_cPa47_cPa47-unknown,1_4_6_1,102,60
Scaffold71-10766_10868,cPa47,0.5,3,10851,10816,cPa174-cPa425-hybrid_cPa47_cPa47-unknown,1_2_1,102,35
Scaffold71-13014_13116,cPa356,1,1,13064,13064,cPa356,1,102,0
Scaffold71-1410_1578,cPa67,0.944444444444444,2,1578,1419,cPa587-cPa353-hybrid_cPa67,1_17,168,159
Scaffold71-17670_17811,cPa118_cPa140_cPa15-unknown,0.333333333333333,3,17759,17720,cPa118_cPa140_cPa15-unknown,1_1_1,141,39
Scaffold71-17826_17928,cPa118_cPa15_cPa248_cPa443,0.25,4,17876,17837,cPa118_cPa15_cPa248_cPa443,1_1_1_1,102,39
Scaffold71-18596_18698,cPa443,0.666666666666667,2,18651,18646,cPa15_cPa443,1_2,102,5
Scaffold71-18869_18971,cPa67,0.6,3,18971,18919,cPa15-cPa264-hybrid_cPa443_cPa67,1_1_3,102,52
Scaffold71-19377_19479,cPa67,1,1,19450,19377,cPa67,6,102,73
Scaffold71-2099_2380,cPa67,0.594285714285714,6,2340,2099,cPa410-unknown_cPa526-unknown_cPa587-cPa118-hybrid_cPa587-cPa443-hybrid_cPa587-unknown_cPa67,20_5_1_2_43_104,281,241
Scaffold71-2390_2660,cPa67,0.96,2,2628,2410,cPa587-unknown_cPa67,1_24,270,218
Scaffold71-25531_25633,cPa391,1,1,25594,25562,cPa391,4,102,32
Scaffold71-26031_26222,cPa391-cPa18-hybrid,0.666666666666667,2,26187,26081,cPa293-cPa18-hybrid_cPa391-cPa18-hybrid,1_2,191,106
Scaffold71-29209_29528,cPa587-PRIMA41_repbase_PRIMA41_MER41A-hybrid_HERV-W_repbase_HERV17_LTR17-PRIMA41_repbase_PRIMA41_MER41A-hybrid,0.174757281553398,25,29476,29259,cPa168-PRIMA41_repbase_PRIMA41_MER41A-hybrid_cPa413-PRIMA41_repbase_PRIMA41_MER41A-hybrid_cPa419_cPa42-cPa413-hybrid_cPa42-PRIMA41_repbase_PRIMA41_MER41A-hybrid_cPa587-cPa158-hybrid_cPa587-cPa18-hybrid_cPa587-cPa413-hybrid_cPa587-cPa419-hybrid_cPa587-HML8_repbase_HERVK11I_MER11A-hybrid_cPa587-PRIMA41_repbase_PRIMA41_MER41A-hybrid_cPa587-unknown_HERV-F_repbase_HERVFH19I_LTR19A-cPa18-hybrid_HERV-F_repbase_HERVFH19I_LTR19A-cPa419-hybrid_HERV-F_repbase_HERVFH19I_LTR19A-PRIMA41_repbase_PRIMA41_MER41A-hybrid_HERV-F_repbase_HERVFH19I_LTR19A-unknown_HERV-Fb_repbase_HERVH48I_MER48-PRIMA41_repbase_PRIMA41_MER41A-hybrid_HERV-W_repbase_HERV17_LTR17-cPa18-hybrid_HERV-W_repbase_HERV17_LTR17-cPa425-hybrid_HERV-W_repbase_HERV17_LTR17-HML8_repbase_HERVK11I_MER11A-hybrid_HERV-W_repbase_HERV17_LTR17-PRIMA41_repbase_PRIMA41_MER41A-hybrid_HERV-W_repbase_HERV17_LTR17-unknown_HERV-XA34_repbase_HERVFH21I_LTR21A-cPa18-hybrid_HERV-XA34_repbase_HERVFH21I_LTR21A-PRIMA41_repbase_PRIMA41_MER41A-hybrid_HERV-XA34_repbase_HERVFH21I_LTR21A-unknown,1_2_1_1_4_1_5_1_1_1_18_5_2_1_6_1_1_13_1_1_18_11_2_3_2,319,217
Scaffold71-34105_34212,cPa413,1,1,34212,34106,cPa413,10,107,106
Scaffold71-65203_65372,cPa425,0.540540540540541,5,65369,65226,cPa254_cPa392_cPa404-cPa47-hybrid_cPa425_cPa425-unknown,3_8_1_20_5,169,143
Scaffold71-7047_7199,cPa356,0.649350649350649,8,7155,7097,cPa356_cPa356-unknown_cPa434_cPa447_cPa447-cPa356-hybrid_cPa447-cPa434-hybrid_cPa447-unknown_cPa526-unknown,50_7_1_1_3_1_13_1,152,58
Scaffold71-7306_7587,cPa356,0.5,3,7565,7346,cPa356_cPa434_cPa434-unknown,15_11_4,281,219
Scaffold711-2040_2142,cPa419,1,1,2129,2042,cPa419,6,102,87
Scaffold711-2204_2703,cPa419,1,1,2703,2208,cPa419,98,499,495
Scaffold711-2767_2869,cPa419,1,1,2866,2771,cPa419,16,102,95
Scaffold711-2995_3097,cPa419,1,1,3065,3045,cPa419,2,102,20
Scaffold711-3523_3830,cPa419,0.99375,2,3819,3541,cPa229_cPa419,1_159,307,278
Scaffold711-4148_4250,cPa419,1,1,4248,4156,cPa419,28,102,92
Scaffold711-4777_4879,cPa419,1,1,4859,4780,cPa419,12,102,79
Scaffold711-4887_4989,cPa419,0.933333333333333,2,4978,4895,cPa229_cPa419,2_28,102,83
Scaffold711-5095_5335,cPa419,1,1,5327,5107,cPa419,66,240,220
Scaffold711-5354_5456,cPa419,1,1,5414,5380,cPa419,8,102,34
Scaffold711-5658_5760,cPa419,1,1,5758,5690,cPa419,6,102,68
Scaffold711-6062_6235,cPa419,1,1,6235,6070,cPa419,13,173,165
Scaffold711-6239_6576,cPa419,1,1,6524,6289,cPa419,18,337,235
Scaffold712-2677_2779,cPa419,1,1,2734,2727,cPa419,2,102,7
Scaffold713-2087_2189,cPa428,1,1,2137,2137,cPa428,1,102,0
Scaffold713-2270_2386,cPa428,0.625,3,2383,2314,cPa356_cPa428_cPa428-cPa356-hybrid,2_5_1,116,69
Scaffold713-2624_2726,cPa428,0.585714285714286,2,2691,2624,cPa356_cPa428,29_41,102,67
Scaffold713-2774_3020,cPa428,0.542857142857143,2,3013,2779,cPa356_cPa428,16_19,246,234
Scaffold713-3861_3963,cPa428,1,1,3911,3904,cPa428,2,102,7
Scaffold714-5629_5808,cPa419,0.444444444444444,5,5756,5670,cPa419_cPa447_cPa449_cPa449-cPa456-hybrid_cPa449-cPa75-hybrid,4_2_1_1_1,179,86
Scaffold717-1174_1296,cPa356,0.550724637681159,5,1295,1224,cPa356_cPa419_cPa428_cPa452_cPa75,38_1_28_1_1,122,71
Scaffold717-3003_3105,cPa428,1,1,3095,3053,cPa428,4,102,42
Scaffold717-3658_3833,cPa356,0.545454545454545,2,3833,3660,cPa356_cPa428,12_10,175,173
Scaffold717-387_489,cPa356,0.5,3,441,404,cPa356_cPa419_cPa428,5_1_4,102,37
Scaffold717-4113_4215,cPa428,0.631578947368421,2,4196,4130,cPa356_cPa428,7_12,102,66
Scaffold717-804_906,cPa356_cPa428,0.46875,3,903,854,cPa356_cPa419_cPa428,30_4_30,102,49
Scaffold719-4251_4353,cPa360,1,1,4352,4260,cPa360,22,102,92
Scaffold719-4530_4719,cPa360,0.907894736842105,2,4711,4529,cPa360_cPa75,69_7,189,182
Scaffold719-4889_5060,cPa75-unknown,0.230769230769231,10,5046,4901,cPa107-cPa183-hybrid_cPa107-unknown_cPa130-unknown_cPa360_cPa447-cPa183-hybrid_cPa75_cPa75-cPa183-hybrid_cPa75-cPa246-hybrid_cPa75-cPa424-hybrid_cPa75-unknown,3_1_1_5_1_2_5_1_1_6,171,145
Scaffold719-5571_5688,cPa392-unknown,0.461538461538462,10,5648,5570,cPa106-cPa183-hybrid_cPa106-cPa246-hybrid_cPa106-cPa424-hybrid_cPa106-unknown_cPa392_cPa392-cPa183-hybrid_cPa392-cPa246-hybrid_cPa392-cPa424-hybrid_cPa392-unknown_PERV_AJ293656-cPa246-hybrid,3_1_6_32_3_3_3_11_54_1,117,78
Scaffold719-980_1143,cPa308-cPa356-hybrid,0.592592592592593,5,1116,982,cPa308-cPa356-hybrid_cPa353-cPa356-hybrid_cPa356_cPa381-cPa356-hybrid_cPa486-cPa356-hybrid,16_3_6_1_1,163,134
Scaffold72-15186_15288,cPa387-unknown,1,1,15276,15236,cPa387-unknown,5,102,40
Scaffold72-21920_22074,cPa168,1,1,22022,21970,cPa168,5,154,52
Scaffold72-2794_2929,cPa356,0.875,2,2881,2844,cPa356_cPa419,7_1,135,37
Scaffold72-3006_3108,cPa356,1,1,3071,3056,cPa356,3,102,15
Scaffold72-30228_30346,cPa426-cPa486-hybrid,0.666666666666667,2,30294,30278,cPa391-SIV_NC001549-hybrid_cPa426-cPa486-hybrid,1_2,118,16
Scaffold72-5244_5347,cPa118,0.5,4,5295,5293,cPa118_cPa15_cPa248-cPa15-hybrid_cPa443,5_2_1_2,103,2
Scaffold72-6293_6516,cPa435-RELIK_ERVK-hybrid,0.229508196721311,28,6479,6294,cPa15-cPa67-hybrid_cPa200_cPa200-cPa194-hybrid_cPa200-cPa424-hybrid_cPa200-cPa67-hybrid_cPa200-HIV1_NC001802-hybrid_cPa200-RELIK_ERVK-hybrid_cPa200-unknown_cPa391-RELIK_ERVK-hybrid_cPa419_cPa424_cPa435_cPa435-cPa15-hybrid_cPa435-cPa194-hybrid_cPa435-cPa67-hybrid_cPa435-HIV1_NC001802-hybrid_cPa435-RELIK_ERVK-hybrid_cPa435-unknown_cPa61_cPa61-cPa194-hybrid_cPa67-cPa419-hybrid_HERV30_repbase_HERV30I_LTR30-cPa61-hybrid_HERV30_repbase_HERV30I_LTR30-RELIK_ERVK-hybrid_HTLV1_NC001436-cPa118-hybrid_HTLV1_NC001436-cPa15-hybrid_HTLV1_NC001436-cPa194-hybrid_HTLV1_NC001436-RELIK_ERVK-hybrid_HTLV1_NC001436-unknown,1_1_1_1_1_2_1_4_1_1_1_1_1_2_2_3_14_6_1_1_1_1_1_1_2_1_4_4,223,185
Scaffold720-4968_5070,cPa356,0.518518518518518,2,5070,4992,cPa356_cPa428,14_13,102,78
Scaffold720-5095_5197,cPa356,0.517241379310345,3,5183,5095,cPa356_cPa356-unknown_cPa428,15_1_13,102,88
Scaffold726-1010_1122,cPa356,0.5625,2,1122,1009,cPa356_cPa428,36_28,112,113
Scaffold726-1185_1386,cPa356,0.51685393258427,2,1369,1189,cPa356_cPa428,46_43,201,180
Scaffold726-709_921,cPa356,0.51219512195122,2,884,713,cPa356_cPa428,42_40,212,171
Scaffold727-860_991,cPa356,0.428571428571429,4,953,910,cPa356_cPa419_cPa428_cPa428-cPa308-hybrid,6_2_5_1,131,43
Scaffold727-997_1267,cPa356,0.428571428571429,6,1267,1009,cPa356_cPa356-cPa308-hybrid_cPa419_cPa428_cPa428-cPa308-hybrid_cPa428-unknown,18_2_1_16_4_1,270,258
Scaffold73-17186_17288,cPa145-unknown,1,1,17236,17236,cPa145-unknown,1,102,0
Scaffold73-20336_20438,HERV-Fb_repbase_HERVH48I_MER48-unknown,0.222222222222222,8,20438,20336,cPa127-cPa254-hybrid_cPa127-unknown_cPa419_cPa530-cPa254-hybrid_cPa530-cPa572-hybrid_HERV-Fb_repbase_HERVH48I_MER48-cPa254-hybrid_HERV-Fb_repbase_HERVH48I_MER48-cPa356-hybrid_HERV-Fb_repbase_HERVH48I_MER48-unknown,1_1_1_1_1_1_1_2,102,102
Scaffold73-30587_30689,cPa339,1,1,30661,30637,cPa339,2,102,24
Scaffold73-32133_32235,cPa15,0.666666666666667,2,32212,32150,cPa15_cPa67,2_1,102,62
Scaffold73-32243_32481,cPa67,0.422222222222222,12,32465,32248,cPa15_cPa15-cPa404-hybrid_cPa15-HERV30_repbase_HERV30I_LTR30-hybrid_cPa174_cPa248_cPa404_cPa443-cPa15-hybrid_cPa443-cPa174-hybrid_cPa47_cPa67_cPa67-cPa125-hybrid_cPa67-unknown,28_1_1_2_11_1_1_1_3_38_1_2,238,217
Scaffold73-33084_33269,cPa456,0.387096774193548,12,33268,33134,cPa15-cPa227-hybrid_cPa229_cPa248-cPa332-hybrid_cPa313-cPa332-hybrid_cPa332_cPa345_cPa419_cPa449_cPa456_cPa67-cPa345-hybrid_cPa67-cPa392-hybrid_cPa67-cPa553-hybrid,1_5_1_1_4_1_1_2_12_1_1_1,185,134
Scaffold73-34768_34927,cPa223_cPa449,0.242424242424242,8,34912,34768,cPa223_cPa229_cPa313_cPa313-cPa450-hybrid_cPa332_cPa419_cPa449_cPa456,8_4_3_1_4_1_8_4,159,144
Scaffold73-34931_35033,cPa223,0.238095238095238,8,35024,34932,cPa223_cPa229_cPa229-cPa223-hybrid_cPa313_cPa332_cPa428_cPa449_cPa456,5_1_1_3_4_1_3_3,102,92
Scaffold73-35391_35506,cPa449,0.354838709677419,7,35482,35398,cPa223_cPa229_cPa313_cPa332_cPa419_cPa449_cPa456,4_3_10_12_1_22_10,115,84
Scaffold73-35575_35677,cPa456,0.287878787878788,6,35677,35574,cPa223_cPa229_cPa313_cPa332_cPa449_cPa456,11_5_9_11_11_19,102,103
Scaffold73-35848_35959,cPa449,0.323529411764706,7,35953,35847,cPa223_cPa229_cPa313_cPa332_cPa419_cPa449_cPa456,4_3_2_4_2_11_8,111,106
Scaffold73-36446_36548,cPa332_cPa456,0.333333333333333,14,36545,36452,cPa113-cPa199-hybrid_cPa113-cPa273-hybrid_cPa113-cPa345-hybrid_cPa199_cPa223_cPa227-cPa313-hybrid_cPa229_cPa313_cPa332_cPa356_cPa449_cPa449-cPa273-hybrid_cPa450-cPa313-hybrid_cPa456,2_1_1_1_3_1_1_1_20_1_6_1_1_20,102,93
Scaffold73-37522_37624,cPa456,0.467741935483871,6,37621,37522,cPa223_cPa315-cPa273-hybrid_cPa332_cPa419_cPa449_cPa456,2_1_24_5_1_29,102,99
Scaffold73-37625_37727,cPa332,0.488888888888889,5,37720,37626,cPa332_cPa363_cPa419_cPa449_cPa456,22_1_1_1_20,102,94
Scaffold73-37792_37894,cPa332,0.545454545454545,2,37842,37841,cPa332_cPa456,6_5,102,1
Scaffold73-38085_38199,cPa456,0.472972972972973,8,38188,38116,cPa113_cPa113-cPa363-hybrid_cPa113-unknown_cPa332_cPa363_cPa419_cPa449_cPa456,3_1_1_30_1_2_1_35,114,72
Scaffold73-38467_38569,cPa456,0.428571428571429,4,38565,38487,cPa363_cPa371-cPa308-hybrid_cPa419_cPa456,1_2_1_3,102,78
Scaffold73-45263_45518,cPa356,0.862068965517241,5,45466,45284,cPa118-cPa356-hybrid_cPa356_cPa356-cPa248-hybrid_cPa356-cPa268-hybrid_cPa434-cPa268-hybrid,1_25_1_1_1,255,182
Scaffold73-4708_5027,cPa413-unknown,0.470873786407767,13,4975,4730,cPa394-unknown_cPa413_cPa413-cPa254-hybrid_cPa413-cPa308-hybrid_cPa413-cPa424-hybrid_cPa413-cPa62-hybrid_cPa413-unknown_cPa419_cPa572-unknown_HERV-XA34_repbase_HERVFH21I_LTR21A-cPa308-hybrid_HERV-XA34_repbase_HERVFH21I_LTR21A-cPa394-hybrid_HERV-XA34_repbase_HERVFH21I_LTR21A-cPa62-hybrid_HERV-XA34_repbase_HERVFH21I_LTR21A-unknown,1_66_1_1_1_1_97_7_1_1_1_1_27,319,245
Scaffold73-48544_48646,cPa434,1,1,48594,48553,cPa434,2,102,41
Scaffold73-49260_49562,cPa434,0.583333333333333,7,49556,49294,cPa241-cPa14-hybrid_cPa241-cPa356-hybrid_cPa356_cPa356-cPa566-hybrid_cPa419_cPa434_cPa434-unknown,1_1_40_1_1_63_1,302,262
Scaffold73-50738_50859,cPa568,0.652173913043478,10,50811,50770,cPa193_cPa193-cPa568-hybrid_cPa193-unknown_cPa241-cPa193-hybrid_cPa241-cPa568-hybrid_cPa356-cPa193-hybrid_cPa356-cPa568-hybrid_cPa434-cPa568-hybrid_cPa566-cPa193-hybrid_cPa568,4_3_1_1_1_1_1_3_1_30,121,41
Scaffold73-50865_50986,SIV_NC001549-ALVJ_Z46390-hybrid,0.666666666666667,2,50983,50915,cPa568_SIV_NC001549-ALVJ_Z46390-hybrid,2_4,121,68
Scaffold73-53154_53256,cPa117,1,1,53204,53204,cPa117,1,102,0
Scaffold73-53639_53741,cPa371-cPa145-hybrid,1,1,53689,53689,cPa371-cPa145-hybrid,1,102,0
Scaffold73-58675_58918,cPa127-unknown,0.382352941176471,12,58866,58710,cPa127-cPa356-hybrid_cPa127-cPa387-hybrid_cPa127-cPa486-hybrid_cPa127-cPa542-hybrid_cPa127-SIV_NC001549-hybrid_cPa127-unknown_cPa168-cPa387-hybrid_cPa168-cPa486-hybrid_cPa168-cPa542-hybrid_cPa168-unknown_cPa356_cPa530-cPa486-hybrid,1_1_6_2_1_13_1_1_1_5_1_1,243,156
Scaffold73-64392_64494,cPa419,1,1,64442,64442,cPa419,1,102,0
Scaffold73-64620_64722,cPa391,1,1,64670,64670,cPa391,1,102,0
Scaffold73-68271_68384,cPa424,0.6,3,68332,68297,cPa173_cPa173-HIV1_NC001802-hybrid_cPa424,1_1_3,113,35
Scaffold73-68427_68543,cPa391-HERV-XA34_repbase_HERVFH21I_LTR21A-hybrid_cPa391-HIV1_NC001802-hybrid_cPa424-cPa67-hybrid_RELIK_ERVK,0.25,4,68491,68455,cPa391-HERV-XA34_repbase_HERVFH21I_LTR21A-hybrid_cPa391-HIV1_NC001802-hybrid_cPa424-cPa67-hybrid_RELIK_ERVK,1_1_1_1,116,36
Scaffold73-69167_69269,cPa67,0.571428571428571,3,69261,69190,cPa194_cPa391-cPa194-hybrid_cPa67,5_1_8,102,71
Scaffold73-69462_69650,cPa194,0.580645161290323,2,69639,69509,cPa194_cPa67,18_13,188,130
Scaffold73-69674_69872,cPa194,0.505376344086022,4,69868,69681,cPa194_cPa194-cPa67-hybrid_cPa428_cPa67,47_1_1_44,198,187
Scaffold73-79523_79625,cPa75-cPa424-hybrid,0.4,4,79576,79558,cPa391-cPa327-hybrid_cPa60-cPa327-hybrid_cPa75-cPa327-hybrid_cPa75-cPa424-hybrid,1_1_1_2,102,18
Scaffold73-79948_80471,cPa327,0.410852713178295,12,80419,79998,cPa177-cPa424-hybrid_cPa327_cPa327-cPa424-hybrid_cPa327-unknown_cPa424_cPa424-cPa327-hybrid_cPa459-cPa424-hybrid_cPa75-cPa424-hybrid_S71_repbase_HERVS71_LTR6A_S71_repbase_HERVS71_LTR6A-cPa327-hybrid_S71_repbase_HERVS71_LTR6A-cPa424-hybrid_S71_repbase_HERVS71_LTR6A-unknown,1_53_4_5_39_1_1_1_14_1_2_7,523,421
Scaffold73-83927_84298,cPa163,0.615384615384615,7,84265,83977,cPa104_cPa104-cPa518-hybrid_cPa163_cPa220_cPa220-unknown_cPa75-cPa220-hybrid_cPa95,1_2_40_17_1_3_1,371,288
Scaffold73-85197_85299,cPa425,0.666666666666667,2,85273,85242,cPa425_cPa75,2_1,102,31
Scaffold73-85319_85479,cPa425,0.714285714285714,2,85427,85369,cPa425_cPa75-cPa425-hybrid,5_2,160,58
Scaffold73-85767_85869,cPa425,0.5,3,85837,85798,cPa419_cPa425_cPa75-ENTV_NC004994-hybrid,1_2_1,102,39
Scaffold73-85918_86064,cPa425,0.75,2,86012,85933,cPa419_cPa425,1_3,146,79
Scaffold731-1076_1196,cPa419,1,1,1153,1117,cPa419,34,120,36
Scaffold731-1238_1437,cPa419,1,1,1385,1288,cPa419,20,199,97
Scaffold731-1700_1802,cPa419,1,1,1802,1750,cPa419,3,102,52
Scaffold735-1560_1662,cPa419,1,1,1620,1609,cPa419,4,102,11
Scaffold735-3100_3233,cPa419,1,1,3190,3140,cPa419,31,133,50
Scaffold735-3686_3788,cPa419,1,1,3788,3689,cPa419,14,102,99
Scaffold735-407_509,cPa419,1,1,457,457,cPa419,1,102,0
Scaffold735-4439_4541,cPa419,1,1,4489,4475,cPa419,2,102,14
Scaffold738-3055_3240,cPa205,0.75,4,3238,3078,cPa205_cPa61_cPa61-cPa205-hybrid_cPa61-cPa60-hybrid,9_1_1_1,185,160
Scaffold74-10758_11391,cPa459,0.237777777777778,59,11347,10766,cPa176_cPa176-cPa173-hybrid_cPa176-cPa424-hybrid_cPa176-cPa425-hybrid_cPa176-HTLV1_NC001436-hybrid_cPa196_cPa196-cPa111-hybrid_cPa196-cPa173-hybrid_cPa196-cPa176-hybrid_cPa196-cPa327-hybrid_cPa196-cPa424-hybrid_cPa196-cPa425-hybrid_cPa196-unknown_cPa260_cPa260-cPa173-hybrid_cPa260-cPa205-hybrid_cPa260-cPa424-hybrid_cPa260-cPa459-hybrid_cPa305-cPa173-hybrid_cPa305-cPa424-hybrid_cPa305-cPa61-hybrid_cPa305-HTLV1_NC001436-hybrid_cPa305-unknown_cPa308_cPa308-cPa173-hybrid_cPa308-cPa205-hybrid_cPa308-cPa424-hybrid_cPa327_cPa327-cPa173-hybrid_cPa327-cPa205-hybrid_cPa327-cPa424-hybrid_cPa327-cPa425-hybrid_cPa327-cPa459-hybrid_cPa327-cPa61-hybrid_cPa327-HTLV1_NC001436-hybrid_cPa327-unknown_cPa357-cPa424-hybrid_cPa402-cPa425-hybrid_cPa424_cPa425_cPa433_cPa433-cPa111-hybrid_cPa433-cPa173-hybrid_cPa433-cPa327-hybrid_cPa433-cPa424-hybrid_cPa433-HTLV1_NC001436-hybrid_cPa433-unknown_cPa435-cPa173-hybrid_cPa435-cPa327-hybrid_cPa435-HTLV1_NC001436-hybrid_cPa459_cPa459-cPa173-hybrid_cPa459-cPa391-hybrid_cPa459-cPa424-hybrid_cPa459-cPa61-hybrid_cPa67-cPa424-hybrid_HERV30_repbase_HERV30I_LTR30-cPa173-hybrid_HERV30_repbase_HERV30I_LTR30-cPa424-hybrid_HERV30_repbase_HERV30I_LTR30-cPa425-hybrid,1_1_8_1_1_11_1_31_1_1_11_1_2_2_2_1_3_1_19_17_1_1_2_1_1_1_2_23_9_3_15_1_1_1_1_9_1_1_46_6_50_1_4_1_8_1_5_1_1_1_107_4_2_3_1_1_10_6_1,633,581
Scaffold74-1108_1261,S71_repbase_HERVS71_LTR6A,0.956521739130435,2,1221,1153,cPa117-unknown_S71_repbase_HERVS71_LTR6A,1_22,153,68
Scaffold74-13844_13946,cPa130,1,1,13936,13893,cPa130,9,102,43
Scaffold74-6443_6765,cPa391,0.405882352941176,15,6761,6443,cPa18-cPa298-hybrid_cPa18-HERVHcons-hybrid_cPa298_cPa298-cPa391-hybrid_cPa298-cPa447-hybrid_cPa298-unknown_cPa391_cPa391-cPa447-hybrid_cPa391-unknown_cPa475_cPa475-cPa298-hybrid_cPa475-cPa391-hybrid_cPa475-cPa447-hybrid_cPa475-unknown_cPa500-FIV_NC001482-hybrid,1_1_1_1_7_8_69_9_18_11_1_1_20_21_1,322,318
Scaffold74-6825_6927,cPa391,0.916666666666667,3,6924,6843,cPa107-cPa447-hybrid_cPa298-cPa447-hybrid_cPa391,1_1_22,102,81
Scaffold74-6947_7118,cPa391,0.9,2,7104,6954,cPa391_cPa500-unknown,18_2,171,150
Scaffold74-8055_8157,cPa475-cPa447-hybrid,0.444444444444444,4,8110,8079,cPa298-cPa447-hybrid_cPa391-cPa447-hybrid_cPa447-cPa298-hybrid_cPa475-cPa447-hybrid,2_2_1_4,102,31
Scaffold74-9283_9385,HERV30_repbase_HERV30I_LTR30-cPa173-hybrid,1,1,9333,9333,HERV30_repbase_HERV30I_LTR30-cPa173-hybrid,1,102,0
Scaffold74-983_1085,S71_repbase_HERVS71_LTR6A,0.833333333333333,2,1069,997,S71_repbase_HERVS71_LTR6A_S71_repbase_HERVS71_LTR6A-unknown,5_1,102,72
Scaffold742-1017_1427,HERV-W_repbase_HERV17_LTR17,0.497109826589595,55,1427,1022,BLV_NC001414-HERV-XA34_repbase_HERVFH21I_LTR21A-hybrid_BLV_NC001414-MLV_Xmv43-hybrid_cPa117-MDEV_AF053745-hybrid_cPa117-PERV_AJ293656-hybrid_cPa117-PERVB_AY099324-hybrid_cPa183-MDEV_AF053745-hybrid_cPa254-MDEV_AF053745-hybrid_cPa285_cPa293-cPa130-hybrid_cPa356-MDEV_AF053745-hybrid_cPa363-cPa194-hybrid_cPa363-HERV-F_repbase_HERVFH19I_LTR19A-hybrid_cPa363-MSEV_CT990572-hybrid_cPa419_cPa419-cPa130-hybrid_cPa419-MDEV_AF053745-hybrid_cPa419-PERV_AJ293656-hybrid_cPa428_cPa434_cPa449-cPa298-hybrid_cPa449-cPa395-hybrid_cPa449-cPa434-hybrid_cPa449-cPa463-hybrid_cPa449-cPa546-hybrid_cPa449-cPa572-hybrid_cPa449-cPa67-hybrid_cPa449-HERV-F_repbase_HERVFH19I_LTR19A-hybrid_cPa449-HERV-W_repbase_HERV17_LTR17-hybrid_cPa449-MDEV_AF053745-hybrid_cPa449-MLV_Xmv43-hybrid_cPa449-MSEV_CT990572-hybrid_cPa449-PERV_AJ293656-hybrid_cPa449-PERVB_AY099324-hybrid_cPa449-PERVC_HM159246-hybrid_cPa62_cPa62-cPa293-hybrid_cPa62-cPa67-hybrid_cPa67_cPa67-HERV-F_repbase_HERVFH19I_LTR19A-hybrid_cPa75_GaLV_M26927_GaLV_M26927-cPa16-hybrid_GaLV_M26927-cPa395-hybrid_GaLV_M26927-MDEV_AF053745-hybrid_GaLV_M26927-PERV_AJ293656-hybrid_GaLV_M26927-unknown_HERV-F_repbase_HERVFH19I_LTR19A_HERV-F_repbase_HERVFH19I_LTR19A-MDEV_AF053745-hybrid_HERV-W_repbase_HERV17_LTR17_HERV-W_repbase_HERV17_LTR17-MLV_Xmv43-hybrid_HERV-XA34_repbase_HERVFH21I_LTR21A_KoRV_AF151794_MLV_Xmv43_PERV_AJ293656_PERVC_HM159246-unknown,1_1_1_1_1_2_1_1_1_1_1_1_1_6_1_1_1_1_1_1_1_5_1_1_1_1_3_1_2_2_3_2_1_2_1_1_1_2_1_2_1_1_1_2_1_3_7_1_86_1_1_4_1_2_1,410,405
Scaffold742-2079_2252,cPa419,0.163934426229508,41,2251,2080,cPa117-cPa395-hybrid_cPa117-cPa546-hybrid_cPa117-cPa572-hybrid_cPa117-HERV-F_repbase_HERVFH19I_LTR19A-hybrid_cPa117-PERV_AJ293656-hybrid_cPa121-cPa130-hybrid_cPa121-PERVC_HM159246-hybrid_cPa183-cPa16-hybrid_cPa285_cPa356-MLV_Xmv43-hybrid_cPa363-cPa130-hybrid_cPa363-cPa395-hybrid_cPa363-cPa572-hybrid_cPa363-HERV-F_repbase_HERVFH19I_LTR19A-hybrid_cPa363-MDEV_AF053745-hybrid_cPa363-MLV_Xmv43-hybrid_cPa363-PERV_AJ293656-hybrid_cPa363-PERVC_HM159246-hybrid_cPa419_cPa419-cPa293-hybrid_cPa419-cPa395-hybrid_cPa419-PERV_AJ293656-hybrid_cPa428_cPa449-unknown_cPa456-cPa572-hybrid_cPa456-HERV-XA34_repbase_HERVFH21I_LTR21A-hybrid_cPa456-MDEV_AF053745-hybrid_cPa456-MSEV_CT990572-hybrid_cPa456-PERV_AJ293656-hybrid_cPa62-BLV_NC001414-hybrid_cPa75_cPa75-cPa16-hybrid_cPa75-cPa285-hybrid_GaLV_M26927-cPa16-hybrid_GaLV_M26927-cPa183-hybrid_GaLV_M26927-cPa293-hybrid_HERV-W_repbase_HERV17_LTR17-cPa16-hybrid_KoRV_AF151794-cPa293-hybrid_PERV_AJ293656-cPa293-hybrid_PERVB_AY099324-cPa293-hybrid_PERVC_HM159246-cPa285-hybrid,1_1_1_3_1_1_1_1_1_1_1_1_1_3_3_1_2_1_10_1_1_1_1_5_1_1_1_1_1_1_1_1_1_1_1_1_1_1_1_1_1,173,171
Scaffold742-2304_2410,cPa449-unknown,0.666666666666667,2,2379,2354,cPa419_cPa449-unknown,1_2,106,25
Scaffold742-2493_2601,cPa293,0.407407407407407,11,2601,2543,cPa117-cPa62-hybrid_cPa16_cPa16-cPa293-hybrid_cPa183-cPa16-hybrid_cPa285_cPa293_cPa419_cPa449-unknown_cPa450-cPa293-hybrid_cPa456-cPa293-hybrid_cPa62,1_4_1_1_30_33_2_5_1_1_2,108,58
Scaffold742-770_942,HERV-W_repbase_HERV17_LTR17,0.317757009345794,34,939,787,cPa163-cPa16-hybrid_cPa293_cPa293-cPa434-hybrid_cPa293-unknown_cPa419_cPa419-cPa434-hybrid_cPa434_cPa449-cPa224-hybrid_cPa449-cPa298-hybrid_cPa449-cPa419-hybrid_cPa449-cPa434-hybrid_cPa449-cPa75-hybrid_cPa62_cPa62-cPa434-hybrid_cPa75-BLV_NC001414-hybrid_cPa75-cPa434-hybrid_cPa75-MDEV_AF053745-hybrid_cPa75-MLV_Xmv43-hybrid_cPa75-MSEV_CT990572-hybrid_cPa75-unknown_GaLV_M26927-cPa434-hybrid_HERV-F_repbase_HERVFH19I_LTR19A_HERV-F_repbase_HERVFH19I_LTR19A-cPa434-hybrid_HERV-W_repbase_HERV17_LTR17_HERV-W_repbase_HERV17_LTR17-cPa434-hybrid_HERV-XA34_repbase_HERVFH21I_LTR21A_HERV-XA34_repbase_HERVFH21I_LTR21A-cPa434-hybrid_KoRV_AF151794-cPa434-hybrid_MDEV_AF053745_MLV_Xmv43_MSEV_CT990572-cPa434-hybrid_PERV_AJ293656_PERV_AJ293656-HERV-XA34_repbase_HERVFH21I_LTR21A-hybrid_PERVC_HM159246-cPa434-hybrid,1_2_2_1_5_2_1_1_2_1_25_2_1_2_1_3_1_2_1_1_1_3_1_34_1_1_1_1_1_1_1_1_1_2,172,152
Scaffold743-1544_1646,cPa67,1,1,1646,1547,cPa67,8,102,99
Scaffold743-1824_1926,cPa67,1,1,1874,1854,cPa67,4,102,20
Scaffold743-625_727,cPa67,1,1,707,624,cPa67,39,102,83
Scaffold743-730_832,cPa67,1,1,780,740,cPa67,3,102,40
Scaffold744-1629_1731,cPa428,1,1,1729,1679,cPa428,3,102,50
Scaffold744-2441_2543,cPa356,1,1,2521,2491,cPa356,2,102,30
Scaffold744-2600_2702,HERV-W_repbase_HERV17_LTR17,0.833333333333333,2,2701,2605,HERV-W_repbase_HERV17_LTR17_SIV_NC001870,5_1,102,96
Scaffold746-2250_2352,cPa199,1,1,2300,2300,cPa199,1,102,0
Scaffold75-10614_10763,cPa356,0.916666666666667,2,10732,10664,cPa199-unknown_cPa356,1_11,149,68
Scaffold75-11641_11743,cPa447,0.428571428571429,4,11701,11641,cPa356_cPa356-unknown_cPa434-unknown_cPa447,2_1_1_3,102,60
Scaffold75-15118_15234,cPa434,0.888888888888889,2,15182,15167,cPa223-cPa270-hybrid_cPa434,1_8,116,15
Scaffold75-15302_15480,cPa434,0.96,2,15474,15335,cPa434_cPa555,24_1,178,139
Scaffold75-17276_17520,cPa434,0.459677419354839,10,17481,17281,cPa130-unknown_cPa14_cPa356_cPa356-cPa566-hybrid_cPa356-cPa575-hybrid_cPa356-unknown_cPa434_cPa434-cPa194-hybrid_cPa434-cPa356-hybrid_cPa434-unknown,4_1_47_1_1_4_57_1_1_7,244,200
Scaffold75-17614_18035,cPa356,0.573991031390135,10,17998,17641,cPa356_cPa356-unknown_cPa391-unknown_cPa434_cPa434-cPa447-hybrid_cPa434-unknown_cPa447_cPa447-cPa190-hybrid_cPa447-unknown_cPa526-unknown,128_7_1_15_4_17_34_2_14_1,421,357
Scaffold75-22521_22698,cPa145-cPa333-hybrid,0.365853658536585,12,22666,22557,cPa121-cPa333-hybrid_cPa145_cPa145-cPa333-hybrid_cPa145-cPa362-hybrid_cPa145-cPa413-hybrid_cPa145-unknown_cPa150-cPa315-hybrid_cPa150-cPa407-hybrid_cPa419_cPa516-cPa333-hybrid_cPa543-cPa333-hybrid_cPa543-cPa413-hybrid,2_13_30_3_16_8_1_1_1_2_4_1,177,109
Scaffold75-2555_2854,cPa434-cPa402-hybrid,0.129032258064516,21,2802,2564,cPa381-cPa293-hybrid_cPa381-cPa391-hybrid_cPa381-cPa402-hybrid_cPa391_cPa434_cPa434-cPa152-hybrid_cPa434-cPa293-hybrid_cPa434-cPa363-hybrid_cPa434-cPa402-hybrid_cPa434-cPa452-hybrid_cPa434-cPa492-hybrid_cPa434-cPa67-hybrid_cPa434-unknown_cPa447_cPa447-cPa152-hybrid_cPa447-cPa293-hybrid_cPa447-cPa363-hybrid_cPa447-cPa402-hybrid_cPa447-cPa492-hybrid_cPa459-cPa402-hybrid_cPa502-cPa402-hybrid,1_2_1_1_1_1_3_1_4_1_1_1_2_3_1_1_1_1_1_2_1,299,238
Scaffold75-2881_2999,cPa434-cPa67-hybrid,1,1,2950,2923,cPa434-cPa67-hybrid,6,118,27
Scaffold75-5396_5510,cPa357-cPa391-hybrid_cPa419_cPa435-cPa67-hybrid,0.333333333333333,3,5458,5439,cPa357-cPa391-hybrid_cPa419_cPa435-cPa67-hybrid,1_1_1,114,19
Scaffold75-6311_6503,cPa357-unknown,0.333333333333333,5,6499,6313,cPa339-cPa194-hybrid_cPa339-unknown_cPa357-cPa391-hybrid_cPa357-EIAV_NC001450-hybrid_cPa357-unknown,1_1_1_1_2,192,186
Scaffold75-9111_9213,EqFV_NC002201-cPa356-hybrid,1,1,9161,9161,EqFV_NC002201-cPa356-hybrid,1,102,0
Scaffold750-1504_1606,cPa419,1,1,1582,1511,cPa419,20,102,71
Scaffold750-1640_1819,cPa419,1,1,1804,1690,cPa419,38,179,114
Scaffold752-1062_1197,cPa356_cPa428,0.5,2,1145,1086,cPa356_cPa428,2_2,135,59
Scaffold752-2324_2429,cPa194,0.285714285714286,8,2377,2327,cPa194_cPa194-cPa356-hybrid_cPa194-cPa428-hybrid_cPa194-cPa446-hybrid_cPa194-unknown_cPa67_cPa67-cPa345-hybrid_cPa67-unknown,4_2_1_2_1_2_1_1,105,50
Scaffold752-911_1013,cPa356,0.666666666666667,3,990,927,cPa194-cPa428-hybrid_cPa356_cPa428,1_4_1,102,63
Scaffold753-1043_1159,cPa419,1,1,1116,1070,cPa419,24,116,46
Scaffold753-1227_1561,cPa419,1,1,1538,1228,cPa419,38,334,310
Scaffold753-1566_1668,cPa419,1,1,1635,1590,cPa419,4,102,45
Scaffold755-989_1202,cPa428,0.529850746268657,2,1202,991,cPa356_cPa428,63_71,213,211
Scaffold758-1511_1613,cPa356,0.6,2,1598,1514,cPa356_cPa428,3_2,102,84
Scaffold76-14604_14706,cPa410-cPa298-hybrid,1,1,14654,14654,cPa410-cPa298-hybrid,1,102,0
Scaffold76-14800_15020,cPa410-cPa391-hybrid,0.555555555555556,4,14968,14850,cPa410-cPa298-hybrid_cPa410-cPa391-hybrid_cPa410-HERVHcons-hybrid_cPa410-HML8_repbase_HERVK11I_MER11A-hybrid,2_5_1_1,220,118
Scaffold76-15737_15891,cPa410-cPa298-hybrid_cPa410-HML8_repbase_HERVK11I_MER11A-hybrid,0.4,3,15839,15767,cPa410-cPa298-hybrid_cPa410-HERVHcons-hybrid_cPa410-HML8_repbase_HERVK11I_MER11A-hybrid,2_1_2,154,72
Scaffold76-2152_2303,cPa434,1,1,2251,2202,cPa434,3,151,49
Scaffold76-2313_2415,cPa434,1,1,2363,2363,cPa434,1,102,0
Scaffold76-2453_2608,cPa425,0.520833333333333,11,2575,2489,cPa174_cPa174-cPa254-hybrid_cPa174-cPa404-hybrid_cPa174-cPa47-hybrid_cPa392_cPa425_cPa425-cPa254-hybrid_cPa425-cPa404-hybrid_cPa425-cPa47-hybrid_cPa434_cPa566-cPa254-hybrid,6_1_3_2_1_25_1_1_2_5_1,155,86
Scaffold76-2651_2890,cPa223_cPa434,0.111111111111111,19,2886,2701,cPa174_cPa174-cPa167-hybrid_cPa174-cPa223-hybrid_cPa174-cPa392-hybrid_cPa174-cPa50-hybrid_cPa223_cPa223-cPa121-hybrid_cPa425-cPa223-hybrid_cPa425-cPa285-hybrid_cPa425-cPa75-hybrid_cPa425-unknown_cPa434_REV_NC006934-cPa167-hybrid_REV_NC006934-cPa223-hybrid_REV_NC006934-cPa254-hybrid_REV_NC006934-cPa392-hybrid_REV_NC006934-cPa404-hybrid_REV_NC006934-cPa47-hybrid_REV_NC006934-cPa50-hybrid,1_1_1_1_1_3_1_1_1_1_2_3_1_1_2_2_2_1_1,239,185
Scaffold76-28552_28654,cPa511-FrMuLV_NC001362-hybrid_cPa511-unknown,0.5,2,28608,28602,cPa511-FrMuLV_NC001362-hybrid_cPa511-unknown,1_1,102,6
Scaffold76-28869_28971,cPa511-FIV_NC001482-hybrid,1,1,28919,28919,cPa511-FIV_NC001482-hybrid,1,102,0
Scaffold76-29080_29182,cPa511-FrMuLV_NC001362-hybrid,1,1,29130,29130,cPa511-FrMuLV_NC001362-hybrid,1,102,0
Scaffold76-5921_6196,cPa356,0.425149700598802,9,6196,5920,cPa356_cPa434_cPa434-cPa356-hybrid_cPa434-unknown_cPa447_cPa447-BLV_NC001414-hybrid_cPa447-cPa566-hybrid_cPa447-cPa62-hybrid_cPa447-unknown,71_62_1_1_22_1_2_1_6,275,276
Scaffold76-6230_6443,cPa356,0.389830508474576,14,6433,6230,cPa356_cPa356-cPa395-hybrid_cPa356-cPa447-hybrid_cPa356-unknown_cPa434_cPa434-cPa356-hybrid_cPa447_cPa447-cPa339-hybrid_cPa447-cPa395-hybrid_cPa447-HERVFc2_repbase-hybrid_cPa447-unknown_cPa549-BLV_NC001414-hybrid_cPa549-unknown_cPa566-cPa356-hybrid,23_1_1_2_2_1_14_1_5_2_4_1_1_1,213,203
Scaffold76-6547_6663,cPa447_cPa447-cPa395-hybrid,0.357142857142857,4,6614,6579,cPa356_cPa447_cPa447-cPa395-hybrid_cPa447-unknown,1_5_5_3,116,35
Scaffold76-7055_7157,cPa447-cPa395-hybrid,1,1,7105,7105,cPa447-cPa395-hybrid,1,102,0
Scaffold76-8739_8897,cPa18-cPa395-hybrid,0.714285714285714,3,8883,8789,cPa18-cPa339-hybrid_cPa18-cPa395-hybrid_cPa188-cPa395-hybrid,1_10_3,158,94
Scaffold760-1215_1339,cPa419,1,1,1301,1233,cPa419,23,124,68
Scaffold761-1730_1834,cPa419,1,1,1791,1737,cPa419,31,104,54
Scaffold761-1964_2229,cPa419,1,1,2214,2008,cPa419,65,265,206
Scaffold764-2217_2319,cPa419,1,1,2267,2267,cPa419,1,102,0
Scaffold766-2147_2289,cPa456,0.346938775510204,11,2287,2189,cPa356-CAEV_NC001463-hybrid_cPa356-cPa456-hybrid_cPa356-cPa62-hybrid_cPa419_cPa419-cPa456-hybrid_cPa428-CAEV_NC001463-hybrid_cPa428-cPa456-hybrid_cPa456_cPa62_cPa62-CAEV_NC001463-hybrid_cPa62-cPa456-hybrid,4_9_1_2_1_3_3_17_5_2_2,142,98
Scaffold768-1276_1858,cPa75,0.234920634920635,144,1806,1276,CAEV_NC001463_CAEV_NC001463-unknown_cPa109_cPa109-PERVE_NC003059-hybrid_cPa109-unknown_cPa138-cPa62-hybrid_cPa157-cPa62-hybrid_cPa157-KWERV_GQ222416-hybrid_cPa196-cPa293-hybrid_cPa196-cPa62-hybrid_cPa199_cPa199-cPa157-hybrid_cPa199-cPa227-hybrid_cPa199-cPa258-hybrid_cPa199-cPa260-hybrid_cPa199-cPa293-hybrid_cPa199-cPa345-hybrid_cPa199-cPa419-hybrid_cPa199-cPa450-hybrid_cPa199-cPa482-hybrid_cPa199-cPa553-hybrid_cPa199-cPa563-hybrid_cPa199-cPa62-hybrid_cPa199-cPa75-hybrid_cPa199-KWERV_GQ222416-hybrid_cPa199-PERVE_NC003059-hybrid_cPa199-unknown_cPa223_cPa223-cPa293-hybrid_cPa223-cPa450-hybrid_cPa223-cPa75-hybrid_cPa223-PERVE_NC003059-hybrid_cPa223-unknown_cPa260_cPa273-cPa258-hybrid_cPa273-cPa62-hybrid_cPa285_cPa285-cPa157-hybrid_cPa285-cPa258-hybrid_cPa285-cPa293-hybrid_cPa285-cPa450-hybrid_cPa285-cPa482-hybrid_cPa285-cPa553-hybrid_cPa285-cPa563-hybrid_cPa285-cPa62-hybrid_cPa285-cPa75-hybrid_cPa285-PERVE_NC003059-hybrid_cPa285-unknown_cPa293_cPa293-cPa258-hybrid_cPa293-cPa419-hybrid_cPa293-cPa62-hybrid_cPa293-cPa75-hybrid_cPa293-KWERV_GQ222416-hybrid_cPa305-cPa199-hybrid_cPa305-cPa258-hybrid_cPa305-cPa293-hybrid_cPa305-cPa482-hybrid_cPa305-cPa62-hybrid_cPa305-KWERV_GQ222416-hybrid_cPa305-PERVC_HM159246-hybrid_cPa305-unknown_cPa308_cPa371-cPa62-hybrid_cPa419_cPa419-cPa62-hybrid_cPa450-cPa258-hybrid_cPa450-cPa62-hybrid_cPa542-cPa62-hybrid_cPa542-cPa75-hybrid_cPa553-cPa62-hybrid_cPa566-cPa199-hybrid_cPa566-cPa258-hybrid_cPa566-cPa260-hybrid_cPa566-cPa345-hybrid_cPa566-cPa482-hybrid_cPa566-cPa553-hybrid_cPa566-cPa563-hybrid_cPa566-cPa62-hybrid_cPa566-KoRV_AF151794-hybrid_cPa566-KWERV_GQ222416-hybrid_cPa566-unknown_cPa572_cPa572-cPa260-hybrid_cPa572-cPa293-hybrid_cPa572-cPa345-hybrid_cPa572-cPa356-hybrid_cPa572-cPa419-hybrid_cPa572-cPa450-hybrid_cPa572-cPa482-hybrid_cPa572-cPa553-hybrid_cPa572-cPa75-hybrid_cPa572-PERVE_NC003059-hybrid_cPa572-unknown_cPa587_cPa587-cPa293-hybrid_cPa587-cPa62-hybrid_cPa62_cPa71_cPa71-cPa258-hybrid_cPa71-cPa293-hybrid_cPa71-cPa62-hybrid_cPa75_FeFV_NC001871_FeFV_NC001871-cPa345-hybrid_FeFV_NC001871-cPa482-hybrid_FeFV_NC001871-cPa62-hybrid_FeFV_NC001871-cPa75-hybrid_FeFV_NC001871-KoRV_AF151794-hybrid_FeFV_NC001871-KWERV_GQ222416-hybrid_FeFV_NC001871-PERVC_HM159246-hybrid_FeFV_NC001871-unknown_HERV-W_repbase_HERV17_LTR17_HERV-W_repbase_HERV17_LTR17-cPa345-hybrid_HERV-W_repbase_HERV17_LTR17-cPa450-hybrid_HERV-W_repbase_HERV17_LTR17-cPa62-hybrid_HERV-W_repbase_HERV17_LTR17-cPa75-hybrid_HERV-W_repbase_HERV17_LTR17-unknown_HERV-XA34_repbase_HERVFH21I_LTR21A-cPa157-hybrid_HERV-XA34_repbase_HERVFH21I_LTR21A-cPa199-hybrid_HERV-XA34_repbase_HERVFH21I_LTR21A-cPa227-hybrid_HERV-XA34_repbase_HERVFH21I_LTR21A-cPa260-hybrid_HERV-XA34_repbase_HERVFH21I_LTR21A-cPa293-hybrid_HERV-XA34_repbase_HERVFH21I_LTR21A-cPa345-hybrid_HERV-XA34_repbase_HERVFH21I_LTR21A-cPa419-hybrid_HERV-XA34_repbase_HERVFH21I_LTR21A-cPa450-hybrid_HERV-XA34_repbase_HERVFH21I_LTR21A-cPa482-hybrid_HERV-XA34_repbase_HERVFH21I_LTR21A-cPa515-hybrid_HERV-XA34_repbase_HERVFH21I_LTR21A-cPa553-hybrid_HERV-XA34_repbase_HERVFH21I_LTR21A-cPa62-hybrid_HERV-XA34_repbase_HERVFH21I_LTR21A-cPa75-hybrid_HERV-XA34_repbase_HERVFH21I_LTR21A-KWERV_GQ222416-hybrid_HERV-XA34_repbase_HERVFH21I_LTR21A-PERVE_NC003059-hybrid_HERV-XA34_repbase_HERVFH21I_LTR21A-unknown_KWERV_GQ222416_KWERV_GQ222416-cPa223-hybrid_KWERV_GQ222416-cPa258-hybrid_KWERV_GQ222416-cPa345-hybrid_KWERV_GQ222416-cPa450-hybrid_KWERV_GQ222416-KoRV_AF151794-hybrid_KWERV_GQ222416-PERVE_NC003059-hybrid_MSFV_NC010819_MSFV_NC010819-PERVE_NC003059-hybrid_PERVB_AY099324,1_1_1_1_3_1_2_1_1_2_152_1_1_8_1_9_1_2_3_1_1_2_16_10_1_2_32_5_1_1_3_1_1_3_1_1_40_1_14_15_5_1_1_2_41_2_3_22_42_3_2_3_1_1_1_2_1_2_3_1_1_1_1_1_8_1_2_1_1_1_1_1_8_4_1_2_1_1_14_1_1_2_10_1_1_1_1_1_4_1_1_5_2_12_1_1_1_4_2_2_1_2_222_2_1_3_2_1_1_1_1_1_24_1_2_1_2_2_1_1_1_1_3_2_2_5_5_1_1_1_6_2_2_34_8_1_1_1_1_1_1_2_1_1,582,530
Scaffold77-14611_14760,cPa260,0.833333333333333,4,14760,14658,cPa260_cPa260-cPa298-hybrid_cPa260-unknown_cPa391,65_3_2_8,149,102
Scaffold77-19996_20098,cPa254-cPa413-hybrid,1,1,20046,20046,cPa254-cPa413-hybrid,1,102,0
Scaffold77-22113_22215,cPa379-cPa16-hybrid,1,1,22163,22163,cPa379-cPa16-hybrid,1,102,0
Scaffold77-24454_24689,cPa356,0.494949494949495,15,24686,24504,BLV_NC001414-cPa356-hybrid_BLV_NC001414-cPa434-hybrid_cPa356_cPa356-cPa16-hybrid_cPa356-cPa434-hybrid_cPa357-cPa434-hybrid_cPa434_cPa447-cPa16-hybrid_cPa447-cPa356-hybrid_cPa447-cPa379-hybrid_cPa447-cPa434-hybrid_cPa447-cPa566-hybrid_cPa447-unknown_cPa575-cPa16-hybrid_cPa575-cPa434-hybrid,1_2_98_2_4_1_2_13_6_1_61_1_4_1_1,235,182
Scaffold77-4757_4859,cPa145,0.307692307692308,6,4837,4770,cPa145_cPa308-cPa145-hybrid_cPa308-cPa333-hybrid_cPa308-cPa362-hybrid_cPa407-cPa145-hybrid_cPa407-cPa362-hybrid,4_1_1_3_2_2,102,67
Scaffold77-8591_8711,cPa323,0.571428571428571,3,8681,8641,cPa199_cPa323_cPa582,2_4_1,120,40
Scaffold771-1514_1703,cPa356,0.5625,2,1677,1535,cPa356_cPa428,9_7,189,142
Scaffold771-1779_2383,cPa356,0.595959595959596,4,2383,1782,cPa163_cPa356_cPa428_cPa428-cPa163-hybrid,1_59_38_1,604,601
Scaffold773-654_756,cPa223-unknown,0.545454545454545,6,756,685,cPa223_cPa223-cPa332-hybrid_cPa223-unknown_cPa332_cPa419_HERV-E_repbase_HERVE_LTR2-unknown,6_1_12_1_1_1,102,71
Scaffold778-580_682,cPa434,1,1,630,601,cPa434,2,102,29
Scaffold78-10790_10907,cPa434,0.666666666666667,2,10899,10840,cPa118_cPa434,1_2,117,59
Scaffold78-10991_11245,cPa443-cPa104-hybrid,0.211764705882353,21,11195,10991,cPa118-cPa104-hybrid_cPa118-cPa200-hybrid_cPa140-cPa104-hybrid_cPa140-cPa200-hybrid_cPa140-cPa264-hybrid_cPa248-cPa104-hybrid_cPa264-cPa104-hybrid_cPa339-cPa200-hybrid_cPa339-cPa220-hybrid_cPa391-cPa200-hybrid_cPa434-cPa104-hybrid_cPa434-cPa200-hybrid_cPa443-cPa104-hybrid_cPa443-cPa200-hybrid_cPa443-cPa220-hybrid_cPa443-unknown_cPa505-cPa200-hybrid_cPa516-cPa200-hybrid_cPa566-cPa200-hybrid_cPa67-cPa104-hybrid_cPa67-cPa200-hybrid,5_6_7_1_1_2_2_3_2_9_4_2_18_13_1_1_1_1_1_1_4,254,204
Scaffold78-19476_19599,cPa356,0.538461538461538,4,19585,19516,cPa188-cPa447-hybrid_cPa199-cPa447-hybrid_cPa356_cPa447,1_1_7_4,123,69
Scaffold78-19642_19815,cPa356,0.5,6,19812,19668,cPa356_cPa356-cPa447-hybrid_cPa356-unknown_cPa434_cPa434-cPa447-hybrid_cPa447,7_1_1_3_1_1,173,144
Scaffold78-21389_21491,cPa434,1,1,21443,21439,cPa434,2,102,4
Scaffold78-21891_21993,cPa434,1,1,21941,21941,cPa434,1,102,0
Scaffold78-22019_22154,cPa434,0.523809523809524,5,22135,22069,cPa15-cPa201-hybrid_cPa356-cPa201-hybrid_cPa434_cPa434-cPa174-hybrid_cPa434-cPa201-hybrid,1_1_11_1_7,135,66
Scaffold78-23679_23836,cPa434,0.923076923076923,2,23819,23729,cPa434_cPa434-cPa201-hybrid,12_1,157,90
Scaffold78-25516_25618,cPa434,0.8,4,25614,25545,cPa356_cPa434_cPa434-cPa356-hybrid_cPa434-unknown,2_16_1_1,102,69
Scaffold78-25724_26358,cPa434,0.547486033519553,9,26358,25754,cPa356_cPa356-unknown_cPa419_cPa434_cPa434-cPa356-hybrid_cPa434-cPa419-hybrid_cPa447_cPa447-cPa356-hybrid_HERV-XA34_repbase_HERVFH21I_LTR21A-cPa549-hybrid,65_3_2_98_6_1_1_2_1,634,604
Scaffold78-28526_28628,cPa363,0.5,4,28576,28537,cPa363_cPa452-cPa456-hybrid_cPa452-cPa75-hybrid_cPa452-unknown,4_1_1_2,102,39
Scaffold78-28631_28733,cPa363,0.375,6,28684,28661,cPa363_cPa363-cPa456-hybrid_cPa363-cPa75-hybrid_cPa452_cPa452-unknown_cPa456,6_1_1_2_5_1,102,23
Scaffold78-30244_30509,cPa67,0.875,4,30457,30244,cPa264-cPa67-hybrid_cPa264-unknown_cPa363-cPa443-hybrid_cPa67,1_2_1_28,265,213
Scaffold78-30618_30790,cPa67,1,1,30779,30668,cPa67,54,172,111
Scaffold78-34690_34792,REV_NC006934,1,1,34740,34740,REV_NC006934,1,102,0
Scaffold78-3828_3931,cPa391,0.5,3,3879,3878,cPa391_HML8_repbase_HERVK11I_MER11A-cPa199-hybrid_HML8_repbase_HERVK11I_MER11A-cPa391-hybrid,2_1_1,103,1
Scaffold78-38567_38669,cPa446,1,1,38617,38617,cPa446,1,102,0
Scaffold78-39939_40041,cPa285-cPa482-hybrid,1,1,40008,39989,cPa285-cPa482-hybrid,2,102,19
Scaffold78-559_661,cPa260_cPa260-cPa400-hybrid_cPa425,0.333333333333333,3,609,608,cPa260_cPa260-cPa400-hybrid_cPa425,1_1_1,102,1
Scaffold780-1676_1778,cPa469-unknown,1,1,1726,1723,cPa469-unknown,2,102,3
Scaffold780-383_485,HERV-W_repbase_HERV17_LTR17-unknown,1,1,462,433,HERV-W_repbase_HERV17_LTR17-unknown,2,102,29
Scaffold780-498_600,HERV-W_repbase_HERV17_LTR17-unknown,0.75,2,548,502,cPa67-unknown_HERV-W_repbase_HERV17_LTR17-unknown,1_3,102,46
Scaffold781-986_1137,cPa428,0.666666666666667,2,1116,1036,cPa428_cPa428-cPa356-hybrid,2_1,151,80
Scaffold784-1917_2019,cPa428,1,1,1967,1967,cPa428,1,102,0
Scaffold784-603_705,cPa356,0.8,2,673,649,cPa356_cPa428-unknown,4_1,102,24
Scaffold79-100452_100568,cPa387-cPa486-hybrid,0.75,2,100516,100502,cPa363-cPa486-hybrid_cPa387-cPa486-hybrid,1_3,116,14
Scaffold79-101904_102006,cPa168-unknown,0.666666666666667,2,101954,101952,cPa168-unknown_cPa530-cPa413-hybrid,2_1,102,2
Scaffold79-102110_102212,cPa168-cPa395-hybrid,0.666666666666667,2,102160,102144,cPa127_cPa168-cPa395-hybrid,1_2,102,16
Scaffold79-112208_112310,cPa391,0.8125,3,112303,112258,cPa391_cPa391-cPa345-hybrid_cPa391-unknown,13_2_1,102,45
Scaffold79-12524_12692,cPa298-cPa391-hybrid,0.5,3,12658,12574,cPa298-cPa391-hybrid_cPa298-REV_NC006934-hybrid_cPa391,3_1_2,168,84
Scaffold79-12703_12819,cPa391,0.75,2,12808,12753,cPa298-cPa391-hybrid_cPa391,1_3,116,55
Scaffold79-12836_13001,cPa298-cPa391-hybrid,0.533333333333333,4,12988,12886,cPa130-cPa391-hybrid_cPa298-cPa391-hybrid_cPa298-unknown_cPa391,3_8_1_3,165,102
Scaffold79-13137_13239,cPa298-cPa391-hybrid,0.545454545454545,6,13187,13143,cPa130-cPa391-hybrid_cPa199_cPa298-cPa199-hybrid_cPa298-cPa391-hybrid_cPa391_cPa391-unknown,1_1_1_6_1_1,102,44
Scaffold79-1727_1829,cPa419_cPa492-unknown_cPa75-cPa356-hybrid_HERV-W_repbase_HERV17_LTR17-HERVHcons-hybrid,0.25,4,1814,1754,cPa419_cPa492-unknown_cPa75-cPa356-hybrid_HERV-W_repbase_HERV17_LTR17-HERVHcons-hybrid,1_1_1_1,102,60
Scaffold79-17779_17920,cPa67,1,1,17904,17779,cPa67,51,141,125
Scaffold79-17957_18195,cPa67,1,1,18157,17976,cPa67,34,238,181
Scaffold79-18777_18879,cPa67,1,1,18827,18799,cPa67,3,102,28
Scaffold79-1933_2035,cPa492-unknown,0.307692307692308,9,2033,1939,cPa290-HERVHcons-hybrid_cPa419_cPa492_cPa492-HERVHcons-hybrid_cPa492-unknown_HERVHcons_S71_repbase_HERVS71_LTR6A-cPa356-hybrid_S71_repbase_HERVS71_LTR6A-cPa549-hybrid_S71_repbase_HERVS71_LTR6A-HERVHcons-hybrid,1_1_1_2_4_1_1_1_1,102,94
Scaffold79-19838_20008,cPa140-unknown_cPa264-unknown,0.428571428571429,3,19956,19888,cPa140-unknown_cPa248-unknown_cPa264-unknown,6_2_6,170,68
Scaffold79-21485_21685,cPa356,0.92,3,21635,21525,cPa200-unknown_cPa356_cPa356-unknown,1_23_1,200,110
Scaffold79-25323_25845,cPa425,0.266666666666667,16,25793,25322,cPa113-cPa174-hybrid_cPa113-cPa356-hybrid_cPa174_cPa254_cPa392_cPa402_cPa419_cPa419-cPa174-hybrid_cPa425_cPa425-cPa174-hybrid_cPa425-unknown_cPa434_cPa434-cPa174-hybrid_cPa434-cPa254-hybrid_cPa434-cPa452-hybrid_cPa434-unknown,1_1_4_1_1_1_2_1_16_3_1_14_5_1_1_7,522,471
Scaffold79-26046_26148,cPa434,0.5,3,26112,26092,cPa425-cPa402-hybrid_cPa434_cPa434-unknown,1_2_1,102,20
Scaffold79-2685_2787,S71_repbase_HERVS71_LTR6A,0.666666666666667,2,2735,2719,S71_repbase_HERVS71_LTR6A_S71_repbase_HERVS71_LTR6A-unknown,2_1,102,16
Scaffold79-27983_28085,cPa363_cPa363-cPa140-hybrid_cPa427-cPa452-hybrid,0.333333333333333,3,28071,28018,cPa363_cPa363-cPa140-hybrid_cPa427-cPa452-hybrid,1_1_1,102,53
Scaffold79-28629_28731,cPa125-cPa248-hybrid_cPa15,0.5,2,28679,28653,cPa125-cPa248-hybrid_cPa15,1_1,102,26
Scaffold79-29203_29521,cPa443,0.273504273504274,28,29469,29205,cPa125_cPa125-cPa264-hybrid_cPa125-cPa61-hybrid_cPa15_cPa258-cPa140-hybrid_cPa258-cPa452-hybrid_cPa258-HERV-W_repbase_HERV17_LTR17-hybrid_cPa264_cPa363-cPa125-hybrid_cPa363-cPa15-hybrid_cPa363-cPa264-hybrid_cPa363-cPa443-hybrid_cPa363-cPa566-hybrid_cPa427-cPa125-hybrid_cPa434_cPa434-cPa125-hybrid_cPa434-cPa15-hybrid_cPa434-cPa248-hybrid_cPa434-cPa264-hybrid_cPa434-cPa61-hybrid_cPa443_cPa443-cPa61-hybrid_cPa443-unknown_cPa452-cPa264-hybrid_cPa566_cPa61_cPa67-cPa15-hybrid_HERV-W_repbase_HERV17_LTR17-cPa125-hybrid,5_1_1_14_1_5_1_9_1_1_2_2_1_1_11_3_1_2_2_1_32_1_1_1_6_9_1_1,318,264
Scaffold79-29525_29690,cPa67,0.201834862385321,30,29690,29575,cPa125-cPa264-hybrid_cPa15_cPa15-cPa264-hybrid_cPa248_cPa258-cPa15-hybrid_cPa258-cPa248-hybrid_cPa258-cPa264-hybrid_cPa258-cPa434-hybrid_cPa258-cPa443-hybrid_cPa258-cPa452-hybrid_cPa258-cPa566-hybrid_cPa258-cPa61-hybrid_cPa264_cPa264-cPa61-hybrid_cPa363-cPa15-hybrid_cPa363-cPa264-hybrid_cPa363-cPa443-hybrid_cPa434_cPa434-cPa264-hybrid_cPa443_cPa443-cPa15-hybrid_cPa443-cPa434-hybrid_cPa452-cPa566-hybrid_cPa56-cPa434-hybrid_cPa566_cPa566-cPa264-hybrid_cPa61_cPa61-cPa264-hybrid_cPa67_cPa67-cPa452-hybrid,1_3_1_1_1_2_13_2_5_2_1_4_7_1_1_2_1_5_3_14_1_1_1_1_4_1_6_1_22_1,165,115
Scaffold79-30243_30545,cPa67,0.817567567567568,11,30535,30245,cPa258-cPa125-hybrid_cPa258-cPa15-hybrid_cPa258-cPa248-hybrid_cPa258-cPa264-hybrid_cPa258-cPa268-hybrid_cPa258-cPa434-hybrid_cPa258-cPa61-hybrid_cPa258-unknown_cPa264_cPa4-cPa248-hybrid_cPa67,3_6_4_4_2_3_2_1_1_1_121,302,290
Scaffold79-30648_30750,cPa67,1,1,30698,30653,cPa67,3,102,45
Scaffold79-32412_32514,cPa339,1,1,32505,32414,cPa339,6,102,91
Scaffold79-46206_46308,cPa308,1,1,46256,46230,cPa308,2,102,26
Scaffold79-46760_46862,cPa308,1,1,46815,46810,cPa308,2,102,5
Scaffold79-63979_64359,cPa323,0.333333333333333,11,64307,64019,cPa323_cPa323-cPa371-hybrid_cPa339-cPa323-hybrid_cPa339-cPa333-hybrid_cPa339-cPa371-hybrid_cPa444-cPa371-hybrid_cPa447-unknown_cPa568_cPa568-cPa323-hybrid_cPa568-cPa371-hybrid_cPa568-unknown,10_1_1_1_1_1_1_1_6_5_2,380,288
Scaffold79-68396_68523,JSRV_DQ838494-cPa201-hybrid,0.2,11,68486,68446,BaEV_D10032-cPa173-hybrid_BaEV_D10032-cPa75-hybrid_cPa394-cPa199-hybrid_cPa394-cPa75-hybrid_cPa527-cPa201-hybrid_cPa527-cPa75-hybrid_HERV-W_repbase_HERV17_LTR17-cPa201-hybrid_JSRV_DQ838494-cPa201-hybrid_JSRV_DQ838494-cPa492-hybrid_JSRV_DQ838494-cPa75-hybrid_JSRV_DQ838494-RELIK_ERVK-hybrid,1_1_1_2_1_1_2_3_1_1_1,127,40
Scaffold79-68569_68671,JSRV_DQ838494-cPa75-hybrid_JSRV_DQ838494-unknown,0.181818181818182,9,68657,68614,BaEV_D10032-cPa201-hybrid_cPa394-cPa199-hybrid_cPa394-cPa201-hybrid_cPa394-cPa75-hybrid_HERV-W_repbase_HERV17_LTR17-cPa257-hybrid_HERV-W_repbase_HERV17_LTR17-cPa75-hybrid_JSRV_DQ838494-cPa201-hybrid_JSRV_DQ838494-cPa75-hybrid_JSRV_DQ838494-unknown,1_1_1_1_1_1_1_2_2,102,43
Scaffold79-7416_7552,cPa145,0.625,3,7500,7466,cPa145_cPa145-HERV-Fb_repbase_HERVH48I_MER48-hybrid_cPa145-unknown,5_1_2,136,34
Scaffold79-99914_100085,cPa387-cPa486-hybrid,0.333333333333333,5,100033,99964,cPa254-unknown_cPa363-cPa486-hybrid_cPa387-cPa486-hybrid_cPa452_cPa71,1_1_2_1_1,171,69
Scaffold794-1173_1275,cPa428,1,1,1223,1215,cPa428,2,102,8
Scaffold797-1076_1278,cPa75,1,1,1229,1105,cPa75,8,202,124
Scaffold80-10247_10349,cPa419,0.6,2,10317,10294,cPa419_cPa492,3_2,102,23
Scaffold80-31960_32062,STLV2_NC001815-unknown,0.75,7,32059,31963,cPa121-cPa413-hybrid_cPa413_cPa413-cPa223-hybrid_cPa413-cPa247-hybrid_STLV2_NC001815-cPa247-hybrid_STLV2_NC001815-cPa413-hybrid_STLV2_NC001815-unknown,1_1_1_1_3_2_27,102,96
Scaffold80-32210_32386,STLV2_NC001815-unknown,0.769230769230769,4,32334,32260,cPa75_STLV2_NC001815-cPa163-hybrid_STLV2_NC001815-cPa500-hybrid_STLV2_NC001815-unknown,1_1_1_10,176,74
Scaffold80-32718_32820,cPa223_STLV2_NC001815-cPa500-hybrid,0.5,2,32800,32768,cPa223_STLV2_NC001815-cPa500-hybrid,1_1,102,32
Scaffold80-37796_38220,cPa391,0.684684684684685,10,38197,37835,cPa107-HERVHcons-hybrid_cPa107-unknown_cPa298_cPa298-cPa391-hybrid_cPa298-cPa75-hybrid_cPa298-HERVHcons-hybrid_cPa298-unknown_cPa391_cPa391-cPa75-hybrid_cPa475,1_1_2_6_2_1_20_76_1_1,424,362
Scaffold80-7679_7781,cPa419,1,1,7729,7729,cPa419,1,102,0
Scaffold81-11234_11473,cPa391,0.868852459016393,5,11433,11250,cPa199_cPa199-HML8_repbase_HERVK11I_MER11A-hybrid_cPa199-unknown_cPa298-cPa199-hybrid_cPa391,4_1_2_1_53,239,183
Scaffold81-30611_30713,cPa173-unknown,1,1,30661,30661,cPa173-unknown,1,102,0
Scaffold81-30775_30885,cPa173-unknown,0.857142857142857,3,30867,30808,cPa173_cPa173-cPa47-hybrid_cPa173-unknown,1_1_12,110,59
Scaffold81-37886_38047,cPa413_STLV2_NC001815,0.3,5,38032,37936,cPa223-cPa247-hybrid_cPa413_cPa75_STLV2_NC001815_STLV2_NC001815-unknown,2_3_1_3_1,161,96
Scaffold81-38712_38814,cPa223,1,1,38776,38725,cPa223,4,102,51
Scaffold81-41317_41419,cPa425-cPa75-hybrid,0.8,2,41367,41342,cPa18-cPa75-hybrid_cPa425-cPa75-hybrid,1_4,102,25
Scaffold81-42440_42542,cPa18-cPa391-hybrid,0.666666666666667,2,42502,42481,cPa18-cPa298-hybrid_cPa18-cPa391-hybrid,1_2,102,21
Scaffold81-42925_43027,cPa18-cPa391-hybrid,1,1,42975,42975,cPa18-cPa391-hybrid,1,102,0
Scaffold81-43387_43527,cPa391,0.869565217391304,4,43515,43418,cPa199-cPa391-hybrid_cPa298-cPa391-hybrid_cPa391_cPa500-unknown,1_1_20_1,140,97
Scaffold81-52607_52805,cPa356,0.7,8,52777,52655,cPa118-cPa575-hybrid_cPa356_cPa356-cPa434-hybrid_cPa356-cPa447-hybrid_cPa434_cPa447_cPa447-cPa434-hybrid_cPa575,1_28_1_2_4_2_1_1,198,122
Scaffold81-58854_59261,cPa505-unknown,0.509090909090909,12,59209,58857,cPa425_cPa469-unknown_cPa505_cPa505-CAEV_NC001463-hybrid_cPa505-cPa425-hybrid_cPa505-cPa75-hybrid_cPa505-HERV-XA34_repbase_HERVFH21I_LTR21A-hybrid_cPa505-SMRV_NC001514-hybrid_cPa505-unknown_cPa75_cPa75-SMRV_NC001514-hybrid_GaLV_M26927,3_1_13_1_2_1_1_2_28_1_1_1,407,352
Scaffold81-61491_61595,CAEV_NC001463-PRIMA41_repbase_PRIMA41_MER41A-hybrid,0.571428571428571,4,61543,61526,CAEV_NC001463-cPa113-hybrid_CAEV_NC001463-cPa188-hybrid_CAEV_NC001463-PRIMA41_repbase_PRIMA41_MER41A-hybrid_cPa113-PRIMA41_repbase_PRIMA41_MER41A-hybrid,1_1_4_1,104,17
Scaffold81-66797_67098,cPa298,0.751937984496124,6,67091,66805,cPa298_cPa391_cPa391-cPa293-hybrid_cPa391-FIV_NC001482-hybrid_cPa391-unknown_MLV_Xmv43-cPa391-hybrid,97_25_1_1_4_1,301,286
Scaffold81-72064_72415,cPa145,0.411764705882353,20,72414,72070,cPa145_cPa145-cPa167-hybrid_cPa145-cPa362-hybrid_cPa145-cPa413-hybrid_cPa333_cPa333-cPa145-hybrid_cPa333-cPa413-hybrid_cPa333-EIAV_NC001450-hybrid_cPa362_cPa362-cPa167-hybrid_cPa362-cPa413-hybrid_cPa362-cPa511-hybrid_cPa413_cPa527-cPa145-hybrid_cPa575-cPa145-hybrid_cPa575-cPa413-hybrid_cPa75_cPa75-cPa362-hybrid_KoRV_AF151794-cPa145-hybrid_S71_repbase_HERVS71_LTR6A-cPa413-hybrid,35_2_1_3_4_3_13_1_6_1_1_1_3_1_1_4_1_2_1_1,351,344
Scaffold82-11279_11381,cPa469-cPa446-hybrid,1,1,11329,11316,cPa469-cPa446-hybrid,2,102,13
Scaffold82-12466_12568,cPa391,1,1,12524,12502,cPa391,6,102,22
Scaffold82-22025_22127,cPa434,0.571428571428571,2,22124,22070,cPa356_cPa434,3_4,102,54
Scaffold82-22457_22571,cPa434,1,1,22526,22507,cPa434,5,114,19
Scaffold82-22748_23014,cPa434,1,1,23009,22785,cPa434,25,266,224
Scaffold82-23300_23454,cPa434,1,1,23402,23329,cPa434,9,154,73
Scaffold82-33778_33880,cPa145-unknown,0.375,5,33858,33798,cPa145-cPa254-hybrid_cPa145-cPa413-hybrid_cPa145-unknown_cPa456-cPa443-hybrid_cPa543-unknown,1_1_3_1_2,102,60
Scaffold82-34011_34113,cPa145-cPa413-hybrid_cPa145-unknown,0.4,3,34074,34053,cPa145-cPa413-hybrid_cPa145-unknown_cPa543-cPa413-hybrid,2_2_1,102,21
Scaffold82-45085_45187,cPa118_cPa15-BLV_NC001414-hybrid,0.5,2,45135,45135,cPa118_cPa15-BLV_NC001414-hybrid,1_1,102,0
Scaffold82-48632_48886,cPa67,0.983606557377049,2,48849,48682,cPa113-cPa199-hybrid_cPa67,1_60,254,167
Scaffold82-49388_49607,cPa67,1,1,49555,49432,cPa67,10,219,123
Scaffold82-49802_50223,cPa67,1,1,50192,49828,cPa67,91,421,364
Scaffold82-4983_5085,S71_repbase_HERVS71_LTR6A,1,1,5041,5025,S71_repbase_HERVS71_LTR6A,3,102,16
Scaffold82-55594_55765,cPa434,0.642857142857143,3,55764,55644,cPa356_cPa434_cPa434-unknown,4_9_1,171,120
Scaffold82-56149_56307,cPa434,0.6,2,56266,56199,cPa356_cPa434,2_3,158,67
Scaffold82-56504_56615,cPa434,0.641025641025641,5,56580,56505,cPa14-cPa447-hybrid_cPa356_cPa356-unknown_cPa434_cPa434-unknown,1_10_1_25_2,111,75
Scaffold82-57185_57287,cPa434,1,1,57287,57235,cPa434,4,102,52
Scaffold82-7645_7747,cPa492-unknown,1,1,7695,7695,cPa492-unknown,1,102,0
Scaffold83-11653_11755,cPa248,1,1,11703,11703,cPa248,1,102,0
Scaffold83-12385_12487,cPa248,1,1,12435,12435,cPa248,1,102,0
Scaffold83-12703_12805,cPa118_cPa15_cPa516,0.333333333333333,3,12767,12753,cPa118_cPa15_cPa516,1_1_1,102,14
Scaffold83-14102_14204,cPa15,0.25,15,14203,14115,cPa118_cPa125_cPa125-cPa264-hybrid_cPa125-cPa516-hybrid_cPa140_cPa15_cPa248_cPa254-cPa140-hybrid_cPa268_cPa425-cPa264-hybrid_cPa443_cPa443-cPa140-hybrid_cPa443-cPa268-hybrid_cPa443-cPa516-hybrid_cPa47,3_9_1_1_2_12_1_1_8_1_5_1_1_1_1,102,88
Scaffold83-14289_15101,cPa125,0.133834586466165,85,15055,14288,cPa118_cPa118-cPa119-hybrid_cPa118-cPa140-hybrid_cPa118-cPa15-hybrid_cPa118-cPa174-hybrid_cPa118-cPa264-hybrid_cPa118-cPa404-hybrid_cPa118-cPa425-hybrid_cPa118-cPa443-hybrid_cPa118-cPa47-hybrid_cPa118-cPa516-hybrid_cPa118-unknown_cPa119_cPa119-cPa254-hybrid_cPa119-cPa264-hybrid_cPa119-cPa268-hybrid_cPa119-cPa404-hybrid_cPa119-cPa47-hybrid_cPa119-cPa516-hybrid_cPa119-unknown_cPa125_cPa125-cPa174-hybrid_cPa125-cPa404-hybrid_cPa125-cPa425-hybrid_cPa125-cPa47-hybrid_cPa140_cPa140-cPa125-hybrid_cPa140-cPa15-hybrid_cPa140-cPa174-hybrid_cPa140-cPa264-hybrid_cPa140-cPa404-hybrid_cPa140-cPa443-hybrid_cPa140-unknown_cPa15_cPa15-cPa118-hybrid_cPa15-cPa140-hybrid_cPa15-cPa404-hybrid_cPa15-cPa47-hybrid_cPa15-unknown_cPa174_cPa174-cPa118-hybrid_cPa174-cPa125-hybrid_cPa174-cPa140-hybrid_cPa174-cPa15-hybrid_cPa174-cPa264-hybrid_cPa174-cPa404-hybrid_cPa174-cPa425-hybrid_cPa174-cPa47-hybrid_cPa174-unknown_cPa248_cPa264_cPa264-cPa174-hybrid_cPa264-cPa404-hybrid_cPa264-cPa47-hybrid_cPa268_cPa268-cPa118-hybrid_cPa268-cPa125-hybrid_cPa268-cPa15-hybrid_cPa268-cPa174-hybrid_cPa268-cPa254-hybrid_cPa268-cPa404-hybrid_cPa268-cPa425-hybrid_cPa268-cPa443-hybrid_cPa268-cPa47-hybrid_cPa268-cPa516-hybrid_cPa268-unknown_cPa404_cPa404-cPa125-hybrid_cPa404-cPa425-hybrid_cPa404-cPa443-hybrid_cPa404-cPa47-hybrid_cPa404-unknown_cPa425_cPa425-cPa118-hybrid_cPa425-cPa174-hybrid_cPa425-cPa404-hybrid_cPa425-cPa47-hybrid_cPa425-unknown_cPa443_cPa443-cPa125-hybrid_cPa443-cPa404-hybrid_cPa443-cPa47-hybrid_cPa47_cPa47-cPa404-hybrid_cPa47-cPa443-hybrid,31_1_1_2_2_1_26_1_2_1_1_3_4_1_3_1_7_1_1_1_89_1_4_1_1_31_1_1_2_1_10_1_1_35_1_1_5_1_1_46_2_2_1_3_3_14_1_3_3_5_12_1_3_1_26_2_1_2_1_1_8_1_1_1_1_6_37_1_2_2_2_1_14_1_1_6_1_1_62_1_9_2_87_3_2,812,767
Scaffold83-15252_15354,cPa118_cPa140_cPa15,0.333333333333333,3,15341,15302,cPa118_cPa140_cPa15,1_1_1,102,39
Scaffold83-15466_15568,cPa15,0.571428571428571,5,15536,15466,cPa15_cPa268_cPa268-cPa140-hybrid_cPa268-cPa443-hybrid_cPa443,8_1_1_1_3,102,70
Scaffold83-16251_16353,cPa15,1,1,16349,16301,cPa15,2,102,48
Scaffold83-16934_17036,cPa140-cPa339-hybrid,0.454545454545455,4,16996,16966,cPa140-cPa339-hybrid_cPa15-cPa339-hybrid_cPa268-cPa339-hybrid_cPa339-cPa425-hybrid,5_4_1_1,102,30
Scaffold83-17358_17605,cPa339,0.575757575757576,9,17604,17408,cPa140-cPa339-hybrid_cPa268-cPa339-hybrid_cPa315_cPa339_cPa419_cPa419-cPa339-hybrid_cPa75-cPa339-hybrid_HERV30_repbase_HERV30I_LTR30-cPa315-hybrid_HERV30_repbase_HERV30I_LTR30-cPa339-hybrid,4_1_2_19_1_2_1_1_2,247,196
Scaffold83-18554_18736,HERV30_repbase_HERV30I_LTR30-cPa434-hybrid,0.666666666666667,2,18684,18604,BLV_NC001414-cPa434-hybrid_HERV30_repbase_HERV30I_LTR30-cPa434-hybrid,1_2,182,80
Scaffold83-8645_8747,cPa356,1,1,8706,8695,cPa356,2,102,11
Scaffold84-19201_19382,cPa117-unknown_cPa452,0.375,4,19338,19249,cPa117_cPa117-unknown_cPa452_cPa452-unknown,1_3_3_1,181,89
Scaffold849-4073_4175,cPa224-PERV_AJ293656-hybrid,1,1,4123,4109,cPa224-PERV_AJ293656-hybrid,2,102,14
Scaffold849-5380_5482,cPa419,1,1,5430,5430,cPa419,1,102,0
Scaffold849-8304_8542,cPa62,0.787878787878788,6,8508,8350,cPa285_cPa285-cPa379-hybrid_cPa419_cPa62_cPa62-unknown_cPa71,2_1_2_26_1_1,238,158
Scaffold849-8544_8831,cPa62,0.8,4,8779,8554,cPa285_cPa419_cPa62_HERV-F_repbase_HERVFH19I_LTR19A-cPa62-hybrid,8_5_56_1,287,225
Scaffold849-8862_8964,cPa62,0.5,3,8960,8876,cPa419_cPa62_HERV-F_repbase_HERVFH19I_LTR19A-cPa285-hybrid,6_7_1,102,84
Scaffold849-9545_9647,cPa419,0.5,3,9597,9556,cPa419_HERV-F_repbase_HERVFH19I_LTR19A_HERV-F_repbase_HERVFH19I_LTR19A-unknown,2_1_1,102,41
Scaffold85-14351_14870,cPa434,0.543624161073825,6,14865,14351,cPa199-cPa356-hybrid_cPa356_cPa419_cPa434_cPa434-cPa356-hybrid_cPa434-unknown,3_61_1_81_2_1,519,514
Scaffold85-19997_20099,cPa75,0.3,7,20091,20013,cPa127-cPa145-hybrid_cPa127-cPa400-hybrid_cPa127-cPa413-hybrid_cPa527_cPa75_cPa75-cPa356-hybrid_cPa75-unknown,1_2_1_1_3_1_1,102,78
Scaffold85-26976_27104,cPa391,1,1,27089,27008,cPa391,18,128,81
Scaffold85-27601_27844,cPa391,0.423076923076923,8,27792,27628,cPa391_cPa391-cPa459-hybrid_cPa391-unknown_cPa434-cPa391-hybrid_HERV30_repbase_HERV30I_LTR30_HERV30_repbase_HERV30I_LTR30-cPa391-hybrid_HERV30_repbase_HERV30I_LTR30-cPa459-hybrid_HERV30_repbase_HERV30I_LTR30-unknown,11_1_1_1_4_2_2_4,243,164
Scaffold85-30287_30517,cPa67-unknown,0.509433962264151,5,30465,30301,cPa339-cPa67-hybrid_cPa434-cPa67-hybrid_cPa67_cPa67-cPa254-hybrid_cPa67-unknown,3_1_21_1_27,230,164
Scaffold85-3046_3176,cPa248_cPa443,0.235294117647059,10,3161,3057,cPa118-cPa248-hybrid_cPa248_cPa264_cPa264-unknown_cPa434_cPa434-cPa15-hybrid_cPa443_cPa443-unknown_cPa566-cPa15-hybrid_cPa61,1_4_1_1_1_1_4_1_1_2,130,104
Scaffold85-30573_30699,cPa339-unknown,0.58974358974359,7,30693,30599,cPa339_cPa339-cPa254-hybrid_cPa339-cPa67-hybrid_cPa339-unknown_cPa353-unknown_cPa419_cPa67-unknown,2_5_2_23_3_2_2,126,94
Scaffold85-3224_3407,cPa264,0.285714285714286,6,3388,3274,cPa118_cPa125_cPa140_cPa264_cPa566_cPa61,1_1_1_2_1_1,183,114
Scaffold85-33452_33652,cPa67,1,1,33602,33502,cPa67,3,200,100
Scaffold85-33885_34013,cPa67,1,1,33961,33899,cPa67,2,128,62
Scaffold85-35779_35963,cPa67,0.857142857142857,2,35933,35814,cPa15-cPa260-hybrid_cPa67,1_6,184,119
Scaffold85-36041_36220,cPa168-cPa196-hybrid_cPa353-cPa308-hybrid,0.5,2,36168,36091,cPa168-cPa196-hybrid_cPa353-cPa308-hybrid,1_1,179,77
Scaffold85-3795_3942,cPa125_cPa140,0.181818181818182,9,3896,3803,cPa125_cPa140_cPa15_cPa15-cPa395-hybrid_cPa248_cPa264_cPa268_cPa404-cPa566-hybrid_cPa443,2_2_1_1_1_1_1_1_1,147,93
Scaffold85-39054_39156,cPa264,0.4,4,39139,39069,cPa118_cPa118-unknown_cPa15_cPa264,1_1_1_2,102,70
Scaffold85-3943_4045,cPa118,0.230769230769231,11,4041,3992,cPa118_cPa140_cPa15_cPa174_cPa254-cPa425-hybrid_cPa264_cPa264-cPa443-hybrid_cPa419_cPa443_cPa443-cPa419-hybrid_cPa47,3_1_1_1_1_1_1_1_1_1_1,102,49
Scaffold85-39551_39682,cPa118,0.214285714285714,15,39675,39550,cPa118_cPa118-unknown_cPa140-cPa264-hybrid_cPa15-cPa118-hybrid_cPa15-cPa443-hybrid_cPa248_cPa264_cPa443_cPa67_cPa67-cPa118-hybrid_cPa67-cPa140-hybrid_cPa67-cPa248-hybrid_cPa67-cPa264-hybrid_cPa67-cPa443-hybrid_cPa67-unknown,9_2_1_1_1_1_5_3_1_4_2_1_3_5_3,131,125
Scaffold85-4805_5042,cPa125,0.151041666666667,42,5017,4807,cPa118_cPa118-cPa119-hybrid_cPa118-cPa125-hybrid_cPa118-cPa140-hybrid_cPa119_cPa119-cPa254-hybrid_cPa125_cPa125-cPa119-hybrid_cPa125-cPa395-hybrid_cPa125-cPa404-hybrid_cPa140_cPa140-cPa118-hybrid_cPa140-cPa119-hybrid_cPa15_cPa174_cPa174-cPa119-hybrid_cPa248_cPa254_cPa254-cPa119-hybrid_cPa268_cPa268-cPa118-hybrid_cPa268-cPa119-hybrid_cPa268-cPa174-hybrid_cPa268-cPa315-hybrid_cPa268-cPa67-hybrid_cPa268-unknown_cPa353-cPa118-hybrid_cPa404_cPa419_cPa425_cPa425-cPa140-hybrid_cPa425-cPa566-hybrid_cPa434-cPa425-hybrid_cPa443_cPa443-cPa119-hybrid_cPa443-cPa15-hybrid_cPa443-cPa425-hybrid_cPa47_cPa47-cPa119-hybrid_cPa47-cPa140-hybrid_cPa47-cPa566-hybrid_cPa47-unknown,27_1_1_1_3_1_29_1_1_1_10_2_1_17_12_1_1_1_1_12_1_1_1_1_2_2_1_10_1_6_1_1_1_11_3_1_1_14_4_1_2_2,237,210
Scaffold85-5053_5184,cPa118_cPa268,0.2,16,5160,5053,cPa118_cPa118-unknown_cPa119_cPa125_cPa125-cPa174-hybrid_cPa140_cPa15_cPa174_cPa174-cPa118-hybrid_cPa268_cPa268-cPa119-hybrid_cPa419_cPa425_cPa443_cPa443-cPa248-hybrid_cPa47,8_1_1_2_1_2_5_1_1_8_1_1_2_2_1_3,131,107
Scaffold85-5217_5412,cPa125,0.245098039215686,26,5412,5248,cPa118_cPa119_cPa125_cPa140_cPa140-cPa119-hybrid_cPa140-cPa254-hybrid_cPa15_cPa15-cPa425-hybrid_cPa174_cPa174-cPa119-hybrid_cPa268_cPa268-cPa140-hybrid_cPa268-unknown_cPa404-cPa125-hybrid_cPa404-unknown_cPa425_cPa425-cPa119-hybrid_cPa425-cPa140-hybrid_cPa443_cPa443-cPa140-hybrid_cPa443-cPa268-hybrid_cPa443-unknown_cPa47_cPa47-unknown_cPa516_cPa516-cPa109-hybrid,17_6_25_5_1_1_11_1_2_2_5_1_1_1_1_1_1_1_2_1_1_3_9_1_1_1,195,164
Scaffold85-5607_5888,cPa15,0.198473282442748,28,5885,5639,cPa118_cPa118-cPa174-hybrid_cPa118-cPa248-hybrid_cPa119_cPa119-cPa140-hybrid_cPa125_cPa127-cPa425-hybrid_cPa140_cPa140-cPa118-hybrid_cPa15_cPa15-cPa119-hybrid_cPa174_cPa248_cPa254_cPa264-cPa425-hybrid_cPa268_cPa268-cPa118-hybrid_cPa268-cPa119-hybrid_cPa268-cPa254-hybrid_cPa425_cPa425-cPa140-hybrid_cPa443_cPa443-cPa118-hybrid_cPa47_cPa47-cPa15-hybrid_cPa47-cPa174-hybrid_cPa516_cPa516-unknown,25_1_1_7_1_11_1_13_1_26_1_8_1_1_1_11_1_1_1_1_1_1_1_10_1_1_1_1,281,246
Scaffold85-6186_6288,cPa125_cPa15,0.184210526315789,24,6282,6202,cPa118_cPa119_cPa119-unknown_cPa125_cPa125-cPa248-hybrid_cPa140_cPa140-cPa125-hybrid_cPa140-cPa174-hybrid_cPa140-cPa268-hybrid_cPa15_cPa15-unknown_cPa174_cPa248_cPa264-cPa119-hybrid_cPa264-cPa248-hybrid_cPa268_cPa268-cPa119-hybrid_cPa268-cPa140-hybrid_cPa443-unknown_cPa47_cPa516_cPa516-cPa119-hybrid_cPa516-cPa254-hybrid_cPa516-cPa264-hybrid,20_4_1_21_1_11_1_1_1_21_1_2_2_1_1_6_1_1_2_11_1_1_1_1,102,80
Scaffold85-6327_6597,cPa15,0.313725490196078,21,6582,6326,cPa118_cPa119_cPa119-cPa67-hybrid_cPa125_cPa125-cPa140-hybrid_cPa140_cPa15_cPa15-unknown_cPa174_cPa248_cPa254_cPa264_cPa268_cPa268-cPa118-hybrid_cPa268-cPa119-hybrid_cPa268-cPa140-hybrid_cPa404-cPa443-hybrid_cPa443_cPa443-cPa119-hybrid_cPa516_cPa516-unknown,40_4_1_26_2_18_64_2_5_2_1_2_13_1_1_1_1_7_2_10_1,270,256
Scaffold85-6622_6724,cPa15,0.419354838709677,6,6718,6625,cPa118_cPa125_cPa140_cPa15_cPa516_cPa516-unknown,6_7_2_13_2_1,102,93
Scaffold85-7875_7977,cPa15,0.833333333333333,2,7932,7898,cPa118_cPa15,1_5,102,34
Scaffold851-12642_12744,cPa75,1,1,12692,12692,cPa75,1,102,0
Scaffold853-2966_3086,cPa391,0.636363636363636,2,3071,2968,cPa391_cPa391-unknown,14_8,120,103
Scaffold853-3125_3298,cPa391,0.526315789473684,2,3246,3148,cPa391_cPa391-unknown,10_9,173,98
Scaffold853-6864_6966,SFV_U04327-cPa138-hybrid,1,1,6914,6914,SFV_U04327-cPa138-hybrid,1,102,0
Scaffold854-2916_3018,cPa419,0.260869565217391,13,3017,2924,cPa163-cPa357-hybrid_cPa272-cPa15-hybrid_cPa357-cPa228-hybrid_cPa357-KoRV_AF151794-hybrid_cPa391-cPa15-hybrid_cPa419_cPa428_cPa469-cPa15-hybrid_cPa50-cPa118-hybrid_cPa50-cPa15-hybrid_cPa50-cPa75-hybrid_cPa62_cPa75,1_1_1_1_1_6_1_1_1_2_1_5_1,102,93
Scaffold854-3207_3309,cPa177-cPa413-hybrid_cPa419_cPa75,0.333333333333333,3,3308,3257,cPa177-cPa413-hybrid_cPa419_cPa75,1_1_1,102,51
Scaffold854-4493_4595,cPa61,0.590909090909091,8,4589,4497,cPa205_cPa419_cPa61_cPa61-cPa118-hybrid_cPa61-cPa308-hybrid_cPa62_cPa62-cPa15-hybrid_cPa62-cPa308-hybrid,1_1_13_1_2_1_1_2,102,92
Scaffold854-4678_4780,cPa61,0.545454545454545,9,4733,4678,cPa308-cPa75-hybrid_cPa357_cPa357-cPa61-hybrid_cPa357-HERV-W_repbase_HERV17_LTR17-hybrid_cPa419_cPa450-cPa15-hybrid_cPa61_cPa62_cPa75,1_1_2_1_1_1_12_2_1,102,55
Scaffold854-5956_6058,cPa229,1,1,6006,6006,cPa229,1,102,0
Scaffold854-6147_6249,cPa15,0.25,7,6240,6157,cPa15_cPa308-cPa371-hybrid_cPa308-cPa482-hybrid_cPa308-HERV-W_repbase_HERV17_LTR17-hybrid_cPa419_cPa450-cPa199-hybrid_cPa61-cPa443-hybrid,2_1_1_1_1_1_1,102,83
Scaffold854-7364_7486,cPa254-cPa447-hybrid_cPa308_cPa61-cPa469-hybrid,0.333333333333333,3,7434,7404,cPa254-cPa447-hybrid_cPa308_cPa61-cPa469-hybrid,1_1_1,122,30
Scaffold854-819_921,cPa308-cPa339-hybrid_cPa419_cPa419-cPa339-hybrid_cPa472-cPa505-hybrid_cPa62-cPa357-hybrid,0.2,5,916,865,cPa308-cPa339-hybrid_cPa419_cPa419-cPa339-hybrid_cPa472-cPa505-hybrid_cPa62-cPa357-hybrid,1_1_1_1_1,102,51
Scaffold854-8554_8776,cPa447-cPa543-hybrid,0.5,3,8724,8601,cPa447_cPa447-cPa526-hybrid_cPa447-cPa543-hybrid,1_1_2,222,123
Scaffold854-940_1097,cPa357,0.473684210526316,10,1096,945,cPa113-cPa308-hybrid_cPa113-cPa339-hybrid_cPa113-cPa357-hybrid_cPa113-SnRV_NC001724-hybrid_cPa308_cPa308-cPa339-hybrid_cPa308-cPa505-hybrid_cPa357_cPa419_cPa419-cPa109-hybrid,1_2_1_1_1_1_1_9_1_1,157,151
Scaffold855-5839_5941,cPa163,0.625,5,5935,5840,cPa163_cPa224-cPa360-hybrid_cPa224-unknown_cPa254_cPa419,15_2_2_1_4,102,95
Scaffold855-5942_6395,cPa163,0.61046511627907,18,6365,5961,cPa152-cPa360-hybrid_cPa163_cPa224_cPa224-cPa163-hybrid_cPa224-cPa254-hybrid_cPa224-cPa285-hybrid_cPa224-cPa360-hybrid_cPa224-cPa419-hybrid_cPa224-unknown_cPa254_cPa358_cPa358-cPa163-hybrid_cPa360_cPa391_cPa419_cPa502-cPa360-hybrid_cPa62_cPa62-cPa360-hybrid,1_105_10_5_1_1_6_1_15_1_4_1_5_1_11_1_2_1,453,404
Scaffold855-613_924,cPa199,0.204022988505747,32,907,654,cPa199_cPa205-cPa223-hybrid_cPa223_cPa227_cPa227-cPa223-hybrid_cPa227-cPa450-hybrid_cPa227-cPa542-hybrid_cPa273_cPa273-cPa223-hybrid_cPa273-cPa450-hybrid_cPa273-cPa542-hybrid_cPa273-cPa553-hybrid_cPa345_cPa345-cPa199-hybrid_cPa345-cPa223-hybrid_cPa345-cPa227-hybrid_cPa345-cPa419-hybrid_cPa345-cPa450-hybrid_cPa345-cPa542-hybrid_cPa345-cPa553-hybrid_cPa419_cPa450_cPa450-cPa199-hybrid_cPa542_cPa542-cPa223-hybrid_cPa542-cPa273-hybrid_cPa542-cPa450-hybrid_cPa542-cPa553-hybrid_cPa553_cPa553-cPa223-hybrid_cPa553-cPa450-hybrid_HERV-R_repbase_HERV3_LTR4-HERV-Fb_repbase_HERVH48I_MER48-hybrid,142_1_3_136_10_1_1_26_15_5_4_5_95_1_10_1_1_3_1_1_5_117_1_31_17_1_1_2_56_1_1_1,311,253
Scaffold855-8706_9040,HML2_Pheonix,0.615686274509804,32,9038,8721,cPa125_cPa16-cPa71-hybrid_cPa176-cPa223-hybrid_cPa223-cPa71-hybrid_cPa254_cPa254-HML2_repbase_HERVK_LTR5-hybrid_cPa264_cPa285_cPa419_cPa419-cPa71-hybrid_cPa428_cPa446-cPa264-hybrid_cPa446-cPa71-hybrid_cPa446-REV_NC006934-hybrid_cPa456-cPa254-hybrid_cPa456-cPa71-hybrid_cPa502-cPa254-hybrid_cPa502-cPa71-hybrid_cPa62_cPa71_HERV-I_repbase_HERVI_LTR10B-cPa71-hybrid_HML2_Pheonix_HML2_Pheonix-cPa125-hybrid_HML2_Pheonix-cPa163-hybrid_HML2_Pheonix-cPa254-hybrid_HML2_Pheonix-cPa424-hybrid_HML2_Pheonix-cPa71-hybrid_HML2_Pheonix-HFV_NC001736-hybrid_HML2_Pheonix-REV_NC006934-hybrid_HML2_Pheonix-unknown_REV_NC006934_SMRV_NC001514-cPa125-hybrid,7_1_1_1_1_1_1_1_15_2_1_1_1_1_1_2_1_2_1_8_1_157_3_1_3_1_17_1_1_17_2_1,334,317
Scaffold856-1066_1168,cPa247-unknown,0.5,4,1133,1110,cPa247-cPa223-hybrid_cPa247-unknown_cPa425_cPa425-cPa208-hybrid,1_3_1_1,102,23
Scaffold856-2362_2464,FeLV_NC001940-STLV2_NC001815-hybrid,1,1,2412,2412,FeLV_NC001940-STLV2_NC001815-hybrid,1,102,0
Scaffold856-734_836,cPa247,1,1,784,784,cPa247,1,102,0
Scaffold857-2069_2192,cPa356,0.777777777777778,2,2140,2119,cPa356_cPa428,7_2,123,21
Scaffold857-2590_2692,cPa356,1,1,2640,2640,cPa356,1,102,0
Scaffold857-8258_8362,cPa356,0.666666666666667,2,8316,8275,cPa356_cPa428,6_3,104,41
Scaffold857-8392_8509,cPa356,0.636363636363636,2,8473,8423,cPa356_cPa428,7_4,117,50
Scaffold857-8786_8888,cPa356,1,1,8850,8836,cPa356,5,102,14
Scaffold857-8978_9080,cPa356_cPa428,0.5,2,9028,9028,cPa356_cPa428,1_1,102,0
Scaffold86-10449_10801,BFV_NC001831-unknown,0.257575757575758,12,10769,10499,BFV_NC001831-cPa205-hybrid_BFV_NC001831-HML8_repbase_HERVK11I_MER11A-hybrid_BFV_NC001831-unknown_cPa113-cPa205-hybrid_cPa182-cPa205-hybrid_cPa182-unknown_cPa273_cPa273-cPa205-hybrid_cPa273-unknown_cPa434-cPa205-hybrid_HML3_repbase_HERVK9I_MER9-cPa205-hybrid_S71_repbase_HERVS71_LTR6A-cPa205-hybrid,11_4_17_2_2_5_5_4_9_5_1_1,352,270
Scaffold86-12015_12150,cPa113-unknown,0.583333333333333,6,12098,12065,CAEV_NC001463-cPa205-hybrid_cPa113_cPa113-HML8_repbase_HERVK11I_MER11A-hybrid_cPa113-unknown_cPa413-cPa205-hybrid_cPa413-HML8_repbase_HERVK11I_MER11A-hybrid,2_2_1_14_3_2,135,33
Scaffold86-12218_12320,cPa113,0.75,2,12272,12267,cPa113_cPa18-unknown,3_1,102,5
Scaffold86-14865_14967,cPa356,0.777777777777778,3,14915,14866,cPa356_cPa356-unknown_cPa447-unknown,7_1_1,102,49
Scaffold86-15682_15784,cPa118-cPa107-hybrid_cPa434-cPa381-hybrid_cPa443-cPa107-hybrid,0.333333333333333,3,15732,15690,cPa118-cPa107-hybrid_cPa434-cPa381-hybrid_cPa443-cPa107-hybrid,1_1_1,102,42
Scaffold86-6726_6828,cPa391,0.6,2,6779,6745,cPa391_cPa413-cPa391-hybrid,3_2,102,34
Scaffold860-3691_3793,cPa419,1,1,3741,3741,cPa419,1,102,0
Scaffold860-4581_4828,cPa419,1,1,4828,4631,cPa419,14,247,197
Scaffold860-6961_7063,cPa419,1,1,7018,7011,cPa419,2,102,7
Scaffold864-11552_11654,cPa47,0.5,3,11621,11561,cPa174_cPa254-cPa404-hybrid_cPa47,1_1_2,102,60
Scaffold864-11903_12011,cPa47,0.714285714285714,3,11972,11930,cPa404_cPa425_cPa47,1_1_5,108,42
Scaffold864-1820_1924,cPa400-unknown_KoRV_AF151794-cPa486-hybrid,0.5,2,1872,1870,cPa400-unknown_KoRV_AF151794-cPa486-hybrid,1_1,104,2
Scaffold864-2026_2169,cPa486,0.56,14,2117,2048,cPa400-cPa387-hybrid_cPa400-cPa486-hybrid_cPa400-unknown_cPa419_cPa486_cPa486-cPa387-hybrid_cPa486-cPa542-hybrid_cPa521-cPa308-hybrid_cPa526-cPa308-hybrid_cPa526-cPa387-hybrid_cPa526-cPa486-hybrid_cPa542_HML4_repbase_HERVK13I_LTR13-cPa356-hybrid_KoRV_AF151794-cPa387-hybrid,4_1_1_1_28_2_1_1_1_1_1_5_1_2,143,69
Scaffold864-5055_5394,cPa391,0.541666666666667,11,5384,5066,cPa298_cPa298-cPa447-hybrid_cPa298-unknown_cPa298-VISNA_S55323-hybrid_cPa391_cPa391-cPa298-hybrid_cPa391-cPa447-hybrid_cPa391-cPa469-hybrid_cPa391-unknown_cPa391-VISNA_S55323-hybrid_MoMLV_J02255-VISNA_S55323-hybrid,43_3_2_2_104_4_7_1_16_9_1,339,318
Scaffold864-5557_5659,cPa391,0.866666666666667,2,5659,5566,cPa298_cPa391,2_13,102,93
Scaffold864-8721_8823,cPa308-cPa400-hybrid_cPa308-S71_repbase_HERVS71_LTR6A-hybrid,0.5,2,8771,8745,cPa308-cPa400-hybrid_cPa308-S71_repbase_HERVS71_LTR6A-hybrid,1_1,102,26
Scaffold865-10537_10685,cPa356,1,1,10649,10587,cPa356,3,148,62
Scaffold865-9758_9860,cPa356,1,1,9819,9808,cPa356,2,102,11
Scaffold866-1308_1873,cPa285,0.551724137931034,4,1828,1358,cPa285_cPa285-unknown_cPa293_cPa293-unknown,16_1_11_1,565,470
Scaffold867-5825_5927,cPa419_SMRV_NC001514-cPa456-hybrid,0.5,2,5876,5875,cPa419_SMRV_NC001514-cPa456-hybrid,1_1,102,1
Scaffold867-6127_6229,SMRV_NC001514-cPa456-hybrid,0.333333333333333,5,6183,6153,cPa357_cPa419_cPa465-cPa456-hybrid_cPa583-cPa413-hybrid_SMRV_NC001514-cPa456-hybrid,1_1_1_1_2,102,30
Scaffold867-9029_9375,cPa413,0.5,6,9323,9049,cPa285-cPa345-hybrid_cPa285-cPa456-hybrid_cPa315-cPa345-hybrid_cPa345_cPa413_cPa419,2_3_1_3_10_1,346,274
Scaffold868-5861_5963,cPa356,1,1,5911,5911,cPa356,1,102,0
Scaffold868-6138_6240,cPa428,0.666666666666667,2,6215,6188,cPa356_cPa428,1_2,102,27
Scaffold868-7229_7331,cPa428,0.666666666666667,2,7279,7236,cPa356_cPa428,1_2,102,43
Scaffold869-10442_10634,cPa434,0.967741935483871,2,10602,10443,cPa419_cPa434,1_30,192,159
Scaffold869-10645_10900,cPa434,0.833333333333333,3,10848,10651,cPa14_cPa434_MSFV_NC010819,1_10_1,255,197
Scaffold869-11313_11434,cPa434,1,1,11382,11363,cPa434,2,121,19
Scaffold869-11814_11950,cPa434,1,1,11943,11832,cPa434,13,136,111
Scaffold869-6603_6793,cPa434,1,1,6779,6640,cPa434,5,190,139
Scaffold869-7400_7502,cPa434,1,1,7479,7418,cPa434,34,102,61
Scaffold869-8180_8354,cPa434,1,1,8321,8193,cPa434,67,174,128
Scaffold869-8434_8554,cPa434,1,1,8552,8441,cPa434,28,120,111
Scaffold869-8567_8669,cPa434,1,1,8618,8617,cPa434,2,102,1
Scaffold869-9922_10024,cPa434,1,1,9972,9937,cPa434,6,102,35
Scaffold87-15008_15407,cPa391,0.669117647058823,25,15397,15021,cPa199_cPa298_cPa298-cPa104-hybrid_cPa298-cPa107-hybrid_cPa298-cPa199-hybrid_cPa298-cPa220-hybrid_cPa298-cPa345-hybrid_cPa298-cPa419-hybrid_cPa298-MLV_Xmv43-hybrid_cPa298-unknown_cPa345-cPa391-hybrid_cPa391_cPa391-cPa345-hybrid_cPa391-unknown_cPa419-cPa107-hybrid_cPa475-cPa104-hybrid_cPa475-cPa199-hybrid_cPa475-cPa220-hybrid_cPa475-cPa345-hybrid_cPa475-cPa419-hybrid_cPa475-unknown_FIV_NC001482-cPa104-hybrid_FIV_NC001482-cPa220-hybrid_FIV_NC001482-unknown_HTLV2_M10060-cPa199-hybrid,12_20_3_1_4_1_1_1_1_19_1_182_2_2_1_7_5_2_1_1_1_1_1_1_1,399,376
Scaffold87-22582_22684,cPa413-JSRV_DQ838494-hybrid_cPa413-unknown,0.5,2,22632,22591,cPa413-JSRV_DQ838494-hybrid_cPa413-unknown,1_1,102,41
Scaffold87-31745_31949,cPa434,0.8125,4,31915,31781,cPa434_cPa447-EqFV_NC002201-hybrid_cPa566_cPa566-cPa356-hybrid,26_2_3_1,204,134
Scaffold87-32121_32328,cPa434,0.823529411764706,4,32326,32168,cPa434_cPa447-EqFV_NC002201-hybrid_cPa566_PtERV1_AC142352-cPa356-hybrid,14_1_1_1,207,158
Scaffold87-32369_32586,cPa434,0.564705882352941,6,32584,32377,cPa356_cPa434_cPa447-cPa356-hybrid_cPa447-cPa566-hybrid_cPa447-EqFV_NC002201-hybrid_cPa566,29_48_1_1_2_4,217,207
Scaffold87-35992_36094,cPa75,1,1,36042,36042,cPa75,1,102,0
Scaffold87-38904_39075,cPa42-unknown,0.238095238095238,11,39023,38909,cPa182-GaLV_M26927-hybrid_cPa273-cPa380-hybrid_cPa42-GaLV_M26927-hybrid_cPa42-unknown_cPa446-cPa75-hybrid_cPa446-GaLV_M26927-hybrid_cPa446-S71_repbase_HERVS71_LTR6A-hybrid_cPa585-cPa75-hybrid_cPa585-GaLV_M26927-hybrid_cPa585-unknown_GaLV_M26927,1_2_1_5_2_3_1_1_2_1_2,171,114
Scaffold87-39516_39628,cPa400-GaLV_M26927-hybrid,0.4375,13,39577,39565,BFV_NC001831-cPa380-hybrid_BFV_NC001831-GaLV_M26927-hybrid_cPa15-GaLV_M26927-hybrid_cPa273-cPa380-hybrid_cPa400-GaLV_M26927-hybrid_cPa419_cPa42-cPa167-hybrid_cPa42-cPa379-hybrid_cPa42-S71_repbase_HERVS71_LTR6A-hybrid_cPa446_cPa446-cPa167-hybrid_cPa446-cPa387-hybrid_cPa585-cPa379-hybrid,4_1_1_1_14_1_2_2_2_1_1_1_1,112,12
Scaffold87-39742_39844,cPa42-cPa387-hybrid,1,1,39792,39792,cPa42-cPa387-hybrid,1,102,0
Scaffold87-40088_40190,BFV_NC001831-GaLV_M26927-hybrid,0.25,9,40186,40134,BFV_NC001831-cPa380-hybrid_BFV_NC001831-GaLV_M26927-hybrid_cPa118-cPa380-hybrid_cPa118-GaLV_M26927-hybrid_cPa182-cPa380-hybrid_cPa273-GaLV_M26927-hybrid_cPa42-cPa379-hybrid_cPa446-cPa167-hybrid_cPa585-S71_repbase_HERVS71_LTR6A-hybrid,1_3_1_1_1_1_2_1_1,102,52
Scaffold87-41355_41457,HERV30_repbase_HERV30I_LTR30_Xen1_AJ506107-cPa434-hybrid,0.5,2,41423,41405,HERV30_repbase_HERV30I_LTR30_Xen1_AJ506107-cPa434-hybrid,1_1,102,18
Scaffold87-49741_49844,cPa145,0.933333333333333,2,49803,49741,cPa145_cPa413-cPa145-hybrid,14_1,103,62
Scaffold87-49901_50003,cPa145,1,1,49983,49951,cPa145,4,102,32
Scaffold87-56688_56794,cPa492-cPa356-hybrid_cPa492-HERV-Fb_repbase_HERVH48I_MER48-hybrid,0.5,2,56742,56738,cPa492-cPa356-hybrid_cPa492-HERV-Fb_repbase_HERVH48I_MER48-hybrid,1_1,106,4
Scaffold87-59432_60044,cPa492-cPa387-hybrid,0.328358208955224,11,59992,59482,cPa117-cPa486-hybrid_cPa168-cPa486-hybrid_cPa290-cPa486-hybrid_cPa387_cPa400-cPa387-hybrid_cPa469-cPa486-hybrid_cPa492-cPa15-hybrid_cPa492-cPa356-hybrid_cPa492-cPa387-hybrid_cPa492-cPa486-hybrid_cPa492-unknown,1_13_4_2_4_1_1_2_22_13_4,612,510
Scaffold87-60129_60231,SFV_U04327-unknown,0.4,4,60224,60129,cPa168-cPa486-hybrid_HFV_NC001736-cPa387-hybrid_SFV_U04327-cPa515-hybrid_SFV_U04327-unknown,1_1_1_2,102,95
Scaffold87-68108_68210,cPa391,0.28,7,68206,68111,cPa298_cPa391_cPa449-cPa391-hybrid_cPa492-cPa391-hybrid_HIV1_NC001802-cPa298-hybrid_HIV1_NC001802-cPa391-hybrid_HIV1_NC001802-unknown,6_7_2_1_1_5_3,102,95
Scaffold87-68532_68634,HIV1_NC001802-cPa18-hybrid,1,1,68582,68582,HIV1_NC001802-cPa18-hybrid,1,102,0
Scaffold87-71400_71502,cPa356,1,1,71450,71450,cPa356,1,102,0
Scaffold87-79120_79271,cPa434,0.75609756097561,5,79237,79120,cPa356_cPa356-cPa566-hybrid_cPa356-unknown_cPa434_cPa447-cPa400-hybrid,5_2_2_31_1,151,117
Scaffold87-79408_79542,cPa434,0.785714285714286,4,79537,79458,cPa356-cPa444-hybrid_cPa356-unknown_cPa434_cPa443,1_1_11_1,134,79
Scaffold87-80007_80109,cPa434,1,1,80109,80023,cPa434,21,102,86
Scaffold87-81278_81395,cPa145,0.4,4,81343,81312,cPa145_cPa145-cPa566-hybrid_cPa145-unknown_cPa150-cPa400-hybrid,2_1_1_1,117,31
Scaffold87-92868_92995,cPa268,0.409090909090909,7,92985,92918,cPa268_cPa268-unknown_cPa425_cPa47_cPa47-cPa174-hybrid_cPa47-cPa254-hybrid_cPa47-unknown,18_1_3_6_1_1_14,127,67
Scaffold871-1739_1841,cPa434,0.777777777777778,3,1808,1768,cPa400-cPa118-hybrid_cPa434_HERV-E_repbase_HERVE_LTR2-cPa118-hybrid,1_7_1,102,40
Scaffold871-1900_2129,cPa434,0.833333333333333,7,2100,1950,cPa177-cPa118-hybrid_cPa400-cPa117-hybrid_cPa400-cPa443-hybrid_cPa434_cPa566_cPa60-cPa118-hybrid_cPa75-cPa118-hybrid,2_1_3_45_1_1_1,229,150
Scaffold871-4104_4229,cPa568,0.5,3,4177,4126,cPa193_cPa193-cPa568-hybrid_cPa568,2_1_3,125,51
Scaffold871-7595_7697,cPa543-cPa516-hybrid,1,1,7645,7628,cPa543-cPa516-hybrid,2,102,17
Scaffold871-787_889,cPa434,0.736842105263158,5,887,790,cPa434_cPa434-unknown_cPa456-cPa118-hybrid_HIV1_NC001802_HIV1_NC001802-cPa118-hybrid,14_1_1_2_1,102,97
Scaffold871-8659_8761,cPa127,1,1,8709,8709,cPa127,1,102,0
Scaffold872-3768_3870,cPa419,1,1,3818,3818,cPa419,1,102,0
Scaffold872-4081_4183,cPa419,1,1,4178,4131,cPa419,5,102,47
Scaffold872-4242_4344,cPa419,1,1,4292,4292,cPa419,1,102,0
Scaffold872-4411_4513,cPa419,1,1,4461,4461,cPa419,1,102,0
Scaffold874-11841_12255,cPa47,0.264084507042254,42,12203,11843,cPa16_cPa174_cPa199-cPa174-hybrid_cPa199-cPa254-hybrid_cPa199-cPa392-hybrid_cPa199-cPa404-hybrid_cPa254_cPa254-cPa174-hybrid_cPa254-cPa273-hybrid_cPa254-cPa447-hybrid_cPa254-cPa553-hybrid_cPa254-unknown_cPa392_cPa392-cPa273-hybrid_cPa404_cPa404-cPa553-hybrid_cPa419_cPa425_cPa425-cPa174-hybrid_cPa425-cPa254-hybrid_cPa425-cPa273-hybrid_cPa425-cPa339-hybrid_cPa425-cPa404-hybrid_cPa425-cPa447-hybrid_cPa425-cPa450-hybrid_cPa425-cPa553-hybrid_cPa428_cPa47_cPa47-cPa16-hybrid_cPa47-cPa174-hybrid_cPa47-cPa254-hybrid_cPa47-cPa273-hybrid_cPa47-cPa339-hybrid_cPa47-cPa392-hybrid_cPa47-cPa404-hybrid_cPa47-cPa447-hybrid_cPa47-cPa450-hybrid_cPa47-cPa553-hybrid_cPa581-cPa392-hybrid_cPa583-cPa174-hybrid_cPa583-cPa254-hybrid_HML8_repbase_HERVK11I_MER11A-cPa174-hybrid,1_6_4_3_1_2_52_4_3_1_2_1_4_2_1_1_11_3_9_3_20_4_2_2_1_2_2_75_1_21_8_13_3_2_1_1_3_4_1_2_1_1,414,360
Scaffold874-12298_12400,cPa47,0.30952380952381,13,12400,12324,cPa16-cPa404-hybrid_cPa174_cPa199-cPa254-hybrid_cPa199-cPa404-hybrid_cPa254_cPa394-cPa392-hybrid_cPa404_cPa419_cPa425_cPa425-cPa392-hybrid_cPa47_cPa47-cPa339-hybrid_cPa62,2_1_4_4_7_1_3_3_1_1_13_1_1,102,76
Scaffold874-12559_12709,cPa47-cPa339-hybrid,0.191011235955056,23,12698,12588,cPa254_cPa254-cPa174-hybrid_cPa254-cPa339-hybrid_cPa254-cPa390-hybrid_cPa272-cPa174-hybrid_cPa356_cPa379-cPa447-hybrid_cPa392-cPa339-hybrid_cPa394-cPa339-hybrid_cPa404-cPa419-hybrid_cPa419_cPa419-cPa254-hybrid_cPa419-cPa273-hybrid_cPa425-cPa339-hybrid_cPa425-cPa390-hybrid_cPa425-cPa447-hybrid_cPa425-cPa62-hybrid_cPa428_cPa47-cPa339-hybrid_cPa47-cPa390-hybrid_cPa47-cPa447-hybrid_cPa47-cPa62-hybrid_HML8_repbase_HERVK11I_MER11A-cPa339-hybrid,3_1_7_2_1_1_1_1_1_1_10_1_1_13_2_3_1_1_17_7_12_1_1,150,110
Scaffold874-12854_12956,cPa47-cPa339-hybrid,0.307692307692308,8,12935,12884,cPa21-cPa392-hybrid_cPa254-cPa339-hybrid_cPa254-cPa447-hybrid_cPa381-cPa404-hybrid_cPa419_cPa425-cPa339-hybrid_cPa47-cPa339-hybrid_cPa47-cPa447-hybrid,1_1_1_1_1_2_4_2,102,51
Scaffold874-2578_2776,cPa75,0.545454545454545,6,2724,2609,cPa152-cPa71-hybrid_cPa293_cPa62-cPa581-hybrid_cPa62-HERV-W_repbase_HERV17_LTR17-hybrid_cPa62-unknown_cPa75,1_1_1_1_1_6,198,115
Scaffold874-2803_3049,cPa75,0.378378378378378,13,2997,2812,BFV_NC001831-HERV-W_repbase_HERV17_LTR17-hybrid_cPa109-cPa581-hybrid_cPa152-cPa581-hybrid_cPa152-HERV-W_repbase_HERV17_LTR17-hybrid_cPa505-cPa293-hybrid_cPa505-cPa581-hybrid_cPa62_cPa62-cPa581-hybrid_cPa62-cPa71-hybrid_cPa62-unknown_cPa75_cPa75-cPa581-hybrid_cPa75-unknown,1_1_1_1_1_3_4_1_1_3_14_2_4,246,185
Scaffold874-3160_3333,cPa62,0.333333333333333,5,3281,3210,cPa62_cPa62-cPa581-hybrid_cPa75_HERV-W_repbase_HERV17_LTR17_MPMVs_NC001550-cPa419-hybrid,2_1_1_1_1,173,71
Scaffold874-3390_3508,cPa75_cPa75-cPa62-hybrid,0.5,2,3456,3440,cPa75_cPa75-cPa62-hybrid,1_1,118,16
Scaffold874-4008_4110,cPa62,0.571428571428571,3,4078,4048,cPa356_cPa62_cPa75-cPa62-hybrid,1_8_5,102,30
Scaffold874-4716_4904,cPa546,0.25,10,4852,4738,cPa260_cPa546_cPa62_cPa62-cPa260-hybrid_cPa62-HERV-W_repbase_HERV17_LTR17-hybrid_cPa75_cPa75-cPa260-hybrid_cPa75-cPa581-hybrid_cPa75-SMRV_NC001514-hybrid_cPa75-unknown,3_6_1_1_1_4_2_1_2_3,188,114
Scaffold874-4956_5129,cPa546_cPa62-cPa260-hybrid_cPa62-SMRV_NC001514-hybrid_cPa75-cPa260-hybrid_cPa75-unknown_HERV-W_repbase_HERV17_LTR17,0.166666666666667,6,5077,5006,cPa546_cPa62-cPa260-hybrid_cPa62-SMRV_NC001514-hybrid_cPa75-cPa260-hybrid_cPa75-unknown_HERV-W_repbase_HERV17_LTR17,1_1_1_1_1_1,173,71
Scaffold874-5183_5340,cPa546_cPa75-SMRV_NC001514-hybrid,0.5,2,5288,5233,cPa546_cPa75-SMRV_NC001514-hybrid,1_1,157,55
Scaffold874-9991_10375,cPa542,0.183800623052959,50,10364,9999,cPa16-cPa273-hybrid_cPa16-cPa450-hybrid_cPa16-cPa553-hybrid_cPa199_cPa199-cPa16-hybrid_cPa199-cPa174-hybrid_cPa199-cPa254-hybrid_cPa199-cPa273-hybrid_cPa199-cPa345-hybrid_cPa199-cPa419-hybrid_cPa199-cPa450-hybrid_cPa199-cPa542-hybrid_cPa199-cPa553-hybrid_cPa199-cPa62-hybrid_cPa199-HML6_repbase_HERVK3I_LTR3-hybrid_cPa223-cPa419-hybrid_cPa223-cPa62-hybrid_cPa254_cPa254-cPa542-hybrid_cPa273_cPa345_cPa345-cPa273-hybrid_cPa345-cPa553-hybrid_cPa345-cPa62-hybrid_cPa356_cPa379-cPa553-hybrid_cPa404-cPa450-hybrid_cPa419_cPa419-cPa553-hybrid_cPa425-cPa273-hybrid_cPa425-cPa450-hybrid_cPa425-cPa542-hybrid_cPa428_cPa450_cPa450-cPa273-hybrid_cPa450-cPa542-hybrid_cPa47-cPa273-hybrid_cPa47-cPa345-hybrid_cPa47-cPa450-hybrid_cPa47-cPa553-hybrid_cPa542_cPa542-cPa254-hybrid_cPa542-cPa273-hybrid_cPa542-cPa345-hybrid_cPa542-cPa450-hybrid_cPa542-cPa553-hybrid_cPa542-cPa62-hybrid_cPa542-HML6_repbase_HERVK3I_LTR3-hybrid_cPa553_HML6_repbase_HERVK3I_LTR3,2_1_1_29_1_2_1_54_1_1_16_4_15_3_2_1_1_3_1_1_11_8_1_1_1_1_1_12_1_2_1_1_1_32_1_1_2_1_8_6_59_1_11_1_2_2_1_1_9_1,384,365
Scaffold875-1049_1151,cPa47-cPa356-hybrid,1,1,1099,1099,cPa47-cPa356-hybrid,1,102,0
Scaffold875-9230_9332,S71_repbase_HERVS71_LTR6A,1,1,9280,9280,S71_repbase_HERVS71_LTR6A,1,102,0
Scaffold875-9506_9608,cPa75,0.75,2,9594,9546,cPa419_cPa75,1_3,102,48
Scaffold876-10417_10519,cPa419,1,1,10497,10430,cPa419,11,102,67
Scaffold876-11014_11232,cPa419,1,1,11194,11043,cPa419,9,218,151
Scaffold879-6754_6864,cPa419,1,1,6812,6804,cPa419,2,110,8
Scaffold88-10504_10606,KWERV_GQ222416-cPa42-hybrid,1,1,10554,10554,KWERV_GQ222416-cPa42-hybrid,1,102,0
Scaffold88-14276_14436,cPa391,0.944444444444444,4,14392,14326,cPa199_cPa391_cPa500-cPa293-hybrid_cPa543-cPa298-hybrid,1_51_1_1,160,66
Scaffold88-6606_6712,BLV_NC001414,0.875,2,6660,6656,BLV_NC001414_BLV_NC001414-unknown,7_1,106,4
Scaffold881-11071_11173,cPa356_cPa428,0.5,2,11121,11121,cPa356_cPa428,1_1,102,0
Scaffold881-8270_8375,cPa356,0.555555555555556,2,8323,8281,cPa356_cPa428,5_4,105,42
Scaffold882-11257_11359,cPa419,1,1,11307,11307,cPa419,1,102,0
Scaffold882-2422_2524,cPa428,1,1,2472,2472,cPa428,1,102,0
Scaffold882-2643_2745,cPa356_cPa428,0.5,2,2693,2676,cPa356_cPa428,1_1,102,17
Scaffold882-4121_4380,cPa428,0.613636363636364,2,4380,4148,cPa356_cPa428,17_27,259,232
Scaffold882-4801_4903,cPa356,0.571428571428571,2,4902,4800,cPa356_cPa428,20_15,102,102
Scaffold882-5081_5183,cPa356,0.52,2,5171,5083,cPa356_cPa428,13_12,102,88
Scaffold882-5227_5329,cPa428,0.7,2,5328,5234,cPa356_cPa428,3_7,102,94
Scaffold882-6044_6206,cPa428,0.615384615384615,2,6205,6056,cPa356_cPa428,5_8,162,149
Scaffold882-6648_6750,cPa356,0.551724137931034,2,6747,6652,cPa356_cPa428,16_13,102,95
Scaffold882-7128_7240,cPa428,0.571428571428571,2,7218,7133,cPa356_cPa428,12_16,112,85
Scaffold882-8826_8928,cPa419,1,1,8876,8876,cPa419,1,102,0
Scaffold882-8948_9107,cPa419,1,1,9055,8998,cPa419,3,159,57
Scaffold883-6820_6922,cPa428,0.625,2,6904,6870,cPa356_cPa428,3_5,102,34
Scaffold883-7247_7376,cPa356,0.529411764705882,2,7349,7247,cPa356_cPa428,9_8,129,102
Scaffold883-7378_7480,cPa428,0.5625,2,7479,7428,cPa356_cPa428,7_9,102,51
Scaffold883-7873_7975,cPa428,0.571428571428571,2,7969,7873,cPa356_cPa428,15_20,102,96
Scaffold883-8024_8137,cPa428,0.555555555555556,2,8135,8043,cPa356_cPa428,4_5,113,92
Scaffold883-8154_8374,cPa356,0.523809523809524,2,8354,8186,cPa356_cPa428,22_20,220,168
Scaffold883-8453_8555,cPa356_cPa428,0.5,2,8551,8457,cPa356_cPa428,9_9,102,94
Scaffold883-8632_8814,cPa356_cPa428,0.5,2,8762,8631,cPa356_cPa428,11_11,182,131
Scaffold883-9000_9161,cPa428,0.525,3,9109,9013,cPa356_cPa428_cPa428-cPa356-hybrid,18_21_1,161,96
Scaffold883-9574_9676,cPa428,0.533333333333333,2,9670,9624,cPa356_cPa428,14_16,102,46
Scaffold884-10969_11071,cPa419,1,1,11028,10983,cPa419,10,102,45
Scaffold884-11361_11463,cPa419,1,1,11411,11398,cPa419,2,102,13
Scaffold884-4280_4382,cPa419,1,1,4330,4330,cPa419,1,102,0
Scaffold884-6218_6320,cPa419,1,1,6269,6255,cPa419,9,102,14
Scaffold885-1139_1241,cPa419,1,1,1199,1188,cPa419,7,102,11
Scaffold885-1368_1479,cPa419,1,1,1470,1371,cPa419,7,111,99
Scaffold885-1695_1830,cPa419,1,1,1813,1701,cPa419,18,135,112
Scaffold885-2308_2410,cPa419,1,1,2407,2330,cPa419,7,102,77
Scaffold885-4198_4300,cPa419,1,1,4276,4246,cPa419,4,102,30
Scaffold885-4448_4550,cPa419,1,1,4498,4498,cPa419,1,102,0
Scaffold885-5229_5331,cPa419,1,1,5279,5279,cPa419,1,102,0
Scaffold885-6040_6142,cPa419,1,1,6090,6090,cPa419,1,102,0
Scaffold886-10029_10131,cPa428,0.625,2,10124,10033,cPa356_cPa428,3_5,102,91
Scaffold886-11779_11886,cPa419,1,1,11837,11829,cPa419,7,107,8
Scaffold886-2560_2662,cPa356,1,1,2610,2610,cPa356,1,102,0
Scaffold886-3729_3831,cPa356,0.571428571428571,2,3796,3730,cPa356_cPa428,8_6,102,66
Scaffold886-4068_4170,cPa428,0.6,2,4133,4118,cPa356_cPa428,2_3,102,15
Scaffold886-4292_4493,cPa356,0.6,2,4450,4311,cPa356_cPa428,15_10,201,139
Scaffold886-6548_6650,cPa356,0.625,2,6610,6586,cPa356_cPa428,5_3,102,24
Scaffold886-8048_8157,cPa428,0.509433962264151,2,8156,8071,cPa356_cPa428,26_27,109,85
Scaffold886-8783_9258,cPa428,0.565217391304348,2,9207,8794,cPa356_cPa428,20_26,475,413
Scaffold886-9544_9646,cPa356,0.6,2,9642,9546,cPa356_cPa428,6_4,102,96
Scaffold887-11693_11795,cPa587-CAEV_NC001463-hybrid_cPa587-cPa199-hybrid,0.5,2,11743,11702,cPa587-CAEV_NC001463-hybrid_cPa587-cPa199-hybrid,1_1,102,41
Scaffold887-11852_11954,cPa392-CAEV_NC001463-hybrid,1,1,11902,11902,cPa392-CAEV_NC001463-hybrid,1,102,0
Scaffold887-2149_2382,cPa426,0.314285714285714,16,2382,2199,cPa130-cPa287-hybrid_cPa257-cPa130-hybrid_cPa257-cPa287-hybrid_cPa293_cPa293-cPa130-hybrid_cPa293-unknown_cPa391_cPa391-cPa130-hybrid_cPa391-cPa287-hybrid_cPa391-cPa426-hybrid_cPa391-cPa435-hybrid_cPa426_cPa426-cPa287-hybrid_cPa426-cPa293-hybrid_cPa435-cPa293-hybrid_cPa60,1_1_1_5_1_1_2_2_1_1_1_11_1_1_1_4,233,183
Scaffold887-8732_8834,cPa308,0.615384615384615,5,8829,8782,cPa257-unknown_cPa308_cPa308-cPa228-hybrid_cPa546_cPa60,1_8_2_1_1,102,47
Scaffold887-9041_9143,cPa308,0.916666666666667,2,9091,9046,cPa308_cPa308-cPa228-hybrid,11_1,102,45
Scaffold888-3935_4037,cPa62,0.666666666666667,2,4002,3982,cPa360_cPa62,1_2,102,20
Scaffold89-1094_1224,cPa425,0.636363636363636,5,1172,1116,cPa174-cPa254-hybrid_cPa174-cPa425-hybrid_cPa254_cPa254-cPa404-hybrid_cPa425,1_1_5_1_14,130,56
Scaffold89-1446_1548,cPa391_cPa391-cPa425-hybrid_cPa425-cPa298-hybrid,0.333333333333333,3,1517,1487,cPa391_cPa391-cPa425-hybrid_cPa425-cPa298-hybrid,1_1_1,102,30
Scaffold89-1707_1809,cPa391,0.909090909090909,2,1808,1728,cPa391_cPa391-unknown,10_1,102,80
Scaffold89-1965_2262,cPa391,1,1,2246,2015,cPa391,18,297,231
Scaffold89-659_761,cPa425,0.428571428571429,4,716,690,cPa254_cPa254-cPa425-hybrid_cPa404-unknown_cPa425,2_1_1_3,102,26
Scaffold89-814_968,cPa425,0.441176470588235,6,916,864,cPa174_cPa174-cPa298-hybrid_cPa254_cPa254-cPa425-hybrid_cPa254-unknown_cPa425,1_1_14_1_2_15,154,52
Scaffold890-1896_1998,cPa419,1,1,1946,1946,cPa419,1,102,0
Scaffold890-2645_2837,cPa419,1,1,2837,2695,cPa419,4,192,142
Scaffold890-4305_4495,cPa419,1,1,4462,4313,cPa419,11,190,149
Scaffold890-4631_4733,cPa419,1,1,4684,4681,cPa419,2,102,3
Scaffold890-5906_6008,cPa419,1,1,6004,5956,cPa419,12,102,48
Scaffold890-8439_8541,cPa419,1,1,8489,8473,cPa419,3,102,16
Scaffold890-9010_9112,cPa419,1,1,9063,9042,cPa419,3,102,21
Scaffold892-9997_10132,cPa404-cPa127-hybrid_cPa472-cPa469-hybrid,0.5,2,10080,10047,cPa404-cPa127-hybrid_cPa472-cPa469-hybrid,1_1,135,33
Scaffold893-10306_10408,cPa298-cPa260-hybrid,1,1,10356,10356,cPa298-cPa260-hybrid,1,102,0
Scaffold893-11154_11262,cPa298-cPa260-hybrid,0.833333333333333,2,11253,11185,cPa298-cPa260-hybrid_cPa585-cPa391-hybrid,5_1,108,68
Scaffold894-1812_1914,cPa67,1,1,1907,1815,cPa67,20,102,92
Scaffold894-8738_8840,cPa459,0.3,6,8808,8748,cPa260_cPa260-cPa409-hybrid_cPa305_cPa424_cPa439-cPa260-hybrid_cPa459,2_1_2_1_1_3,102,60
Scaffold895-5364_5532,cPa428,0.523809523809524,2,5499,5366,cPa356_cPa428,20_22,168,133
Scaffold895-6042_6203,cPa428,0.538461538461538,3,6172,6092,cPa356_cPa419_cPa428,5_1_7,161,80
Scaffold896-1670_1772,cPa391,0.769230769230769,3,1762,1713,cPa107-cPa419-hybrid_cPa391_cPa391-unknown,1_10_2,102,49
Scaffold896-1872_1974,cPa391-unknown,1,1,1922,1900,cPa391-unknown,2,102,22
Scaffold896-7976_8078,PERVC_HM159246,1,1,8063,8026,PERVC_HM159246,3,102,37
Scaffold90-13965_14067,cPa425-cPa199-hybrid_cPa425-unknown,0.5,2,14015,13999,cPa425-cPa199-hybrid_cPa425-unknown,1_1,102,16
Scaffold90-24960_25062,cPa434,1,1,25010,25010,cPa434,1,102,0
Scaffold90-26404_26506,cPa333,0.666666666666667,2,26490,26454,cPa333_cPa95-unknown,2_1,102,36
Scaffold90-27704_27806,cPa333-S71_repbase_HERVS71_LTR6A-hybrid,1,1,27757,27754,cPa333-S71_repbase_HERVS71_LTR6A-hybrid,3,102,3
Scaffold90-38582_38684,cPa447,0.818181818181818,3,38676,38603,cPa447_cPa449-cPa15-hybrid_cPa449-unknown,9_1_1,102,73
Scaffold90-39322_39487,cPa447,0.789189189189189,24,39468,39322,cPa118-cPa549-hybrid_cPa228-cPa527-hybrid_cPa254-cPa452-hybrid_cPa254-cPa549-hybrid_cPa339-cPa402-hybrid_cPa357-cPa228-hybrid_cPa357-cPa402-hybrid_cPa419_cPa425-cPa549-hybrid_cPa447_cPa447-unknown_cPa449-cPa290-hybrid_cPa449-cPa515-hybrid_cPa449-cPa549-hybrid_cPa47-cPa117-hybrid_cPa482-cPa75-hybrid_cPa515-cPa527-hybrid_cPa581-cPa113-hybrid_cPa581-cPa117-hybrid_cPa581-cPa15-hybrid_cPa581-cPa363-hybrid_cPa581-cPa452-hybrid_cPa581-cPa527-hybrid_cPa581-cPa549-hybrid,1_1_2_1_2_1_1_6_1_146_2_2_1_1_1_1_1_1_3_1_2_3_2_2,165,146
Scaffold90-39734_40022,cPa447,0.52,18,39970,39759,BaEV_D10032-cPa290-hybrid_cPa118-cPa290-hybrid_cPa15_cPa15-cPa285-hybrid_cPa228_cPa254-cPa228-hybrid_cPa254-cPa75-hybrid_cPa357-cPa75-hybrid_cPa419_cPa447_cPa515_cPa515-cPa391-hybrid_cPa515-cPa527-hybrid_cPa581-cPa248-hybrid_cPa581-cPa402-hybrid_cPa581-cPa527-hybrid_cPa581-cPa549-hybrid_cPa581-cPa75-hybrid,1_1_1_1_1_1_1_1_4_26_3_1_3_1_1_1_1_1,288,211
Scaffold90-40048_40168,cPa515,0.384615384615385,6,40145,40051,cPa15-cPa290-hybrid_cPa228_cPa285_cPa339-cPa515-hybrid_cPa515_cPa515-cPa290-hybrid,1_3_1_1_5_2,120,94
Scaffold90-40170_40289,cPa515,0.272727272727273,12,40246,40175,cPa15-cPa402-hybrid_cPa228-cPa290-hybrid_cPa254-cPa290-hybrid_cPa285_cPa419_cPa482-cPa75-hybrid_cPa515_cPa515-cPa290-hybrid_cPa581_cPa581-cPa290-hybrid_cPa581-cPa75-hybrid_cPa581-unknown,1_1_1_1_1_1_6_5_1_2_1_1,119,71
Scaffold90-40315_40417,cPa515,1,1,40365,40365,cPa515,2,102,0
Scaffold90-42198_42300,cPa339-cPa75-hybrid,0.375,5,42258,42237,cPa15-cPa452-hybrid_cPa339-cPa174-hybrid_cPa339-cPa75-hybrid_cPa357-cPa228-hybrid_cPa357-cPa75-hybrid,1_1_3_1_2,102,21
Scaffold90-42423_43003,cPa357,0.373056994818653,12,42951,42425,cPa323-unknown_cPa339_cPa339-cPa117-hybrid_cPa339-cPa16-hybrid_cPa339-cPa452-hybrid_cPa339-unknown_cPa357_cPa357-cPa339-hybrid_cPa357-cPa452-hybrid_cPa357-cPa75-hybrid_cPa357-unknown_cPa419,1_69_3_1_2_18_72_1_1_1_23_1,580,526
Scaffold90-4392_4495,cPa357,0.833333333333333,2,4482,4401,cPa357_cPa395-unknown,5_1,103,81
Scaffold90-4671_4773,cPa357,1,1,4721,4721,cPa357,1,102,0
Scaffold90-50919_51025,cPa107,1,1,50973,50933,cPa107,6,106,40
Scaffold90-58047_58176,cPa434-cPa67-hybrid,0.454545454545455,3,58124,58094,cPa434_cPa434-cPa67-hybrid_HML1a_repbase_HERV-K14CI_LTR14C-cPa67-hybrid,2_5_4,129,30
Scaffold90-58531_58655,cPa434-cPa67-hybrid,1,1,58603,58581,cPa434-cPa67-hybrid,2,124,22
Scaffold90-58921_59123,HML1a_repbase_HERV-K14CI_LTR14C-cPa67-hybrid,0.529411764705882,6,59071,58971,cPa434-cPa16-hybrid_cPa434-cPa67-hybrid_cPa434-HERV30_repbase_HERV30I_LTR30-hybrid_HFV_NC001736-cPa67-hybrid_HML1a_repbase_HERV-K14CI_LTR14C-cPa67-hybrid_HML4_repbase_HERVK13I_LTR13-cPa67-hybrid,1_4_1_1_9_1,202,100
Scaffold90-59551_59653,cPa14-HERV30_repbase_HERV30I_LTR30-hybrid_cPa273-BLV_NC001414-hybrid_cPa273-cPa419-hybrid_cPa446-HERV30_repbase_HERV30I_LTR30-hybrid,0.25,4,59614,59587,cPa14-HERV30_repbase_HERV30I_LTR30-hybrid_cPa273-BLV_NC001414-hybrid_cPa273-cPa419-hybrid_cPa446-HERV30_repbase_HERV30I_LTR30-hybrid,1_1_1_1,102,27
Scaffold90-61568_61812,cPa42-unknown,0.666666666666667,4,61767,61618,cPa42-cPa273-hybrid_cPa42-cPa67-hybrid_cPa42-HERV30_repbase_HERV30I_LTR30-hybrid_cPa42-unknown,1_1_1_6,244,149
Scaffold90-64558_64668,cPa356_cPa447,0.5,2,64618,64559,cPa356_cPa447,11_11,110,59
Scaffold90-64929_65031,cPa356,1,1,64979,64979,cPa356,1,102,0
Scaffold90-71964_72073,cPa75-HERV-Fb_repbase_HERVH48I_MER48-hybrid,0.666666666666667,2,72021,71991,cPa75-cPa201-hybrid_cPa75-HERV-Fb_repbase_HERVH48I_MER48-hybrid,1_2,109,30
Scaffold90-72225_72522,cPa75-HERV-Fb_repbase_HERVH48I_MER48-hybrid,0.666666666666667,4,72470,72242,cPa75_cPa75-cPa201-hybrid_cPa75-cPa356-hybrid_cPa75-HERV-Fb_repbase_HERVH48I_MER48-hybrid,2_1_2_10,297,228
Scaffold90-72679_72851,cPa75-HERV-Fb_repbase_HERVH48I_MER48-hybrid,0.571428571428571,2,72844,72729,cPa75-cPa356-hybrid_cPa75-HERV-Fb_repbase_HERVH48I_MER48-hybrid,3_4,172,115
Scaffold90-7486_7608,cPa452-cPa75-hybrid,0.666666666666667,2,7600,7536,cPa452-cPa75-hybrid_cPa521,2_1,122,64
Scaffold90-7609_7919,cPa75,0.303030303030303,15,7894,7610,cPa335-cPa411-hybrid_cPa335-cPa521-hybrid_cPa335-cPa75-hybrid_cPa339-cPa411-hybrid_cPa363-cPa411-hybrid_cPa447-cPa521-hybrid_cPa447-cPa75-hybrid_cPa452-cPa356-hybrid_cPa452-cPa411-hybrid_cPa452-cPa521-hybrid_cPa452-cPa75-hybrid_cPa452-unknown_cPa521_cPa62-cPa75-hybrid_cPa75,5_3_2_1_1_1_3_1_7_2_3_1_14_2_20,310,284
Scaffold90-8261_8363,cPa521,0.666666666666667,2,8325,8311,cPa521_cPa75,2_1,102,14
Scaffold901-11100_11202,cPa447,1,1,11150,11150,cPa447,1,102,0
Scaffold901-5625_5769,cPa95,0.363636363636364,4,5756,5669,cPa356-cPa145-hybrid_cPa356-cPa95-hybrid_cPa413-cPa95-hybrid_cPa95,1_3_3_4,144,87
Scaffold901-6452_6624,cPa413_cPa413-cPa95-hybrid,0.166666666666667,11,6610,6492,cPa356-cPa145-hybrid_cPa395_cPa413_cPa413-cPa168-hybrid_cPa413-cPa241-hybrid_cPa413-cPa434-hybrid_cPa413-cPa95-hybrid_cPa413-unknown_cPa572-cPa168-hybrid_cPa572-cPa241-hybrid_cPa572-cPa95-hybrid,1_2_3_1_2_1_3_2_1_1_1,172,118
Scaffold901-6637_6929,cPa413-unknown,0.285714285714286,10,6877,6645,cPa145_cPa381-cPa95-hybrid_cPa413-cPa145-hybrid_cPa413-cPa434-hybrid_cPa413-unknown_cPa419_cPa463-cPa95-hybrid_cPa539-cPa95-hybrid_cPa572_cPa572-unknown,8_1_5_3_10_1_1_1_4_1,292,232
Scaffold902-11895_12027,cPa434,1,1,11975,11945,cPa434,20,132,30
Scaffold903-7705_8176,cPa75,0.259259259259259,19,8140,7755,cPa117-cPa216-hybrid_cPa117-cPa71-hybrid_cPa117-cPa75-hybrid_cPa117-HERV-W_repbase_HERV17_LTR17-hybrid_cPa117-unknown_cPa193-cPa75-hybrid_cPa216_cPa434-cPa152-hybrid_cPa434-cPa71-hybrid_cPa434-cPa75-hybrid_cPa434-HERV-W_repbase_HERV17_LTR17-hybrid_cPa543-cPa75-hybrid_cPa71_cPa75_GaLV_M26927_GaLV_M26927-cPa152-hybrid_GaLV_M26927-HERV-W_repbase_HERV17_LTR17-hybrid_HERV-W_repbase_HERV17_LTR17_KWERV_GQ222416,2_1_11_1_3_2_2_1_1_5_2_1_1_14_1_1_1_3_1,471,385
Scaffold903-9878_10054,cPa434,0.6,3,10010,9911,cPa193-cPa425-hybrid_cPa434_cPa543-cPa392-hybrid,1_3_1,176,99
Scaffold904-1949_2143,cPa428,0.55,2,2120,1983,cPa356_cPa428,9_11,194,137
Scaffold905-1988_2108,cPa419,1,1,2088,2033,cPa419,10,120,55
Scaffold905-2916_3018,cPa419,1,1,3005,2966,cPa419,3,102,39
Scaffold905-4861_4963,cPa419,1,1,4911,4907,cPa419,3,102,4
Scaffold905-5172_5274,cPa419,1,1,5222,5187,cPa419,3,102,35
Scaffold905-5321_5423,cPa419,1,1,5371,5371,cPa419,1,102,0
Scaffold905-5516_5618,cPa419,1,1,5574,5562,cPa419,4,102,12
Scaffold905-7244_7346,cPa419,1,1,7294,7294,cPa419,1,102,0
Scaffold906-2307_2409,cPa356_cPa428,0.5,2,2357,2343,cPa356_cPa428,1_1,102,14
Scaffold906-2519_2621,cPa356_cPa428,0.5,2,2603,2569,cPa356_cPa428,4_4,102,34
Scaffold906-3585_3687,cPa356_cPa428,0.5,2,3670,3594,cPa356_cPa428,5_5,102,76
Scaffold906-6166_6268,cPa356,0.666666666666667,2,6235,6216,cPa356_cPa428,2_1,102,19
Scaffold906-6693_6869,cPa428,0.525773195876289,2,6869,6692,cPa356_cPa428,46_51,176,177
Scaffold906-7386_7488,cPa356,0.571428571428571,2,7484,7390,cPa356_cPa428,8_6,102,94
Scaffold907-4348_4450,cPa75,1,1,4427,4398,cPa75,3,102,29
Scaffold908-1091_1207,cPa356,0.6,2,1155,1109,cPa356_cPa428,3_2,116,46
Scaffold908-1350_1471,cPa428,0.652173913043478,2,1428,1365,cPa356_cPa428,8_15,121,63
Scaffold908-2012_2114,cPa356_cPa428,0.5,2,2062,2055,cPa356_cPa428,3_3,102,7
Scaffold908-2598_2700,cPa356_cPa428,0.5,2,2648,2648,cPa356_cPa428,1_1,102,0
Scaffold908-3538_3640,cPa428,1,1,3616,3588,cPa428,3,102,28
Scaffold908-3880_3982,cPa428,1,1,3930,3930,cPa428,1,102,0
Scaffold908-4677_4779,cPa428,0.615384615384615,2,4750,4676,cPa356_cPa428,5_8,102,74
Scaffold908-5524_5768,cPa428,0.564102564102564,3,5757,5573,cPa356_cPa419_cPa428,16_1_22,244,184
Scaffold908-6100_6330,cPa428,0.578947368421053,2,6330,6100,cPa356_cPa428,8_11,230,230
Scaffold908-6366_6468,cPa428,0.7,2,6454,6383,cPa356_cPa428,3_7,102,71
Scaffold908-6488_6699,cPa428,0.569444444444444,3,6680,6496,cPa356_cPa356-cPa428-hybrid_cPa428,30_1_41,211,184
Scaffold908-6839_6968,cPa428,0.625,2,6961,6844,cPa356_cPa428,9_15,129,117
Scaffold909-10256_10371,cPa254,0.666666666666667,2,10319,10306,cPa118-cPa254-hybrid_cPa254,1_2,115,13
Scaffold909-10455_10557,cPa254,1,1,10505,10505,cPa254,1,102,0
Scaffold909-10594_10697,cPa425,0.35,12,10696,10644,cPa223-cPa254-hybrid_cPa223-cPa47-hybrid_cPa254_cPa285-cPa254-hybrid_cPa285-cPa47-hybrid_cPa392-cPa174-hybrid_cPa425_cPa566-cPa254-hybrid_cPa566-cPa47-hybrid_cPa75-cPa254-hybrid_cPa75-cPa47-hybrid_REV_NC006934-cPa254-hybrid,2_2_1_1_1_1_7_1_1_1_1_1,103,52
Scaffold909-1365_1521,cPa475,0.544444444444444,27,1469,1378,cPa16_cPa16-cPa104-hybrid_cPa16-cPa298-hybrid_cPa16-cPa333-hybrid_cPa16-HERV-E_repbase_HERVE_LTR2-hybrid_cPa227-cPa298-hybrid_cPa273-cPa298-hybrid_cPa273-cPa390-hybrid_cPa298_cPa391-cPa515-hybrid_cPa391-cPa553-hybrid_cPa391-S71_repbase_HERVS71_LTR6A-hybrid_cPa456_cPa475_cPa515-cPa298-hybrid_REV_NC006934_REV_NC006934-cPa298-hybrid_REV_NC006934-cPa333-hybrid_REV_NC006934-cPa391-hybrid_REV_NC006934-cPa475-hybrid_REV_NC006934-cPa515-hybrid_REV_NC006934-cPa543-hybrid_REV_NC006934-cPa553-hybrid_REV_NC006934-HERV-E_repbase_HERVE_LTR2-hybrid_REV_NC006934-MSEV_CT990572-hybrid_REV_NC006934-S71_repbase_HERVS71_LTR6A-hybrid_REV_NC006934-unknown,1_1_2_1_1_1_1_1_1_1_1_1_1_49_1_4_9_1_1_1_1_1_2_2_1_1_2,156,91
Scaffold909-1546_1883,cPa475,0.447368421052632,20,1867,1573,cPa16-cPa298-hybrid_cPa16-cPa391-hybrid_cPa298_cPa391_cPa391-cPa298-hybrid_cPa391-cPa390-hybrid_cPa391-cPa475-hybrid_cPa391-cPa515-hybrid_cPa391-S71_repbase_HERVS71_LTR6A-hybrid_cPa391-unknown_cPa475_cPa475-cPa298-hybrid_cPa475-unknown_cPa500-cPa475-hybrid_cPa553-cPa260-hybrid_REV_NC006934_REV_NC006934-cPa104-hybrid_REV_NC006934-cPa298-hybrid_REV_NC006934-cPa475-hybrid_REV_NC006934-unknown,1_1_7_59_2_1_3_2_2_11_102_1_4_1_1_3_1_14_9_3,337,294
Scaffold909-5432_5833,cPa67,1,1,5829,5431,cPa67,45,401,398
Scaffold909-6612_6830,cPa67-cPa425-hybrid,0.8,2,6778,6662,cPa447-cPa339-hybrid_cPa67-cPa425-hybrid,1_4,218,116
Scaffold909-7033_7166,cPa67-cPa425-hybrid,0.358024691358025,24,7162,7081,cPa118-cPa425-hybrid_cPa118-cPa587-hybrid_cPa190-cPa425-hybrid_cPa190-HERV-XA34_repbase_HERVFH21I_LTR21A-hybrid_cPa339-cPa425-hybrid_cPa356_cPa443-cPa425-hybrid_cPa443-HML4_repbase_HERVK13I_LTR13-hybrid_cPa447_cPa447-HERV-XA34_repbase_HERVFH21I_LTR21A-hybrid_cPa545-cPa425-hybrid_cPa566-cPa425-hybrid_cPa575-cPa425-hybrid_cPa67-CAEV_NC001463-hybrid_cPa67-cPa381-hybrid_cPa67-cPa425-hybrid_cPa67-cPa486-hybrid_cPa67-cPa544-hybrid_cPa67-HERV-F_repbase_HERVFH19I_LTR19A-hybrid_cPa67-HERV-XA34_repbase_HERVFH21I_LTR21A-hybrid_cPa67-HML4_repbase_HERVK13I_LTR13-hybrid_cPa67-S71_repbase_HERVS71_LTR6A-hybrid_cPa67-unknown_cPa81-HML4_repbase_HERVK13I_LTR13-hybrid,3_1_2_1_1_13_1_1_2_1_1_3_1_2_1_29_1_1_3_7_2_1_2_1,133,81
Scaffold909-7731_7889,cPa356,0.409502262443439,39,7863,7731,cPa118-CAEV_NC001463-hybrid_cPa118-cPa425-hybrid_cPa118-cPa486-hybrid_cPa118-cPa544-hybrid_cPa190-CAEV_NC001463-hybrid_cPa190-cPa381-hybrid_cPa190-cPa425-hybrid_cPa190-HERV-XA34_repbase_HERVFH21I_LTR21A-hybrid_cPa190-HML4_repbase_HERVK13I_LTR13-hybrid_cPa356_cPa434_cPa434-cPa425-hybrid_cPa434-HERV-F_repbase_HERVFH19I_LTR19A-hybrid_cPa434-HERV-XA34_repbase_HERVFH21I_LTR21A-hybrid_cPa434-HML4_repbase_HERVK13I_LTR13-hybrid_cPa443_cPa443-CAEV_NC001463-hybrid_cPa443-cPa425-hybrid_cPa447_cPa447-cPa339-hybrid_cPa447-cPa425-hybrid_cPa447-cPa434-hybrid_cPa447-HERV-XA34_repbase_HERVFH21I_LTR21A-hybrid_cPa447-HML4_repbase_HERVK13I_LTR13-hybrid_cPa447-S71_repbase_HERVS71_LTR6A-hybrid_cPa447-unknown_cPa545-cPa353-hybrid_cPa545-cPa425-hybrid_cPa545-cPa434-hybrid_cPa545-HML4_repbase_HERVK13I_LTR13-hybrid_cPa566-cPa425-hybrid_cPa566-cPa447-hybrid_cPa566-HERV-XA34_repbase_HERVFH21I_LTR21A-hybrid_cPa566-HML4_repbase_HERVK13I_LTR13-hybrid_cPa575_cPa575-cPa425-hybrid_cPa575-cPa587-hybrid_cPa575-S71_repbase_HERVS71_LTR6A-hybrid_cPa67-cPa434-hybrid,1_38_1_2_1_1_14_1_1_181_24_9_1_2_3_1_1_11_92_1_8_2_1_1_1_1_1_11_1_1_17_1_1_2_2_1_1_1_2,158,132
Scaffold909-8524_8626,cPa434,0.75,2,8577,8550,cPa434_cPa566,6_2,102,27
Scaffold909-8678_8780,cPa434_cPa566-cPa254-hybrid,0.4,3,8745,8681,cPa434_cPa566_cPa566-cPa254-hybrid,4_2_4,102,64
Scaffold91-1209_1352,cPa67,1,1,1304,1224,cPa67,8,143,80
Scaffold91-13054_13156,cPa168,0.5,3,13151,13060,cPa168_cPa216-cPa469-hybrid_cPa472-cPa168-hybrid,2_1_1,102,91
Scaffold91-13259_13361,cPa168_cPa472-cPa168-hybrid,0.5,2,13344,13309,cPa168_cPa472-cPa168-hybrid,2_2,102,35
Scaffold91-1443_1675,cPa67,1,1,1649,1475,cPa67,19,232,174
Scaffold91-15364_15469,cPa75,0.333333333333333,14,15450,15371,cPa356-cPa492-hybrid_cPa75_cPa75-cPa118-hybrid_cPa75-cPa15-hybrid_cPa75-cPa168-hybrid_cPa75-cPa220-hybrid_cPa75-unknown_JSRV_DQ838494-cPa118-hybrid_JSRV_DQ838494-cPa15-hybrid_JSRV_DQ838494-cPa168-hybrid_JSRV_DQ838494-cPa443-hybrid_JSRV_DQ838494-HERVHcons-hybrid_Xen1_AJ506107-cPa118-hybrid_Xen1_AJ506107-cPa15-hybrid,1_14_1_1_2_1_1_13_3_1_1_1_1_1,105,79
Scaffold91-15751_15853,JSRV_DQ838494-HERV-XA34_repbase_HERVFH21I_LTR21A-hybrid,1,1,15801,15801,JSRV_DQ838494-HERV-XA34_repbase_HERVFH21I_LTR21A-hybrid,1,102,0
Scaffold91-16152_16254,cPa16-HERVHcons-hybrid,1,1,16202,16202,cPa16-HERVHcons-hybrid,1,102,0
Scaffold91-18967_19069,cPa413-unknown,1,1,19017,19017,cPa413-unknown,1,102,0
Scaffold91-19900_20002,cPa381-unknown,1,1,19984,19950,cPa381-unknown,3,102,34
Scaffold91-8292_8394,cPa391,1,1,8342,8342,cPa391,2,102,0
Scaffold91-8546_8648,cPa391,1,1,8596,8555,cPa391,8,102,41
Scaffold910-1424_1576,cPa358,0.521739130434783,4,1575,1454,cPa251_cPa358_cPa358-cPa251-hybrid_cPa358-unknown,9_12_1_1,152,121
Scaffold910-399_501,cPa251,1,1,449,449,cPa251,1,102,0
Scaffold910-6444_6546,cPa332-cPa363-hybrid_cPa419_cPa449-cPa363-hybrid_cPa456-cPa176-hybrid,0.25,4,6520,6494,cPa332-cPa363-hybrid_cPa419_cPa449-cPa363-hybrid_cPa456-cPa176-hybrid,1_1_1_1,102,26
Scaffold912-3168_3270,cPa75,1,1,3218,3218,cPa75,1,102,0
Scaffold913-8495_8597,cPa62,0.5,3,8566,8509,cPa254-cPa62-hybrid_cPa62_HIV1_NC001802-cPa62-hybrid,1_2_1,102,57
Scaffold914-10560_10662,cPa391,0.666666666666667,4,10652,10610,cPa298-cPa220-hybrid_cPa298-cPa257-hybrid_cPa391_cPa434-cPa391-hybrid,1_2_8_1,102,42
Scaffold914-2256_2421,cPa62-cPa362-hybrid,0.307692307692308,8,2370,2261,cPa145-cPa572-hybrid_cPa413-cPa356-hybrid_cPa413-cPa572-hybrid_cPa419-cPa333-hybrid_cPa62-cPa333-hybrid_cPa62-cPa362-hybrid_cPa62-HERV-W_repbase_HERV17_LTR17-hybrid_HML1b_repbase_HERV-K14I_LTR14A-cPa362-hybrid,1_1_1_1_2_4_1_2,165,109
Scaffold914-9601_9827,cPa391,0.553846153846154,7,9779,9645,cPa298-cPa104-hybrid_cPa298-cPa220-hybrid_cPa298-cPa257-hybrid_cPa298-cPa391-hybrid_cPa391_cPa391-cPa104-hybrid_HFV_NC001736-cPa257-hybrid,7_4_10_3_36_3_2,226,134
Scaffold919-8217_8319,cPa428,1,1,8267,8267,cPa428,1,102,0
Scaffold92-4463_4690,cPa413-cPa145-hybrid,0.6,2,4649,4513,cPa413-cPa145-hybrid_cPa50-cPa145-hybrid,3_2,227,136
Scaffold92-4838_4958,cPa413-cPa145-hybrid,0.666666666666667,2,4906,4888,cPa413-cPa145-hybrid_cPa50-cPa145-hybrid,2_1,120,18
Scaffold92-4972_5074,cPa413-cPa145-hybrid,1,1,5022,5012,cPa413-cPa145-hybrid,3,102,10
Scaffold921-7148_7255,KoRV_AF151794-unknown,0.36,8,7213,7198,cPa302-cPa447-hybrid_cPa339-cPa447-hybrid_cPa339-RELIK_ERVK-hybrid_KoRV_AF151794-cPa302-hybrid_KoRV_AF151794-cPa447-hybrid_KoRV_AF151794-cPa502-hybrid_KoRV_AF151794-unknown_PyERV_AF500296-cPa101-hybrid,2_3_1_6_1_2_9_1,107,15
Scaffold921-7501_7603,cPa502,1,1,7551,7543,cPa502,2,102,8
Scaffold921-8135_8261,cPa502,1,1,8250,8136,cPa502,17,126,114
Scaffold922-6577_6679,cPa18-cPa391-hybrid,1,1,6627,6627,cPa18-cPa391-hybrid,1,102,0
Scaffold922-7227_7329,cPa391,0.5,3,7327,7277,cPa18-cPa391-hybrid_cPa391_cPa419,1_2_1,102,50
Scaffold923-6411_6588,cPa150,0.197916666666667,36,6536,6419,cPa131_cPa131-cPa216-hybrid_cPa131-cPa255-hybrid_cPa150_cPa150-cPa131-hybrid_cPa150-cPa18-hybrid_cPa150-cPa216-hybrid_cPa246-cPa216-hybrid_cPa246-cPa302-hybrid_cPa255_cPa255-cPa302-hybrid_cPa302_cPa315_cPa438_cPa438-cPa18-hybrid_cPa438-cPa526-hybrid_cPa463_cPa463-cPa216-hybrid_cPa478_cPa478-cPa216-hybrid_cPa478-cPa302-hybrid_cPa478-cPa315-hybrid_cPa478-cPa4-hybrid_cPa478-cPa563-hybrid_cPa479_cPa479-cPa150-hybrid_cPa479-cPa216-hybrid_cPa479-cPa246-hybrid_cPa479-unknown_cPa526_cPa526-cPa216-hybrid_cPa529_cPa529-cPa216-hybrid_cPa563_cPa563-cPa131-hybrid_cPa563-cPa216-hybrid,19_4_1_38_1_1_3_1_1_1_1_3_1_4_1_1_2_3_28_2_1_1_1_1_28_1_1_1_1_28_1_1_1_7_1_1,177,117
Scaffold923-7552_7696,cPa563,0.27906976744186,17,7644,7575,cPa131_cPa131-cPa563-hybrid_cPa131-unknown_cPa150-cPa563-hybrid_cPa246_cPa246-cPa541-hybrid_cPa255_cPa302_cPa438_cPa463-cPa255-hybrid_cPa478_cPa478-unknown_cPa479-cPa255-hybrid_cPa526_cPa529_cPa529-cPa216-hybrid_cPa563,1_1_1_1_1_1_2_2_1_1_4_1_1_2_10_1_12,144,69
Scaffold923-7778_7985,cPa479,0.132075471698113,23,7946,7828,cPa104-cPa541-hybrid_cPa131_cPa131-cPa18-hybrid_cPa150-cPa529-hybrid_cPa150-cPa541-hybrid_cPa246-cPa216-hybrid_cPa246-cPa563-hybrid_cPa255_cPa255-cPa18-hybrid_cPa302-cPa255-hybrid_cPa438-cPa255-hybrid_cPa463-cPa18-hybrid_cPa478_cPa478-cPa18-hybrid_cPa478-cPa529-hybrid_cPa478-unknown_cPa479_cPa526_cPa529_cPa529-cPa18-hybrid_cPa529-unknown_cPa563_cPa563-unknown,1_2_3_1_1_1_1_4_1_1_1_1_4_3_2_2_7_5_5_1_2_3_1,207,118
Scaffold923-7997_8099,cPa463-cPa18-hybrid,0.25,7,8047,8014,cPa216_cPa463-cPa18-hybrid_cPa463-cPa541-hybrid_cPa478_cPa478-cPa18-hybrid_cPa529-cPa255-hybrid_cPa563,1_2_1_1_1_1_1,102,33
Scaffold925-4937_5039,cPa75,1,1,4987,4987,cPa75,1,102,0
Scaffold925-5138_5240,cPa75,1,1,5188,5188,cPa75,1,102,0
Scaffold925-5258_5441,cPa75,1,1,5393,5308,cPa75,7,183,85
Scaffold927-2996_3098,cPa419,1,1,3046,3046,cPa419,1,102,0
Scaffold927-8678_8792,cPa419,1,1,8748,8728,cPa419,15,114,20
Scaffold928-9651_9763,cPa356,0.53125,2,9718,9695,cPa356_cPa428,17_15,112,23
Scaffold928-9898_10042,cPa428,0.515151515151515,2,9997,9940,cPa356_cPa428,16_17,144,57
Scaffold929-10242_10562,HERVHcons-cPa75-hybrid,0.711864406779661,5,10557,10292,cPa356-cPa75-hybrid_cPa75_HERV-E_repbase_HERVE_LTR2-cPa75-hybrid_HERVHcons-cPa75-hybrid_HERVHcons-unknown,12_3_1_42_1,320,265
Scaffold929-5014_5182,cPa118-cPa539-hybrid,0.666666666666667,2,5130,5064,cPa118-cPa539-hybrid_cPa15-cPa539-hybrid,2_1,168,66
Scaffold93-10770_10910,cPa257-cPa434-hybrid_cPa447-cPa434-hybrid,0.391304347826087,6,10907,10769,cPa257-cPa434-hybrid_cPa356-cPa434-hybrid_cPa356-unknown_cPa419_cPa447_cPa447-cPa434-hybrid,9_1_1_1_2_9,140,138
Scaffold93-10949_11060,cPa257-cPa434-hybrid,1,1,11008,10999,cPa257-cPa434-hybrid,2,111,9
Scaffold93-11201_11317,cPa447-cPa434-hybrid,0.666666666666667,2,11284,11251,cPa257-cPa434-hybrid_cPa447-cPa434-hybrid,1_2,116,33
Scaffold93-11393_11512,cPa447-cPa434-hybrid,0.5,3,11460,11421,cPa257-cPa434-hybrid_cPa257-PtERV1_AC142352-hybrid_cPa447-cPa434-hybrid,3_1_4,119,39
Scaffold93-12105_12207,cPa257-cPa434-hybrid,1,1,12155,12155,cPa257-cPa434-hybrid,1,102,0
Scaffold93-16922_17042,cPa145-cPa413-hybrid,0.619047619047619,3,17004,16964,cPa121-cPa413-hybrid_cPa145_cPa145-cPa413-hybrid,4_4_13,120,40
Scaffold93-17045_17254,cPa145-cPa413-hybrid,0.526315789473684,4,17207,17095,cPa121-cPa413-hybrid_cPa145_cPa145-cPa413-hybrid_cPa543-cPa413-hybrid,5_3_10_1,209,112
Scaffold93-4575_4677,cPa530-cPa145-hybrid,1,1,4625,4625,cPa530-cPa145-hybrid,1,102,0
Scaffold930-10165_10309,cPa339,1,1,10277,10192,cPa339,64,144,85
Scaffold930-1403_1505,cPa174,0.224489795918367,13,1501,1428,cPa174_cPa174-cPa404-hybrid_cPa174-unknown_cPa254_cPa254-cPa174-hybrid_cPa254-cPa392-hybrid_cPa254-cPa404-hybrid_cPa254-unknown_cPa425_cPa425-cPa404-hybrid_cPa469-cPa425-hybrid_cPa47_cPa47-cPa404-hybrid,11_1_2_7_1_3_2_5_9_1_1_5_1,102,73
Scaffold930-1820_1922,cPa425_cPa47,0.3,4,1920,1821,cPa254_cPa404_cPa425_cPa47,2_2_3_3,102,99
Scaffold930-1934_2113,cPa47,0.2,21,2107,1935,cPa174_cPa174-cPa392-hybrid_cPa174-unknown_cPa254_cPa254-cPa174-hybrid_cPa254-cPa392-hybrid_cPa254-cPa404-hybrid_cPa254-cPa425-hybrid_cPa254-unknown_cPa339-cPa404-hybrid_cPa353_cPa353-cPa392-hybrid_cPa353-cPa404-hybrid_cPa353-cPa425-hybrid_cPa404_cPa404-cPa425-hybrid_cPa425_cPa425-cPa404-hybrid_cPa47_cPa47-cPa404-hybrid_cPa47-unknown,9_1_1_18_5_4_6_1_4_2_1_4_6_1_2_1_11_1_20_1_1,179,172
Scaffold930-3838_3940,cPa339,0.857142857142857,2,3920,3841,cPa339_cPa419,6_1,102,79
Scaffold930-4223_4325,cPa339,0.769230769230769,3,4322,4260,cPa339_cPa353_cPa419,10_1_2,102,62
Scaffold930-4353_4541,cPa339,0.964285714285714,2,4531,4403,cPa339_cPa419,81_3,188,128
Scaffold930-4798_4946,cPa339,0.92,2,4938,4823,cPa205_cPa339,2_23,148,115
Scaffold930-4997_5099,cPa339,0.909090909090909,2,5066,4999,cPa339_cPa419,20_2,102,67
Scaffold930-5164_5308,cPa339,0.92,2,5289,5169,cPa339_cPa419,23_2,144,120
Scaffold930-5325_5434,cPa339,0.9,2,5399,5335,cPa339_cPa419,9_1,109,64
Scaffold930-5734_5857,cPa339,0.939393939393939,2,5840,5735,cPa339_cPa419,31_2,123,105
Scaffold930-6872_7006,cPa339,0.949152542372881,2,7005,6879,cPa339_cPa446,56_3,134,126
Scaffold930-7358_7462,cPa339,0.98,2,7457,7368,cPa339_cPa402-cPa446-hybrid,49_1,104,89
Scaffold930-8478_8662,cPa339,1,1,8621,8480,cPa339,17,184,141
Scaffold930-9555_9673,cPa339,1,1,9652,9556,cPa339,49,118,96
Scaffold931-4731_4846,cPa428,0.555555555555556,3,4829,4780,cPa356_cPa356-unknown_cPa428,3_1_5,115,49
Scaffold931-4885_5013,cPa428,0.647058823529412,2,5004,4928,cPa356_cPa428,6_11,128,76
Scaffold931-6708_6855,cPa428,0.529411764705882,2,6813,6758,cPa356_cPa428,8_9,147,55
Scaffold931-7167_7269,cPa428,0.666666666666667,2,7253,7217,cPa356_cPa428,1_2,102,36
Scaffold931-8633_8735,cPa356,1,1,8683,8683,cPa356,1,102,0
Scaffold933-5930_6032,cPa308_cPa75-cPa196-hybrid,0.5,2,5980,5980,cPa308_cPa75-cPa196-hybrid,1_1,102,0
Scaffold933-6171_6297,cPa308,0.75,3,6265,6221,cPa308_cPa308-cPa196-hybrid_cPa75-cPa140-hybrid,6_1_1,126,44
Scaffold933-6333_6534,cPa308,0.857142857142857,2,6482,6383,cPa308_cPa75-cPa308-hybrid,6_1,201,99
Scaffold933-6596_6698,cPa308,1,1,6646,6646,cPa308,1,102,0
Scaffold934-5289_5391,cPa75,1,1,5339,5339,cPa75,1,102,0
Scaffold935-1845_1947,cPa356,0.666666666666667,4,1924,1856,cPa308-unknown_cPa356_cPa356-unknown_HML7_repbase_HERVK11DI_MER11D-cPa434-hybrid,1_8_2_1,102,68
Scaffold935-2353_2557,cPa356,0.436363636363636,16,2556,2360,ALVE_FJ793550-cPa356-hybrid_cPa308-cPa381-hybrid_cPa308-cPa434-hybrid_cPa308-cPa486-hybrid_cPa356_cPa356-cPa434-hybrid_cPa356-cPa75-hybrid_cPa425-cPa356-hybrid_cPa434_cPa447-cPa356-hybrid_cPa447-cPa434-hybrid_cPa523_cPa523-cPa111-hybrid_cPa523-cPa381-hybrid_cPa523-cPa447-hybrid_cPa523-unknown,3_2_2_1_48_3_1_1_25_1_2_16_2_1_1_1,204,196
Scaffold935-4164_4266,cPa75-cPa356-hybrid,1,1,4214,4214,cPa75-cPa356-hybrid,1,102,0
Scaffold937-5888_5990,cPa61,0.555555555555556,2,5982,5892,cPa205_cPa61,8_10,102,90
Scaffold937-6110_6212,cPa61,0.666666666666667,2,6185,6123,cPa205_cPa61,4_8,102,62
Scaffold937-6246_6504,cPa61,0.557692307692308,4,6475,6268,cPa205_cPa205-unknown_cPa61_cPa61-cPa419-hybrid,21_1_29_1,258,207
Scaffold938-3005_3233,cPa419,1,1,3233,3042,cPa419,18,228,191
Scaffold938-4385_4487,cPa419,1,1,4435,4435,cPa419,1,102,0
Scaffold938-6454_6556,cPa419,1,1,6504,6504,cPa419,1,102,0
Scaffold938-7418_7520,cPa419,1,1,7507,7459,cPa419,24,102,48
Scaffold939-3380_3482,HERVHcons-unknown,1,1,3435,3421,HERVHcons-unknown,3,102,14
Scaffold94-1116_1218,cPa391,1,1,1196,1166,cPa391,2,102,30
Scaffold94-1266_1368,cPa391,1,1,1331,1302,cPa391,9,102,29
Scaffold94-14308_14410,cPa434,0.692307692307692,2,14390,14349,cPa356_cPa434,4_9,102,41
Scaffold94-15806_15908,cPa434-cPa254-hybrid,0.666666666666667,2,15857,15851,cPa402-cPa254-hybrid_cPa434-cPa254-hybrid,1_2,102,6
Scaffold94-19224_19326,cPa434,1,1,19274,19274,cPa434,1,102,0
Scaffold94-20094_20201,cPa434,1,1,20149,20130,cPa434,5,107,19
Scaffold94-23878_24076,cPa118,0.32133676092545,30,24073,23886,cPa118_cPa118-cPa61-hybrid_cPa118-unknown_cPa125-cPa140-hybrid_cPa140_cPa140-cPa61-hybrid_cPa140-unknown_cPa15_cPa15-cPa140-hybrid_cPa15-cPa264-hybrid_cPa15-cPa61-hybrid_cPa15-cPa67-hybrid_cPa15-unknown_cPa248_cPa248-cPa118-hybrid_cPa248-cPa61-hybrid_cPa264_cPa264-cPa140-hybrid_cPa264-cPa15-hybrid_cPa264-cPa61-hybrid_cPa264-unknown_cPa443_cPa443-cPa140-hybrid_cPa443-cPa15-hybrid_cPa443-cPa61-hybrid_cPa443-unknown_cPa61_cPa61-cPa140-hybrid_cPa67-cPa140-hybrid_cPa67-cPa61-hybrid,125_1_1_3_49_1_1_83_8_1_2_1_5_2_1_1_34_9_1_8_4_21_3_1_4_2_13_2_1_1,198,187
Scaffold94-24840_25070,cPa67,1,1,25067,24869,cPa67,39,230,198
Scaffold94-25071_25320,cPa67,1,1,25274,25081,cPa67,73,249,193
Scaffold94-26432_26599,cPa67,1,1,26551,26449,cPa67,33,167,102
Scaffold94-32887_32989,cPa391,1,1,32937,32937,cPa391,1,102,0
Scaffold94-33178_33280,cPa298,0.6,2,33265,33199,cPa298_cPa391,3_2,102,66
Scaffold94-4385_4500,cPa258-cPa16-hybrid,0.6,3,4448,4435,cPa258-cPa16-hybrid_cPa258-cPa452-hybrid_cPa260-cPa363-hybrid,3_1_1,115,13
Scaffold94-5211_5372,cPa472-cPa117-hybrid_cPa472-cPa127-hybrid_cPa472-cPa356-hybrid,0.105263157894737,16,5320,5215,cPa196-cPa117-hybrid_cPa196-cPa119-hybrid_cPa196-EqFV_NC002201-hybrid_cPa196-HERV30_repbase_HERV30I_LTR30-hybrid_cPa356-cPa16-hybrid_cPa356-cPa363-hybrid_cPa356-cPa67-hybrid_cPa472-cPa117-hybrid_cPa472-cPa119-hybrid_cPa472-cPa127-hybrid_cPa472-cPa356-hybrid_cPa472-cPa475-hybrid_cPa472-EqFV_NC002201-hybrid_cPa472-HERV30_repbase_HERV30I_LTR30-hybrid_HERV-W_repbase_HERV17_LTR17-cPa119-hybrid_HERV-W_repbase_HERV17_LTR17-EqFV_NC002201-hybrid,1_1_1_1_1_1_1_2_1_2_2_1_1_1_1_1,161,105
Scaffold94-5686_5788,cPa196-EqFV_NC002201-hybrid,1,1,5736,5736,cPa196-EqFV_NC002201-hybrid,1,102,0
Scaffold94-7185_7287,S71_repbase_HERVS71_LTR6A,0.8,3,7239,7231,cPa117-cPa395-hybrid_cPa527-cPa395-hybrid_S71_repbase_HERVS71_LTR6A,1_1_8,102,8
Scaffold94-8487_8591,S71_repbase_HERVS71_LTR6A-cPa150-hybrid,0.571428571428571,4,8550,8495,cPa117-cPa150-hybrid_cPa248-cPa150-hybrid_cPa527-cPa362-hybrid_S71_repbase_HERVS71_LTR6A-cPa150-hybrid,1_1_1_4,104,55
Scaffold940-10716_10818,cPa419,1,1,10766,10766,cPa419,1,102,0
Scaffold942-1256_1358,cPa419,1,1,1339,1280,cPa419,7,102,59
Scaffold942-5958_6060,cPa419,1,1,6008,6008,cPa419,1,102,0
Scaffold942-953_1055,cPa419,1,1,1046,956,cPa419,10,102,90
Scaffold944-7252_7792,cPa542-cPa4-hybrid,0.29080118694362,52,7783,7257,cPa152-cPa4-hybrid_cPa168-cPa4-hybrid_cPa177-cPa168-hybrid_cPa177-cPa251-hybrid_cPa177-cPa356-hybrid_cPa177-cPa4-hybrid_cPa177-cPa511-hybrid_cPa177-cPa75-hybrid_cPa177-unknown_cPa201-cPa4-hybrid_cPa356_cPa356-cPa4-hybrid_cPa357-cPa356-hybrid_cPa357-cPa4-hybrid_cPa363-cPa4-hybrid_cPa363-cPa511-hybrid_cPa363-WDSV_NC001867-hybrid_cPa395-cPa356-hybrid_cPa395-cPa4-hybrid_cPa395-cPa452-hybrid_cPa395-WDSV_NC001867-hybrid_cPa419_cPa452-cPa356-hybrid_cPa452-cPa4-hybrid_cPa472-cPa452-hybrid_cPa472-WDSV_NC001867-hybrid_cPa527-cPa254-hybrid_cPa527-cPa356-hybrid_cPa527-cPa4-hybrid_cPa527-cPa511-hybrid_cPa542-cPa168-hybrid_cPa542-cPa251-hybrid_cPa542-cPa356-hybrid_cPa542-cPa4-hybrid_cPa542-cPa419-hybrid_cPa542-cPa452-hybrid_cPa542-cPa511-hybrid_cPa542-cPa541-hybrid_cPa542-cPa62-hybrid_cPa542-unknown_cPa555-cPa356-hybrid_cPa555-cPa4-hybrid_cPa56-cPa168-hybrid_cPa56-cPa356-hybrid_cPa56-cPa4-hybrid_cPa56-cPa75-hybrid_cPa56-unknown_cPa568-cPa4-hybrid_cPa568-cPa419-hybrid_HML7_repbase_HERVK11DI_MER11D_HML7_repbase_HERVK11DI_MER11D-cPa4-hybrid_PtERV1_AC142352-cPa356-hybrid,2_1_2_1_11_29_1_1_1_1_5_3_1_3_5_1_1_1_3_1_1_7_8_33_1_1_1_2_12_1_7_1_25_98_3_1_4_2_1_21_1_2_3_5_14_1_1_1_1_2_1_1,540,526
Scaffold949-7009_7111,cPa419,1,1,7059,7059,cPa419,1,102,0
Scaffold949-7201_7353,cPa419,1,1,7348,7251,cPa419,5,152,97
Scaffold949-7448_7550,cPa419,1,1,7539,7461,cPa419,4,102,78
Scaffold949-7605_7727,cPa419,1,1,7675,7655,cPa419,3,122,20
Scaffold949-7897_8046,cPa419,1,1,7994,7914,cPa419,6,149,80
Scaffold949-8438_8540,cPa419,1,1,8539,8439,cPa419,7,102,100
Scaffold95-109424_109554,cPa67,0.4,5,109502,109457,cPa34-cPa394-hybrid_cPa34-cPa450-hybrid_cPa67_cPa67-cPa339-hybrid_cPa67-cPa394-hybrid,1_1_4_2_2,130,45
Scaffold95-110449_110551,cPa67-cPa394-hybrid,0.5,4,110500,110463,cPa16-HERV-ADP_repbase_HERVP71A_I_LTR71A-hybrid_cPa339-unknown_cPa34-cPa394-hybrid_cPa67-cPa394-hybrid,1_1_1_3,102,37
Scaffold95-114150_114252,cPa118-cPa391-hybrid,1,1,114200,114200,cPa118-cPa391-hybrid,1,102,0
Scaffold95-116041_116143,cPa176,0.5,3,116091,116071,cPa176_cPa363_cPa391,2_1_1,102,20
Scaffold95-14370_14475,cPa67-cPa254-hybrid_cPa67-cPa392-hybrid,0.5,2,14423,14420,cPa67-cPa254-hybrid_cPa67-cPa392-hybrid,1_1,105,3
Scaffold95-28277_28574,cPa475,0.339285714285714,13,28551,28283,cPa18-cPa391-hybrid_cPa298_cPa298-cPa475-hybrid_cPa298-SIV_NC001549-hybrid_cPa298-unknown_cPa391_cPa391-cPa475-hybrid_cPa391-SIV_NC001549-hybrid_cPa391-unknown_cPa475_FIV_NC001482-cPa475-hybrid_FIV_NC001482-SIV_NC001549-hybrid_HERVHcons-SIV_NC001549-hybrid,1_1_6_8_1_14_15_21_4_38_1_1_1,297,268
Scaffold95-3145_3247,cPa413-unknown,1,1,3195,3195,cPa413-unknown,1,102,0
Scaffold95-32765_32867,cPa339,0.8,2,32819,32815,cPa339_cPa339-cPa152-hybrid,4_1,102,4
Scaffold95-34987_35155,cPa67,1,1,35131,35036,cPa67,5,168,95
Scaffold95-35342_35444,cPa67,1,1,35435,35392,cPa67,2,102,43
Scaffold95-35698_35800,cPa67,1,1,35751,35748,cPa67,2,102,3
Scaffold95-36342_36538,cPa67,1,1,36523,36389,cPa67,35,196,134
Scaffold95-37387_37489,cPa67-cPa118-hybrid,1,1,37437,37437,cPa67-cPa118-hybrid,1,102,0
Scaffold95-39813_39915,cPa356,1,1,39863,39863,cPa356,1,102,0
Scaffold95-55111_55213,HERVHcons,1,1,55161,55161,HERVHcons,1,102,0
Scaffold95-56143_56245,cPa223-unknown,1,1,56193,56193,cPa223-unknown,1,102,0
Scaffold95-61046_61148,cPa34-cPa395-hybrid,0.5,3,61120,61064,cPa34_cPa34-cPa395-hybrid_cPa34-unknown,1_2_1,102,56
Scaffold95-61169_61271,cPa34,0.555555555555556,5,61228,61198,cPa308_cPa34_cPa34-cPa395-hybrid_cPa34-unknown_cPa527,1_5_1_1_1,102,30
Scaffold95-61932_62034,cPa356,1,1,61992,61944,cPa356,12,102,48
Scaffold95-62040_62260,cPa356,1,1,62235,62090,cPa356,21,220,145
Scaffold95-68358_68545,cPa391,0.533333333333333,3,68493,68378,cPa104_cPa391_cPa434-cPa391-hybrid,1_8_6,187,115
Scaffold95-69794_69896,cPa434-BLV_NC001414-hybrid,1,1,69844,69844,cPa434-BLV_NC001414-hybrid,1,102,0
Scaffold95-69934_70036,cPa434-BLV_NC001414-hybrid,1,1,69984,69984,cPa434-BLV_NC001414-hybrid,1,102,0
Scaffold95-70594_70724,BLV_NC001414,0.8,2,70673,70644,BLV_NC001414_BLV_NC001414-unknown,4_1,130,29
Scaffold95-7126_7228,cPa18-cPa391-hybrid,1,1,7176,7176,cPa18-cPa391-hybrid,1,102,0
Scaffold95-79692_79863,cPa434,0.666666666666667,2,79811,79742,cPa434_cPa456,2_1,171,69
Scaffold95-7987_8089,cPa18-cPa391-hybrid,0.666666666666667,2,8050,8037,cPa18-cPa391-hybrid_cPa380-unknown,2_1,102,13
Scaffold95-79985_80114,PERVC_HM159246-cPa443-hybrid_REV_NC006934-cPa456-hybrid,0.5,2,80062,80035,PERVC_HM159246-cPa443-hybrid_REV_NC006934-cPa456-hybrid,1_1,129,27
Scaffold95-80317_80562,cPa434,0.808510638297872,7,80560,80342,cPa419-cPa356-hybrid_cPa434_cPa434-unknown_cPa456_cPa566-cPa356-hybrid_cPa566-cPa447-hybrid_cPa566-cPa456-hybrid,1_38_1_4_1_1_1,245,218
Scaffold95-81115_81217,cPa434,1,1,81165,81118,cPa434,5,102,47
Scaffold95-81948_82544,cPa434,0.428571428571429,20,82540,81951,cPa130-cPa118-hybrid_cPa14-cPa443-hybrid_cPa356_cPa356-cPa434-hybrid_cPa356-unknown_cPa419_cPa419-cPa356-hybrid_cPa419-cPa542-hybrid_cPa434_cPa434-cPa356-hybrid_cPa434-cPa511-hybrid_cPa434-unknown_cPa447_cPa447-cPa356-hybrid_cPa447-cPa434-hybrid_cPa447-cPa443-hybrid_cPa447-cPa456-hybrid_cPa447-cPa566-hybrid_cPa447-unknown_FIV_NC001482-cPa118-hybrid,2_1_76_1_5_1_1_1_84_1_1_2_1_1_2_7_1_1_6_1,596,589
Scaffold95-83315_83417,FIV_NC001482-cPa246-hybrid,1,1,83365,83365,FIV_NC001482-cPa246-hybrid,1,102,0
Scaffold95-8479_8581,cPa18-cPa391-hybrid,1,1,8529,8529,cPa18-cPa391-hybrid,1,102,0
Scaffold95-84804_85014,cPa117,0.615384615384615,10,85003,84850,cPa117_cPa117-cPa2-hybrid_cPa117-cPa452-hybrid_cPa117-HML3_repbase_HERVK9I_MER9-hybrid_cPa353-cPa246-hybrid_cPa419_cPa452_cPa452-cPa117-hybrid_cPa568-cPa61-hybrid_cPa568-unknown,16_1_1_1_1_1_2_1_1_1,210,153
Scaffold95-85453_85555,cPa117-HML3_repbase_HERVK9I_MER9-hybrid_cPa339_cPa419_cPa419-cPa527-hybrid,0.25,4,85503,85453,cPa117-HML3_repbase_HERVK9I_MER9-hybrid_cPa339_cPa419_cPa419-cPa527-hybrid,1_1_1_1,102,50
Scaffold95-85624_85876,cPa339,0.644628099173554,15,85824,85647,cPa117-HML3_repbase_HERVK9I_MER9-hybrid_cPa339_cPa339-HML3_repbase_HERVK9I_MER9-hybrid_cPa353_cPa353-cPa117-hybrid_cPa353-cPa229-hybrid_cPa353-cPa246-hybrid_cPa353-cPa298-hybrid_cPa353-cPa425-hybrid_cPa353-cPa452-hybrid_cPa353-HERV-XA34_repbase_HERVFH21I_LTR21A-hybrid_cPa353-HML3_repbase_HERVK9I_MER9-hybrid_cPa353-unknown_cPa360_cPa452-HML3_repbase_HERVK9I_MER9-hybrid,4_78_1_8_1_1_5_1_1_1_2_10_5_2_1,252,177
Scaffold95-87438_87589,cPa363-HML3_repbase_HERVK9I_MER9-hybrid,0.625,4,87537,87488,cPa353-cPa452-hybrid_cPa363-cPa339-hybrid_cPa363-HERV-XA34_repbase_HERVFH21I_LTR21A-hybrid_cPa363-HML3_repbase_HERVK9I_MER9-hybrid,1_1_1_5,151,49
Scaffold95-91404_91506,cPa356,0.875,2,91500,91454,cPa356_cPa545-cPa75-hybrid,7_1,102,46
Scaffold953-2004_2115,cPa419,1,1,2111,2054,cPa419,6,111,57
Scaffold953-2209_2311,cPa419,1,1,2285,2226,cPa419,5,102,59
Scaffold953-2407_2603,cPa419,1,1,2570,2431,cPa419,20,196,139
Scaffold953-3869_3971,cPa419,1,1,3956,3919,cPa419,3,102,37
Scaffold953-4924_5084,cPa419,1,1,5065,4938,cPa419,39,160,127
Scaffold954-2982_3084,cPa62-cPa360-hybrid,1,1,3032,3032,cPa62-cPa360-hybrid,1,102,0
Scaffold955-1006_1227,cPa428,0.515463917525773,2,1210,1005,cPa356_cPa428,47_50,221,205
Scaffold955-1767_1869,cPa428,0.51219512195122,2,1863,1780,cPa356_cPa428,20_21,102,83
Scaffold955-2077_2179,cPa356,0.666666666666667,2,2136,2127,cPa356_cPa428,2_1,102,9
Scaffold955-2365_2533,cPa428,0.545454545454545,2,2490,2366,cPa356_cPa428,5_6,168,124
Scaffold955-2748_2867,cPa356,0.666666666666667,2,2855,2752,cPa356_cPa428,10_5,119,103
Scaffold955-877_992,cPa356,0.727272727272727,2,978,924,cPa356_cPa428,8_3,115,54
Scaffold956-3627_3729,cPa428,0.5625,2,3718,3640,cPa356_cPa428,21_27,102,78
Scaffold956-4014_4128,cPa428,0.571428571428571,2,4114,4026,cPa356_cPa428,9_12,114,88
Scaffold956-4222_4324,cPa428,0.509803921568627,2,4320,4221,cPa356_cPa428,25_26,102,99
Scaffold956-5107_5291,cPa428,0.521739130434783,3,5290,5106,cPa356_cPa419_cPa428,21_1_24,184,184
Scaffold956-5368_5793,cPa428,0.520958083832335,4,5755,5418,cPa356_cPa356-unknown_cPa419_cPa428,78_1_1_87,425,337
Scaffold956-7064_7245,cPa356,0.529411764705882,3,7209,7064,cPa356_cPa419_cPa428,9_1_7,181,145
Scaffold956-7343_7535,cPa428,0.529411764705882,2,7510,7393,cPa356_cPa428,8_9,192,117
Scaffold957-7373_7687,cPa356,0.552380952380952,2,7686,7374,cPa356_cPa428,58_47,314,312
Scaffold957-8228_8330,cPa356_cPa428,0.5,2,8321,8252,cPa356_cPa428,19_19,102,69
Scaffold96-23787_23961,cPa434,0.926829268292683,4,23947,23786,cPa270-cPa392-hybrid_cPa356-HERV-I_repbase_HERVI_LTR10B-hybrid_cPa434_HERV-E_repbase_HERVE_LTR2-unknown,1_1_38_1,174,161
Scaffold96-25798_26049,cPa434,0.8,5,26028,25848,cPa174-cPa381-hybrid_cPa434_cPa47-HIV1_NC001802-hybrid_REV_NC006934-cPa456-hybrid_REV_NC006934-unknown,1_20_2_1_1,251,180
Scaffold96-27037_27163,cPa434,0.979591836734694,2,27163,27037,cPa434_cPa434-cPa356-hybrid,48_1,126,126
Scaffold96-27267_27457,cPa434,0.963855421686747,4,27422,27285,cPa434_HERV-ADP_repbase_HERVP71A_I_LTR71A-cPa443-hybrid_HIV1_NC001802-cPa356-hybrid_HIV1_NC001802-SMRV_NC001514-hybrid,80_1_1_1,190,137
Scaffold96-27549_28083,cPa434,0.528189910979229,7,28075,27591,cPa356_cPa434_cPa434-cPa356-hybrid_cPa447-cPa419-hybrid_cPa447-HIV1_NC001802-hybrid_cPa568-cPa443-hybrid_HERV-R_repbase_HERV3_LTR4-cPa356-hybrid,154_178_1_1_1_1_1,534,484
Scaffold96-28329_28431,cPa356,0.6,2,28408,28336,cPa356_cPa434,3_2,102,72
Scaffold96-29658_29892,cPa193-cPa308-hybrid_cPa264-MER52A_repbase_MER52AI_MER52A-hybrid_cPa356_cPa443-MER52A_repbase_MER52AI_MER52A-hybrid_cPa568-cPa285-hybrid_SIV_NC001549-MER52A_repbase_MER52AI_MER52A-hybrid,0.166666666666667,6,29840,29708,cPa193-cPa308-hybrid_cPa264-MER52A_repbase_MER52AI_MER52A-hybrid_cPa356_cPa443-MER52A_repbase_MER52AI_MER52A-hybrid_cPa568-cPa285-hybrid_SIV_NC001549-MER52A_repbase_MER52AI_MER52A-hybrid,1_1_1_1_1_1,234,132
Scaffold96-31151_31331,cPa118-unknown,0.145161290322581,24,31310,31150,cPa118_cPa118-cPa109-hybrid_cPa118-cPa138-hybrid_cPa118-cPa15-hybrid_cPa118-cPa308-hybrid_cPa118-SIV_NC001549-hybrid_cPa118-unknown_cPa140_cPa140-cPa138-hybrid_cPa140-cPa15-hybrid_cPa140-cPa264-hybrid_cPa15_cPa15-unknown_cPa264_cPa264-cPa140-hybrid_cPa264-cPa15-hybrid_cPa443-cPa109-hybrid_cPa443-cPa138-hybrid_cPa443-cPa140-hybrid_cPa443-cPa15-hybrid_cPa443-unknown_cPa516-cPa264-hybrid_cPa516-unknown_SIV_NC001549-cPa15-hybrid,5_2_6_6_1_1_9_1_1_1_1_8_1_2_1_2_1_2_1_5_2_1_1_1,180,160
Scaffold96-32301_32588,cPa67,0.926605504587156,9,32583,32300,cPa118-cPa138-hybrid_cPa118-cPa15-hybrid_cPa140-cPa138-hybrid_cPa264-cPa138-hybrid_cPa443-cPa109-hybrid_cPa443-cPa138-hybrid_cPa67_cPa75-cPa138-hybrid_cPa75-cPa15-hybrid,1_1_1_1_1_1_101_1_1,287,283
Scaffold96-33674_33776,cPa67,0.990476190476191,2,33776,33682,cPa452-cPa15-hybrid_cPa67,1_104,102,94
Scaffold96-33970_34072,cPa67,1,1,34072,33974,cPa67,7,102,98
Scaffold96-34313_34429,cPa67,0.928571428571429,2,34429,34363,cPa419_cPa67,1_13,116,66
Scaffold96-34467_34569,cPa67,1,1,34517,34517,cPa67,1,102,0
Scaffold96-34633_34735,cPa67,0.75,4,34729,34666,cPa34-cPa456-hybrid_cPa452-cPa363-hybrid_cPa456_cPa67,1_1_1_9,102,63
Scaffold96-34837_34939,cPa67,1,1,34887,34887,cPa67,1,102,0
Scaffold96-40329_40431,cPa391,1,1,40379,40330,cPa391,4,102,49
Scaffold96-6080_6259,cPa75_HERVHcons-cPa75-hybrid_MDEV_AF053745-cPa16-hybrid_MDEV_AF053745-cPa313-hybrid,0.25,4,6207,6130,cPa75_HERVHcons-cPa75-hybrid_MDEV_AF053745-cPa16-hybrid_MDEV_AF053745-cPa313-hybrid,1_1_1_1,179,77
Scaffold96-6267_6381,cPa75,0.5,3,6340,6281,cPa75_HERV-Fb_repbase_HERVH48I_MER48-cPa75-hybrid_MDEV_AF053745-cPa419-hybrid,2_1_1,114,59
Scaffold964-9487_9589,cPa505,0.483870967741935,8,9588,9495,cPa109_cPa109-cPa505-hybrid_cPa152_cPa201_cPa201-cPa419-hybrid_cPa201-cPa505-hybrid_cPa402-cPa505-hybrid_cPa505,1_1_7_3_1_2_1_15,102,93
Scaffold964-9795_9897,cPa152_cPa201,0.5,2,9845,9809,cPa152_cPa201,2_2,102,36
Scaffold965-7772_7874,cPa353-cPa113-hybrid,1,1,7822,7822,cPa353-cPa113-hybrid,1,102,0
Scaffold966-7361_7464,cPa75,1,1,7412,7411,cPa75,2,103,1
Scaffold966-7715_7817,cPa75,1,1,7765,7765,cPa75,1,102,0
Scaffold97-3166_3268,cPa391,0.857142857142857,2,3248,3174,cPa391_cPa391-cPa298-hybrid,6_1,102,74
Scaffold97-3317_3419,cPa391,1,1,3373,3318,cPa391,5,102,55
Scaffold971-10163_10281,cPa428,0.6875,2,10247,10206,cPa356_cPa428,5_11,118,41
Scaffold971-1330_1712,cPa356,0.551724137931034,2,1690,1365,cPa356_cPa428,16_13,382,325
Scaffold971-3600_3705,cPa428,0.771428571428571,2,3699,3609,cPa356_cPa428,8_27,105,90
Scaffold971-3855_3957,cPa356,0.666666666666667,2,3905,3889,cPa356_cPa428,2_1,102,16
Scaffold971-4144_4246,cPa428,0.857142857142857,2,4237,4161,cPa356_cPa428,1_6,102,76
Scaffold971-4997_5321,cPa428,0.615384615384615,2,5269,5009,cPa356_cPa428,20_32,324,260
Scaffold971-5346_5448,cPa428,0.75,2,5448,5392,cPa356_cPa428,1_3,102,56
Scaffold971-6322_6424,cPa428,0.595238095238095,2,6418,6358,cPa356_cPa428,17_25,102,60
Scaffold971-7431_7533,cPa356_cPa428,0.5,2,7522,7450,cPa356_cPa428,3_3,102,72
Scaffold971-8373_8647,cPa356,0.538461538461538,2,8622,8387,cPa356_cPa428,35_30,274,235
Scaffold971-8713_8815,cPa428,0.8,2,8784,8732,cPa356_cPa428,1_4,102,52
Scaffold971-9288_9487,cPa428,0.571428571428571,2,9454,9308,cPa356_cPa428,3_4,199,146
Scaffold971-9851_9953,cPa356,1,1,9901,9901,cPa356,1,102,0
Scaffold972-2834_2936,cPa419,1,1,2908,2877,cPa419,7,102,31
Scaffold972-3069_3269,cPa419,1,1,3217,3104,cPa419,4,200,113
Scaffold972-3657_3759,cPa419,1,1,3707,3676,cPa419,3,102,31
Scaffold972-4280_4382,cPa419,1,1,4336,4325,cPa419,4,102,11
Scaffold972-4490_4592,cPa419,1,1,4590,4540,cPa419,3,102,50
Scaffold972-4608_4710,cPa419,1,1,4704,4642,cPa419,5,102,62
Scaffold972-4957_5059,cPa419,1,1,5032,5007,cPa419,3,102,25
Scaffold972-5281_5537,cPa419,1,1,5531,5297,cPa419,49,256,234
Scaffold972-5548_5722,cPa419,1,1,5720,5548,cPa419,42,174,172
Scaffold972-6563_6665,cPa419,1,1,6633,6564,cPa419,18,102,69
Scaffold972-6871_7027,cPa419,1,1,7009,6874,cPa419,142,156,135
Scaffold972-7581_7683,cPa419,0.6,3,7631,7588,cPa356_cPa419_cPa428,1_3_1,102,43
Scaffold972-7872_7974,cPa419,1,1,7974,7871,cPa419,53,102,103
Scaffold972-8399_8501,cPa419,1,1,8501,8437,cPa419,6,102,64
Scaffold972-8987_9188,cPa419,1,1,9188,9029,cPa419,13,201,159
Scaffold972-9225_9496,cPa419,1,1,9492,9253,cPa419,35,271,239
Scaffold972-9644_9746,cPa419,1,1,9728,9667,cPa419,9,102,61
Scaffold973-3908_4010,cPa127_cPa241,0.214285714285714,8,3961,3931,cPa11_cPa127_cPa127-cPa241-hybrid_cPa241_cPa515_cPa530_cPa531_cPa540,2_3_1_3_1_1_1_2,102,30
Scaffold973-4953_5460,cPa531,0.228070175438596,19,5429,4952,cPa11_cPa11-cPa515-hybrid_cPa11-cPa530-hybrid_cPa127_cPa241_cPa241-cPa127-hybrid_cPa241-cPa290-hybrid_cPa241-unknown_cPa356_cPa515_cPa515-cPa11-hybrid_cPa530_cPa530-cPa356-hybrid_cPa531_cPa531-unknown_cPa540_cPa540-cPa127-hybrid_cPa552-cPa127-hybrid_cPa552-cPa540-hybrid,4_1_1_3_8_2_1_1_1_4_1_8_1_13_2_3_1_1_1,507,477
Scaffold973-8523_8625,cPa127,0.26530612244898,6,8619,8557,cPa11_cPa127_cPa241_cPa515_cPa530_cPa540,10_13_6_5_7_8,102,62
Scaffold973-8972_9074,cPa127_cPa515,0.5,2,9022,9022,cPa127_cPa515,1_1,102,0
Scaffold973-9164_9349,cPa530,0.263157894736842,8,9349,9165,cPa11_cPa127_cPa241_cPa290_cPa515_cPa530_cPa530-cPa127-hybrid_cPa540,7_7_3_2_5_10_1_3,185,184
Scaffold973-9443_9545,cPa530,0.208,14,9545,9445,cPa11_cPa127_cPa127-cPa11-hybrid_cPa241_cPa241-cPa11-hybrid_cPa241-cPa127-hybrid_cPa290_cPa515_cPa515-cPa11-hybrid_cPa515-cPa241-hybrid_cPa530_cPa530-cPa540-hybrid_cPa540_cPa540-cPa11-hybrid,19_22_1_16_1_1_5_17_1_1_26_1_13_1,102,100
Scaffold975-1748_1850,cPa428,0.75,2,1818,1774,cPa356_cPa428,2_6,102,44
Scaffold975-8376_8478,cPa356,0.666666666666667,2,8476,8400,cPa356_cPa428,8_4,102,76
Scaffold976-6106_6265,cPa356_cPa428,0.5,2,6213,6156,cPa356_cPa428,2_2,159,57
Scaffold976-6370_6481,cPa428,0.777777777777778,2,6460,6386,cPa356_cPa428,2_7,111,74
Scaffold976-6557_6683,cPa356,0.5,3,6682,6607,cPa356_cPa356-unknown_cPa428,7_1_6,126,75
Scaffold983-4906_5008,cPa75,1,1,4956,4956,cPa75,1,102,0
Scaffold983-7186_7288,cPa117-cPa419-hybrid_cPa323,0.5,2,7236,7211,cPa117-cPa419-hybrid_cPa323,1_1,102,25
Scaffold983-7376_7504,cPa117,0.705882352941177,6,7473,7414,cPa117_cPa117-cPa323-hybrid_cPa117-cPa333-hybrid_cPa287-cPa419-hybrid_cPa323_cPa419,12_1_1_1_1_1,128,59
Scaffold983-7564_7726,cPa117,0.285714285714286,9,7725,7584,cPa117_cPa117-cPa293-hybrid_cPa287-cPa323-hybrid_cPa287-cPa333-hybrid_cPa287-cPa50-hybrid_cPa293-cPa333-hybrid_cPa323_cPa333_cPa371-cPa193-hybrid,4_1_1_1_1_1_3_1_1,162,141
Scaffold983-8495_8815,cPa293,0.229007633587786,30,8772,8518,cPa117-cPa293-hybrid_cPa117-cPa391-hybrid_cPa117-cPa426-hybrid_cPa118-cPa426-hybrid_cPa199-cPa426-hybrid_cPa287_cPa287-cPa293-hybrid_cPa287-cPa298-hybrid_cPa287-cPa323-hybrid_cPa287-cPa333-hybrid_cPa287-cPa391-hybrid_cPa287-cPa419-hybrid_cPa287-cPa426-hybrid_cPa287-cPa568-hybrid_cPa287-unknown_cPa293_cPa293-cPa298-hybrid_cPa293-cPa323-hybrid_cPa293-cPa333-hybrid_cPa293-cPa391-hybrid_cPa293-cPa426-hybrid_cPa323-cPa426-hybrid_cPa333-cPa391-hybrid_cPa371-cPa426-hybrid_cPa391_cPa419_cPa426_cPa568-unknown_cPa75-cPa391-hybrid_cPa75-cPa426-hybrid,1_9_8_1_1_7_3_1_4_3_29_1_34_1_9_60_1_2_2_3_6_1_1_1_52_2_16_1_1_1,320,254
Scaffold985-1313_1415,cPa568,0.6875,6,1383,1327,cPa193_cPa193-cPa356-hybrid_cPa193-cPa568-hybrid_cPa193-HERVHcons-hybrid_cPa568_cPa568-HERVHcons-hybrid,3_1_1_2_22_3,102,56
Scaffold985-2945_3187,cPa434,0.425373134328358,22,3184,2970,cPa15-cPa356-hybrid_cPa190-unknown_cPa193-cPa130-hybrid_cPa248-HERVHcons-hybrid_cPa356_cPa356-cPa130-hybrid_cPa356-cPa568-hybrid_cPa356-HERVHcons-hybrid_cPa356-unknown_cPa434_cPa434-cPa356-hybrid_cPa434-unknown_cPa443-cPa130-hybrid_cPa443-HERVHcons-hybrid_cPa566-cPa130-hybrid_cPa566-cPa248-hybrid_cPa566-cPa568-hybrid_cPa566-HERVHcons-hybrid_cPa566-unknown_cPa568-cPa14-hybrid_cPa568-cPa356-hybrid_cPa568-HERVHcons-hybrid,2_1_1_1_34_1_1_2_2_57_2_1_1_5_1_1_1_12_2_1_2_3,242,214
Scaffold985-3357_3459,cPa434,1,1,3407,3407,cPa434,1,102,0
Scaffold987-1627_1729,HML2_repbase_HERVK_LTR5-cPa255-hybrid_HML6_repbase_HERVK3I_LTR3-cPa255-hybrid,0.5,2,1704,1677,HML2_repbase_HERVK_LTR5-cPa255-hybrid_HML6_repbase_HERVK3I_LTR3-cPa255-hybrid,1_1,102,27
Scaffold987-1775_1880,cPa333-cPa255-hybrid,0.4,4,1828,1818,cPa333-cPa255-hybrid_cPa50-cPa255-hybrid_HML2_repbase_HERVK_LTR5-cPa255-hybrid_HML5_repbase_HERVK22I_LTR22-cPa255-hybrid,2_1_1_1,105,10
Scaffold987-2017_2249,cPa333-cPa255-hybrid,0.711111111111111,5,2197,2053,cPa308-cPa255-hybrid_cPa333-cPa255-hybrid_cPa50-cPa255-hybrid_HML2_repbase_HERVK_LTR5-cPa255-hybrid_HML6_repbase_HERVK3I_LTR3-cPa255-hybrid,2_32_1_1_9,232,144
Scaffold987-2890_3001,cPa333-cPa255-hybrid,1,1,2949,2921,cPa333-cPa255-hybrid,4,111,28
Scaffold987-4185_4347,cPa182,1,1,4295,4235,cPa182,7,162,60
Scaffold987-4724_4826,cPa182,1,1,4774,4774,cPa182,1,102,0
Scaffold987-4899_5001,cPa182,1,1,4949,4949,cPa182,1,102,0
Scaffold987-5180_5282,cPa182,1,1,5230,5230,cPa182,1,102,0
Scaffold99-12151_12306,cPa428,0.584615384615385,3,12263,12167,cPa356_cPa428_cPa428-cPa356-hybrid,26_38_1,155,96
Scaffold99-12362_12478,cPa428,0.526315789473684,3,12436,12403,cPa356_cPa428_cPa428-cPa356-hybrid,35_40_1,116,33
Scaffold99-12774_12911,cPa428,0.72,2,12911,12824,cPa356_cPa428,7_18,137,87
Scaffold99-13003_13105,cPa356_cPa428,0.5,2,13060,13008,cPa356_cPa428,5_5,102,52
Scaffold99-2793_2895,cPa428,1,1,2843,2843,cPa428,1,102,0
Scaffold990-1450_1555,cPa413-cPa247-hybrid,0.333333333333333,13,1510,1451,cPa145-STLV2_NC001815-hybrid_cPa223-cPa121-hybrid_cPa223-cPa425-hybrid_cPa223-STLV2_NC001815-hybrid_cPa413-cPa150-hybrid_cPa413-cPa228-hybrid_cPa413-cPa247-hybrid_cPa413-cPa302-hybrid_cPa413-cPa545-hybrid_cPa425_HML8_repbase_HERVK11I_MER11A-cPa228-hybrid_HML8_repbase_HERVK11I_MER11A-cPa247-hybrid_SMRV_NC001514-cPa247-hybrid,1_1_1_1_1_3_8_1_1_1_1_2_2,105,59
Scaffold990-1648_1750,cPa413-STLV2_NC001815-hybrid,0.666666666666667,2,1702,1698,cPa413_cPa413-STLV2_NC001815-hybrid,1_2,102,4
Scaffold994-7910_8014,cPa356,1,1,7962,7960,cPa356,2,104,2
Scaffold994-8043_8145,cPa356_cPa428,0.5,2,8102,8093,cPa356_cPa428,1_1,102,9
Scaffold994-8923_9025,cPa356,0.666666666666667,2,8973,8969,cPa356_cPa428,2_1,102,4
