"","locus","counts","chr","start","end","width","erv.call"
"CNV_chr2_15757201-15767400","CNV_chr2_15757201-15767400",4,"chr2",15757201,15767400,10199,"cPa345_cPa530_cPa515_cPa127_cPa540_cPa290_cPa531_cPa11_cPa241"
"CNV_chr2_17034901-17050800","CNV_chr2_17034901-17050800",9,"chr2",17034901,17050800,15899,"cPa264_cPa125_cPa227_cPa392_cPa268_cPa248_cPa118_cPa140_cPa130_cPa546_cPa257_cPa435_cPa523_cPa138_cPa572_cPa527_cPa107"
"CNV_chr2_19170601-19181700","CNV_chr2_19170601-19181700",200,"chr2",19170601,19181700,11099,"cPa479_cPa255_cPa131_cPa216_cPa478_cPa438"
"CNV_chr2_21120901-21129000","CNV_chr2_21120901-21129000",1,"chr2",21120901,21129000,8099,"cPa529_cPa545_cPa247_cPa95_cPa133"
"CNV_chr2_25848901-25854600","CNV_chr2_25848901-25854600",3,"chr2",25848901,25854600,5699,"cPa199_cPa223_cPa157_cPa229"
"CNV_chr2_26947501-26954100","CNV_chr2_26947501-26954100",8,"chr2",26947501,26954100,6599,"cPa199_cPa315"
"CNV_chr2_28456501-28468200","CNV_chr2_28456501-28468200",25,"chr2",28456501,28468200,11699,"cPa138"
"CNV_chr2_30670801-30684000","CNV_chr2_30670801-30684000",9,"chr2",30670801,30684000,13199,"HERV-W_repbase_HERV17_LTR17"
"CNV_chr2_46208701-46219200","CNV_chr2_46208701-46219200",14,"chr2",46208701,46219200,10499,"cPa142_cPa167"
"CNV_chr2_49216201-49223700","CNV_chr2_49216201-49223700",128,"chr2",49216201,49223700,7499,"cPa157_cPa121_cPa183_cPa229_cPa193_cPa500"
"CNV_chr2_55602601-55611900","CNV_chr2_55602601-55611900",8,"chr2",55602601,55611900,9299,"cPa51_cPa551_cPa145"
"CNV_chr2_75514201-75520500","CNV_chr2_75514201-75520500",3,"chr2",75514201,75520500,6299,"cPa264_cPa248_cPa443_cPa118_cPa140_cPa15_cPa125_cPa516_cPa268_cPa119"
"CNV_chr2_78699901-78710700","CNV_chr2_78699901-78710700",22,"chr2",78699901,78710700,10799,"cPa150_cPa302_cPa246"
"CNV_chr2_94781701-94793100","CNV_chr2_94781701-94793100",2,"chr2",94781701,94793100,11399,"cPa50_cPa333_cPa492_cPa157_cPa362_cPa391"
"CNV_chr2_96217801-96232800","CNV_chr2_96217801-96232800",1,"chr2",96217801,96232800,14999,"cPa205_cPa61_cPa260_cPa305_cPa424_cPa327_cPa459_cPa433_cPa542_cPa450_cPa390_cPa357"
"CNV_chr2_97379401-97390500","CNV_chr2_97379401-97390500",2,"chr2",97379401,97390500,11099,"cPa47_cPa425_cPa254_cPa268_cPa205_cPa61_cPa194_cPa264_cPa419_cPa75"
"CNV_chr2_119837101-119844000","CNV_chr2_119837101-119844000",240,"chr2",119837101,119844000,6899,"cPa264_cPa248_cPa443_cPa118_cPa140_cPa15_cPa125_cPa268_cPa119"
"CNV_chr2_124393501-124401000","CNV_chr2_124393501-124401000",5,"chr2",124393501,124401000,7499,"cPa121_cPa229_cPa183_cPa157_cPa193_cPa500_cPa188_cPa34_cPa465_cPa220"
"CNV_chr2_135066001-135072300","CNV_chr2_135066001-135072300",102,"chr2",135066001,135072300,6299,"cPa264_cPa248_cPa443_cPa118_cPa140_cPa15_cPa125_cPa516_cPa268_cPa119_cPa174_cPa254"
"CNV_chr2_151734001-151749000","CNV_chr2_151734001-151749000",163,"chr2",151734001,151749000,14999,"cPa260"
"CNV_chr1_559501-579000","CNV_chr1_559501-579000",39,"chr1",559501,579000,19499,"cPa446_cPa260"
"CNV_chr1_4829401-4837200","CNV_chr1_4829401-4837200",7,"chr1",4829401,4837200,7799,"cPa268_cPa516_cPa15_cPa125_cPa118_cPa264_cPa248_cPa140_cPa61_cPa443_cPa410_cPa425_cPa254_cPa119_cPa404_cPa174"
"CNV_chr1_4916101-4930800","CNV_chr1_4916101-4930800",14,"chr1",4916101,4930800,14699,"cPa410_cPa425_cPa516_cPa264_cPa268_cPa61_cPa248_cPa443_cPa118_cPa140_cPa15_cPa125_cPa308"
"CNV_chr1_5563501-5572800","CNV_chr1_5563501-5572800",6,"chr1",5563501,5572800,9299,"cPa425_cPa516_cPa264_cPa268_cPa248_cPa443_cPa118_cPa140_cPa15_cPa125_cPa61_cPa404_cPa47_cPa119_cPa174_cPa254_cPa176"
"CNV_chr1_13069201-13072800","CNV_chr1_13069201-13072800",3,"chr1",13069201,13072800,3599,"cPa542_cPa345_cPa227"
"CNV_chr1_22926601-22936500","CNV_chr1_22926601-22936500",59,"chr1",22926601,22936500,9899,"cPa4_cPa18_cPa541_cPa14_cPa133"
"CNV_chr1_26325301-26331900","CNV_chr1_26325301-26331900",4,"chr1",26325301,26331900,6599,"cPa425_cPa254_cPa47_cPa404_cPa174_cPa392"
"CNV_chr1_31463401-31471800","CNV_chr1_31463401-31471800",200,"chr1",31463401,31471800,8399,"cPa60_cPa285_cPa546_cPa232"
"CNV_chr1_32302501-32308200","CNV_chr1_32302501-32308200",10,"chr1",32302501,32308200,5699,"cPa510_cPa515_cPa127_cPa540"
"CNV_chr1_43506301-43516500","CNV_chr1_43506301-43516500",41,"chr1",43506301,43516500,10199,"cPa47_cPa254_cPa425_cPa199_cPa515_cPa127_cPa540_cPa290_cPa11_cPa241_cPa530_cPa531"
"CNV_chr1_43595401-43604700","CNV_chr1_43595401-43604700",168,"chr1",43595401,43604700,9299,"cPa47_cPa254_cPa425_cPa199_cPa404_cPa174_cPa392_cPa118"
"CNV_chr1_43952101-43962900","CNV_chr1_43952101-43962900",206,"chr1",43952101,43962900,10799,"cPa199_cPa273_cPa220_cPa190_cPa104"
"CNV_chr1_44791501-44796000","CNV_chr1_44791501-44796000",6,"chr1",44791501,44796000,4499,"cPa345_cPa150_cPa302_cPa246_cPa435_cPa518"
"CNV_chr1_44952901-44963700","CNV_chr1_44952901-44963700",76,"chr1",44952901,44963700,10799,"cPa345_cPa541_cPa14_cPa4_cPa133_cPa188"
"CNV_chr1_52022101-52028700","CNV_chr1_52022101-52028700",7,"chr1",52022101,52028700,6599,"cPa61_cPa264_cPa268_cPa248_cPa443_cPa118_cPa140_cPa15_cPa125_cPa516_cPa404_cPa254_cPa47_cPa119_cPa174"
"CNV_chr1_53379901-53384700","CNV_chr1_53379901-53384700",10,"chr1",53379901,53384700,4799,"cPa268_cPa248_cPa118_cPa140_cPa15_cPa223_cPa425_cPa47_cPa254_cPa264_cPa125_cPa404_cPa174_cPa443_cPa119_cPa392"
"CNV_chr1_56018101-56028000","CNV_chr1_56018101-56028000",69,"chr1",56018101,56028000,9899,"cPa220_cPa18_cPa4_cPa190"
"CNV_chr1_60167701-60175500","CNV_chr1_60167701-60175500",58,"chr1",60167701,60175500,7799,"cPa392_cPa404_cPa174_cPa47_cPa254_cPa425"
"CNV_chr1_63450301-63453900","CNV_chr1_63450301-63453900",23,"chr1",63450301,63453900,3599,"cPa391_cPa287_cPa293_cPa426_cPa182_cPa386_cPa20_cPa427"
"CNV_chr1_72792901-72796500","CNV_chr1_72792901-72796500",3,"chr1",72792901,72796500,3599,"cPa62"
"CNV_chr1_76582201-76585200","CNV_chr1_76582201-76585200",16,"chr1",76582201,76585200,2999,"cPa268_cPa118_cPa125_cPa264_cPa248_cPa140_cPa15_cPa199_cPa345"
"CNV_chr1_93255601-93258900","CNV_chr1_93255601-93258900",6,"chr1",93255601,93258900,3299,"cPa516_cPa264_cPa268_cPa248_cPa443_cPa118_cPa140_cPa15_cPa125_cPa425_cPa254_cPa47_cPa119_cPa404_cPa174"
"CNV_chr1_112435801-112450500","CNV_chr1_112435801-112450500",12,"chr1",112435801,112450500,14699,"cPa199_cPa356"
"CNV_chr3_14461801-14476800","CNV_chr3_14461801-14476800",7,"chr3",14461801,14476800,14999,"cPa61_cPa50_cPa333_cPa223_cPa264_cPa125_cPa357_cPa227_cPa273"
"CNV_chr3_63027301-63043500","CNV_chr3_63027301-63043500",47,"chr3",63027301,63043500,16199,"cPa199_cPa515_cPa127_cPa540_cPa290_cPa531_cPa11_cPa241_cPa530"
"CNV_chr3_65905201-65919000","CNV_chr3_65905201-65919000",1,"chr3",65905201,65919000,13799,"cPa199_cPa345"
"CNV_chr3_70149901-70156200","CNV_chr3_70149901-70156200",45,"chr3",70149901,70156200,6299,"cPa199_cPa268_cPa443_cPa118_cPa125_cPa264_cPa61_cPa248_cPa140_cPa15_cPa516_cPa254_cPa404_cPa119_cPa174"
"CNV_chr3_74682901-74689200","CNV_chr3_74682901-74689200",5,"chr3",74682901,74689200,6299,"cPa443_cPa264_cPa61_cPa248_cPa118_cPa140_cPa15_cPa125_cPa516_cPa268_cPa119"
"CNV_chr3_79160401-79170600","CNV_chr3_79160401-79170600",21,"chr3",79160401,79170600,10199,"cPa246_cPa150_cPa302_cPa387_cPa518"
"CNV_chr3_79954201-79964100","CNV_chr3_79954201-79964100",42,"chr3",79954201,79964100,9899,"cPa443_cPa118_cPa15_cPa223_cPa545_cPa247_cPa95_cPa133"
"CNV_chr3_80196901-80206500","CNV_chr3_80196901-80206500",203,"chr3",80196901,80206500,9599,"cPa223_cPa516_cPa264_cPa268_cPa248_cPa443_cPa118_cPa140_cPa15_cPa125_cPa530_cPa127_cPa540_cPa290_cPa11_cPa531"
"CNV_chr3_86357701-86374800","CNV_chr3_86357701-86374800",17,"chr3",86357701,86374800,17099,"cPa227_cPa61"
"CNV_chr3_91956901-91963200","CNV_chr3_91956901-91963200",9,"chr3",91956901,91963200,6299,"cPa254_cPa47_cPa425_cPa264_cPa248_cPa443_cPa118_cPa140_cPa15_cPa125_cPa516_cPa268_cPa119"
"CNV_chr3_94673401-94690800","CNV_chr3_94673401-94690800",143,"chr3",94673401,94690800,17399,"cPa199_cPa255_cPa256_cPa479_cPa131_cPa216_cPa478_cPa438"
"CNV_chr3_94831201-94842300","CNV_chr3_94831201-94842300",35,"chr3",94831201,94842300,11099,"cPa199_cPa256_cPa60_cPa546_cPa257_cPa285_cPa130_cPa555"
"CNV_chr3_97199101-97210200","CNV_chr3_97199101-97210200",24,"chr3",97199101,97210200,11099,"cPa219_cPa258_cPa220_cPa104_cPa190"
"CNV_chr3_99254701-99261000","CNV_chr3_99254701-99261000",5,"chr3",99254701,99261000,6299,"cPa443_cPa264_cPa248_cPa140_cPa15_cPa125_cPa516_cPa268_cPa118_cPa61_cPa119_cPa404_cPa174_cPa425_cPa47"
"CNV_chr3_100679101-100689900","CNV_chr3_100679101-100689900",157,"chr3",100679101,100689900,10799,"cPa438_cPa255_cPa131_cPa216"
"CNV_chr3_104346001-104357700","CNV_chr3_104346001-104357700",14,"chr3",104346001,104357700,11699,"cPa220_cPa190_cPa104_cPa219_cPa258"
"CNV_chr3_107075101-107077500","CNV_chr3_107075101-107077500",8,"chr3",107075101,107077500,2399,"cPa332"
"CNV_chr3_110089501-110097900","CNV_chr3_110089501-110097900",1,"chr3",110089501,110097900,8399,"cPa248_cPa443_cPa118_cPa424_cPa327_cPa16_cPa260"
"CNV_chr3_111367501-111383100","CNV_chr3_111367501-111383100",3,"chr3",111367501,111383100,15599,"cPa268_cPa61_cPa443_cPa264_cPa248_cPa118_cPa140_cPa15_cPa125_cPa516"
"CNV_chr3_112195201-112209000","CNV_chr3_112195201-112209000",73,"chr3",112195201,112209000,13799,"cPa61_cPa223_cPa229_cPa449_cPa183_cPa424_cPa327"
"CNV_chrZ_2554801-2564100","CNV_chrZ_2554801-2564100",5,"chrZ",2554801,2564100,9299,"cPa125_cPa438_cPa479_cPa255_cPa131_cPa478"
"CNV_chrZ_2579401-2590800","CNV_chrZ_2579401-2590800",55,"chrZ",2579401,2590800,11399,"cPa125_cPa478_cPa479_cPa255_cPa131"
"CNV_chrZ_3240301-3255300","CNV_chrZ_3240301-3255300",38,"chrZ",3240301,3255300,14999,"cPa443_cPa256_cPa101"
"CNV_chrZ_3695401-3705000","CNV_chrZ_3695401-3705000",35,"chrZ",3695401,3705000,9599,"cPa443_cPa199_cPa515_cPa290_cPa127_cPa540_cPa11_cPa241_cPa530_cPa531"
"CNV_chrZ_3729901-3740700","CNV_chrZ_3729901-3740700",8,"chrZ",3729901,3740700,10799,"cPa443_cPa518_cPa205_cPa390_cPa444"
"CNV_chrZ_3743401-3746700","CNV_chrZ_3743401-3746700",4,"chrZ",3743401,3746700,3299,"cPa443_cPa390_cPa62"
"CNV_chrZ_4753501-4765200","CNV_chrZ_4753501-4765200",3,"chrZ",4753501,4765200,11699,"cPa61_cPa410"
"CNV_chrZ_4953901-4966200","CNV_chrZ_4953901-4966200",105,"chrZ",4953901,4966200,12299,"cPa541_cPa14_cPa4_cPa133_cPa188"
"CNV_chrZ_5237701-5251200","CNV_chrZ_5237701-5251200",2,"chrZ",5237701,5251200,13499,"cPa529_cPa545_cPa95_cPa247"
"CNV_chrZ_8304901-8317800","CNV_chrZ_8304901-8317800",102,"chrZ",8304901,8317800,12899,"cPa201_cPa109_cPa106_cPa118_cPa264_cPa248_cPa140_cPa15_cPa125_cPa516_cPa268_cPa381_cPa582_cPa356"
"CNV_chrZ_8334601-8342400","CNV_chrZ_8334601-8342400",57,"chrZ",8334601,8342400,7799,"cPa201_cPa109_cPa106_cPa118_cPa264_cPa248_cPa140_cPa15_cPa125_cPa516_cPa268_cPa381_cPa356_cPa152_cPa505"
"CNV_chrZ_10977301-10989900","CNV_chrZ_10977301-10989900",9,"chrZ",10977301,10989900,12599,"cPa268_cPa74"
"CNV_chrZ_12409801-12421500","CNV_chrZ_12409801-12421500",149,"chrZ",12409801,12421500,11699,"cPa563_cPa526_cPa463_cPa438"
"CNV_chrZ_14135101-14138100","CNV_chrZ_14135101-14138100",4,"chrZ",14135101,14138100,2999,"cPa332"
"CNV_chrZ_25868701-25875300","CNV_chrZ_25868701-25875300",16,"chrZ",25868701,25875300,6599,"cPa404_cPa174_cPa47_cPa254_cPa425_cPa61_cPa118_cPa264_cPa248_cPa443_cPa140_cPa15_cPa125_cPa516_cPa268_cPa119"
"CNV_chrZ_27653701-27661800","CNV_chrZ_27653701-27661800",66,"chrZ",27653701,27661800,8099,"cPa264_cPa140_cPa268_cPa183_cPa61_cPa395_cPa327_cPa424_cPa308_cPa248_cPa443_cPa118_cPa15_cPa125_cPa516_cPa205"
"CNV_chrZ_29418901-29427900","CNV_chrZ_29418901-29427900",8,"chrZ",29418901,29427900,8999,"cPa183_cPa61_cPa205_cPa363_cPa452_cPa390_cPa345_cPa201_cPa444_cPa67_cPa194"
"CNV_chrZ_29701201-29719500","CNV_chrZ_29701201-29719500",4,"chrZ",29701201,29719500,18299,"cPa363_cPa452_cPa345_cPa201_cPa456_cPa390_cPa205_cPa61_cPa50_cPa323_cPa333_cPa339_cPa502_cPa353_cPa505_cPa109_cPa152"
"CNV_chrZ_32071501-32085000","CNV_chrZ_32071501-32085000",32,"chrZ",32071501,32085000,13499,"cPa510_cPa511"
"CNV_chrZ_36000901-36006900","CNV_chrZ_36000901-36006900",11,"chrZ",36000901,36006900,5999,"cPa125_cPa443_cPa516_cPa264_cPa268_cPa248_cPa118_cPa140_cPa15_cPa254_cPa47_cPa119_cPa404_cPa174"
"CNV_chrZ_36975301-36981000","CNV_chrZ_36975301-36981000",6,"chrZ",36975301,36981000,5699,"cPa223_cPa516_cPa264_cPa268_cPa248_cPa443_cPa118_cPa140_cPa15_cPa125_cPa119"
"CNV_chrZ_39343501-39355500","CNV_chrZ_39343501-39355500",38,"chrZ",39343501,39355500,11999,"cPa61_cPa526_cPa463"
"CNV_chrZ_39651601-39664800","CNV_chrZ_39651601-39664800",63,"chrZ",39651601,39664800,13199,"cPa527"
"CNV_chrZ_41562001-41571000","CNV_chrZ_41562001-41571000",10,"chrZ",41562001,41571000,8999,"cPa264_cPa248_cPa443_cPa118_cPa140_cPa15_cPa125_cPa516_cPa268_cPa587_cPa529_cPa545_cPa133"
"CNV_chrZ_42649201-42658200","CNV_chrZ_42649201-42658200",69,"chrZ",42649201,42658200,8999,"cPa530_cPa515_cPa127_cPa540_cPa290_cPa11_cPa241_cPa531"
"CNV_chrZ_42661201-42665100","CNV_chrZ_42661201-42665100",69,"chrZ",42661201,42665100,3899,"cPa540_cPa290_cPa11_cPa241_cPa515_cPa127_cPa530_cPa531"
"CNV_chrZ_49874701-49884300","CNV_chrZ_49874701-49884300",16,"chrZ",49874701,49884300,9599,"cPa515_cPa127_cPa540_cPa290_cPa11_cPa241_cPa530_cPa531"
"CNV_chrZ_50541301-50550000","CNV_chrZ_50541301-50550000",54,"chrZ",50541301,50550000,8699,"cPa515_cPa199_cPa542_cPa450_cPa273"
"CNV_chrZ_51780901-51792000","CNV_chrZ_51780901-51792000",33,"chrZ",51780901,51792000,11099,"cPa543_cPa544"
"CNV_chrZ_52221601-52231800","CNV_chrZ_52221601-52231800",19,"chrZ",52221601,52231800,10199,"cPa544_cPa107"
"CNV_chrZ_53071201-53081400","CNV_chrZ_53071201-53081400",5,"chrZ",53071201,53081400,10199,"cPa60_cPa130_cPa546_cPa257_cPa285_cPa518"
"CNV_chrZ_53320201-53331600","CNV_chrZ_53320201-53331600",72,"chrZ",53320201,53331600,11399,"cPa518_cPa549"
"CNV_chrZ_54949801-54961200","CNV_chrZ_54949801-54961200",18,"chrZ",54949801,54961200,11399,"cPa50_cPa333_cPa551_cPa145"
"CNV_chrZ_59233501-59242200","CNV_chrZ_59233501-59242200",55,"chrZ",59233501,59242200,8699,"cPa554"
"CNV_chrZ_63002101-63013200","CNV_chrZ_63002101-63013200",41,"chrZ",63002101,63013200,11099,"cPa152_cPa201_cPa505_cPa109_cPa563_cPa463_cPa438"
"CNV_chrZ_64210801-64223100","CNV_chrZ_64210801-64223100",3,"chrZ",64210801,64223100,12299,"cPa61_cPa357_cPa67_cPa194_cPa264_cPa248_cPa443_cPa118_cPa140_cPa15_cPa125_cPa516_cPa268_cPa119"
"CNV_chrZ_64497601-64514400","CNV_chrZ_64497601-64514400",32,"chrZ",64497601,64514400,16799,"cPa264_cPa118_cPa15_cPa516_cPa194_cPa268_cPa248_cPa443_cPa140_cPa125_cPa425_cPa254_cPa119_cPa404_cPa174"
"CNV_chrZ_71270701-71275500","CNV_chrZ_71270701-71275500",6,"chrZ",71270701,71275500,4799,"cPa315"
"CNV_chrZ_71602501-71610600","CNV_chrZ_71602501-71610600",4,"chrZ",71602501,71610600,8099,"cPa575_cPa398"
"CNV_chr1A_456601-472500","CNV_chr1A_456601-472500",48,"chr1A",456601,472500,15899,"cPa260"
"CNV_chr1A_924301-938400","CNV_chr1A_924301-938400",11,"chr1A",924301,938400,14099,"cPa75_cPa260"
"CNV_chr1A_1403401-1425900","CNV_chr1A_1403401-1425900",38,"chr1A",1403401,1425900,22499,"cPa227_cPa16_cPa450_cPa260"
"CNV_chr1A_4510501-4523400","CNV_chr1A_4510501-4523400",103,"chr1A",4510501,4523400,12899,"cPa492"
"CNV_chr1A_4973101-4989600","CNV_chr1A_4973101-4989600",10,"chr1A",4973101,4989600,16499,"cPa152"
"CNV_chr1A_6693001-6696300","CNV_chr1A_6693001-6696300",1,"chr1A",6693001,6696300,3299,"cPa424"
"CNV_chr1A_10641601-10652700","CNV_chr1A_10641601-10652700",206,"chr1A",10641601,10652700,11099,"cPa95_cPa545_cPa247_cPa133"
"CNV_chr1A_15270901-15283200","CNV_chr1A_15270901-15283200",149,"chr1A",15270901,15283200,12299,"cPa264_cPa268_cPa248_cPa443_cPa118_cPa140_cPa15_cPa125_cPa516_cPa530_cPa515_cPa127_cPa540_cPa290_cPa531_cPa11_cPa241"
"CNV_chr1A_17610601-17623500","CNV_chr1A_17610601-17623500",260,"chr1A",17610601,17623500,12899,"cPa95_cPa545_cPa526_cPa247"
"CNV_chr1A_17670901-17680800","CNV_chr1A_17670901-17680800",1,"chr1A",17670901,17680800,9899,"cPa95_cPa545_cPa247_cPa133_cPa18"
"CNV_chr1A_27660601-27672000","CNV_chr1A_27660601-27672000",10,"chr1A",27660601,27672000,11399,"cPa199_cPa425_cPa404_cPa174_cPa47_cPa254_cPa118_cPa119_cPa264"
"CNV_chr1A_29768401-29778900","CNV_chr1A_29768401-29778900",64,"chr1A",29768401,29778900,10499,"cPa256_cPa101"
"CNV_chr1A_30894301-30900600","CNV_chr1A_30894301-30900600",38,"chr1A",30894301,30900600,6299,"cPa264_cPa61_cPa248_cPa443_cPa118_cPa140_cPa15_cPa125_cPa516_cPa268_cPa119_cPa404_cPa174_cPa254"
"CNV_chr1A_32424001-32431200","CNV_chr1A_32424001-32431200",35,"chr1A",32424001,32431200,7199,"cPa425_cPa47_cPa254_cPa516_cPa264_cPa268_cPa248_cPa443_cPa118_cPa140_cPa15_cPa125_cPa61_cPa404_cPa174_cPa119"
"CNV_chr1A_40438201-40448700","CNV_chr1A_40438201-40448700",6,"chr1A",40438201,40448700,10499,"cPa220_cPa190_cPa104_cPa18_cPa219_cPa258"
"CNV_chr1A_41267401-41273400","CNV_chr1A_41267401-41273400",49,"chr1A",41267401,41273400,5999,"cPa425_cPa47_cPa254"
"CNV_chr1A_53943301-53949900","CNV_chr1A_53943301-53949900",3,"chr1A",53943301,53949900,6599,"cPa268_cPa15_cPa264_cPa248_cPa140_cPa443_cPa118_cPa125_cPa516_cPa107_cPa199_cPa223_cPa152_cPa109_cPa505_cPa201_cPa106"
"CNV_chr1A_54049801-54062100","CNV_chr1A_54049801-54062100",3,"chr1A",54049801,54062100,12299,"cPa15_cPa268_cPa443_cPa199_cPa223_cPa109_cPa201_cPa313_cPa264_cPa248_cPa118_cPa140_cPa125_cPa516_cPa419_cPa183"
"CNV_chr1A_56193901-56202600","CNV_chr1A_56193901-56202600",2,"chr1A",56193901,56202600,8699,"cPa268_cPa223_cPa443_cPa118_cPa125_cPa264_cPa248_cPa140_cPa15_cPa516_cPa273_cPa75_cPa357"
"CNV_chr1A_56309701-56317800","CNV_chr1A_56309701-56317800",3,"chr1A",56309701,56317800,8099,"cPa268_cPa223_cPa273_cPa118_cPa264_cPa248_cPa443_cPa140_cPa15_cPa125_cPa516_cPa67_cPa227"
"CNV_chr1A_60512701-60524100","CNV_chr1A_60512701-60524100",1,"chr1A",60512701,60524100,11399,"cPa482"
"CNV_chr1A_61120801-61131000","CNV_chr1A_61120801-61131000",2,"chr1A",61120801,61131000,10199,"cPa264_cPa248_cPa443_cPa118_cPa140_cPa15_cPa125_cPa516_cPa268_cPa113_cPa332"
"CNV_chr1A_65267401-65282700","CNV_chr1A_65267401-65282700",26,"chr1A",65267401,65282700,15299,"HERV-W_repbase_HERV17_LTR17"
"CNV_chr4_1293601-1310700","CNV_chr4_1293601-1310700",51,"chr4",1293601,1310700,17099,"cPa75"
"CNV_chr4_24656101-24662400","CNV_chr4_24656101-24662400",4,"chr4",24656101,24662400,6299,"cPa268_cPa516_cPa264_cPa248_cPa118_cPa140_cPa15_cPa125_cPa61_cPa443_cPa425_cPa254_cPa47_cPa119_cPa404_cPa174"
"CNV_chr4_25095001-25104300","CNV_chr4_25095001-25104300",37,"chr4",25095001,25104300,9299,"cPa199_cPa220_cPa104_cPa219_cPa258_cPa190"
"CNV_chr4_26835001-26838600","CNV_chr4_26835001-26838600",11,"chr4",26835001,26838600,3599,"cPa264_cPa248_cPa443_cPa125_cPa61_cPa118_cPa140_cPa15_cPa516_cPa268_cPa119_cPa174_cPa254"
"CNV_chr4_41396101-41403300","CNV_chr4_41396101-41403300",1,"chr4",41396101,41403300,7199,"cPa450"
"CNV_chr4_60037201-60042000","CNV_chr4_60037201-60042000",19,"chr4",60037201,60042000,4799,"cPa264_cPa268_cPa61_cPa248_cPa443_cPa118_cPa140_cPa15_cPa125_cPa516_cPa254_cPa119_cPa404_cPa174"
"CNV_chr5_3783301-3789600","CNV_chr5_3783301-3789600",99,"chr5",3783301,3789600,6299,"cPa268_cPa223_cPa15_cPa516_cPa273_cPa443_cPa118_cPa125_cPa264_cPa248_cPa140_cPa119"
"CNV_chr5_6416101-6431700","CNV_chr5_6416101-6431700",160,"chr5",6416101,6431700,15599,"cPa515_cPa127_cPa540_cPa290_cPa11_cPa241_cPa531_cPa530_cPa272"
"CNV_chr5_29998801-30005700","CNV_chr5_29998801-30005700",189,"chr5",29998801,30005700,6899,"cPa264_cPa125_cPa61_cPa248_cPa443_cPa118_cPa140_cPa15_cPa516_cPa268_cPa119"
"CNV_chr5_42502201-42509700","CNV_chr5_42502201-42509700",11,"chr5",42502201,42509700,7499,"cPa199_cPa285_cPa257_cPa546_cPa60_cPa555"
"CNV_chr7_495601-505200","CNV_chr7_495601-505200",7,"chr7",495601,505200,9599,"cPa260_cPa248_cPa268_cPa308_cPa196_cPa459_cPa305_cPa433_cPa424_cPa327_cPa125_cPa439_cPa425_cPa95_cPa529_cPa133_cPa246_cPa358_cPa251"
"CNV_chr7_521101-535200","CNV_chr7_521101-535200",21,"chr7",521101,535200,14099,"cPa260_cPa248_cPa268_cPa308_cPa125_cPa196_cPa459_cPa439_cPa305_cPa424_cPa327_cPa433_cPa425_cPa404_cPa174"
"CNV_chr7_1216201-1228200","CNV_chr7_1216201-1228200",4,"chr7",1216201,1228200,11999,"cPa248_cPa268_cPa125_cPa308_cPa424_cPa327_cPa140_cPa15_cPa443_cPa516_cPa264_cPa118_cPa67"
"CNV_chr7_1510801-1517400","CNV_chr7_1510801-1517400",1,"chr7",1510801,1517400,6599,"cPa248_cPa268_cPa308_cPa327_cPa140_cPa15_cPa443_cPa264_cPa125_cPa516_cPa118_cPa410_cPa223"
"CNV_chr7_1525801-1536900","CNV_chr7_1525801-1536900",1,"chr7",1525801,1536900,11099,"cPa248_cPa268_cPa308_cPa327_cPa140_cPa15_cPa443_cPa264_cPa125_cPa516_cPa118_cPa410_cPa223"
"CNV_chr7_1538701-1550700","CNV_chr7_1538701-1550700",3,"chr7",1538701,1550700,11999,"cPa248_cPa268_cPa308_cPa327_cPa140_cPa15_cPa443_cPa264_cPa125_cPa516_cPa118_cPa410_cPa223"
"CNV_chr7_30002701-30012900","CNV_chr7_30002701-30012900",41,"chr7",30002701,30012900,10199,"cPa246_cPa150_cPa302_cPa188"
"CNV_chr7_32983201-32990400","CNV_chr7_32983201-32990400",1,"chr7",32983201,32990400,7199,"cPa199_cPa223"
"CNV_chr7_37464901-37479900","CNV_chr7_37464901-37479900",115,"chr7",37464901,37479900,14999,"cPa424_cPa327_cPa260_cPa486"
"CNV_chr11_3577801-3584400","CNV_chr11_3577801-3584400",53,"chr11",3577801,3584400,6599,"cPa264_cPa248_cPa443_cPa118_cPa140_cPa15_cPa125_cPa516_cPa268_cPa61_cPa119_cPa47"
"CNV_chr11_15024001-15033900","CNV_chr11_15024001-15033900",287,"chr11",15024001,15033900,9899,"cPa190_cPa219_cPa258"
"CNV_chr11_17644501-17656800","CNV_chr11_17644501-17656800",40,"chr11",17644501,17656800,12299,"cPa199_cPa140_cPa248_cPa443_cPa264_cPa118_cPa125_cPa516_cPa268_cPa15_cPa47_cPa425_cPa254_cPa61_cPa205_cPa62_cPa390_cPa444_cPa308_cPa51_cPa552_cPa145"
"CNV_chr11_17881501-17885400","CNV_chr11_17881501-17885400",1,"chr11",17881501,17885400,3899,"cPa199_cPa268_cPa264_cPa248_cPa118_cPa125_cPa542_cPa443_cPa140_cPa15_cPa392_cPa450_cPa56"
"CNV_chr11_20068801-20074500","CNV_chr11_20068801-20074500",1,"chr11",20068801,20074500,5699,"cPa268_cPa248_cPa443_cPa118_cPa140_cPa125_cPa327_cPa486_cPa194"
"CNV_chr13_15710401-15727800","CNV_chr13_15710401-15727800",11,"chr13",15710401,15727800,17399,"cPa199"
"CNV_chr13_15819001-15822300","CNV_chr13_15819001-15822300",4,"chr13",15819001,15822300,3299,"cPa199_cPa356_cPa428"
"CNV_chr13_16685401-16695000","CNV_chr13_16685401-16695000",31,"chr13",16685401,16695000,9599,"cPa268_cPa260_cPa327_cPa410_cPa61_cPa248_cPa443_cPa118_cPa140_cPa15_cPa125_cPa264_cPa450_cPa566"
"CNV_chr14_1528201-1545000","CNV_chr14_1528201-1545000",21,"chr14",1528201,1545000,16799,"cPa273_cPa223_cPa260"
"CNV_chr14_3491101-3498600","CNV_chr14_3491101-3498600",1,"chr14",3491101,3498600,7499,"cPa450_cPa199_cPa183_cPa74_cPa402_cPa539"
"CNV_chr17_8811901-8827500","CNV_chr17_8811901-8827500",20,"chr17",8811901,8827500,15599,"cPa410_cPa268_cPa446_cPa379_cPa264_cPa118_cPa140_cPa15_cPa125_cPa248_cPa443_cPa61_cPa516_cPa482"
"CNV_chr17_10035301-10048200","CNV_chr17_10035301-10048200",10,"chr17",10035301,10048200,12899,"cPa379_cPa264_cPa248_cPa140_cPa15_cPa125_cPa443_cPa118_cPa260_cPa327"
"CNV_chr17_10224601-10239300","CNV_chr17_10224601-10239300",22,"chr17",10224601,10239300,14699,"cPa264_cPa248_cPa140_cPa15_cPa125_cPa443_cPa118_cPa260_cPa327_cPa410_cPa425"
"CNV_chr17_10705801-10720200","CNV_chr17_10705801-10720200",19,"chr17",10705801,10720200,14399,"cPa443_cPa516_cPa264_cPa268_cPa248_cPa118_cPa140_cPa15_cPa125_cPa260_cPa152_cPa201_cPa109_cPa505_cPa106"
"CNV_chr17_11076901-11092500","CNV_chr17_11076901-11092500",60,"chr17",11076901,11092500,15599,"cPa443_cPa516_cPa264_cPa268_cPa248_cPa118_cPa140_cPa15_cPa125_cPa260_cPa410"
"CNV_chr17_11481001-11494200","CNV_chr17_11481001-11494200",12,"chr17",11481001,11494200,13199,"cPa371"
"CNV_chr23_319201-324600","CNV_chr23_319201-324600",3,"chr23",319201,324600,5399,"cPa363_cPa264_cPa125_cPa443_cPa15_cPa516_cPa268_cPa61_cPa248_cPa118_cPa140_cPa404_cPa119"
"CNV_chr23_585301-592800","CNV_chr23_585301-592800",3,"chr23",585301,592800,7499,"cPa363_cPa264_cPa125_cPa516_cPa268_cPa248_cPa443_cPa118_cPa140_cPa15_cPa424_cPa223_cPa327_cPa61_cPa260_cPa452_cPa566"
"CNV_chr23_1382101-1392000","CNV_chr23_1382101-1392000",4,"chr23",1382101,1392000,9899,"cPa516_cPa264_cPa268_cPa248_cPa443_cPa118_cPa140_cPa15_cPa125_cPa61_cPa566_cPa542_cPa482_cPa410_cPa260"
"CNV_chr23_1518001-1532400","CNV_chr23_1518001-1532400",1,"chr23",1518001,1532400,14399,"cPa516_cPa264_cPa268_cPa248_cPa443_cPa118_cPa140_cPa15_cPa125_cPa61_cPa542_cPa260_cPa410"
"CNV_chr23_3156001-3165600","CNV_chr23_3156001-3165600",6,"chr23",3156001,3165600,9599,"cPa446_cPa419"
"CNV_chr23_5724601-5739600","CNV_chr23_5724601-5739600",32,"chr23",5724601,5739600,14999,"cPa424_cPa357"
"CNV_chr22_2025601-2040600","CNV_chr22_2025601-2040600",5,"chr22",2025601,2040600,14999,"cPa268_cPa486_cPa482"
"CNV_chr22_2357401-2372100","CNV_chr22_2357401-2372100",27,"chr22",2357401,2372100,14699,"cPa482_cPa486_cPa16_cPa183_cPa176_cPa371_cPa568"
"CNV_chr22_3431401-3452700","CNV_chr22_3431401-3452700",87,"chr22",3431401,3452700,21299,"cPa268_cPa446_cPa443_cPa125_cPa248_cPa118_cPa264_cPa140_cPa15"
"CNV_chr22_3597901-3613500","CNV_chr22_3597901-3613500",85,"chr22",3597901,3613500,15599,"cPa268_cPa446_cPa443_cPa125_cPa248_cPa118_cPa264_cPa140_cPa15_cPa260"
"CNV_chr22_4162801-4173600","CNV_chr22_4162801-4173600",49,"chr22",4162801,4173600,10799,"cPa268_cPa443_cPa118_cPa125_cPa264_cPa248_cPa140_cPa15_cPa273_cPa227_cPa516_cPa71_cPa410_cPa220_cPa190_cPa104_cPa219_cPa18_cPa258_cPa407"
"CNV_chr22_4185301-4201500","CNV_chr22_4185301-4201500",161,"chr22",4185301,4201500,16199,"cPa268_cPa443_cPa118_cPa125_cPa264_cPa248_cPa140_cPa15_cPa273_cPa516_cPa71_cPa410_cPa363_cPa176_cPa16_cPa452_cPa223"
"CNV_chr22_4411501-4421700","CNV_chr22_4411501-4421700",3,"chr22",4411501,4421700,10199,"cPa268_cPa443_cPa118_cPa125_cPa264_cPa248_cPa140_cPa15_cPa516_cPa183_cPa486_cPa410_cPa553_cPa450_cPa260"
"CNV_Scaffold152_1-11700","CNV_Scaffold152_1-11700",6,"Scaffold152",1,11700,11699,"cPa428_cPa356"
"CNV_Scaffold152_20701-25800","CNV_Scaffold152_20701-25800",3,"Scaffold152",20701,25800,5099,"cPa428_cPa356"
"CNV_Scaffold152_33001-35700","CNV_Scaffold152_33001-35700",1,"Scaffold152",33001,35700,2699,"cPa428_cPa356"
"CNV_Scaffold152_41101-49200","CNV_Scaffold152_41101-49200",18,"Scaffold152",41101,49200,8099,"cPa428_cPa356"
"CNV_Scaffold152_98701-107100","CNV_Scaffold152_98701-107100",56,"Scaffold152",98701,107100,8399,"cPa428"
"CNV_Scaffold190_1-13200","CNV_Scaffold190_1-13200",45,"Scaffold190",1,13200,13199,"cPa356_cPa428"
"CNV_Scaffold190_61201-67200","CNV_Scaffold190_61201-67200",23,"Scaffold190",61201,67200,5999,"cPa428_cPa356"
"CNV_Scaffold199_1-14400","CNV_Scaffold199_1-14400",88,"Scaffold199",1,14400,14399,"cPa419"
"CNV_Scaffold1667_28501-36900","CNV_Scaffold1667_28501-36900",126,"Scaffold1667",28501,36900,8399,"cPa308"
"CNV_Scaffold242_1-11100","CNV_Scaffold242_1-11100",279,"Scaffold242",1,11100,11099,"cPa356_cPa428"
"CNV_Scaffold242_17101-24000","CNV_Scaffold242_17101-24000",126,"Scaffold242",17101,24000,6899,"cPa428_cPa356"
"CNV_Scaffold254_1-6000","CNV_Scaffold254_1-6000",186,"Scaffold254",1,6000,5999,"cPa428_cPa356"
"CNV_Scaffold254_15301-29700","CNV_Scaffold254_15301-29700",55,"Scaffold254",15301,29700,14399,"cPa428_cPa356"
"CNV_Scaffold290_1-10200","CNV_Scaffold290_1-10200",192,"Scaffold290",1,10200,10199,"cPa428_cPa356"
"CNV_Scaffold290_30601-37200","CNV_Scaffold290_30601-37200",22,"Scaffold290",30601,37200,6599,"cPa356"
"CNV_Scaffold306_1-13800","CNV_Scaffold306_1-13800",57,"Scaffold306",1,13800,13799,"cPa356_cPa428"
"CNV_Scaffold312_1-7200","CNV_Scaffold312_1-7200",62,"Scaffold312",1,7200,7199,"cPa356"
"CNV_Scaffold312_30301-35400","CNV_Scaffold312_30301-35400",71,"Scaffold312",30301,35400,5099,"cPa356"
"CNV_Scaffold395_21001-25800","CNV_Scaffold395_21001-25800",35,"Scaffold395",21001,25800,4799,"cPa428_cPa356"
"CNV_Scaffold430_1-4800","CNV_Scaffold430_1-4800",9,"Scaffold430",1,4800,4799,"cPa356_cPa428"
"CNV_Scaffold430_20101-26700","CNV_Scaffold430_20101-26700",150,"Scaffold430",20101,26700,6599,"cPa428_cPa356"
"CNV_Scaffold465_1-13500","CNV_Scaffold465_1-13500",19,"Scaffold465",1,13500,13499,"cPa356_cPa428"
"CNV_Scaffold473_1-12300","CNV_Scaffold473_1-12300",96,"Scaffold473",1,12300,12299,"cPa428_cPa356"
"CNV_Scaffold473_14401-20700","CNV_Scaffold473_14401-20700",6,"Scaffold473",14401,20700,6299,"cPa428_cPa356"
"CNV_Scaffold496_1-9900","CNV_Scaffold496_1-9900",86,"Scaffold496",1,9900,9899,"cPa356_cPa428"
"CNV_Scaffold496_16201-22200","CNV_Scaffold496_16201-22200",3,"Scaffold496",16201,22200,5999,"cPa428_cPa356"
"CNV_Scaffold497_1-14100","CNV_Scaffold497_1-14100",93,"Scaffold497",1,14100,14099,"cPa356"
"CNV_Scaffold59_17701-21900","CNV_Scaffold59_17701-21900",18,"Scaffold59",17701,21900,4199,"cPa434"
"CNV_Scaffold521_11401-21000","CNV_Scaffold521_11401-21000",25,"Scaffold521",11401,21000,9599,"cPa419"
"CNV_Scaffold534_5401-20100","CNV_Scaffold534_5401-20100",127,"Scaffold534",5401,20100,14699,"cPa428_cPa356"
"CNV_Scaffold536_1-10200","CNV_Scaffold536_1-10200",216,"Scaffold536",1,10200,10199,"cPa356_cPa428"
"CNV_Scaffold547_1-14700","CNV_Scaffold547_1-14700",141,"Scaffold547",1,14700,14699,"cPa356"
"CNV_Scaffold110_1-12300","CNV_Scaffold110_1-12300",114,"Scaffold110",1,12300,12299,"cPa356_cPa428"
"CNV_Scaffold116_3601-18300","CNV_Scaffold116_3601-18300",258,"Scaffold116",3601,18300,14699,"cPa356_cPa428"
"CNV_Scaffold573_1-4800","CNV_Scaffold573_1-4800",35,"Scaffold573",1,4800,4799,"cPa434_cPa428"
"CNV_Scaffold585_1-7500","CNV_Scaffold585_1-7500",131,"Scaffold585",1,7500,7499,"cPa428_cPa356"
"CNV_Scaffold40_1-11100","CNV_Scaffold40_1-11100",6,"Scaffold40",1,11100,11099,"cPa308"
"CNV_Scaffold593_1-8400","CNV_Scaffold593_1-8400",224,"Scaffold593",1,8400,8399,"cPa356_cPa428"
"CNV_Scaffold593_14401-17100","CNV_Scaffold593_14401-17100",69,"Scaffold593",14401,17100,2699,"cPa356"
"CNV_Scaffold642_1-15000","CNV_Scaffold642_1-15000",154,"Scaffold642",1,15000,14999,"cPa356_cPa428"
"CNV_Scaffold850_1-15000","CNV_Scaffold850_1-15000",273,"Scaffold850",1,15000,14999,"cPa428_cPa356"
"CNV_Scaffold873_1-13800","CNV_Scaffold873_1-13800",265,"Scaffold873",1,13800,13799,"cPa356"
"CNV_Scaffold889_1-13200","CNV_Scaffold889_1-13200",292,"Scaffold889",1,13200,13199,"cPa356_cPa428"
"CNV_Scaffold911_1-12900","CNV_Scaffold911_1-12900",184,"Scaffold911",1,12900,12899,"cPa356_cPa428"
"CNV_Scaffold920_1-12600","CNV_Scaffold920_1-12600",253,"Scaffold920",1,12600,12599,"cPa356_cPa428"
"CNV_Scaffold935_3601-12000","CNV_Scaffold935_3601-12000",110,"Scaffold935",3601,12000,8399,"cPa264_cPa268_cPa61_cPa248_cPa443_cPa118_cPa140_cPa15_cPa125_cPa516_cPa119_cPa254"
"CNV_Scaffold947_1-11700","CNV_Scaffold947_1-11700",173,"Scaffold947",1,11700,11699,"cPa428_cPa356"
"CNV_Scaffold950_1-11700","CNV_Scaffold950_1-11700",210,"Scaffold950",1,11700,11699,"cPa356_cPa428"
"CNV_Scaffold957_1-7800","CNV_Scaffold957_1-7800",70,"Scaffold957",1,7800,7799,"cPa356_cPa428"
"CNV_Scaffold957_9301-11400","CNV_Scaffold957_9301-11400",4,"Scaffold957",9301,11400,2099,"cPa356"
"CNV_Scaffold959_1-11400","CNV_Scaffold959_1-11400",68,"Scaffold959",1,11400,11399,"cPa428_cPa356"
"CNV_Scaffold961_1-11400","CNV_Scaffold961_1-11400",246,"Scaffold961",1,11400,11399,"cPa356_cPa428"
"CNV_Scaffold967_1-11400","CNV_Scaffold967_1-11400",123,"Scaffold967",1,11400,11399,"cPa199_cPa353_cPa74"
"CNV_Scaffold978_1-11100","CNV_Scaffold978_1-11100",276,"Scaffold978",1,11100,11099,"cPa428_cPa356"
"CNV_Scaffold984_1-10800","CNV_Scaffold984_1-10800",257,"Scaffold984",1,10800,10799,"cPa356_cPa428"
"CNV_Scaffold993_1-10800","CNV_Scaffold993_1-10800",289,"Scaffold993",1,10800,10799,"cPa428_cPa356"
"CNV_Scaffold1001_1-10500","CNV_Scaffold1001_1-10500",188,"Scaffold1001",1,10500,10499,"cPa428_cPa356"
"CNV_Scaffold1002_1-10500","CNV_Scaffold1002_1-10500",282,"Scaffold1002",1,10500,10499,"cPa356_cPa428"
"CNV_Scaffold1003_1-10500","CNV_Scaffold1003_1-10500",84,"Scaffold1003",1,10500,10499,"cPa229_cPa313_cPa482_cPa199"
"CNV_Scaffold1004_1-10500","CNV_Scaffold1004_1-10500",291,"Scaffold1004",1,10500,10499,"cPa434"
"CNV_Scaffold1008_2101-10500","CNV_Scaffold1008_2101-10500",62,"Scaffold1008",2101,10500,8399,"cPa428_cPa356"
"CNV_Scaffold1011_1-10500","CNV_Scaffold1011_1-10500",273,"Scaffold1011",1,10500,10499,"cPa356_cPa428"
"CNV_Scaffold1020_1-10200","CNV_Scaffold1020_1-10200",129,"Scaffold1020",1,10200,10199,"cPa434"
"CNV_Scaffold1022_1-10200","CNV_Scaffold1022_1-10200",215,"Scaffold1022",1,10200,10199,"cPa419"
"CNV_Scaffold1023_1-10200","CNV_Scaffold1023_1-10200",229,"Scaffold1023",1,10200,10199,"cPa428_cPa356"
"CNV_Scaffold1035_1-9900","CNV_Scaffold1035_1-9900",118,"Scaffold1035",1,9900,9899,"cPa356_cPa428"
"CNV_Scaffold1043_1-9900","CNV_Scaffold1043_1-9900",292,"Scaffold1043",1,9900,9899,"cPa428_cPa356"
"CNV_Scaffold1044_1-9900","CNV_Scaffold1044_1-9900",232,"Scaffold1044",1,9900,9899,"cPa356_cPa428"
"CNV_Scaffold1049_1-9600","CNV_Scaffold1049_1-9600",288,"Scaffold1049",1,9600,9599,"cPa428_cPa356"
"CNV_Scaffold1052_1-9600","CNV_Scaffold1052_1-9600",292,"Scaffold1052",1,9600,9599,"cPa356_cPa428"
"CNV_Scaffold1056_1-9600","CNV_Scaffold1056_1-9600",258,"Scaffold1056",1,9600,9599,"cPa356_cPa428"
"CNV_Scaffold1063_1-9300","CNV_Scaffold1063_1-9300",212,"Scaffold1063",1,9300,9299,"cPa428_cPa356"
"CNV_Scaffold1069_1-9300","CNV_Scaffold1069_1-9300",168,"Scaffold1069",1,9300,9299,"cPa419"
"CNV_Scaffold1092_1-9000","CNV_Scaffold1092_1-9000",256,"Scaffold1092",1,9000,8999,"cPa428_cPa356"
"CNV_Scaffold1110_1-8400","CNV_Scaffold1110_1-8400",263,"Scaffold1110",1,8400,8399,"cPa356_cPa428"
"CNV_Scaffold1118_1-8400","CNV_Scaffold1118_1-8400",130,"Scaffold1118",1,8400,8399,"cPa356_cPa428"
"CNV_Scaffold1122_1-8400","CNV_Scaffold1122_1-8400",196,"Scaffold1122",1,8400,8399,"cPa356_cPa428"
"CNV_Scaffold1126_1-8400","CNV_Scaffold1126_1-8400",290,"Scaffold1126",1,8400,8399,"cPa356_cPa428"
"CNV_Scaffold1127_1-8400","CNV_Scaffold1127_1-8400",264,"Scaffold1127",1,8400,8399,"cPa356_cPa428"
"CNV_Scaffold1129_1-8400","CNV_Scaffold1129_1-8400",288,"Scaffold1129",1,8400,8399,"cPa356_cPa428"
"CNV_Scaffold1132_1-8400","CNV_Scaffold1132_1-8400",283,"Scaffold1132",1,8400,8399,"cPa428_cPa356"
"CNV_Scaffold1138_1-8100","CNV_Scaffold1138_1-8100",227,"Scaffold1138",1,8100,8099,"cPa428_cPa356"
"CNV_Scaffold1139_1-8100","CNV_Scaffold1139_1-8100",287,"Scaffold1139",1,8100,8099,"cPa356_cPa428"
"CNV_Scaffold1145_1-8100","CNV_Scaffold1145_1-8100",228,"Scaffold1145",1,8100,8099,"cPa428_cPa356"
"CNV_Scaffold1144_1-8100","CNV_Scaffold1144_1-8100",267,"Scaffold1144",1,8100,8099,"cPa428_cPa356"
"CNV_Scaffold1153_1-8100","CNV_Scaffold1153_1-8100",281,"Scaffold1153",1,8100,8099,"cPa428_cPa356"
"CNV_Scaffold1155_1-8100","CNV_Scaffold1155_1-8100",240,"Scaffold1155",1,8100,8099,"cPa428_cPa356"
"CNV_Scaffold1158_1-7800","CNV_Scaffold1158_1-7800",291,"Scaffold1158",1,7800,7799,"cPa356_cPa428"
"CNV_Scaffold1167_1-7800","CNV_Scaffold1167_1-7800",291,"Scaffold1167",1,7800,7799,"cPa428"
"CNV_Scaffold1181_1-7500","CNV_Scaffold1181_1-7500",283,"Scaffold1181",1,7500,7499,"cPa356_cPa428"
"CNV_Scaffold1189_1-7500","CNV_Scaffold1189_1-7500",216,"Scaffold1189",1,7500,7499,"cPa356_cPa428"
"CNV_Scaffold1192_1-7500","CNV_Scaffold1192_1-7500",185,"Scaffold1192",1,7500,7499,"cPa428_cPa356"
"CNV_Scaffold1196_1-7200","CNV_Scaffold1196_1-7200",291,"Scaffold1196",1,7200,7199,"cPa356_cPa428"
"CNV_Scaffold1199_1-7200","CNV_Scaffold1199_1-7200",290,"Scaffold1199",1,7200,7199,"cPa356"
"CNV_Scaffold1203_1-7200","CNV_Scaffold1203_1-7200",287,"Scaffold1203",1,7200,7199,"cPa428_cPa356"
"CNV_Scaffold1206_1-7200","CNV_Scaffold1206_1-7200",224,"Scaffold1206",1,7200,7199,"cPa428_cPa356"
"CNV_Scaffold1216_1-6900","CNV_Scaffold1216_1-6900",290,"Scaffold1216",1,6900,6899,"cPa356"
"CNV_Scaffold710_1-6900","CNV_Scaffold710_1-6900",47,"Scaffold710",1,6900,6899,"cPa428_cPa356"
"CNV_Scaffold1229_1-6900","CNV_Scaffold1229_1-6900",259,"Scaffold1229",1,6900,6899,"cPa356_cPa428"
"CNV_Scaffold1231_1-6900","CNV_Scaffold1231_1-6900",241,"Scaffold1231",1,6900,6899,"cPa428_cPa356"
"CNV_Scaffold1234_1-6900","CNV_Scaffold1234_1-6900",292,"Scaffold1234",1,6900,6899,"cPa356"
"CNV_Scaffold1235_1-6900","CNV_Scaffold1235_1-6900",288,"Scaffold1235",1,6900,6899,"cPa428"
"CNV_Scaffold1239_1-6600","CNV_Scaffold1239_1-6600",212,"Scaffold1239",1,6600,6599,"cPa356_cPa428"
"CNV_Scaffold1244_1-6600","CNV_Scaffold1244_1-6600",236,"Scaffold1244",1,6600,6599,"cPa356_cPa428"
"CNV_Scaffold1254_1-6600","CNV_Scaffold1254_1-6600",253,"Scaffold1254",1,6600,6599,"cPa428_cPa356"
"CNV_Scaffold1256_1-6600","CNV_Scaffold1256_1-6600",290,"Scaffold1256",1,6600,6599,"cPa428"
"CNV_Scaffold1259_1-6600","CNV_Scaffold1259_1-6600",174,"Scaffold1259",1,6600,6599,"cPa428_cPa356"
"CNV_Scaffold1260_1-6600","CNV_Scaffold1260_1-6600",289,"Scaffold1260",1,6600,6599,"cPa356_cPa428"
"CNV_Scaffold1263_1-6600","CNV_Scaffold1263_1-6600",290,"Scaffold1263",1,6600,6599,"cPa356_cPa428"
"CNV_Scaffold1271_1-6300","CNV_Scaffold1271_1-6300",288,"Scaffold1271",1,6300,6299,"cPa428_cPa356"
"CNV_Scaffold1281_1-6300","CNV_Scaffold1281_1-6300",191,"Scaffold1281",1,6300,6299,"cPa356_cPa428"
"CNV_Scaffold1283_1-6300","CNV_Scaffold1283_1-6300",192,"Scaffold1283",1,6300,6299,"cPa428_cPa356"
"CNV_Scaffold1290_1-6300","CNV_Scaffold1290_1-6300",242,"Scaffold1290",1,6300,6299,"cPa356_cPa428"
"CNV_Scaffold1291_1-6300","CNV_Scaffold1291_1-6300",287,"Scaffold1291",1,6300,6299,"cPa428_cPa356"
"CNV_Scaffold1318_1-6000","CNV_Scaffold1318_1-6000",277,"Scaffold1318",1,6000,5999,"cPa356_cPa428"
"CNV_Scaffold1321_1-6000","CNV_Scaffold1321_1-6000",289,"Scaffold1321",1,6000,5999,"cPa428_cPa356"
"CNV_Scaffold1328_1-6000","CNV_Scaffold1328_1-6000",204,"Scaffold1328",1,6000,5999,"cPa419"
"CNV_Scaffold1336_1-5700","CNV_Scaffold1336_1-5700",216,"Scaffold1336",1,5700,5699,"cPa428_cPa356"
"CNV_Scaffold1339_1-5700","CNV_Scaffold1339_1-5700",268,"Scaffold1339",1,5700,5699,"cPa356_cPa428"
"CNV_Scaffold1341_1-5700","CNV_Scaffold1341_1-5700",292,"Scaffold1341",1,5700,5699,"cPa356_cPa428"
"CNV_Scaffold1343_1-5700","CNV_Scaffold1343_1-5700",292,"Scaffold1343",1,5700,5699,"cPa356_cPa428"
"CNV_Scaffold721_1-5700","CNV_Scaffold721_1-5700",98,"Scaffold721",1,5700,5699,"cPa428_cPa356"
"CNV_Scaffold1349_1-5700","CNV_Scaffold1349_1-5700",285,"Scaffold1349",1,5700,5699,"cPa428"
"CNV_Scaffold1359_1-5400","CNV_Scaffold1359_1-5400",292,"Scaffold1359",1,5400,5399,"cPa443_cPa205_cPa390_cPa444"
"CNV_Scaffold1364_1-5400","CNV_Scaffold1364_1-5400",259,"Scaffold1364",1,5400,5399,"cPa356_cPa428"
"CNV_Scaffold1372_1-5400","CNV_Scaffold1372_1-5400",290,"Scaffold1372",1,5400,5399,"cPa356_cPa428"
"CNV_Scaffold1376_1-5400","CNV_Scaffold1376_1-5400",292,"Scaffold1376",1,5400,5399,"cPa434_cPa516"
"CNV_Scaffold1377_1-5400","CNV_Scaffold1377_1-5400",238,"Scaffold1377",1,5400,5399,"cPa356_cPa428"
"CNV_Scaffold1386_1-5100","CNV_Scaffold1386_1-5100",289,"Scaffold1386",1,5100,5099,"cPa428_cPa356"
"CNV_Scaffold1390_1-5100","CNV_Scaffold1390_1-5100",212,"Scaffold1390",1,5100,5099,"cPa428_cPa356"
"CNV_Scaffold1393_1-5100","CNV_Scaffold1393_1-5100",158,"Scaffold1393",1,5100,5099,"cPa428"
"CNV_Scaffold1401_1-5100","CNV_Scaffold1401_1-5100",288,"Scaffold1401",1,5100,5099,"cPa356_cPa428"
"CNV_Scaffold1403_1-5100","CNV_Scaffold1403_1-5100",245,"Scaffold1403",1,5100,5099,"cPa428_cPa356"
"CNV_Scaffold1410_1-5100","CNV_Scaffold1410_1-5100",284,"Scaffold1410",1,5100,5099,"cPa428_cPa356"
"CNV_Scaffold1418_1-5100","CNV_Scaffold1418_1-5100",289,"Scaffold1418",1,5100,5099,"cPa356_cPa428"
"CNV_Scaffold1428_1-4800","CNV_Scaffold1428_1-4800",208,"Scaffold1428",1,4800,4799,"cPa356_cPa428"
"CNV_Scaffold1430_1-4800","CNV_Scaffold1430_1-4800",283,"Scaffold1430",1,4800,4799,"cPa356_cPa428"
"CNV_Scaffold1432_1-4800","CNV_Scaffold1432_1-4800",292,"Scaffold1432",1,4800,4799,"cPa133"
"CNV_Scaffold1433_1-4800","CNV_Scaffold1433_1-4800",257,"Scaffold1433",1,4800,4799,"cPa356_cPa428"
"CNV_Scaffold1439_1-4800","CNV_Scaffold1439_1-4800",224,"Scaffold1439",1,4800,4799,"cPa356_cPa428"
"CNV_Scaffold1442_1-4500","CNV_Scaffold1442_1-4500",291,"Scaffold1442",1,4500,4499,"cPa356"
"CNV_Scaffold1446_1-4500","CNV_Scaffold1446_1-4500",238,"Scaffold1446",1,4500,4499,"cPa428_cPa356"
"CNV_Scaffold1448_1-4500","CNV_Scaffold1448_1-4500",281,"Scaffold1448",1,4500,4499,"cPa356_cPa428"
"CNV_Scaffold1454_1-4500","CNV_Scaffold1454_1-4500",215,"Scaffold1454",1,4500,4499,"cPa356_cPa428"
"CNV_Scaffold1456_1-4200","CNV_Scaffold1456_1-4200",269,"Scaffold1456",1,4200,4199,"cPa428_cPa356"
"CNV_Scaffold1460_1-4200","CNV_Scaffold1460_1-4200",288,"Scaffold1460",1,4200,4199,"cPa356_cPa428"
"CNV_Scaffold1471_1-4200","CNV_Scaffold1471_1-4200",288,"Scaffold1471",1,4200,4199,"cPa356_cPa428"
"CNV_Scaffold1474_1-4200","CNV_Scaffold1474_1-4200",121,"Scaffold1474",1,4200,4199,"cPa428"
"CNV_Scaffold1478_1-4200","CNV_Scaffold1478_1-4200",209,"Scaffold1478",1,4200,4199,"cPa419"
"CNV_Scaffold1483_1-3900","CNV_Scaffold1483_1-3900",243,"Scaffold1483",1,3900,3899,"cPa356_cPa428"
"CNV_Scaffold1485_1-3900","CNV_Scaffold1485_1-3900",247,"Scaffold1485",1,3900,3899,"cPa356"
"CNV_Scaffold1491_1-3900","CNV_Scaffold1491_1-3900",261,"Scaffold1491",1,3900,3899,"cPa356_cPa428"
"CNV_Scaffold1493_1-3900","CNV_Scaffold1493_1-3900",288,"Scaffold1493",1,3900,3899,"cPa356"
"CNV_Scaffold1496_1-3900","CNV_Scaffold1496_1-3900",287,"Scaffold1496",1,3900,3899,"cPa428"
"CNV_Scaffold1498_1-3900","CNV_Scaffold1498_1-3900",220,"Scaffold1498",1,3900,3899,"cPa428_cPa356"
"CNV_Scaffold1499_1-3900","CNV_Scaffold1499_1-3900",248,"Scaffold1499",1,3900,3899,"cPa356_cPa428"
"CNV_Scaffold1501_1-3600","CNV_Scaffold1501_1-3600",247,"Scaffold1501",1,3600,3599,"cPa356_cPa428"
"CNV_Scaffold1507_1-3600","CNV_Scaffold1507_1-3600",237,"Scaffold1507",1,3600,3599,"cPa356"
"CNV_Scaffold1509_1-3600","CNV_Scaffold1509_1-3600",278,"Scaffold1509",1,3600,3599,"cPa428_cPa356"
"CNV_Scaffold1512_1-3600","CNV_Scaffold1512_1-3600",209,"Scaffold1512",1,3600,3599,"cPa356_cPa428"
"CNV_Scaffold1513_1-3600","CNV_Scaffold1513_1-3600",207,"Scaffold1513",1,3600,3599,"cPa356_cPa428"
"CNV_Scaffold1514_1-3600","CNV_Scaffold1514_1-3600",261,"Scaffold1514",1,3600,3599,"cPa428"
"CNV_Scaffold1517_1-3300","CNV_Scaffold1517_1-3300",254,"Scaffold1517",1,3300,3299,"cPa428_cPa356"
"CNV_Scaffold1522_1-3300","CNV_Scaffold1522_1-3300",254,"Scaffold1522",1,3300,3299,"cPa356"
"CNV_Scaffold1530_1-3300","CNV_Scaffold1530_1-3300",252,"Scaffold1530",1,3300,3299,"cPa356_cPa428"
"CNV_Scaffold1531_1-3300","CNV_Scaffold1531_1-3300",189,"Scaffold1531",1,3300,3299,"cPa428_cPa356"
"CNV_chr10_17453101-17455500","CNV_chr10_17453101-17455500",21,"chr10",17453101,17455500,2399,"cPa516_cPa248_cPa260_cPa268_cPa356_cPa428"
"CNV_chr10_17470201-17484600","CNV_chr10_17470201-17484600",9,"chr10",17470201,17484600,14399,"cPa516_cPa248_cPa260_cPa268_cPa356_cPa428_cPa332"
"CNV_chr10_17946901-17955000","CNV_chr10_17946901-17955000",40,"chr10",17946901,17955000,8099,"cPa516_cPa248_cPa268_cPa264_cPa61_cPa443_cPa118_cPa140_cPa15_cPa125_cPa119"
"CNV_chr20_9575401-9590400","CNV_chr20_9575401-9590400",29,"chr20",9575401,9590400,14999,"cPa260_S71_repbase_HERVS71_LTR6A_cPa587"
"CNV_chr20_12513001-12522900","CNV_chr20_12513001-12522900",3,"chr20",12513001,12522900,9899,"cPa363_cPa452_cPa140_cPa125_cPa268_cPa199_cPa424_cPa443_cPa118_cPa264_cPa248_cPa183_cPa223_cPa379_cPa15_cPa345_cPa410_cPa176"
"CNV_chr20_12923401-12932400","CNV_chr20_12923401-12932400",1,"chr20",12923401,12932400,8999,"cPa140_cPa125_cPa268_cPa183_cPa223_cPa15_cPa443_cPa118_cPa248_cPa176_cPa264_cPa452_cPa410_cPa260_cPa424_cPa71"
"CNV_chr20_13031101-13045500","CNV_chr20_13031101-13045500",1,"chr20",13031101,13045500,14399,"cPa140_cPa125_cPa268_cPa183_cPa15_cPa176_cPa248_cPa443_cPa118_cPa452_cPa264_cPa424_cPa71_cPa260_cPa410"
"CNV_chr20_13210201-13225200","CNV_chr20_13210201-13225200",1,"chr20",13210201,13225200,14999,"cPa140_cPa125_cPa268_cPa183_cPa15_cPa248_cPa443_cPa118_cPa452_cPa264_cPa424_cPa71_cPa260_cPa363_cPa176"
"CNV_chr20_13856701-13863300","CNV_chr20_13856701-13863300",4,"chr20",13856701,13863300,6599,"cPa268_cPa176_cPa452_cPa542_cPa443_cPa264_cPa118_cPa125_cPa410_cPa248_cPa140_cPa15_cPa516_cPa71"
"CNV_chr20_14841901-14848500","CNV_chr20_14841901-14848500",185,"chr20",14841901,14848500,6599,"cPa268_cPa443_cPa125_cPa140_cPa118_cPa248_cPa264_cPa15_cPa516_cPa223_cPa61_cPa119"
"CNV_chr20_14870401-14882400","CNV_chr20_14870401-14882400",17,"chr20",14870401,14882400,11999,"cPa268_cPa443_cPa125_cPa264_cPa223_cPa61_cPa248_cPa118_cPa140_cPa15_cPa516_cPa119_cPa183_cPa157_cPa229_cPa193_cPa121_cPa34_cPa500_cPa188"
"CNV_chr21_533701-548700","CNV_chr21_533701-548700",8,"chr21",533701,548700,14999,"cPa199_cPa260_cPa223"
"CNV_chr21_1087501-1098600","CNV_chr21_1087501-1098600",10,"chr21",1087501,1098600,11099,"cPa199_cPa273_cPa268_cPa443_cPa118_cPa248_cPa140_cPa227_cPa75"
"CNV_Scaffold19_250501-260700","CNV_Scaffold19_250501-260700",53,"Scaffold19",250501,260700,10199,"cPa264_cPa61_cPa248_cPa443_cPa118_cPa140_cPa15_cPa125_cPa516_cPa268_cPa119_cPa229_cPa313_cPa447_cPa205_cPa308_cPa196_cPa305_cPa424_cPa327_cPa459_cPa433_cPa392_cPa425_cPa47_cPa254"
"CNV_Scaffold19_388801-394500","CNV_Scaffold19_388801-394500",1,"Scaffold19",388801,394500,5699,"cPa264_cPa61_cPa248_cPa443_cPa118_cPa140_cPa15_cPa125_cPa516_cPa268_cPa119_cPa308_cPa196_cPa305_cPa424_cPa327_cPa459_cPa433_cPa392_cPa223_cPa363_cPa452_cPa254_cPa425_cPa404_cPa174_cPa47"
"CNV_Scaffold19_395401-406800","CNV_Scaffold19_395401-406800",12,"Scaffold19",395401,406800,11399,"cPa264_cPa61_cPa248_cPa443_cPa118_cPa140_cPa15_cPa125_cPa516_cPa268_cPa119_cPa308_cPa196_cPa305_cPa424_cPa327_cPa459_cPa433_cPa392_cPa223_cPa363_cPa452_cPa254_cPa425_cPa47"
"CNV_Scaffold19_414001-429000","CNV_Scaffold19_414001-429000",30,"Scaffold19",414001,429000,14999,"cPa264_cPa61_cPa248_cPa443_cPa118_cPa140_cPa15_cPa125_cPa516_cPa268_cPa119_cPa308_cPa196_cPa305_cPa424_cPa327_cPa459_cPa433_cPa392_cPa223_cPa254_cPa425"
"CNV_Scaffold19_480301-484800","CNV_Scaffold19_480301-484800",3,"Scaffold19",480301,484800,4499,"cPa264_cPa248_cPa443_cPa118_cPa140_cPa15_cPa125_cPa516_cPa268_cPa61_cPa308_cPa196_cPa305_cPa424_cPa327_cPa459_cPa433_cPa425_cPa42"
"CNV_Scaffold153_60901-67800","CNV_Scaffold153_60901-67800",9,"Scaffold153",60901,67800,6899,"cPa223_cPa196_cPa308_cPa459_cPa305_cPa433_cPa327_cPa424_cPa260_cPa409_cPa439_cPa16_cPa183_cPa425"
"CNV_Scaffold160_35701-48300","CNV_Scaffold160_35701-48300",36,"Scaffold160",35701,48300,12599,"cPa356_cPa428"
"CNV_Scaffold160_87001-97800","CNV_Scaffold160_87001-97800",53,"Scaffold160",87001,97800,10799,"cPa428_cPa356"
"CNV_Scaffold170_40801-45000","CNV_Scaffold170_40801-45000",2,"Scaffold170",40801,45000,4199,"cPa428_cPa356"
"CNV_Scaffold170_75001-82500","CNV_Scaffold170_75001-82500",30,"Scaffold170",75001,82500,7499,"cPa428_cPa356"
"CNV_Scaffold246_35401-42900","CNV_Scaffold246_35401-42900",15,"Scaffold246",35401,42900,7499,"cPa371_cPa345_cPa199_cPa227_cPa273"
"CNV_Scaffold425_1-5700","CNV_Scaffold425_1-5700",23,"Scaffold425",1,5700,5699,"cPa356_cPa428"
"CNV_Scaffold425_9601-15000","CNV_Scaffold425_9601-15000",3,"Scaffold425",9601,15000,5399,"cPa428_cPa356"
"CNV_Scaffold492_15001-22500","CNV_Scaffold492_15001-22500",132,"Scaffold492",15001,22500,7499,"cPa428_cPa356"
"CNV_Scaffold516_8101-21300","CNV_Scaffold516_8101-21300",95,"Scaffold516",8101,21300,13199,"cPa428"
"CNV_Scaffold518_8401-21000","CNV_Scaffold518_8401-21000",86,"Scaffold518",8401,21000,12599,"cPa428_cPa356"
"CNV_Scaffold133_1-14700","CNV_Scaffold133_1-14700",29,"Scaffold133",1,14700,14699,"cPa356"
"CNV_Scaffold119_5401-18600","CNV_Scaffold119_5401-18600",23,"Scaffold119",5401,18600,13199,"cPa428_cPa356"
"CNV_Scaffold578_1-5100","CNV_Scaffold578_1-5100",114,"Scaffold578",1,5100,5099,"cPa419"
"CNV_Scaffold620_9301-15900","CNV_Scaffold620_9301-15900",158,"Scaffold620",9301,15900,6599,"cPa428_cPa356"
"CNV_Scaffold858_1-14400","CNV_Scaffold858_1-14400",196,"Scaffold858",1,14400,14399,"cPa443_cPa516_cPa264_cPa268_cPa119_cPa248_cPa118_cPa140_cPa15_cPa125_cPa61"
"CNV_Scaffold863_1-14400","CNV_Scaffold863_1-14400",87,"Scaffold863",1,14400,14399,"cPa356_cPa428"
"CNV_Scaffold649_3901-14100","CNV_Scaffold649_3901-14100",83,"Scaffold649",3901,14100,10199,"cPa356_cPa428"
"CNV_Scaffold877_1-13800","CNV_Scaffold877_1-13800",146,"Scaffold877",1,13800,13799,"cPa428_cPa356"
"CNV_Scaffold658_1-13200","CNV_Scaffold658_1-13200",136,"Scaffold658",1,13200,13199,"cPa428_cPa356"
"CNV_Scaffold899_1-10800","CNV_Scaffold899_1-10800",75,"Scaffold899",1,10800,10799,"cPa428_cPa356"
"CNV_Scaffold915_1-12900","CNV_Scaffold915_1-12900",162,"Scaffold915",1,12900,12899,"cPa356_cPa428"
"CNV_Scaffold916_1-12900","CNV_Scaffold916_1-12900",138,"Scaffold916",1,12900,12899,"cPa356"
"CNV_Scaffold945_1-11700","CNV_Scaffold945_1-11700",102,"Scaffold945",1,11700,11699,"cPa428_cPa356"
"CNV_Scaffold982_5101-11100","CNV_Scaffold982_5101-11100",104,"Scaffold982",5101,11100,5999,"cPa428_cPa356"
"CNV_Scaffold994_1-7500","CNV_Scaffold994_1-7500",30,"Scaffold994",1,7500,7499,"cPa428_cPa356"
"CNV_Scaffold1007_1-9300","CNV_Scaffold1007_1-9300",65,"Scaffold1007",1,9300,9299,"cPa356_cPa428"
"CNV_Scaffold1016_1-10200","CNV_Scaffold1016_1-10200",63,"Scaffold1016",1,10200,10199,"cPa356"
"CNV_Scaffold1050_1-9600","CNV_Scaffold1050_1-9600",154,"Scaffold1050",1,9600,9599,"cPa419"
"CNV_Scaffold1080_1-9000","CNV_Scaffold1080_1-9000",115,"Scaffold1080",1,9000,8999,"cPa428_cPa356"
"CNV_Scaffold1174_1-7500","CNV_Scaffold1174_1-7500",98,"Scaffold1174",1,7500,7499,"cPa428"
"CNV_Scaffold1194_1-7200","CNV_Scaffold1194_1-7200",59,"Scaffold1194",1,7200,7199,"cPa419"
"CNV_Scaffold1210_1-4500","CNV_Scaffold1210_1-4500",168,"Scaffold1210",1,4500,4499,"cPa308"
"CNV_Scaffold1241_1-6600","CNV_Scaffold1241_1-6600",143,"Scaffold1241",1,6600,6599,"cPa419"
"CNV_Scaffold1300_1-6000","CNV_Scaffold1300_1-6000",135,"Scaffold1300",1,6000,5999,"cPa356_cPa428"
"CNV_Scaffold1325_1-6000","CNV_Scaffold1325_1-6000",200,"Scaffold1325",1,6000,5999,"cPa428_cPa356"
"CNV_Scaffold1357_1-5700","CNV_Scaffold1357_1-5700",139,"Scaffold1357",1,5700,5699,"cPa428_cPa356"
"CNV_Scaffold1360_1-5400","CNV_Scaffold1360_1-5400",173,"Scaffold1360",1,5400,5399,"cPa356_cPa428"
"CNV_Scaffold1453_1-4500","CNV_Scaffold1453_1-4500",171,"Scaffold1453",1,4500,4499,"cPa428_cPa356"
"CNV_Scaffold1515_1-3600","CNV_Scaffold1515_1-3600",161,"Scaffold1515",1,3600,3599,"cPa428_cPa356"
"CNV_chr15_12223801-12232500","CNV_chr15_12223801-12232500",77,"chr15",12223801,12232500,8699,"cPa443_cPa264_cPa248_cPa118_cPa140_cPa15_cPa125_cPa516_cPa268_cPa410_cPa260_cPa61_cPa119"
"CNV_chr15_14085601-14093700","CNV_chr15_14085601-14093700",38,"chr15",14085601,14093700,8099,"cPa118_cPa125_cPa264_cPa268_cPa140_cPa15_cPa516_cPa410_cPa248_cPa61_cPa443"
"CNV_chr24_1076701-1084800","CNV_chr24_1076701-1084800",62,"chr24",1076701,1084800,8099,"cPa264_cPa268_cPa248_cPa118_cPa140_cPa15_cPa125_cPa516_cPa61_cPa379_cPa443_cPa482_cPa260_cPa410_cPa254_cPa404_cPa174_cPa425_cPa119"
"CNV_chr24_2603701-2614500","CNV_chr24_2603701-2614500",5,"chr24",2603701,2614500,10799,"cPa260_cPa424_cPa223_cPa327"
"CNV_chr24_3665101-3675000","CNV_chr24_3665101-3675000",4,"chr24",3665101,3675000,9899,"cPa260_cPa268_cPa410_cPa308_cPa305_cPa424_cPa327_cPa459_cPa433_cPa196_cPa345_cPa227_cPa200"
"CNV_Scaffold165_5701-13500","CNV_Scaffold165_5701-13500",2,"Scaffold165",5701,13500,7799,"cPa428_cPa356"
"CNV_Scaffold165_37201-51000","CNV_Scaffold165_37201-51000",3,"Scaffold165",37201,51000,13799,"cPa428_cPa356"
"CNV_Scaffold165_81301-90300","CNV_Scaffold165_81301-90300",22,"Scaffold165",81301,90300,8999,"cPa428_cPa356"
"CNV_Scaffold234_1-10500","CNV_Scaffold234_1-10500",69,"Scaffold234",1,10500,10499,"cPa356_cPa428"
"CNV_Scaffold234_36001-47100","CNV_Scaffold234_36001-47100",30,"Scaffold234",36001,47100,11099,"cPa428_cPa356"
"CNV_Scaffold285_1-11700","CNV_Scaffold285_1-11700",25,"Scaffold285",1,11700,11699,"cPa356_cPa428"
"CNV_Scaffold285_14101-16800","CNV_Scaffold285_14101-16800",5,"Scaffold285",14101,16800,2699,"cPa356_cPa428"
"CNV_Scaffold285_21001-32100","CNV_Scaffold285_21001-32100",53,"Scaffold285",21001,32100,11099,"cPa356_cPa428"
"CNV_Scaffold288_1-14400","CNV_Scaffold288_1-14400",14,"Scaffold288",1,14400,14399,"cPa428_cPa356"
"CNV_Scaffold288_14701-22500","CNV_Scaffold288_14701-22500",4,"Scaffold288",14701,22500,7799,"cPa428_cPa356"
"CNV_Scaffold288_29101-33000","CNV_Scaffold288_29101-33000",3,"Scaffold288",29101,33000,3899,"cPa356_cPa428"
"CNV_Scaffold295_1-13500","CNV_Scaffold295_1-13500",62,"Scaffold295",1,13500,13499,"cPa356_cPa428"
"CNV_Scaffold295_28201-36900","CNV_Scaffold295_28201-36900",23,"Scaffold295",28201,36900,8699,"cPa356_cPa428"
"CNV_Scaffold336_1-10200","CNV_Scaffold336_1-10200",155,"Scaffold336",1,10200,10199,"cPa356_cPa428"
"CNV_Scaffold342_1-5100","CNV_Scaffold342_1-5100",14,"Scaffold342",1,5100,5099,"cPa356_cPa428"
"CNV_Scaffold342_21301-33300","CNV_Scaffold342_21301-33300",80,"Scaffold342",21301,33300,11999,"cPa428_cPa356"
"CNV_Scaffold404_8101-11100","CNV_Scaffold404_8101-11100",1,"Scaffold404",8101,11100,2999,"cPa428_cPa60_cPa546_cPa285_cPa356_cPa257_cPa472"
"CNV_Scaffold404_18901-29400","CNV_Scaffold404_18901-29400",119,"Scaffold404",18901,29400,10499,"cPa428_cPa60_cPa546_cPa356_cPa257_cPa285_cPa555"
"CNV_Scaffold134_4501-17700","CNV_Scaffold134_4501-17700",52,"Scaffold134",4501,17700,13199,"cPa356"
"CNV_Scaffold579_1-4500","CNV_Scaffold579_1-4500",41,"Scaffold579",1,4500,4499,"cPa428_cPa356"
"CNV_Scaffold579_8101-17700","CNV_Scaffold579_8101-17700",39,"Scaffold579",8101,17700,9599,"cPa428_cPa356"
"CNV_Scaffold643_1-14700","CNV_Scaffold643_1-14700",153,"Scaffold643",1,14700,14699,"cPa356_cPa428"
"CNV_Scaffold865_1-7800","CNV_Scaffold865_1-7800",102,"Scaffold865",1,7800,7799,"cPa435_cPa356_cPa428_cPa60_cPa546_cPa257_cPa285_cPa555"
"CNV_Scaffold865_11701-14400","CNV_Scaffold865_11701-14400",20,"Scaffold865",11701,14400,2699,"cPa356_cPa428"
"CNV_Scaffold648_6601-14100","CNV_Scaffold648_6601-14100",94,"Scaffold648",6601,14100,7499,"cPa356_cPa428"
"CNV_Scaffold895_1-4200","CNV_Scaffold895_1-4200",8,"Scaffold895",1,4200,4199,"cPa356_cPa428"
"CNV_Scaffold895_6301-13200","CNV_Scaffold895_6301-13200",12,"Scaffold895",6301,13200,6899,"cPa428_cPa356"
"CNV_Scaffold1041_1-9900","CNV_Scaffold1041_1-9900",172,"Scaffold1041",1,9900,9899,"cPa428_cPa356"
"CNV_Scaffold1078_1-9000","CNV_Scaffold1078_1-9000",99,"Scaffold1078",1,9000,8999,"cPa356_cPa428"
"CNV_Scaffold1435_1-4800","CNV_Scaffold1435_1-4800",157,"Scaffold1435",1,4800,4799,"cPa356_cPa428"
"CNV_Scaffold1443_1-4500","CNV_Scaffold1443_1-4500",62,"Scaffold1443",1,4500,4499,"cPa391_cPa287_cPa293_cPa426_cPa386_cPa20_cPa427"
"CNV_chr6_1803901-1822500","CNV_chr6_1803901-1822500",86,"chr6",1803901,1822500,18599,"cPa199_cPa264_cPa248_cPa308_cPa424_cPa327_cPa16"
"CNV_chr6_2662801-2672100","CNV_chr6_2662801-2672100",8,"chr6",2662801,2672100,9299,"cPa264_cPa248_cPa443_cPa15_cPa125_cPa268_cPa308_cPa118_cPa140_cPa356_cPa428"
"CNV_chr6_3089701-3105300","CNV_chr6_3089701-3105300",38,"chr6",3089701,3105300,15599,"cPa264_cPa248_cPa443_cPa15_cPa125_cPa268_cPa118_cPa140_cPa308_cPa424_cPa327"
"CNV_chr6_17373601-17381100","CNV_chr6_17373601-17381100",94,"chr6",17373601,17381100,7499,"cPa404_cPa174_cPa425_cPa254_cPa47"
"CNV_chr28_949801-961500","CNV_chr28_949801-961500",73,"chr28",949801,961500,11699,"HERV-XA34_repbase_HERVFH21I_LTR21A"
"CNV_chr28_2569501-2583900","CNV_chr28_2569501-2583900",25,"chr28",2569501,2583900,14399,"cPa223_cPa183_cPa125_cPa482_cPa446_cPa379_cPa67_cPa264"
"CNV_chr28_2914801-2929200","CNV_chr28_2914801-2929200",10,"chr28",2914801,2929200,14399,"cPa446_cPa264_cPa268_cPa248_cPa443_cPa118_cPa140_cPa125_cPa379_cPa61_cPa482"
"CNV_chr28_3412801-3431400","CNV_chr28_3412801-3431400",44,"chr28",3412801,3431400,18599,"cPa118_cPa125_cPa248_cPa443_cPa379_cPa308_cPa268_cPa61"
"CNV_chr28_3976501-3982800","CNV_chr28_3976501-3982800",9,"chr28",3976501,3982800,6299,"cPa118_cPa125_cPa446_cPa345_cPa482_cPa379_cPa443_cPa268_cPa248_cPa140_cPa223_cPa512"
"CNV_chr28_4095601-4113900","CNV_chr28_4095601-4113900",17,"chr28",4095601,4113900,18299,"cPa118_cPa125_cPa379_cPa443_cPa268_cPa248_cPa140_cPa223_cPa260_cPa482_cPa446_cPa61_cPa434"
"CNV_chr28_4355401-4366800","CNV_chr28_4355401-4366800",16,"chr28",4355401,4366800,11399,"cPa379_cPa118_cPa443_cPa268_cPa248_cPa140_cPa223_cPa446_cPa61_cPa410_cPa308_cPa260"
"CNV_chr28_4545601-4557900","CNV_chr28_4545601-4557900",12,"chr28",4545601,4557900,12299,"cPa379_cPa443_cPa268_cPa248_cPa118_cPa446_cPa61_cPa308_cPa140_cPa264_cPa15_cPa125_cPa260"
"CNV_chr28_4693501-4708200","CNV_chr28_4693501-4708200",71,"chr28",4693501,4708200,14699,"cPa443_cPa268_cPa248_cPa118_cPa379_cPa140_cPa264_cPa15_cPa125_cPa446_cPa260"
"CNV_Scaffold144_1-5100","CNV_Scaffold144_1-5100",24,"Scaffold144",1,5100,5099,"cPa419"
"CNV_Scaffold195_1-5400","CNV_Scaffold195_1-5400",9,"Scaffold195",1,5400,5399,"cPa428_cPa356"
"CNV_Scaffold195_42001-54900","CNV_Scaffold195_42001-54900",46,"Scaffold195",42001,54900,12899,"cPa356_cPa428"
"CNV_Scaffold216_1-1800","CNV_Scaffold216_1-1800",1,"Scaffold216",1,1800,1799,"cPa428"
"CNV_Scaffold216_34201-39900","CNV_Scaffold216_34201-39900",1,"Scaffold216",34201,39900,5699,"cPa428_cPa356"
"CNV_Scaffold216_42001-54900","CNV_Scaffold216_42001-54900",47,"Scaffold216",42001,54900,12899,"cPa428_cPa356"
"CNV_chr226_15601-30600","CNV_chr226_15601-30600",65,"chr226",15601,30600,14999,"cPa428_cPa356"
"CNV_Scaffold546_1-9900","CNV_Scaffold546_1-9900",16,"Scaffold546",1,9900,9899,"cPa428_cPa356"
"CNV_Scaffold546_14101-19500","CNV_Scaffold546_14101-19500",34,"Scaffold546",14101,19500,5399,"cPa428_cPa356"
"CNV_Scaffold122_1-4800","CNV_Scaffold122_1-4800",1,"Scaffold122",1,4800,4799,"cPa356_cPa428"
"CNV_Scaffold122_14101-19500","CNV_Scaffold122_14101-19500",60,"Scaffold122",14101,19500,5399,"cPa356_cPa428"
"CNV_Scaffold557_14101-19200","CNV_Scaffold557_14101-19200",56,"Scaffold557",14101,19200,5099,"cPa356_cPa428"
"CNV_Scaffold624_1501-15600","CNV_Scaffold624_1501-15600",68,"Scaffold624",1501,15600,14099,"cPa419"
"CNV_Scaffold632_1-10500","CNV_Scaffold632_1-10500",103,"Scaffold632",1,10500,10499,"cPa428_cPa356"
"CNV_Scaffold632_13201-15600","CNV_Scaffold632_13201-15600",1,"Scaffold632",13201,15600,2399,"cPa428_cPa356"
"CNV_Scaffold995_1-10800","CNV_Scaffold995_1-10800",108,"Scaffold995",1,10800,10799,"cPa356"
"CNV_Scaffold1006_1-10500","CNV_Scaffold1006_1-10500",47,"Scaffold1006",1,10500,10499,"cPa356"
"CNV_Scaffold678_1-5100","CNV_Scaffold678_1-5100",12,"Scaffold678",1,5100,5099,"cPa419"
"CNV_Scaffold1053_1-9600","CNV_Scaffold1053_1-9600",35,"Scaffold1053",1,9600,9599,"cPa356_cPa428"
"CNV_Scaffold1090_4201-9000","CNV_Scaffold1090_4201-9000",82,"Scaffold1090",4201,9000,4799,"cPa419"
"CNV_Scaffold1150_601-8100","CNV_Scaffold1150_601-8100",32,"Scaffold1150",601,8100,7499,"cPa428_cPa356"
"CNV_Scaffold1209_3601-7200","CNV_Scaffold1209_3601-7200",84,"Scaffold1209",3601,7200,3599,"cPa428_cPa356"
"CNV_Scaffold1211_1-7200","CNV_Scaffold1211_1-7200",123,"Scaffold1211",1,7200,7199,"cPa428_cPa356"
"CNV_Scaffold1267_1-6300","CNV_Scaffold1267_1-6300",170,"Scaffold1267",1,6300,6299,"cPa419"
"CNV_Scaffold1519_1-3300","CNV_Scaffold1519_1-3300",208,"Scaffold1519",1,3300,3299,"cPa356_cPa428"
"CNV_Scaffold1529_1-3300","CNV_Scaffold1529_1-3300",189,"Scaffold1529",1,3300,3299,"cPa356"
"CNV_chr9_1308901-1326600","CNV_chr9_1308901-1326600",17,"chr9",1308901,1326600,17699,"cPa260"
"CNV_chr9_6911401-6917100","CNV_chr9_6911401-6917100",79,"chr9",6911401,6917100,5699,"cPa516_cPa264_cPa268_cPa248_cPa443_cPa118_cPa140_cPa15_cPa125_cPa254_cPa119_cPa404_cPa174_cPa61"
"CNV_chr9_20560501-20575800","CNV_chr9_20560501-20575800",16,"chr9",20560501,20575800,15299,"cPa118_cPa268_cPa443_cPa125_cPa248_cPa345_cPa227"
"CNV_chr9_25362301-25375200","CNV_chr9_25362301-25375200",1,"chr9",25362301,25375200,12899,"cPa268_cPa553_cPa118_cPa125_cPa264_cPa248_cPa140_cPa15"
"CNV_chr25_412801-427200","CNV_chr25_412801-427200",26,"chr25",412801,427200,14399,"cPa264_cPa248_cPa443_cPa118_cPa140_cPa15_cPa125_cPa516_cPa268"
"CNV_Scaffold297_3601-11100","CNV_Scaffold297_3601-11100",7,"Scaffold297",3601,11100,7499,"cPa419"
"CNV_Scaffold297_24901-30000","CNV_Scaffold297_24901-30000",31,"Scaffold297",24901,30000,5099,"cPa419"
"CNV_Scaffold356_20101-32700","CNV_Scaffold356_20101-32700",48,"Scaffold356",20101,32700,12599,"cPa428_cPa356"
"CNV_Scaffold408_1-6300","CNV_Scaffold408_1-6300",155,"Scaffold408",1,6300,6299,"cPa428_cPa356"
"CNV_Scaffold408_16201-29100","CNV_Scaffold408_16201-29100",60,"Scaffold408",16201,29100,12899,"cPa428_cPa356"
"CNV_Scaffold417_1-10800","CNV_Scaffold417_1-10800",16,"Scaffold417",1,10800,10799,"cPa428_cPa356"
"CNV_Scaffold417_14701-28500","CNV_Scaffold417_14701-28500",28,"Scaffold417",14701,28500,13799,"cPa428_cPa356"
"CNV_Scaffold580_1-2400","CNV_Scaffold580_1-2400",3,"Scaffold580",1,2400,2399,"cPa428_cPa356"
"CNV_Scaffold580_7501-17700","CNV_Scaffold580_7501-17700",12,"Scaffold580",7501,17700,10199,"cPa428_cPa356"
"CNV_Scaffold636_1-5400","CNV_Scaffold636_1-5400",189,"Scaffold636",1,5400,5399,"cPa428_cPa356"
"CNV_Scaffold904_7201-12900","CNV_Scaffold904_7201-12900",140,"Scaffold904",7201,12900,5699,"cPa356_cPa428"
"CNV_Scaffold928_1-7200","CNV_Scaffold928_1-7200",78,"Scaffold928",1,7200,7199,"cPa428_cPa356"
"CNV_Scaffold963_1-11400","CNV_Scaffold963_1-11400",67,"Scaffold963",1,11400,11399,"cPa419"
"CNV_Scaffold991_1-10800","CNV_Scaffold991_1-10800",12,"Scaffold991",1,10800,10799,"cPa428_cPa356"
"CNV_Scaffold1031_1-9900","CNV_Scaffold1031_1-9900",67,"Scaffold1031",1,9900,9899,"cPa419"
"CNV_Scaffold1071_1-9300","CNV_Scaffold1071_1-9300",206,"Scaffold1071",1,9300,9299,"cPa419"
"CNV_Scaffold1142_1-8100","CNV_Scaffold1142_1-8100",119,"Scaffold1142",1,8100,8099,"cPa419"
"CNV_Scaffold1151_1-8100","CNV_Scaffold1151_1-8100",132,"Scaffold1151",1,8100,8099,"cPa419"
"CNV_Scaffold1208_1-7200","CNV_Scaffold1208_1-7200",194,"Scaffold1208",1,7200,7199,"cPa428_cPa356"
"CNV_Scaffold1237_1-6900","CNV_Scaffold1237_1-6900",108,"Scaffold1237",1,6900,6899,"cPa356_cPa428"
"CNV_Scaffold1273_1-6300","CNV_Scaffold1273_1-6300",126,"Scaffold1273",1,6300,6299,"cPa419"
"CNV_Scaffold1302_1-6000","CNV_Scaffold1302_1-6000",114,"Scaffold1302",1,6000,5999,"cPa428_cPa356"
"CNV_Scaffold1305_1-6000","CNV_Scaffold1305_1-6000",56,"Scaffold1305",1,6000,5999,"cPa428_cPa356"
"CNV_Scaffold1320_1-6000","CNV_Scaffold1320_1-6000",37,"Scaffold1320",1,6000,5999,"cPa419"
"CNV_Scaffold1406_1-5100","CNV_Scaffold1406_1-5100",96,"Scaffold1406",1,5100,5099,"cPa419"
"CNV_Scaffold1447_1-4500","CNV_Scaffold1447_1-4500",177,"Scaffold1447",1,4500,4499,"cPa424_cPa327_cPa16_cPa264"
"CNV_chr4A_61501-70500","CNV_chr4A_61501-70500",3,"chr4A",61501,70500,8999,"cPa183_cPa273_cPa583_cPa542"
"CNV_chr4A_2798101-2808300","CNV_chr4A_2798101-2808300",28,"chr4A",2798101,2808300,10199,"cPa199_cPa260_cPa428_cPa356"
"CNV_chr4A_2808901-2820600","CNV_chr4A_2808901-2820600",14,"chr4A",2808901,2820600,11699,"cPa199_cPa260_cPa428_cPa356"
"CNV_chr19_1718101-1724400","CNV_chr19_1718101-1724400",1,"chr19",1718101,1724400,6299,"cPa199_cPa264_cPa248_cPa443_cPa118_cPa140_cPa15_cPa125_cPa268_cPa486_cPa358_cPa251_cPa410_cPa339_cPa227"
"CNV_chr19_3167701-3180300","CNV_chr19_3167701-3180300",2,"chr19",3167701,3180300,12599,"cPa260_cPa268_cPa118_cPa140_cPa125_cPa248_cPa410_cPa227_cPa264_cPa443_cPa15_cPa516"
"CNV_chr19_3357001-3372600","CNV_chr19_3357001-3372600",21,"chr19",3357001,3372600,15599,"cPa268_cPa227_cPa125_cPa264_cPa248_cPa443_cPa118_cPa140_cPa15_cPa516_cPa273_cPa345_cPa61_cPa333_cPa50_cPa410_cPa379_cPa446"
"CNV_chr27_29401-34800","CNV_chr27_29401-34800",4,"chr27",29401,34800,5399,"cPa199_cPa264_cPa248_cPa443_cPa118_cPa140_cPa15_cPa125_cPa516_cPa268_cPa119_cPa61"
"CNV_chr27_322501-332400","CNV_chr27_322501-332400",3,"chr27",322501,332400,9899,"cPa199_cPa268_cPa443_cPa264_cPa248_cPa118_cPa140_cPa15_cPa125_cPa516_cPa61_cPa260_cPa410_cPa542"
"CNV_chr27_3741301-3748200","CNV_chr27_3741301-3748200",8,"chr27",3741301,3748200,6899,"cPa356_cPa428"
"CNV_Scaffold1668_21901-37200","CNV_Scaffold1668_21901-37200",133,"Scaffold1668",21901,37200,15299,"cPa75"
"CNV_Scaffold1668_59701-68400","CNV_Scaffold1668_59701-68400",16,"Scaffold1668",59701,68400,8699,"cPa264_cPa268_cPa61_cPa248_cPa443_cPa118_cPa140_cPa15_cPa125_cPa516_cPa254_cPa119_cPa404_cPa174"
"CNV_Scaffold207_33301-37800","CNV_Scaffold207_33301-37800",1,"Scaffold207",33301,37800,4499,"cPa419_cPa285"
"CNV_Scaffold251_33301-42000","CNV_Scaffold251_33301-42000",79,"Scaffold251",33301,42000,8699,"cPa356"
"CNV_Scaffold281_25501-36300","CNV_Scaffold281_25501-36300",11,"Scaffold281",25501,36300,10799,"cPa356"
"CNV_Scaffold113_7801-18300","CNV_Scaffold113_7801-18300",44,"Scaffold113",7801,18300,10499,"cPa356"
"CNV_Scaffold645_1-14700","CNV_Scaffold645_1-14700",99,"Scaffold645",1,14700,14699,"cPa419"
"CNV_Scaffold1133_1-8400","CNV_Scaffold1133_1-8400",108,"Scaffold1133",1,8400,8399,"cPa428_cPa356"
"CNV_chr8_1119001-1131300","CNV_chr8_1119001-1131300",13,"chr8",1119001,1131300,12299,"cPa260"
"CNV_chr8_29269501-29279400","CNV_chr8_29269501-29279400",2,"chr8",29269501,29279400,9899,"cPa268_cPa443_cPa118_cPa264_cPa248_cPa140_cPa15_cPa125_cPa61_cPa308"
"CNV_Scaffold262_1-9000","CNV_Scaffold262_1-9000",7,"Scaffold262",1,9000,8999,"cPa428_cPa356"
"CNV_Scaffold421_1-12300","CNV_Scaffold421_1-12300",77,"Scaffold421",1,12300,12299,"cPa356"
"CNV_Scaffold885_7501-13500","CNV_Scaffold885_7501-13500",61,"Scaffold885",7501,13500,5999,"cPa419"
"CNV_Scaffold890_1-13200","CNV_Scaffold890_1-13200",56,"Scaffold890",1,13200,13199,"cPa419"
"CNV_Scaffold960_1-11400","CNV_Scaffold960_1-11400",58,"Scaffold960",1,11400,11399,"cPa356_cPa428"
"CNV_Scaffold1028_5101-9900","CNV_Scaffold1028_5101-9900",3,"Scaffold1028",5101,9900,4799,"cPa419"
"CNV_Scaffold1175_1-7500","CNV_Scaffold1175_1-7500",75,"Scaffold1175",1,7500,7499,"cPa419"
"CNV_Scaffold1275_1-6300","CNV_Scaffold1275_1-6300",55,"Scaffold1275",1,6300,6299,"cPa428_cPa356"
"CNV_Scaffold1383_1-5400","CNV_Scaffold1383_1-5400",129,"Scaffold1383",1,5400,5399,"cPa356_cPa428"
"CNV_Scaffold1477_1-4200","CNV_Scaffold1477_1-4200",175,"Scaffold1477",1,4200,4199,"cPa428_cPa356"
"CNV_Scaffold1503_1-3600","CNV_Scaffold1503_1-3600",220,"Scaffold1503",1,3600,3599,"cPa428_cPa356"
"CNV_Scaffold1506_1-3600","CNV_Scaffold1506_1-3600",88,"Scaffold1506",1,3600,3599,"cPa419"
"CNV_Scaffold244_1-14100","CNV_Scaffold244_1-14100",8,"Scaffold244",1,14100,14099,"cPa419"
"CNV_Scaffold244_36001-43200","CNV_Scaffold244_36001-43200",55,"Scaffold244",36001,43200,7199,"cPa419"
"CNV_Scaffold427_1-14400","CNV_Scaffold427_1-14400",39,"Scaffold427",1,14400,14399,"cPa356_cPa428"
"CNV_Scaffold481_10501-23700","CNV_Scaffold481_10501-23700",85,"Scaffold481",10501,23700,13199,"cPa402_cPa74"
"CNV_Scaffold524_5701-20700","CNV_Scaffold524_5701-20700",42,"Scaffold524",5701,20700,14999,"cPa356"
"CNV_Scaffold882_1-9000","CNV_Scaffold882_1-9000",38,"Scaffold882",1,9000,8999,"cPa428_cPa356_cPa419"
"CNV_Scaffold1033_5701-9900","CNV_Scaffold1033_5701-9900",218,"Scaffold1033",5701,9900,4199,"cPa305_cPa196_cPa459_cPa308_cPa433_cPa424_cPa327_cPa260_cPa409_cPa439"
"CNV_chr18_6001-11400","CNV_chr18_6001-11400",1,"chr18",6001,11400,5399,"cPa419_cPa392_cPa174_cPa404_cPa425_cPa254_cPa47"
"CNV_chr18_7506001-7519200","CNV_chr18_7506001-7519200",14,"chr18",7506001,7519200,13199,"cPa327_cPa268_cPa260"
"CNV_chr18_10017001-10030500","CNV_chr18_10017001-10030500",5,"chr18",10017001,10030500,13499,"cPa268_cPa118_cPa125_cPa264_cPa248_cPa140_cPa15_cPa443_cPa410"
"CNV_chr18_10092001-10104000","CNV_chr18_10092001-10104000",7,"chr18",10092001,10104000,11999,"cPa268_cPa118_cPa125_cPa264_cPa248_cPa140_cPa15_cPa443_cPa410_cPa308_cPa50"
"CNV_chr18_11111101-11114100","CNV_chr18_11111101-11114100",6,"chr18",11111101,11114100,2999,"cPa268_cPa118_cPa125_cPa264_cPa248_cPa140_cPa15_cPa443_cPa424_cPa327_cPa61_cPa516_cPa254_cPa119_cPa404_cPa174"
"CNV_Scaffold164_72901-77400","CNV_Scaffold164_72901-77400",1,"Scaffold164",72901,77400,4499,"HERV-W_repbase_HERV17_LTR17"
"CNV_Scaffold213_5401-18900","CNV_Scaffold213_5401-18900",30,"Scaffold213",5401,18900,13499,"cPa428_cPa356"
"CNV_Scaffold213_32401-46500","CNV_Scaffold213_32401-46500",34,"Scaffold213",32401,46500,14099,"cPa428_cPa356"
"CNV_Scaffold351_1-11100","CNV_Scaffold351_1-11100",17,"Scaffold351",1,11100,11099,"cPa419"
"CNV_Scaffold351_28501-33000","CNV_Scaffold351_28501-33000",2,"Scaffold351",28501,33000,4499,"cPa419"
"CNV_chrLGE22_1129501-1141800","CNV_chrLGE22_1129501-1141800",46,"chrLGE22",1129501,1141800,12299,"cPa410_cPa264_cPa379_cPa248_cPa15"
"CNV_chrLGE22_2125501-2136300","CNV_chrLGE22_2125501-2136300",100,"chrLGE22",2125501,2136300,10799,"cPa428_cPa356"
"CNV_chrLGE22_2142301-2144700","CNV_chrLGE22_2142301-2144700",1,"chrLGE22",2142301,2144700,2399,"cPa428_cPa356"
"CNV_Scaffold391_1-3600","CNV_Scaffold391_1-3600",23,"Scaffold391",1,3600,3599,"cPa428_cPa356"
"CNV_Scaffold391_15301-30300","CNV_Scaffold391_15301-30300",67,"Scaffold391",15301,30300,14999,"cPa356_cPa428"
"CNV_Scaffold1666_1-7200","CNV_Scaffold1666_1-7200",85,"Scaffold1666",1,7200,7199,"cPa360_cPa163"
"CNV_Scaffold1666_48001-51900","CNV_Scaffold1666_48001-51900",33,"Scaffold1666",48001,51900,3899,"cPa308"
"CNV_Scaffold46_48301-51900","CNV_Scaffold46_48301-51900",48,"Scaffold46",48301,51900,3599,"cPa339"
"CNV_Scaffold219_1-13200","CNV_Scaffold219_1-13200",21,"Scaffold219",1,13200,13199,"cPa356"
"CNV_Scaffold47_30001-36000","CNV_Scaffold47_30001-36000",62,"Scaffold47",30001,36000,5999,"cPa391_cPa287_cPa293_cPa426_cPa386_cPa20_cPa427_cPa482"
"CNV_Scaffold345_1-6300","CNV_Scaffold345_1-6300",44,"Scaffold345",1,6300,6299,"cPa404_cPa174_cPa425_cPa254_cPa47"
"CNV_Scaffold407_1-10800","CNV_Scaffold407_1-10800",16,"Scaffold407",1,10800,10799,"cPa356_cPa428"
"CNV_Scaffold407_14101-29100","CNV_Scaffold407_14101-29100",50,"Scaffold407",14101,29100,14999,"cPa428_cPa356"
"CNV_Scaffold501_1-4800","CNV_Scaffold501_1-4800",12,"Scaffold501",1,4800,4799,"cPa428_cPa356"
"CNV_Scaffold501_9601-22200","CNV_Scaffold501_9601-22200",45,"Scaffold501",9601,22200,12599,"cPa356_cPa428"
"CNV_Scaffold131_6301-17100","CNV_Scaffold131_6301-17100",91,"Scaffold131",6301,17100,10799,"cPa356"
"CNV_Scaffold921_1-8400","CNV_Scaffold921_1-8400",56,"Scaffold921",1,8400,8399,"cPa264_cPa268_cPa248_cPa443_cPa118_cPa140_cPa15_cPa125_cPa516_cPa119_cPa61_cPa502"
"CNV_Scaffold1176_1-7500","CNV_Scaffold1176_1-7500",84,"Scaffold1176",1,7500,7499,"cPa404_cPa174_cPa254_cPa47_cPa425_cPa392_cPa71_cPa452_cPa16_cPa363_cPa446_cPa62_cPa444_cPa205_cPa390"
"CNV_Scaffold1543_1-2700","CNV_Scaffold1543_1-2700",112,"Scaffold1543",1,2700,2699,"cPa356"
"CNV_Scaffold1546_1-2700","CNV_Scaffold1546_1-2700",86,"Scaffold1546",1,2700,2699,"cPa392"
"CNV_Scaffold16_1782601-1792200","CNV_Scaffold16_1782601-1792200",4,"Scaffold16",1782601,1792200,9599,"cPa434_cPa199_cPa425_cPa205"
"CNV_Scaffold16_1837201-1848900","CNV_Scaffold16_1837201-1848900",4,"Scaffold16",1837201,1848900,11699,"cPa434_cPa199_cPa205_cPa47_cPa254_cPa447_cPa443_cPa516_cPa566_cPa308"
"CNV_Scaffold300_1-15000","CNV_Scaffold300_1-15000",114,"Scaffold300",1,15000,14999,"cPa356"
"CNV_Scaffold300_24901-36300","CNV_Scaffold300_24901-36300",97,"Scaffold300",24901,36300,11399,"cPa356"
"CNV_Scaffold469_1-15000","CNV_Scaffold469_1-15000",15,"Scaffold469",1,15000,14999,"cPa356"
"CNV_Scaffold469_19501-24300","CNV_Scaffold469_19501-24300",28,"Scaffold469",19501,24300,4799,"cPa356"
"CNV_Scaffold1089_4201-9000","CNV_Scaffold1089_4201-9000",73,"Scaffold1089",4201,9000,4799,"cPa428_cPa356"
"CNV_Scaffold18_513001-516600","CNV_Scaffold18_513001-516600",7,"Scaffold18",513001,516600,3599,"cPa428_cPa356"
"CNV_Scaffold541_9001-19800","CNV_Scaffold541_9001-19800",38,"Scaffold541",9001,19800,10799,"cPa428_cPa356"
"CNV_Scaffold622_5401-15900","CNV_Scaffold622_5401-15900",114,"Scaffold622",5401,15900,10499,"cPa356"
"CNV_Scaffold1458_1-4200","CNV_Scaffold1458_1-4200",118,"Scaffold1458",1,4200,4199,"cPa428_cPa356"
"CNV_chr12_695701-714000","CNV_chr12_695701-714000",122,"chr12",695701,714000,18299,"cPa264_cPa61_cPa248_cPa443_cPa118_cPa140_cPa15_cPa125_cPa516_cPa268_cPa260"
"CNV_chr12_754801-767100","CNV_chr12_754801-767100",2,"chr12",754801,767100,12299,"cPa264_cPa61_cPa248_cPa443_cPa118_cPa140_cPa15_cPa125_cPa516_cPa268_cPa260_cPa413_cPa205"
"CNV_chr12_1125601-1139100","CNV_chr12_1125601-1139100",30,"chr12",1125601,1139100,13499,"cPa268_cPa443_cPa118_cPa125_cPa264_cPa248_cPa140_cPa15_cPa61_cPa413_cPa516_cPa205_cPa390_cPa62_cPa339_cPa353"
"CNV_chr12_20027701-20038500","CNV_chr12_20027701-20038500",25,"chr12",20027701,20038500,10799,"cPa60_cPa546_cPa285_cPa257_cPa472"
"CNV_Scaffold252_22201-29700","CNV_Scaffold252_22201-29700",106,"Scaffold252",22201,29700,7499,"cPa356_cPa428"
"CNV_Scaffold252_30301-42000","CNV_Scaffold252_30301-42000",107,"Scaffold252",30301,42000,11699,"cPa356_cPa428"
"CNV_Scaffold1487_1-3900","CNV_Scaffold1487_1-3900",55,"Scaffold1487",1,3900,3899,"cPa428"
"CNV_Scaffold169_78601-84300","CNV_Scaffold169_78601-84300",31,"Scaffold169",78601,84300,5699,"cPa356"
"CNV_Scaffold184_23101-29100","CNV_Scaffold184_23101-29100",53,"Scaffold184",23101,29100,5999,"cPa419"
"CNV_Scaffold184_68101-72300","CNV_Scaffold184_68101-72300",10,"Scaffold184",68101,72300,4199,"cPa419"
"CNV_Scaffold539_1-9000","CNV_Scaffold539_1-9000",12,"Scaffold539",1,9000,8999,"cPa419"
"CNV_Scaffold81_1-4500","CNV_Scaffold81_1-4500",41,"Scaffold81",1,4500,4499,"HERV-W_repbase_HERV17_LTR17_cPa434_cPa125"
"CNV_Scaffold434_15301-26100","CNV_Scaffold434_15301-26100",18,"Scaffold434",15301,26100,10799,"cPa434_cPa400"
"CNV_Scaffold494_8401-22200","CNV_Scaffold494_8401-22200",20,"Scaffold494",8401,22200,13799,"cPa419"
"CNV_Scaffold998_1-10500","CNV_Scaffold998_1-10500",14,"Scaffold998",1,10500,10499,"cPa356_cPa428"
"CNV_Scaffold1085_1-9000","CNV_Scaffold1085_1-9000",19,"Scaffold1085",1,9000,8999,"cPa419"
"CNV_Scaffold183_26401-33600","CNV_Scaffold183_26401-33600",32,"Scaffold183",26401,33600,7199,"cPa356"
"CNV_Scaffold183_55801-60600","CNV_Scaffold183_55801-60600",30,"Scaffold183",55801,60600,4799,"cPa356"
"CNV_Scaffold183_68701-72900","CNV_Scaffold183_68701-72900",32,"Scaffold183",68701,72900,4199,"cPa356"
"CNV_Scaffold563_14101-18600","CNV_Scaffold563_14101-18600",32,"Scaffold563",14101,18600,4499,"cPa428"
"CNV_Scaffold997_1-10800","CNV_Scaffold997_1-10800",33,"Scaffold997",1,10800,10799,"cPa356_cPa428"
"CNV_Scaffold1019_1-10200","CNV_Scaffold1019_1-10200",46,"Scaffold1019",1,10200,10199,"cPa356_cPa428"
"CNV_Scaffold1340_1-5700","CNV_Scaffold1340_1-5700",42,"Scaffold1340",1,5700,5699,"cPa356_cPa428"
"CNV_Scaffold1532_1-3300","CNV_Scaffold1532_1-3300",75,"Scaffold1532",1,3300,3299,"cPa419"
"CNV_Scaffold1533_1-3300","CNV_Scaffold1533_1-3300",162,"Scaffold1533",1,3300,3299,"cPa419"
"CNV_Scaffold271_26101-39300","CNV_Scaffold271_26101-39300",4,"Scaffold271",26101,39300,13199,"cPa356_cPa428"
"CNV_Scaffold277_31801-38400","CNV_Scaffold277_31801-38400",52,"Scaffold277",31801,38400,6599,"cPa419_cPa434"
"CNV_Scaffold319_8101-14700","CNV_Scaffold319_8101-14700",16,"Scaffold319",8101,14700,6599,"cPa428_cPa356"
"CNV_Scaffold335_16801-23100","CNV_Scaffold335_16801-23100",8,"Scaffold335",16801,23100,6299,"cPa428_cPa356"
"CNV_chr222_1-8400","CNV_chr222_1-8400",10,"chr222",1,8400,8399,"cPa356_cPa428"
"CNV_chr222_19201-23700","CNV_chr222_19201-23700",7,"chr222",19201,23700,4499,"cPa428_cPa356"
"CNV_Scaffold503_16801-21900","CNV_Scaffold503_16801-21900",45,"Scaffold503",16801,21900,5099,"cPa434"
"CNV_Scaffold506_1501-5400","CNV_Scaffold506_1501-5400",3,"Scaffold506",1501,5400,3899,"cPa419"
"CNV_Scaffold506_9601-16200","CNV_Scaffold506_9601-16200",20,"Scaffold506",9601,16200,6599,"cPa419"
"CNV_Scaffold528_1-3300","CNV_Scaffold528_1-3300",25,"Scaffold528",1,3300,3299,"cPa419"
"CNV_Scaffold545_1-5100","CNV_Scaffold545_1-5100",2,"Scaffold545",1,5100,5099,"cPa356_cPa428"
"CNV_Scaffold545_16801-19500","CNV_Scaffold545_16801-19500",14,"Scaffold545",16801,19500,2699,"cPa428_cPa356"
"CNV_Scaffold565_15601-18300","CNV_Scaffold565_15601-18300",1,"Scaffold565",15601,18300,2699,"cPa428_cPa356"
"CNV_Scaffold566_1-3900","CNV_Scaffold566_1-3900",128,"Scaffold566",1,3900,3899,"cPa356_cPa428"
"CNV_Scaffold603_4801-11700","CNV_Scaffold603_4801-11700",7,"Scaffold603",4801,11700,6899,"cPa428_cPa356"
"CNV_Scaffold610_1201-15900","CNV_Scaffold610_1201-15900",64,"Scaffold610",1201,15900,14699,"cPa356"
"CNV_Scaffold926_1-12600","CNV_Scaffold926_1-12600",35,"Scaffold926",1,12600,12599,"cPa428_cPa356"
"CNV_Scaffold955_3601-11100","CNV_Scaffold955_3601-11100",5,"Scaffold955",3601,11100,7499,"cPa428_cPa356"
"CNV_Scaffold1046_5101-9900","CNV_Scaffold1046_5101-9900",54,"Scaffold1046",5101,9900,4799,"cPa428_cPa356"
"CNV_Scaffold1051_1-9600","CNV_Scaffold1051_1-9600",33,"Scaffold1051",1,9600,9599,"cPa356"
"CNV_Scaffold1099_4801-8700","CNV_Scaffold1099_4801-8700",9,"Scaffold1099",4801,8700,3899,"cPa419"
"CNV_Scaffold695_2401-7800","CNV_Scaffold695_2401-7800",42,"Scaffold695",2401,7800,5399,"cPa419"
"CNV_Scaffold1157_1-7800","CNV_Scaffold1157_1-7800",53,"Scaffold1157",1,7800,7799,"cPa428_cPa356"
"CNV_Scaffold1423_1-4800","CNV_Scaffold1423_1-4800",145,"Scaffold1423",1,4800,4799,"cPa428_cPa356"
"CNV_Scaffold1452_1-4500","CNV_Scaffold1452_1-4500",25,"Scaffold1452",1,4500,4499,"cPa428_cPa356"
"CNV_Scaffold1502_1-3600","CNV_Scaffold1502_1-3600",42,"Scaffold1502",1,3600,3599,"cPa419"
"CNV_Scaffold1505_1-2400","CNV_Scaffold1505_1-2400",24,"Scaffold1505",1,2400,2399,"cPa227"
"CNV_Scaffold1536_1-3000","CNV_Scaffold1536_1-3000",140,"Scaffold1536",1,3000,2999,"cPa356"
"CNV_Scaffold1537_1-3000","CNV_Scaffold1537_1-3000",143,"Scaffold1537",1,3000,2999,"cPa356_cPa428"
"CNV_Scaffold1549_1-2700","CNV_Scaffold1549_1-2700",62,"Scaffold1549",1,2700,2699,"cPa428_cPa356"
"CNV_Scaffold1552_1-2700","CNV_Scaffold1552_1-2700",13,"Scaffold1552",1,2700,2699,"cPa419"
"CNV_Scaffold1557_1-2700","CNV_Scaffold1557_1-2700",66,"Scaffold1557",1,2700,2699,"cPa356_cPa428"
"CNV_Scaffold1559_1-2400","CNV_Scaffold1559_1-2400",27,"Scaffold1559",1,2400,2399,"cPa356_cPa428"
"CNV_Scaffold1564_1-2400","CNV_Scaffold1564_1-2400",15,"Scaffold1564",1,2400,2399,"cPa356_cPa428"
"CNV_Scaffold793_1-2400","CNV_Scaffold793_1-2400",23,"Scaffold793",1,2400,2399,"cPa356_cPa428"
"CNV_Scaffold1571_1-2400","CNV_Scaffold1571_1-2400",25,"Scaffold1571",1,2400,2399,"cPa356_cPa428"
"CNV_Scaffold905_6001-12900","CNV_Scaffold905_6001-12900",65,"Scaffold905",6001,12900,6899,"cPa419"
"CNV_Scaffold1345_1-5700","CNV_Scaffold1345_1-5700",87,"Scaffold1345",1,5700,5699,"cPa428_cPa356"
"CNV_Scaffold520_1-10800","CNV_Scaffold520_1-10800",35,"Scaffold520",1,10800,10799,"cPa356_cPa428"
"CNV_Scaffold520_13201-21000","CNV_Scaffold520_13201-21000",8,"Scaffold520",13201,21000,7799,"cPa428_cPa356"
"CNV_Scaffold692_1-9000","CNV_Scaffold692_1-9000",63,"Scaffold692",1,9000,8999,"cPa358_cPa251_cPa583"
"CNV_Scaffold1294_301-5400","CNV_Scaffold1294_301-5400",6,"Scaffold1294",301,5400,5099,"cPa356_cPa381_cPa446_cPa339_cPa353"
"CNV_chr26_1865701-1881900","CNV_chr26_1865701-1881900",68,"chr26",1865701,1881900,16199,"cPa61_cPa268_cPa264_cPa248_cPa443_cPa118_cPa140_cPa15_cPa125_cPa379_cPa446_cPa410_cPa434_cPa199_cPa371"
"CNV_chr26_4335601-4341300","CNV_chr26_4335601-4341300",6,"chr26",4335601,4341300,5699,"cPa268_cPa264_cPa248_cPa443_cPa118_cPa140_cPa15_cPa125_cPa516_cPa428_cPa356_cPa566_cPa61_cPa119"
"CNV_Scaffold1030_2701-9900","CNV_Scaffold1030_2701-9900",35,"Scaffold1030",2701,9900,7199,"cPa419"
"CNV_Scaffold308_2401-10800","CNV_Scaffold308_2401-10800",35,"Scaffold308",2401,10800,8399,"cPa315"
"CNV_Scaffold575_1-9600","CNV_Scaffold575_1-9600",9,"Scaffold575",1,9600,9599,"cPa419"
"CNV_Scaffold575_12901-16500","CNV_Scaffold575_12901-16500",1,"Scaffold575",12901,16500,3599,"cPa419"
"CNV_Scaffold613_1-10200","CNV_Scaffold613_1-10200",51,"Scaffold613",1,10200,10199,"cPa356_cPa428"
"CNV_Scaffold869_1-6600","CNV_Scaffold869_1-6600",55,"Scaffold869",1,6600,6599,"cPa434"
"CNV_Scaffold936_1-12000","CNV_Scaffold936_1-12000",10,"Scaffold936",1,12000,11999,"cPa428_cPa356"
"CNV_Scaffold341_4801-13200","CNV_Scaffold341_4801-13200",28,"Scaffold341",4801,13200,8399,"cPa428_cPa356"
"CNV_Scaffold341_30301-33300","CNV_Scaffold341_30301-33300",12,"Scaffold341",30301,33300,2999,"cPa428_cPa356"
"CNV_Scaffold1100_1-8700","CNV_Scaffold1100_1-8700",39,"Scaffold1100",1,8700,8699,"cPa391"
"CNV_Scaffold438_13501-23700","CNV_Scaffold438_13501-23700",16,"Scaffold438",13501,23700,10199,"cPa419"
"CNV_Scaffold1475_1-4200","CNV_Scaffold1475_1-4200",35,"Scaffold1475",1,4200,4199,"cPa419"
"CNV_Scaffold60_1-5100","CNV_Scaffold60_1-5100",1,"Scaffold60",1,5100,5099,"cPa434_cPa199"
"CNV_Scaffold60_21601-29400","CNV_Scaffold60_21601-29400",38,"Scaffold60",21601,29400,7799,"cPa391"
"CNV_Scaffold861_1-8700","CNV_Scaffold861_1-8700",5,"Scaffold861",1,8700,8699,"cPa428_cPa356"
"CNV_Scaffold1249_1-6600","CNV_Scaffold1249_1-6600",54,"Scaffold1249",1,6600,6599,"cPa356_cPa428"
"CNV_Scaffold1087_4501-9000","CNV_Scaffold1087_4501-9000",7,"Scaffold1087",4501,9000,4499,"cPa428_cPa356"
"CNV_Scaffold570_1-8400","CNV_Scaffold570_1-8400",54,"Scaffold570",1,8400,8399,"cPa419"
"CNV_Scaffold570_9001-18000","CNV_Scaffold570_9001-18000",59,"Scaffold570",9001,18000,8999,"cPa419"
"CNV_Scaffold151_1-6300","CNV_Scaffold151_1-6300",15,"Scaffold151",1,6300,6299,"cPa356"
"CNV_Scaffold151_13501-26100","CNV_Scaffold151_13501-26100",14,"Scaffold151",13501,26100,12599,"cPa356_cPa428"
"CNV_Scaffold1675_44701-53100","CNV_Scaffold1675_44701-53100",11,"Scaffold1675",44701,53100,8399,"cPa264_cPa268_cPa61_cPa248_cPa443_cPa118_cPa140_cPa15_cPa125_cPa516_cPa404_cPa174_cPa425_cPa392_cPa254_cPa47"
"CNV_Scaffold1675_72901-87000","CNV_Scaffold1675_72901-87000",9,"Scaffold1675",72901,87000,14099,"cPa61_cPa542"
"CNV_chr220_11401-21000","CNV_chr220_11401-21000",15,"chr220",11401,21000,9599,"cPa67_cPa542_cPa194"
"CNV_Scaffold69_13801-22800","CNV_Scaffold69_13801-22800",11,"Scaffold69",13801,22800,8999,"cPa264_cPa268_cPa61_cPa248_cPa443_cPa118_cPa140_cPa15_cPa125_cPa516_cPa119_cPa425"
"CNV_Scaffold83_1-6600","CNV_Scaffold83_1-6600",20,"Scaffold83",1,6600,6599,"cPa434"
"CNV_Scaffold924_1-12600","CNV_Scaffold924_1-12600",12,"Scaffold924",1,12600,12599,"cPa413"
"CNV_Scaffold1163_1-7800","CNV_Scaffold1163_1-7800",30,"Scaffold1163",1,7800,7799,"cPa428_cPa356"
"CNV_Scaffold1179_1-7500","CNV_Scaffold1179_1-7500",18,"Scaffold1179",1,7500,7499,"cPa356_cPa428"
"CNV_Scaffold1365_1-5400","CNV_Scaffold1365_1-5400",46,"Scaffold1365",1,5400,5399,"cPa356_cPa428"
"CNV_Scaffold1385_1-5400","CNV_Scaffold1385_1-5400",35,"Scaffold1385",1,5400,5399,"cPa428_cPa356"
"CNV_Scaffold422_14401-27300","CNV_Scaffold422_14401-27300",35,"Scaffold422",14401,27300,12899,"cPa356_cPa428"
"CNV_Scaffold571_9001-18000","CNV_Scaffold571_9001-18000",20,"Scaffold571",9001,18000,8999,"cPa428_cPa356"
"CNV_Scaffold854_1-14700","CNV_Scaffold854_1-14700",13,"Scaffold854",1,14700,14699,"cPa587_cPa308"
"CNV_Scaffold1214_1-7200","CNV_Scaffold1214_1-7200",70,"Scaffold1214",1,7200,7199,"cPa428_cPa356"
"CNV_Scaffold1261_3301-6600","CNV_Scaffold1261_3301-6600",76,"Scaffold1261",3301,6600,3299,"cPa428_cPa356"
"CNV_Scaffold1297_1-3600","CNV_Scaffold1297_1-3600",74,"Scaffold1297",1,3600,3599,"cPa356_cPa428"
"CNV_Scaffold247_6301-21000","CNV_Scaffold247_6301-21000",14,"Scaffold247",6301,21000,14699,"cPa428_cPa356"
"CNV_Scaffold247_30301-39300","CNV_Scaffold247_30301-39300",8,"Scaffold247",30301,39300,8999,"cPa356_cPa428"
"CNV_Scaffold485_7201-19200","CNV_Scaffold485_7201-19200",21,"Scaffold485",7201,19200,11999,"cPa356_cPa428"
"CNV_Scaffold491_1-13500","CNV_Scaffold491_1-13500",3,"Scaffold491",1,13500,13499,"cPa428_cPa356"
"CNV_Scaffold543_9001-19800","CNV_Scaffold543_9001-19800",46,"Scaffold543",9001,19800,10799,"cPa356_cPa428"
"CNV_Scaffold616_1-3000","CNV_Scaffold616_1-3000",60,"Scaffold616",1,3000,2999,"cPa356"
"CNV_Scaffold616_6601-15900","CNV_Scaffold616_6601-15900",71,"Scaffold616",6601,15900,9299,"cPa356"
"CNV_Scaffold1061_6601-9600","CNV_Scaffold1061_6601-9600",30,"Scaffold1061",6601,9600,2999,"cPa428_cPa356"
"CNV_Scaffold337_11701-17400","CNV_Scaffold337_11701-17400",12,"Scaffold337",11701,17400,5699,"cPa428_cPa356"
"CNV_Scaffold163_7801-15900","CNV_Scaffold163_7801-15900",8,"Scaffold163",7801,15900,8099,"cPa428_cPa356"
"CNV_Scaffold143_81001-95400","CNV_Scaffold143_81001-95400",12,"Scaffold143",81001,95400,14399,"cPa428_cPa356"
"CNV_Scaffold143_104101-109800","CNV_Scaffold143_104101-109800",1,"Scaffold143",104101,109800,5699,"cPa428_cPa356"
"CNV_Scaffold143_136501-154500","CNV_Scaffold143_136501-154500",44,"Scaffold143",136501,154500,17999,"cPa428_cPa356"
"CNV_Scaffold167_52201-58200","CNV_Scaffold167_52201-58200",2,"Scaffold167",52201,58200,5999,"cPa419"
"CNV_Scaffold171_66301-77400","CNV_Scaffold171_66301-77400",10,"Scaffold171",66301,77400,11099,"cPa434_cPa363_cPa404_cPa392_cPa174_cPa425_cPa254_cPa47"
"CNV_Scaffold222_28501-40200","CNV_Scaffold222_28501-40200",14,"Scaffold222",28501,40200,11699,"cPa428_cPa356"
"CNV_Scaffold222_49501-51900","CNV_Scaffold222_49501-51900",3,"Scaffold222",49501,51900,2399,"cPa356"
"CNV_Scaffold266_18901-28200","CNV_Scaffold266_18901-28200",3,"Scaffold266",18901,28200,9299,"cPa419"
"CNV_Scaffold120_1-7200","CNV_Scaffold120_1-7200",3,"Scaffold120",1,7200,7199,"cPa356_cPa428"
"CNV_Scaffold120_7801-12300","CNV_Scaffold120_7801-12300",1,"Scaffold120",7801,12300,4499,"cPa428_cPa356"
"CNV_Scaffold120_20101-23400","CNV_Scaffold120_20101-23400",4,"Scaffold120",20101,23400,3299,"cPa428_cPa356"
"CNV_Scaffold305_32701-35700","CNV_Scaffold305_32701-35700",9,"Scaffold305",32701,35700,2999,"cPa428_cPa356"
"CNV_Scaffold379_1-3600","CNV_Scaffold379_1-3600",18,"Scaffold379",1,3600,3599,"cPa356_cPa428"
"CNV_Scaffold379_6301-11700","CNV_Scaffold379_6301-11700",3,"Scaffold379",6301,11700,5399,"cPa428_cPa356"
"CNV_Scaffold379_20401-30900","CNV_Scaffold379_20401-30900",6,"Scaffold379",20401,30900,10499,"cPa428_cPa356"
"CNV_chr228_1-11700","CNV_chr228_1-11700",33,"chr228",1,11700,11699,"cPa356_cPa428"
"CNV_chr228_12301-16200","CNV_chr228_12301-16200",18,"chr228",12301,16200,3899,"cPa356_cPa428"
"CNV_Scaffold424_1-10200","CNV_Scaffold424_1-10200",2,"Scaffold424",1,10200,10199,"cPa356"
"CNV_Scaffold428_12601-22500","CNV_Scaffold428_12601-22500",56,"Scaffold428",12601,22500,9899,"cPa356_cPa428"
"CNV_Scaffold118_1-9900","CNV_Scaffold118_1-9900",32,"Scaffold118",1,9900,9899,"cPa356_cPa428"
"CNV_Scaffold538_14701-18600","CNV_Scaffold538_14701-18600",2,"Scaffold538",14701,18600,3899,"cPa428_cPa356"
"CNV_Scaffold127_6001-17100","CNV_Scaffold127_6001-17100",29,"Scaffold127",6001,17100,11099,"cPa428_cPa356"
"CNV_Scaffold589_301-2400","CNV_Scaffold589_301-2400",1,"Scaffold589",301,2400,2099,"cPa428_cPa356"
"CNV_Scaffold637_2401-15300","CNV_Scaffold637_2401-15300",18,"Scaffold637",2401,15300,12899,"cPa356_cPa428"
"CNV_Scaffold651_1-4500","CNV_Scaffold651_1-4500",5,"Scaffold651",1,4500,4499,"cPa428_cPa356"
"CNV_Scaffold651_6001-10500","CNV_Scaffold651_6001-10500",5,"Scaffold651",6001,10500,4499,"cPa428_cPa356"
"CNV_Scaffold918_1-12600","CNV_Scaffold918_1-12600",34,"Scaffold918",1,12600,12599,"cPa356_cPa428"
"CNV_Scaffold946_7201-11700","CNV_Scaffold946_7201-11700",13,"Scaffold946",7201,11700,4499,"cPa428_cPa356"
"CNV_Scaffold1026_6901-10200","CNV_Scaffold1026_6901-10200",8,"Scaffold1026",6901,10200,3299,"cPa428_cPa356"
"CNV_Scaffold1060_1-9600","CNV_Scaffold1060_1-9600",5,"Scaffold1060",1,9600,9599,"cPa419"
"CNV_Scaffold1066_1-9300","CNV_Scaffold1066_1-9300",9,"Scaffold1066",1,9300,9299,"cPa419"
"CNV_Scaffold688_4801-9300","CNV_Scaffold688_4801-9300",30,"Scaffold688",4801,9300,4499,"cPa419"
"CNV_Scaffold1130_1-3000","CNV_Scaffold1130_1-3000",2,"Scaffold1130",1,3000,2999,"cPa419"
"CNV_Scaffold1168_5401-7800","CNV_Scaffold1168_5401-7800",4,"Scaffold1168",5401,7800,2399,"cPa356_cPa428"
"CNV_Scaffold1177_1-2100","CNV_Scaffold1177_1-2100",2,"Scaffold1177",1,2100,2099,"cPa356_cPa428"
"CNV_Scaffold1420_1-4800","CNV_Scaffold1420_1-4800",36,"Scaffold1420",1,4800,4799,"cPa428_cPa356"
"CNV_Scaffold1486_1801-3900","CNV_Scaffold1486_1801-3900",11,"Scaffold1486",1801,3900,2099,"cPa356_cPa428"
"CNV_Scaffold1542_1-2700","CNV_Scaffold1542_1-2700",17,"Scaffold1542",1,2700,2699,"cPa419"
"CNV_Scaffold1545_1-2700","CNV_Scaffold1545_1-2700",3,"Scaffold1545",1,2700,2699,"cPa419"
"CNV_Scaffold1563_1-2400","CNV_Scaffold1563_1-2400",22,"Scaffold1563",1,2400,2399,"cPa356_cPa428"
"CNV_Scaffold1574_1-2100","CNV_Scaffold1574_1-2100",14,"Scaffold1574",1,2100,2099,"cPa356_cPa428"
"CNV_Scaffold1576_1-2100","CNV_Scaffold1576_1-2100",14,"Scaffold1576",1,2100,2099,"cPa356"
"CNV_Scaffold1578_1-2100","CNV_Scaffold1578_1-2100",7,"Scaffold1578",1,2100,2099,"cPa419"
"CNV_Scaffold1579_1-2100","CNV_Scaffold1579_1-2100",14,"Scaffold1579",1,2100,2099,"cPa428_cPa356"
"CNV_Scaffold1580_1-2100","CNV_Scaffold1580_1-2100",13,"Scaffold1580",1,2100,2099,"cPa356_cPa428"
"CNV_Scaffold1587_1-1800","CNV_Scaffold1587_1-1800",3,"Scaffold1587",1,1800,1799,"cPa356_cPa428"
"CNV_Scaffold400_1-3000","CNV_Scaffold400_1-3000",3,"Scaffold400",1,3000,2999,"cPa428_cPa356"
"CNV_Scaffold400_15601-29400","CNV_Scaffold400_15601-29400",26,"Scaffold400",15601,29400,13799,"cPa428_cPa356"
"CNV_Scaffold409_12901-27300","CNV_Scaffold409_12901-27300",75,"Scaffold409",12901,27300,14399,"cPa356"
"CNV_Scaffold41_18301-21600","CNV_Scaffold41_18301-21600",56,"Scaffold41",18301,21600,3299,"cPa434"
"CNV_Scaffold561_1-6600","CNV_Scaffold561_1-6600",22,"Scaffold561",1,6600,6599,"cPa356_cPa428"
"CNV_Scaffold1135_1-6300","CNV_Scaffold1135_1-6300",15,"Scaffold1135",1,6300,6299,"cPa356_cPa428"
"CNV_Scaffold535_1-8100","CNV_Scaffold535_1-8100",21,"Scaffold535",1,8100,8099,"cPa428_cPa356"
"CNV_Scaffold535_15001-20100","CNV_Scaffold535_15001-20100",28,"Scaffold535",15001,20100,5099,"cPa428_cPa356"
"CNV_Scaffold168_74101-88200","CNV_Scaffold168_74101-88200",61,"Scaffold168",74101,88200,14099,"cPa428"
"CNV_Scaffold881_1-5100","CNV_Scaffold881_1-5100",1,"Scaffold881",1,5100,5099,"cPa428_cPa356"
"CNV_Scaffold1449_1-4500","CNV_Scaffold1449_1-4500",83,"Scaffold1449",1,4500,4499,"cPa428_cPa356"
"CNV_Scaffold206_1-14100","CNV_Scaffold206_1-14100",32,"Scaffold206",1,14100,14099,"cPa356_cPa428"
"CNV_Scaffold206_51301-59400","CNV_Scaffold206_51301-59400",3,"Scaffold206",51301,59400,8099,"cPa428_cPa356"
"CNV_Scaffold883_8401-13500","CNV_Scaffold883_8401-13500",11,"Scaffold883",8401,13500,5099,"cPa356_cPa428"
"CNV_Scaffold270_29401-39600","CNV_Scaffold270_29401-39600",14,"Scaffold270",29401,39600,10199,"cPa356_cPa428"
"CNV_Scaffold354_15601-25800","CNV_Scaffold354_15601-25800",4,"Scaffold354",15601,25800,10199,"cPa419"
"CNV_Scaffold476_1-7800","CNV_Scaffold476_1-7800",17,"Scaffold476",1,7800,7799,"cPa428_cPa356"
"CNV_Scaffold476_15901-23700","CNV_Scaffold476_15901-23700",2,"Scaffold476",15901,23700,7799,"cPa428_cPa356"
"CNV_Scaffold499_1-3000","CNV_Scaffold499_1-3000",1,"Scaffold499",1,3000,2999,"cPa428_cPa356"
"CNV_Scaffold499_7201-22200","CNV_Scaffold499_7201-22200",6,"Scaffold499",7201,22200,14999,"cPa428_cPa356"
"CNV_Scaffold956_1-2700","CNV_Scaffold956_1-2700",11,"Scaffold956",1,2700,2699,"cPa428_cPa356"
"CNV_Scaffold958_1-11400","CNV_Scaffold958_1-11400",29,"Scaffold958",1,11400,11399,"cPa356_cPa428"
"CNV_Scaffold1000_6001-10500","CNV_Scaffold1000_6001-10500",42,"Scaffold1000",6001,10500,4499,"cPa428_cPa356"
"CNV_Scaffold1012_1-10200","CNV_Scaffold1012_1-10200",9,"Scaffold1012",1,10200,10199,"cPa356"
"CNV_Scaffold1055_1-5700","CNV_Scaffold1055_1-5700",8,"Scaffold1055",1,5700,5699,"cPa308"
"CNV_Scaffold1075_1-9000","CNV_Scaffold1075_1-9000",38,"Scaffold1075",1,9000,8999,"cPa428_cPa356"
"CNV_Scaffold1102_1-8700","CNV_Scaffold1102_1-8700",15,"Scaffold1102",1,8700,8699,"cPa356"
"CNV_Scaffold1173_1-7500","CNV_Scaffold1173_1-7500",17,"Scaffold1173",1,7500,7499,"cPa428_cPa356"
"CNV_Scaffold1197_1-7200","CNV_Scaffold1197_1-7200",9,"Scaffold1197",1,7200,7199,"cPa308"
"CNV_Scaffold1212_1-7200","CNV_Scaffold1212_1-7200",45,"Scaffold1212",1,7200,7199,"cPa163"
"CNV_Scaffold1243_1-6600","CNV_Scaffold1243_1-6600",11,"Scaffold1243",1,6600,6599,"cPa428_cPa356"
"CNV_Scaffold1264_2101-6600","CNV_Scaffold1264_2101-6600",19,"Scaffold1264",2101,6600,4499,"cPa419"
"CNV_Scaffold1270_1-6300","CNV_Scaffold1270_1-6300",15,"Scaffold1270",1,6300,6299,"cPa428_cPa356"
"CNV_Scaffold1436_1-2700","CNV_Scaffold1436_1-2700",3,"Scaffold1436",1,2700,2699,"cPa356_cPa428"
"CNV_Scaffold1523_1-3300","CNV_Scaffold1523_1-3300",10,"Scaffold1523",1,3300,3299,"cPa428_cPa356"
"CNV_Scaffold1538_1-3000","CNV_Scaffold1538_1-3000",4,"Scaffold1538",1,3000,2999,"cPa419"
"CNV_Scaffold327_1-12900","CNV_Scaffold327_1-12900",126,"Scaffold327",1,12900,12899,"cPa419"
"CNV_Scaffold572_1-10800","CNV_Scaffold572_1-10800",9,"Scaffold572",1,10800,10799,"cPa428_cPa356"
"CNV_Scaffold95_12601-27000","CNV_Scaffold95_12601-27000",9,"Scaffold95",12601,27000,14399,"cPa404_cPa174_cPa425_cPa392_cPa254_cPa47_cPa363"
"CNV_Scaffold95_92101-104700","CNV_Scaffold95_92101-104700",4,"Scaffold95",92101,104700,12599,"cPa434"
"CNV_Scaffold95_123301-129300","CNV_Scaffold95_123301-129300",1,"Scaffold95",123301,129300,5999,"cPa390_cPa205_cPa444_cPa62_cPa398"
"CNV_Scaffold1673_17701-29700","CNV_Scaffold1673_17701-29700",1,"Scaffold1673",17701,29700,11999,"cPa404_cPa392_cPa174_cPa425_cPa47_cPa254"
"CNV_Scaffold483_13501-23400","CNV_Scaffold483_13501-23400",10,"Scaffold483",13501,23400,9899,"cPa428_cPa356"
"CNV_Scaffold215_14401-21600","CNV_Scaffold215_14401-21600",66,"Scaffold215",14401,21600,7199,"cPa428_cPa356"
"CNV_Scaffold263_11701-19200","CNV_Scaffold263_11701-19200",1,"Scaffold263",11701,19200,7499,"cPa152_cPa109_cPa106_cPa505_cPa201_cPa424_cPa327_cPa16_cPa183_cPa223"
"CNV_Scaffold906_1-7200","CNV_Scaffold906_1-7200",20,"Scaffold906",1,7200,7199,"cPa356_cPa428"
"CNV_Scaffold917_1-5100","CNV_Scaffold917_1-5100",3,"Scaffold917",1,5100,5099,"cPa428_cPa356"
"CNV_Scaffold1029_1-5400","CNV_Scaffold1029_1-5400",5,"Scaffold1029",1,5400,5399,"cPa428_cPa356"
"CNV_Scaffold257_1-15000","CNV_Scaffold257_1-15000",35,"Scaffold257",1,15000,14999,"cPa356_cPa199_cPa273_cPa345_cPa227_cPa450"
"CNV_Scaffold257_29401-41100","CNV_Scaffold257_29401-41100",18,"Scaffold257",29401,41100,11699,"cPa356"
"CNV_Scaffold371_1-3600","CNV_Scaffold371_1-3600",1,"Scaffold371",1,3600,3599,"cPa356_cPa428"
"CNV_Scaffold371_4201-13500","CNV_Scaffold371_4201-13500",4,"Scaffold371",4201,13500,9299,"cPa428_cPa356"
"CNV_Scaffold371_24901-31500","CNV_Scaffold371_24901-31500",1,"Scaffold371",24901,31500,6599,"cPa428_cPa356"
"CNV_Scaffold1685_13201-25500","CNV_Scaffold1685_13201-25500",24,"Scaffold1685",13201,25500,12299,"cPa371"
"CNV_Scaffold298_1-2700","CNV_Scaffold298_1-2700",3,"Scaffold298",1,2700,2699,"cPa428_cPa356"
"CNV_Scaffold298_26401-36600","CNV_Scaffold298_26401-36600",10,"Scaffold298",26401,36600,10199,"cPa428_cPa356"
"CNV_Scaffold549_1-7500","CNV_Scaffold549_1-7500",13,"Scaffold549",1,7500,7499,"cPa428_cPa356"
"CNV_Scaffold562_1-10200","CNV_Scaffold562_1-10200",2,"Scaffold562",1,10200,10199,"cPa419"
"CNV_Scaffold124_1-14400","CNV_Scaffold124_1-14400",41,"Scaffold124",1,14400,14399,"cPa428_cPa356"
"CNV_Scaffold1704_14101-27000","CNV_Scaffold1704_14101-27000",4,"Scaffold1704",14101,27000,12899,"cPa447_cPa356_cPa434"
"CNV_Scaffold923_1-12600","CNV_Scaffold923_1-12600",18,"Scaffold923",1,12600,12599,"cPa438_cPa216_cPa515_cPa479_cPa255_cPa478_cPa131"
"CNV_Scaffold1223_1-6900","CNV_Scaffold1223_1-6900",4,"Scaffold1223",1,6900,6899,"cPa505"
"CNV_Scaffold221_1-9000","CNV_Scaffold221_1-9000",2,"Scaffold221",1,9000,8999,"cPa428_cPa356"
"CNV_Scaffold221_37201-52200","CNV_Scaffold221_37201-52200",45,"Scaffold221",37201,52200,14999,"cPa428_cPa356"
"CNV_Scaffold1708_1-7200","CNV_Scaffold1708_1-7200",37,"Scaffold1708",1,7200,7199,"cPa363_cPa456_cPa452"
"CNV_Scaffold660_2701-13200","CNV_Scaffold660_2701-13200",16,"Scaffold660",2701,13200,10499,"cPa450"
"CNV_Scaffold919_1-4800","CNV_Scaffold919_1-4800",19,"Scaffold919",1,4800,4799,"cPa428_cPa356"
"CNV_Scaffold943_1-3300","CNV_Scaffold943_1-3300",3,"Scaffold943",1,3300,3299,"cPa419"
"CNV_Scaffold284_23101-34800","CNV_Scaffold284_23101-34800",1,"Scaffold284",23101,34800,11699,"cPa428_cPa356"
"CNV_Scaffold340_19801-33600","CNV_Scaffold340_19801-33600",25,"Scaffold340",19801,33600,13799,"cPa356"
"CNV_Scaffold1701_17701-21900","CNV_Scaffold1701_17701-21900",37,"Scaffold1701",17701,21900,4199,"cPa358_cPa251_cPa583"
"CNV_Scaffold365_12001-25200","CNV_Scaffold365_12001-25200",13,"Scaffold365",12001,25200,13199,"cPa356_cPa428"
"CNV_Scaffold582_1-6900","CNV_Scaffold582_1-6900",38,"Scaffold582",1,6900,6899,"cPa428_cPa356"
"CNV_Scaffold582_9901-17700","CNV_Scaffold582_9901-17700",32,"Scaffold582",9901,17700,7799,"cPa356"
"CNV_Scaffold515_1-12900","CNV_Scaffold515_1-12900",22,"Scaffold515",1,12900,12899,"cPa428_cPa356"
"CNV_Scaffold1413_1-3300","CNV_Scaffold1413_1-3300",4,"Scaffold1413",1,3300,3299,"cPa392"
"CNV_Scaffold56_52501-56700","CNV_Scaffold56_52501-56700",1,"Scaffold56",52501,56700,4199,"cPa391"
"CNV_Scaffold399_7801-16200","CNV_Scaffold399_7801-16200",5,"Scaffold399",7801,16200,8399,"cPa428_cPa356"
"CNV_Scaffold672_5401-8700","CNV_Scaffold672_5401-8700",42,"Scaffold672",5401,8700,3299,"cPa428_cPa356"
"CNV_Scaffold114_1-15000","CNV_Scaffold114_1-15000",40,"Scaffold114",1,15000,14999,"cPa356"
"CNV_Scaffold1700_12901-24000","CNV_Scaffold1700_12901-24000",40,"Scaffold1700",12901,24000,11099,"cPa428_cPa356"
"CNV_Scaffold258_1-5100","CNV_Scaffold258_1-5100",1,"Scaffold258",1,5100,5099,"cPa356_cPa428"
"CNV_Scaffold258_25801-40800","CNV_Scaffold258_25801-40800",11,"Scaffold258",25801,40800,14999,"cPa428_cPa356"
"CNV_Scaffold77_1-4200","CNV_Scaffold77_1-4200",10,"Scaffold77",1,4200,4199,"cPa199_cPa450_cPa345_cPa227_cPa553"
"CNV_Scaffold218_1-3300","CNV_Scaffold218_1-3300",285,"Scaffold218",1,3300,3299,"cPa356_cPa428"
"CNV_Scaffold296_1-10800","CNV_Scaffold296_1-10800",115,"Scaffold296",1,10800,10799,"cPa356"
"CNV_Scaffold296_13801-22500","CNV_Scaffold296_13801-22500",112,"Scaffold296",13801,22500,8699,"cPa356"
"CNV_Scaffold240_1-14100","CNV_Scaffold240_1-14100",51,"Scaffold240",1,14100,14099,"cPa356"
"CNV_Scaffold135_18301-22800","CNV_Scaffold135_18301-22800",7,"Scaffold135",18301,22800,4499,"cPa356"
"CNV_Scaffold180_69301-75000","CNV_Scaffold180_69301-75000",13,"Scaffold180",69301,75000,5699,"cPa419"
"CNV_Scaffold126_6301-12900","CNV_Scaffold126_6301-12900",37,"Scaffold126",6301,12900,6599,"cPa356"
"CNV_Scaffold868_1-3600","CNV_Scaffold868_1-3600",5,"Scaffold868",1,3600,3599,"cPa428_cPa356"
"CNV_Scaffold1103_1-3000","CNV_Scaffold1103_1-3000",4,"Scaffold1103",1,3000,2999,"cPa428_cPa356"
"CNV_Scaffold191_7201-10800","CNV_Scaffold191_7201-10800",4,"Scaffold191",7201,10800,3599,"cPa419"
"CNV_Scaffold191_11401-21600","CNV_Scaffold191_11401-21600",1,"Scaffold191",11401,21600,10199,"cPa419"
"CNV_Scaffold256_21901-27000","CNV_Scaffold256_21901-27000",1,"Scaffold256",21901,27000,5099,"cPa419"
"CNV_Scaffold294_7201-10500","CNV_Scaffold294_7201-10500",1,"Scaffold294",7201,10500,3299,"cPa419"
"CNV_Scaffold294_20101-24300","CNV_Scaffold294_20101-24300",1,"Scaffold294",20101,24300,4199,"cPa419"
"CNV_Scaffold321_29401-34500","CNV_Scaffold321_29401-34500",23,"Scaffold321",29401,34500,5099,"cPa419"
"CNV_Scaffold591_8701-11100","CNV_Scaffold591_8701-11100",4,"Scaffold591",8701,11100,2399,"cPa428_cPa356"
"CNV_Scaffold615_12901-15900","CNV_Scaffold615_12901-15900",2,"Scaffold615",12901,15900,2999,"cPa419"
"CNV_Scaffold927_9001-12600","CNV_Scaffold927_9001-12600",1,"Scaffold927",9001,12600,3599,"cPa419"
"CNV_Scaffold664_8401-12300","CNV_Scaffold664_8401-12300",17,"Scaffold664",8401,12300,3899,"cPa392"
"CNV_Scaffold942_9001-12000","CNV_Scaffold942_9001-12000",6,"Scaffold942",9001,12000,2999,"cPa419"
"CNV_Scaffold1147_1-3300","CNV_Scaffold1147_1-3300",14,"Scaffold1147",1,3300,3299,"cPa419"
"CNV_Scaffold1306_1-6000","CNV_Scaffold1306_1-6000",3,"Scaffold1306",1,6000,5999,"cPa419"
"CNV_Scaffold1317_1-6000","CNV_Scaffold1317_1-6000",6,"Scaffold1317",1,6000,5999,"cPa356_cPa428"
"CNV_Scaffold1354_1-5700","CNV_Scaffold1354_1-5700",7,"Scaffold1354",1,5700,5699,"cPa419"
"CNV_Scaffold1355_1-5700","CNV_Scaffold1355_1-5700",3,"Scaffold1355",1,5700,5699,"cPa419"
"CNV_Scaffold1455_1-4500","CNV_Scaffold1455_1-4500",5,"Scaffold1455",1,4500,4499,"cPa419"
"CNV_Scaffold1504_1-3600","CNV_Scaffold1504_1-3600",10,"Scaffold1504",1,3600,3599,"cPa419"
"CNV_Scaffold1010_1-4200","CNV_Scaffold1010_1-4200",10,"Scaffold1010",1,4200,4199,"cPa419"
"CNV_Scaffold708_1-7200","CNV_Scaffold708_1-7200",7,"Scaffold708",1,7200,7199,"cPa356"
"CNV_Scaffold374_1-7500","CNV_Scaffold374_1-7500",156,"Scaffold374",1,7500,7499,"cPa356_cPa428"
"CNV_Scaffold887_1801-13500","CNV_Scaffold887_1801-13500",12,"Scaffold887",1801,13500,11699,"cPa435_cPa193_cPa518_cPa523_cPa308"
"CNV_Scaffold214_27301-35400","CNV_Scaffold214_27301-35400",4,"Scaffold214",27301,35400,8099,"cPa227_cPa357"
"CNV_Scaffold214_50101-55800","CNV_Scaffold214_50101-55800",6,"Scaffold214",50101,55800,5699,"cPa356_cPa552"
"CNV_Scaffold493_11101-22500","CNV_Scaffold493_11101-22500",2,"Scaffold493",11101,22500,11399,"cPa428_cPa356"
"CNV_Scaffold968_1-11400","CNV_Scaffold968_1-11400",3,"Scaffold968",1,11400,11399,"cPa443_cPa118_cPa125_cPa268_cPa264_cPa248_cPa140_cPa15_cPa516_cPa61"
"CNV_Scaffold1091_1-9000","CNV_Scaffold1091_1-9000",8,"Scaffold1091",1,9000,8999,"cPa61_cPa205_cPa273_cPa345_cPa227_cPa199"
"CNV_Scaffold1121_1-8400","CNV_Scaffold1121_1-8400",4,"Scaffold1121",1,8400,8399,"cPa357_cPa264_cPa268_cPa248_cPa443_cPa118_cPa140_cPa15_cPa125_cPa516_cPa61"
"CNV_Scaffold767_1-3600","CNV_Scaffold767_1-3600",14,"Scaffold767",1,3600,3599,"cPa434"
"CNV_Scaffold1015_1501-8100","CNV_Scaffold1015_1501-8100",3,"Scaffold1015",1501,8100,6599,"cPa61_cPa118_cPa264_cPa268_cPa248_cPa443_cPa140_cPa15_cPa125_cPa516_cPa119"
"CNV_Scaffold393_1-5400","CNV_Scaffold393_1-5400",3,"Scaffold393",1,5400,5399,"cPa404_cPa254_cPa47_cPa392_cPa425"
"CNV_Scaffold235_35401-46800","CNV_Scaffold235_35401-46800",35,"Scaffold235",35401,46800,11399,"cPa356"
"CNV_Scaffold261_1-5700","CNV_Scaffold261_1-5700",3,"Scaffold261",1,5700,5699,"cPa428_cPa356"
"CNV_Scaffold286_23101-37500","CNV_Scaffold286_23101-37500",38,"Scaffold286",23101,37500,14399,"cPa428"
"CNV_Scaffold650_7501-14100","CNV_Scaffold650_7501-14100",8,"Scaffold650",7501,14100,6599,"cPa434"
"CNV_Scaffold324_20401-34500","CNV_Scaffold324_20401-34500",41,"Scaffold324",20401,34500,14099,"cPa356_cPa428"
"CNV_Scaffold175_1501-16500","CNV_Scaffold175_1501-16500",3,"Scaffold175",1501,16500,14999,"cPa356_cPa428"
"CNV_Scaffold89_6901-13800","CNV_Scaffold89_6901-13800",2,"Scaffold89",6901,13800,6899,"cPa434_cPa447"
"CNV_Scaffold722_1-5400","CNV_Scaffold722_1-5400",4,"Scaffold722",1,5400,5399,"cPa356"
"CNV_Scaffold304_28801-36000","CNV_Scaffold304_28801-36000",6,"Scaffold304",28801,36000,7199,"cPa428_cPa356"
"CNV_Scaffold353_3301-13200","CNV_Scaffold353_3301-13200",28,"Scaffold353",3301,13200,9899,"cPa356"
"CNV_Scaffold522_1-4200","CNV_Scaffold522_1-4200",3,"Scaffold522",1,4200,4199,"cPa419"
"CNV_Scaffold1450_1-4500","CNV_Scaffold1450_1-4500",4,"Scaffold1450",1,4500,4499,"cPa308"
"CNV_Scaffold1754_13501-25800","CNV_Scaffold1754_13501-25800",5,"Scaffold1754",13501,25800,12299,"cPa402_cPa74_cPa539"
"CNV_Scaffold608_1-9600","CNV_Scaffold608_1-9600",255,"Scaffold608",1,9600,9599,"cPa356_cPa428"
"CNV_Scaffold608_10201-16500","CNV_Scaffold608_10201-16500",255,"Scaffold608",10201,16500,6299,"cPa428_cPa356"
"CNV_Scaffold467_1-12000","CNV_Scaffold467_1-12000",2,"Scaffold467",1,12000,11999,"cPa419"
"CNV_Scaffold971_1-5400","CNV_Scaffold971_1-5400",5,"Scaffold971",1,5400,5399,"cPa356"
"CNV_Scaffold1115_1-8400","CNV_Scaffold1115_1-8400",3,"Scaffold1115",1,8400,8399,"cPa428_cPa356"
"CNV_Scaffold879_6901-13500","CNV_Scaffold879_6901-13500",2,"Scaffold879",6901,13500,6599,"cPa419"
"CNV_Scaffold891_4501-13200","CNV_Scaffold891_4501-13200",3,"Scaffold891",4501,13200,8699,"cPa419"
"CNV_Scaffold253_1-7500","CNV_Scaffold253_1-7500",42,"Scaffold253",1,7500,7499,"cPa356"
"CNV_Scaffold511_11401-21600","CNV_Scaffold511_11401-21600",2,"Scaffold511",11401,21600,10199,"cPa419"
"CNV_Scaffold44_1-5400","CNV_Scaffold44_1-5400",1,"Scaffold44",1,5400,5399,"cPa339"
"CNV_Scaffold553_1-6600","CNV_Scaffold553_1-6600",30,"Scaffold553",1,6600,6599,"cPa356_cPa428"
"CNV_Scaffold553_7201-19200","CNV_Scaffold553_7201-19200",30,"Scaffold553",7201,19200,11999,"cPa356_cPa428"
"CNV_Scaffold141_107701-117300","CNV_Scaffold141_107701-117300",3,"Scaffold141",107701,117300,9599,"cPa419"
"CNV_Scaffold141_155401-159300","CNV_Scaffold141_155401-159300",2,"Scaffold141",155401,159300,3899,"cPa419"
"CNV_Scaffold193_1-3300","CNV_Scaffold193_1-3300",4,"Scaffold193",1,3300,3299,"cPa419"
"CNV_Scaffold311_1-3300","CNV_Scaffold311_1-3300",1,"Scaffold311",1,3300,3299,"cPa419"
"CNV_Scaffold328_14401-26100","CNV_Scaffold328_14401-26100",2,"Scaffold328",14401,26100,11699,"cPa419"
"CNV_Scaffold464_15601-24900","CNV_Scaffold464_15601-24900",1,"Scaffold464",15601,24900,9299,"cPa419"
"CNV_Scaffold510_1-5400","CNV_Scaffold510_1-5400",6,"Scaffold510",1,5400,5399,"cPa419"
"CNV_Scaffold598_13201-16500","CNV_Scaffold598_13201-16500",1,"Scaffold598",13201,16500,3299,"cPa419"
"CNV_Scaffold941_1-12000","CNV_Scaffold941_1-12000",4,"Scaffold941",1,12000,11999,"cPa75_cPa260_cPa305_cPa196_cPa424_cPa433_cPa425_cPa459_cPa308_cPa327"
"CNV_Scaffold1396_1-2400","CNV_Scaffold1396_1-2400",7,"Scaffold1396",1,2400,2399,"cPa428_cPa356"
"CNV_Scaffold394_1-15000","CNV_Scaffold394_1-15000",3,"Scaffold394",1,15000,14999,"cPa419"
"CNV_Scaffold394_20101-23100","CNV_Scaffold394_20101-23100",11,"Scaffold394",20101,23100,2999,"cPa419"
"CNV_Scaffold1222_1-6900","CNV_Scaffold1222_1-6900",1,"Scaffold1222",1,6900,6899,"cPa308"
"CNV_Scaffold283_14401-28800","CNV_Scaffold283_14401-28800",1,"Scaffold283",14401,28800,14399,"cPa419"
"CNV_Scaffold605_1-11100","CNV_Scaffold605_1-11100",207,"Scaffold605",1,11100,11099,"cPa356_cPa428"
"CNV_Scaffold98_1-6600","CNV_Scaffold98_1-6600",1,"Scaffold98",1,6600,6599,"HERV-F_repbase_HERVFH19I_LTR19A_cPa434"
"CNV_Scaffold211_22801-35400","CNV_Scaffold211_22801-35400",102,"Scaffold211",22801,35400,12599,"cPa356_cPa428"
"CNV_Scaffold1042_6301-9900","CNV_Scaffold1042_6301-9900",5,"Scaffold1042",6301,9900,3599,"cPa428_cPa356"
"CNV_Scaffold178_7201-11400","CNV_Scaffold178_7201-11400",4,"Scaffold178",7201,11400,4199,"cPa419"
"CNV_Scaffold619_7801-15900","CNV_Scaffold619_7801-15900",38,"Scaffold619",7801,15900,8099,"cPa419"
"CNV_Scaffold68_45001-53700","CNV_Scaffold68_45001-53700",7,"Scaffold68",45001,53700,8699,"cPa434"
"CNV_Scaffold676_1-10200","CNV_Scaffold676_1-10200",1,"Scaffold676",1,10200,10199,"cPa152_cPa109_cPa106_cPa505_cPa201_HERV-ADP_repbase_HERVP71A_I_LTR71A"
"CNV_Scaffold123_4801-10200","CNV_Scaffold123_4801-10200",6,"Scaffold123",4801,10200,5399,"cPa428_cPa356"
"CNV_Scaffold556_6901-19200","CNV_Scaffold556_6901-19200",188,"Scaffold556",6901,19200,12299,"cPa356"
"CNV_Scaffold1269_1-6300","CNV_Scaffold1269_1-6300",3,"Scaffold1269",1,6300,6299,"cPa419"
"CNV_Scaffold187_1-6900","CNV_Scaffold187_1-6900",18,"Scaffold187",1,6900,6899,"cPa428_cPa356"
"CNV_Scaffold363_18001-27000","CNV_Scaffold363_18001-27000",2,"Scaffold363",18001,27000,8999,"cPa428_cPa356"
"CNV_Scaffold983_1-11100","CNV_Scaffold983_1-11100",1,"Scaffold983",1,11100,11099,"cPa450_cPa333_cPa323_cPa50"
"CNV_Scaffold238_30601-37200","CNV_Scaffold238_30601-37200",79,"Scaffold238",30601,37200,6599,"cPa428_cPa356"
"CNV_Scaffold486_1-8400","CNV_Scaffold486_1-8400",175,"Scaffold486",1,8400,8399,"cPa428_cPa356"
"CNV_Scaffold228_21901-32400","CNV_Scaffold228_21901-32400",1,"Scaffold228",21901,32400,10499,"cPa363_cPa452_cPa176_cPa449_cPa174_cPa270_cPa456"
"CNV_Scaffold612_5401-15900","CNV_Scaffold612_5401-15900",3,"Scaffold612",5401,15900,10499,"cPa140_cPa125_cPa61_cPa443_cPa363_cPa452_cPa456_cPa308"
"CNV_Scaffold90_66901-73500","CNV_Scaffold90_66901-73500",3,"Scaffold90",66901,73500,6599,"cPa443_cPa264_cPa268_cPa248_cPa118_cPa140_cPa15_cPa125_cPa61"
"CNV_Scaffold326_27301-34200","CNV_Scaffold326_27301-34200",65,"Scaffold326",27301,34200,6899,"cPa428_cPa356"
"CNV_Scaffold1109_6001-8700","CNV_Scaffold1109_6001-8700",4,"Scaffold1109",6001,8700,2699,"cPa428"
